,mr,president,member,congress,honor,today,mark,union,address,old,republic,washington,begin,nation,preservation,liberty,finally,hand,the american people,friend,press,place,let,say,matter,ask,stand,together,speak,day,arm,make,country,serve,well,u,peace,purchase,price,strength,burden,freedom,visit,last year,believe,fail,propose,administration,state,america,could,achieve,prosperity,world,child,humanity,duty,report,tonight,progress,relation,other nation,foundation,lay,change,face,people,high,difference,line,million,harbor,safe,understand,must,look,go,situation,time,see,increase,inflation,soon,turn,government,money,supply,spending,last,6,month,example,percent,remain,interest,rate,reach,largely,continue,industry,construction,already,however,thing,past,call,reduction,cut,nearly,half,first,design,economy,create,job,still,december,run,act,would,far,american,tax,year,ago,faith,steadily,decline,six,10,future,learn,live,also,never,work,wrong,record,clear,history,remember,bring,since,beginning,century,take,away,grow,large,expense,power,start,return,resource,growth,federal,come,energy,independence,help,cost,waste,save,2,billion,get,thousand,effort,many,restore,new,one,way,ahead,easy,suffer,upon,capacity,whatever,need,do,preserve,program,put,road,good,much,course,question,two,happen,moment,product,decade,spend,second,plan,base,four,individual,business,saving,investment,remove,maintain,responsibility,reserve,system,offer,policy,give,back,pass,raise,tell,nt,deficit,budget,office,project,balance,another,highly,point,require,law,show,less,hundred,dollar,important,three,reduce,control,mean,revenue,yet,encourage,production,difficult,without,find,lose,try,seek,relief,promise,keep,provide,invest,urge,produce,hope,exceed,extent,think,occur,5,anticipate,number,employee,force,submit,february,realize,department,education,strong,free,contribute,may,fund,amount,safety,worthy,goal,protect,expenditure,refer,committee,every,abuse,food,whose,almost,area,health,care,nothing,something,august,sign,bill,next,3,the same time,receive,message,intend,others,long,recommend,total,4,affect,social,toward,head,welfare,level,assistance,national,meet,strengthen,pay,operation,benefit,result,capital,essential,citizen,feel,even,school,right,jurisdiction,problem,know,answer,hold,vote,least,neither,properly,indeed,grant,lead,recently,finance,period,avoid,send,want,assume,rapidly,along,exist,part,aid,family,apply,trust,belong,use,either,transportation,choose,fit,accomplish,end,legislation,improve,develop,permit,enterprise,challenge,might,true,reform,like,strongly,support,sound,community,often,service,perform,profit,spirit,source,shall,guarantee,necessary,concern,woman,land,crime,demand,leave,society,justice,forward,house,senate,view,rest,subject,detail,order,the past year,respect,around,approach,leader,little,wealth,instead,friendship,trade,promote,neighbor,south,export,especially,cuba,pursue,negotiate,side,willing,ally,alike,position,action,attempt,behind,clearly,demonstrate,conduct,event,follow,note,january,30th,march,join,announce,soviet,negotiation,defense,process,engage,protection,undertake,europe,asia,east,build,threaten,condition,fall,security,observe,move,pledge,great,rule,god,declare,kind,effect,set,ever,among,men,field,philippine,home,open,water,hard,life,stop,light,generation,test,man,earth,representative,possible,enough,destroy,advance,continent,sense,success,decide,greatly,succeed,endeavor,civil,war,present,heart,struggle,abroad,occupy,material,due,sustain,evil,whole,small,compare,insurance,company,bank,farm,favor,fix,check,diminish,remedy,proceed,regulation,experience,opinion,step,wise,combination,alone,civilization,property,regulate,exercise,confer,name,prevent,corporation,obtain,therefore,unless,mind,attack,merely,determine,draw,proper,wish,become,public,abandon,international,strike,farmer,market,delay,revolution,afford,arise,connection,constitution,execute,statute,within,organization,practice,commerce,operate,directly,earnestly,consideration,passage,provision,effective,doubt,necessity,prove,impossible,purpose,secure,beyond,heretofore,appropriation,enforcement,direction,proposition,tariff,wholly,certainly,include,manufacture,direct,advantage,always,wisdom,treat,perhaps,entirely,exclude,best,principle,regard,allow,cover,labor,soil,standard,wage,treaty,desire,adopt,activity,longer,ratify,pending,seem,application,executive,method,collect,fact,commission,appoint,enjoy,case,constitute,object,competition,judgment,practicable,furnish,circulation,adequate,issue,available,desirable,communication,suggest,character,establish,gold,attention,whether,form,organize,fair,deal,addition,deserve,employ,class,race,judge,general,hop,secretary,employment,request,enact,united,island,lie,felt,amendment,ground,close,thus,recognize,refuse,enter,adoption,north,convention,britain,conclude,ratification,arbitration,settle,difficulty,although,render,necessarily,mexico,court,claim,existence,commend,the last session,panama,acquire,canal,carry,circumstance,importance,invite,discharge,obligation,assure,california,coast,term,opportunity,appear,pacific,promptly,complete,consequence,consent,impose,deem,china,accordance,annual message,instance,branch,prepare,expect,ready,repeal,transmit,govern,july,cease,measure,limit,army,troop,manifest,accept,efficiency,command,body,hostility,officer,train,west,probably,reward,merit,throughout,guard,enable,sell,rather,dispose,post,navy,constantly,territory,population,certain,possession,building,ship,sea,insure,add,development,ability,entitle,danger,receipt,the fiscal year,june,30,fully,justify,establishment,extension,per,cent,able,november,1,extend,value,city,generally,agriculture,settlement,depend,region,living,person,maintenance,involve,credit,management,indian,portion,tribe,induce,though,stock,represent,particularly,thereby,texas,equal,charge,renew,district,columbia,reference,railroad,ought,railway,contain,gratify,appointment,basis,near,accord,session,fear,task,confidence,owe,reason,several,import,central,port,immediately,merchant,conclusion,full,agree,withdraw,except,regret,precede,conference,board,survey,suppose,sure,approve,paper,yield,account,quarter,institution,defend,none,influence,occasion,cause,possess,information,communicate,legislature,supreme,decision,loss,contract,otherwise,agreement,suggestion,commit,party,authority,enforce,derive,study,transfer,tend,sale,violation,third,arrangement,deny,agent,cooperation,compel,attend,destruction,approval,conflict,recommendation,bureau,section,bond,currency,failure,prevail,majesty,france,express,japan,award,date,chief,terminate,commissioner,satisfactory,early,accompany,border,contemplate,across,river,college,assurance,injury,april,frontier,governor,five,fight,relieve,instruction,military,affair,election,october,nicaragua,exchange,custom,consider,agency,loan,privilege,sum,admit,september,york,navigation,gain,indicate,entertain,adjust,consist,article,germany,execution,russia,minister,adjustment,deposit,relate,proposal,manner,embrace,confine,excess,facility,sufficient,behalf,improvement,attain,bear,fiscal year,the public debt,surplus,payment,debt,estimate,treasury,satisfaction,corp,break,age,emergency,appropriate,1st,mile,atlantic,authorize,disposition,acre,mississippi,removal,compensation,12,vessel,interior,pension,majority,ocean,enemy,bind,rise,share,inform,intercourse,veteran,resort,connect,inhabitant,mail,nature,ascertain,silver,repeat,taxation,equally,expand,spain,parent,knowledge,assist,exhibit,commitment,housing,income,worker,commence,science,democracy
mr,1,177,133,177,24,9,1,9,14,2,28,32,13,25,0,5,10,17,5,1,1,20,12,42,16,13,5,11,5,22,8,102,58,2,35,30,7,15,0,1,3,7,13,3,10,9,7,15,305,33,30,3,1,18,14,6,29,22,18,13,10,4,0,21,13,2,18,0,5,10,7,1,2,5,12,5,8,4,44,20,28,0,12,3,140,4,4,3,32,4,8,6,0,22,26,2,11,0,20,4,6,6,16,1,4,14,4,11,5,0,26,0,4,3,4,26,9,2,50,45,26,12,7,48,15,8,1,4,6,0,6,2,0,31,6,30,4,11,5,8,0,16,17,3,2,64,0,8,3,3,24,9,14,0,1,9,19,1,7,8,3,1,3,3,3,4,3,9,8,2,13,52,5,1,0,5,100,0,2,6,21,8,0,2,4,5,19,18,46,37,0,0,2,0,2,0,4,4,0,8,3,0,1,17,20,4,0,4,9,16,62,4,20,4,5,8,4,10,9,1,1,14,3,15,18,29,11,25,3,9,4,11,2,8,7,2,20,2,4,7,42,32,9,10,4,4,2,4,19,0,6,8,14,7,4,8,2,0,2,4,0,25,7,22,1,21,0,2,9,0,77,2,18,3,1,0,13,0,18,3,19,2,1,16,6,0,3,14,4,6,7,13,28,2,2,4,52,26,4,5,17,16,2,1,0,0,17,5,3,0,2,1,10,0,10,4,2,22,7,1,42,11,12,4,45,4,2,33,6,15,0,6,4,1,0,1,4,11,0,8,1,18,13,12,0,6,19,29,3,19,9,3,4,17,16,0,5,0,5,8,3,0,4,18,1,0,23,7,4,6,0,11,2,3,3,4,1,2,4,4,22,2,18,1,2,12,3,11,22,10,20,2,37,34,21,4,35,1,26,6,16,3,3,4,2,4,2,0,7,4,1,11,1,12,6,5,4,10,4,6,3,7,11,12,0,1,6,15,13,15,23,6,0,13,11,7,0,23,2,2,6,6,6,5,4,3,4,5,15,1,3,6,4,6,45,4,0,10,3,24,8,6,22,11,4,0,9,13,9,3,11,2,8,3,2,2,2,30,6,1,3,10,8,2,14,3,3,1,0,3,26,32,3,0,1,2,4,8,5,0,10,1,4,0,10,9,0,8,3,0,3,1,23,6,8,15,2,0,0,4,2,6,1,26,4,4,22,0,14,19,3,4,5,1,3,0,11,13,29,7,3,0,0,0,0,6,2,12,17,4,20,2,3,28,7,7,15,0,0,5,8,3,15,0,8,6,5,3,16,23,4,5,15,4,3,3,0,3,0,5,2,19,5,9,5,3,0,5,7,12,14,32,7,2,10,0,0,2,67,7,11,0,4,3,4,4,8,12,0,0,22,15,26,2,28,4,5,1,9,3,9,0,0,11,0,0,5,6,1,15,1,8,8,11,5,5,0,0,0,3,4,4,0,19,7,38,1,23,3,204,29,1,6,4,24,7,28,5,11,4,1,12,8,28,17,7,4,13,0,13,12,5,43,12,23,2,3,8,16,4,5,20,14,7,4,3,4,8,2,5,5,1,23,6,9,10,2,10,13,9,16,8,3,6,4,13,16,3,0,8,0,29,6,7,8,11,4,7,6,1,5,8,3,14,0,15,6,0,0,5,0,3,0,3,2,4,4,2,58,6,13,5,2,10,16,0,5,4,6,6,4,5,0,19,2,8,7,5,5,5,3,12,3,7,13,4,8,0,4,10,7,3,0,5,1,9,0,2,7,4,0,3,14,1,12,4,2,19,2,17,8,0,3,1,1,8,2,5,3,5,4,3,5,2,2,4,1,4,11,6,0,5,6,11,6,5,3,7,4,6,2,5,6,7,2,2,6,5,15,8,6,0,0,4,2,2,6,12,8,5,17,2,2,5,4,1,3,12,3,9,20,38,3,3,3,2,1,0,5,2,5,12,7,2,3,5,13,7,9,7,3,0,0,0,3,1,11,13,16,2,4,5,4,3,7,2,9,2,3,4,12,22,0,0,1,8,5,22,1,5,3,16,1,9,3,9,10,9,2,14,0,0,3,8,2,11,6,14,5,0,4,0,2,5,6,9,4,49,5,0,0,0,5,0,3,0,0,0,10,2,0,4,0,0,0,11,0,1,0,2,7,5,1,0,0,0,0,8,13,3,0,11,7,3,3,10,0,0,3,4,3,0,13,3,7,4,0,4,2,14,5,4,5,0,5,1,5,0,9,3,2,2,6,1,0,1,0,2,2,0
president,177,1,147,686,36,27,11,115,33,10,125,52,28,129,22,15,20,38,39,18,10,101,47,120,38,62,26,50,35,71,14,396,209,31,111,101,86,11,6,7,20,31,13,11,67,39,46,51,781,83,80,17,23,74,35,9,122,69,42,32,46,11,4,25,50,25,304,11,11,20,31,8,9,13,159,24,35,16,179,53,43,6,32,21,497,34,11,5,87,14,27,5,12,53,64,2,37,8,79,12,26,38,77,17,22,83,2,19,18,15,55,7,19,36,17,64,44,9,223,291,51,57,16,235,53,11,6,3,17,7,24,11,14,102,48,128,18,5,15,37,14,53,64,9,11,165,14,32,14,25,235,6,39,10,10,81,86,8,26,44,24,6,30,22,12,38,10,27,41,36,45,220,30,6,11,19,386,7,13,55,77,27,19,40,3,42,56,36,54,118,13,22,5,8,8,11,42,12,41,14,26,3,2,29,62,47,8,56,22,37,189,19,119,9,17,48,14,29,113,3,8,47,11,19,118,250,38,43,8,7,28,41,23,40,43,14,51,2,8,14,163,72,17,36,23,16,10,27,130,24,18,12,35,4,7,40,26,10,12,42,15,55,46,43,8,80,12,19,20,13,293,11,21,15,7,10,47,10,54,27,138,9,3,42,27,4,43,34,34,30,30,24,136,20,12,18,77,55,32,23,47,122,1,3,9,6,41,21,11,1,3,22,85,11,50,19,16,57,26,12,73,18,89,16,105,17,21,92,18,83,45,20,21,12,18,34,36,17,6,22,12,36,50,28,1,16,83,102,20,25,45,30,21,71,40,10,48,6,29,37,51,10,9,22,4,16,106,16,29,31,1,56,7,22,17,46,26,3,21,5,251,20,88,20,16,39,14,49,60,10,42,15,164,126,62,24,115,11,79,5,48,11,7,12,9,14,17,6,25,18,3,18,6,18,34,20,10,11,6,4,10,24,75,31,3,17,8,30,44,48,38,16,9,48,16,17,5,22,15,6,22,22,10,10,8,5,19,8,58,19,30,22,18,25,74,25,5,70,15,38,19,65,59,39,6,7,27,14,20,8,62,12,9,7,8,34,7,114,26,15,14,39,8,14,17,23,21,8,14,13,117,104,9,17,8,10,7,25,12,21,22,13,4,16,19,40,0,25,15,21,5,22,21,13,27,56,26,16,5,24,5,36,12,91,56,19,42,4,37,62,20,10,23,21,14,14,29,34,117,37,4,9,16,4,7,25,11,23,50,18,283,25,29,101,9,42,25,7,16,37,63,26,61,10,49,21,17,17,76,56,17,7,61,11,16,7,9,9,21,36,1,34,17,31,17,4,11,18,5,21,24,55,25,8,21,6,3,2,99,20,68,4,10,17,12,24,12,122,17,16,69,60,79,7,98,16,38,3,35,7,21,4,4,37,5,10,19,16,29,77,6,39,29,52,14,4,24,6,5,40,12,6,28,103,8,59,15,25,21,437,40,8,21,37,12,36,58,35,35,41,14,8,35,14,21,14,14,12,24,27,32,9,119,77,33,11,7,9,20,13,31,51,34,16,19,27,29,17,10,17,57,24,30,16,17,15,18,35,20,54,15,15,26,11,30,17,29,10,7,12,20,23,12,54,32,61,13,10,28,10,32,24,19,59,6,26,9,3,8,35,9,41,2,11,7,5,36,11,83,15,22,10,9,4,6,10,20,5,18,14,22,5,0,31,12,27,21,12,6,12,4,23,16,14,45,8,20,21,7,10,8,5,6,31,4,22,5,10,16,19,4,16,24,11,50,4,7,59,4,37,14,41,17,9,7,33,2,20,4,42,10,12,37,28,12,17,16,8,40,7,5,18,19,28,2,17,9,16,12,29,17,9,22,45,9,19,13,81,14,14,14,11,33,25,20,24,38,41,11,25,13,21,13,44,3,9,9,18,5,20,67,97,22,6,7,17,9,2,23,14,6,19,22,18,10,18,6,38,14,37,7,19,6,4,16,9,6,29,41,9,11,14,21,11,24,8,8,11,4,9,21,14,11,8,8,38,3,29,23,11,13,17,8,18,79,19,15,15,12,44,17,5,11,11,20,19,5,6,6,2,14,14,8,9,13,14,4,52,14,12,11,12,8,23,20,1,7,16,17,7,11,16,4,4,4,21,9,11,48,27,7,25,14,13,22,13,7,5,80,5,1,7,27,11,11,33,5,1,48,1,12,34,12,6,24,10,1,19,14,18,1,9,10,7,13,1,10,12,21,4,5,1,6,6,1,2,8,10,4,7
member,133,147,1,333,23,11,3,99,4,2,11,14,8,60,5,13,12,15,17,5,7,32,34,47,28,36,15,20,8,29,8,162,93,20,53,57,32,6,8,5,7,14,8,7,36,13,23,22,314,35,50,10,6,31,23,0,54,30,25,11,19,3,4,17,32,21,122,15,8,4,13,2,4,11,92,10,26,4,72,21,32,1,2,2,168,9,4,2,27,4,11,5,3,25,39,6,8,5,31,3,7,22,31,9,7,35,1,4,8,8,18,2,8,17,15,24,9,2,92,154,30,31,22,85,15,4,3,5,7,1,12,5,11,41,19,82,3,6,4,6,5,29,17,3,3,57,9,18,3,16,67,3,16,1,4,57,43,4,8,18,11,4,13,5,7,21,2,18,22,16,14,97,17,11,1,4,121,1,17,37,28,11,6,21,0,22,39,8,64,61,9,4,4,3,7,1,21,3,8,19,25,4,6,7,23,14,12,35,20,12,79,10,43,8,11,20,8,12,34,5,6,23,4,11,64,105,22,20,3,9,13,27,19,21,15,7,34,14,4,5,49,31,12,7,8,9,7,22,55,8,18,8,19,4,5,14,7,2,3,23,5,20,22,8,1,67,15,6,8,16,104,4,13,7,3,0,16,10,11,14,73,4,1,22,10,3,16,13,21,5,5,6,37,7,4,7,26,10,11,19,24,39,0,5,21,11,14,32,8,3,4,14,39,9,35,5,27,38,7,3,38,8,25,11,70,7,11,47,13,42,51,10,12,12,8,15,18,3,11,21,9,17,30,10,0,4,41,34,10,18,13,15,15,22,28,4,11,3,11,41,29,9,8,12,4,6,35,9,28,28,2,26,5,29,9,29,18,2,16,6,87,2,24,12,7,23,16,9,24,5,28,4,110,65,23,5,30,6,31,4,17,5,4,12,10,5,5,5,12,12,5,5,3,11,8,2,2,7,2,2,7,4,14,8,9,7,3,14,4,14,4,10,0,11,14,1,2,7,2,3,8,11,5,2,3,4,7,2,13,2,17,7,9,6,29,31,5,12,8,20,8,25,30,23,4,2,16,14,2,1,24,5,3,4,3,20,4,73,10,3,3,6,2,7,6,15,15,5,2,2,34,38,8,6,6,1,1,14,7,12,7,4,2,2,1,12,7,9,8,5,6,7,8,5,11,20,7,13,4,7,8,14,3,25,6,8,20,7,11,24,12,10,4,8,14,5,3,9,42,27,1,15,7,4,4,8,1,10,14,8,114,2,8,41,15,17,15,4,11,11,16,6,20,2,5,11,11,10,34,36,6,6,19,6,4,6,13,4,9,25,3,11,10,21,8,10,4,6,7,7,21,21,12,1,25,7,1,3,17,10,14,3,4,14,2,20,4,75,5,3,33,47,32,12,32,16,9,3,11,1,4,0,7,22,1,8,1,7,10,21,0,20,28,23,11,3,16,2,8,5,7,15,29,19,4,21,2,10,9,136,18,6,6,17,14,5,37,19,14,13,10,5,16,9,6,8,8,9,6,5,16,8,7,48,14,2,6,4,4,1,5,16,11,4,5,11,9,3,1,5,22,15,14,1,4,2,2,10,10,9,7,7,5,6,24,9,7,8,9,7,8,3,9,20,10,9,7,7,10,7,4,10,1,24,5,3,3,9,10,19,3,24,1,7,6,4,11,3,28,8,6,1,4,5,5,2,6,8,7,13,5,0,0,11,10,15,8,12,6,8,7,13,1,4,27,1,9,7,8,9,5,1,0,18,6,14,4,4,13,8,4,3,9,3,24,5,3,6,6,13,1,19,8,3,3,8,2,8,0,36,3,7,10,11,2,5,5,8,13,4,2,3,1,10,3,2,3,8,2,5,1,1,16,35,0,7,7,21,3,5,12,7,10,6,15,13,8,12,10,7,2,43,18,12,3,1,0,10,2,17,46,23,15,4,6,10,5,0,6,1,5,6,8,18,3,12,0,14,5,7,10,4,4,3,2,10,4,1,18,2,4,6,13,7,11,6,7,4,2,1,7,0,4,3,3,10,2,34,7,8,9,1,7,9,62,5,1,4,3,19,4,5,6,4,28,4,5,3,6,1,2,4,9,11,3,1,1,8,1,1,6,6,7,8,7,0,5,7,7,10,5,11,4,5,0,2,1,1,12,4,4,9,4,3,13,1,1,5,12,1,0,3,8,6,4,1,4,3,43,1,3,4,12,12,6,0,2,2,4,11,1,11,7,0,3,5,11,4,2,2,3,3,1,1,1,1,1,1,5,1
congress,177,686,333,1,129,82,48,544,70,36,268,169,133,611,74,67,97,158,103,37,81,497,187,348,272,355,144,216,78,286,94,2453,1226,141,582,439,301,98,137,54,79,89,47,156,440,201,441,292,3737,306,464,96,157,327,159,49,777,665,125,203,196,54,41,231,275,73,1100,65,88,137,229,83,58,53,800,149,232,56,894,198,571,31,195,66,2265,246,156,39,497,49,109,54,62,348,510,176,175,62,409,151,234,391,374,100,153,507,143,82,168,63,241,91,133,218,80,332,158,50,1503,1629,339,235,233,1096,144,37,39,46,47,48,135,46,53,654,220,706,73,56,93,117,44,337,380,39,28,802,70,151,158,198,845,42,206,81,50,440,339,81,89,243,178,36,93,68,125,122,47,226,255,125,202,956,200,37,47,100,2068,45,134,531,277,145,238,220,101,179,329,214,470,607,51,82,78,13,28,48,281,71,111,113,274,35,48,159,237,176,83,406,141,285,954,81,682,153,38,89,70,203,250,66,61,174,65,164,692,1431,270,234,51,144,207,193,271,276,319,347,332,104,113,82,819,325,69,67,119,120,77,241,858,73,310,238,266,117,121,204,142,66,57,227,97,284,486,109,87,696,99,90,152,68,1635,147,427,75,67,52,253,281,203,139,512,85,44,169,106,31,167,157,151,33,66,71,396,135,80,103,496,221,116,151,233,810,34,59,153,39,212,63,77,39,41,218,434,92,388,201,161,446,136,81,423,97,269,80,566,105,134,334,44,337,171,138,82,75,81,293,164,102,60,147,83,184,237,120,74,72,521,576,214,114,191,150,69,343,225,92,102,49,187,402,558,125,107,186,42,54,478,62,176,153,79,299,63,118,77,408,100,36,115,99,971,32,618,133,71,491,101,222,283,38,258,80,425,285,499,119,1053,86,388,49,246,40,64,49,64,40,67,19,255,151,7,106,48,224,88,113,98,67,47,48,38,91,374,140,26,59,49,124,158,170,133,103,77,281,76,61,17,125,161,67,183,224,93,79,12,19,157,58,360,96,198,87,75,105,421,97,23,198,81,397,123,208,324,194,85,52,198,159,130,18,186,49,46,32,33,60,44,317,196,58,63,150,38,64,74,151,117,54,47,71,729,602,15,46,110,111,34,162,76,157,108,64,51,82,133,184,56,178,103,66,48,90,111,109,174,286,82,122,53,116,38,175,137,284,133,71,233,94,234,341,132,60,39,85,181,60,190,98,406,248,52,51,39,49,92,139,33,205,151,112,833,107,119,540,133,101,308,53,94,180,437,115,418,59,224,180,163,92,488,431,119,124,450,67,97,88,112,57,62,272,70,228,111,136,131,38,65,73,51,117,252,336,110,67,221,43,52,44,541,206,359,38,65,113,136,248,102,513,115,103,330,441,284,57,325,86,235,49,145,76,166,39,64,266,71,100,105,170,157,420,100,535,337,244,136,37,120,92,99,140,107,30,89,256,112,459,98,124,237,1879,184,47,81,129,78,185,359,160,109,164,105,83,245,124,127,113,34,94,111,134,199,118,483,376,374,70,155,321,57,60,145,388,136,136,190,125,126,75,60,110,225,131,190,108,124,194,103,91,186,278,75,74,155,60,171,118,173,60,87,160,66,141,77,393,244,277,89,79,151,97,89,84,52,312,41,151,86,28,65,138,77,222,66,74,76,57,297,46,493,94,147,51,91,97,81,55,175,129,62,110,107,97,73,212,131,161,89,169,96,136,129,160,61,85,290,159,171,78,104,141,63,35,26,173,53,169,90,54,145,116,53,48,114,52,174,77,79,453,79,156,142,302,127,84,153,221,86,153,58,110,80,61,130,251,40,42,76,40,187,85,78,28,158,144,44,87,60,113,55,129,72,72,91,195,143,65,71,270,75,54,104,60,142,70,81,83,107,228,113,132,168,176,92,153,70,148,76,136,134,110,214,420,96,70,58,62,60,92,81,23,79,80,73,78,52,101,34,102,93,404,94,77,77,104,80,54,33,111,179,27,64,75,51,54,163,55,135,73,49,99,65,191,37,63,63,143,51,106,88,57,65,83,68,103,184,48,45,125,66,306,79,90,77,170,194,62,43,90,29,69,105,84,66,133,23,119,29,185,52,70,115,98,75,105,81,59,71,81,54,183,51,117,137,76,65,215,151,259,465,58,54,44,40,66,146,85,60,47,440,70,74,90,61,109,43,174,80,79,120,56,36,77,68,69,110,50,63,67,122,106,115,85,97,81,88,57,73,88,153,35,61,61,59,37,37,67,21,80,29,30
honor,24,36,23,129,1,7,4,35,12,5,22,10,7,130,10,8,12,12,10,7,2,26,18,39,12,21,25,21,13,22,9,140,176,31,46,98,77,0,0,9,5,25,13,2,36,15,23,11,208,54,44,7,28,47,13,9,62,19,26,18,21,4,7,24,20,16,97,4,12,4,3,2,1,5,68,14,16,4,67,35,19,2,7,8,167,8,3,3,25,0,11,11,1,34,61,2,16,3,29,3,2,18,28,16,10,31,3,6,11,2,31,1,7,7,6,25,3,0,41,109,20,38,7,50,9,12,2,4,0,2,20,7,11,37,41,37,12,1,4,16,11,29,24,2,4,66,6,12,10,8,48,1,18,7,3,12,33,8,12,14,6,3,16,2,6,7,7,18,21,12,15,69,19,3,10,10,144,6,10,16,35,14,4,18,6,14,23,18,41,29,1,11,1,1,0,7,11,3,6,12,15,1,1,11,37,15,3,9,16,26,72,14,21,5,9,8,1,9,16,3,1,13,6,10,32,69,25,23,4,2,9,9,8,5,18,4,20,8,2,3,60,22,11,4,15,3,6,21,30,2,13,9,22,7,6,9,6,1,5,10,0,32,21,3,2,10,2,18,24,6,102,8,9,12,7,2,41,5,7,11,80,7,1,25,4,4,8,18,33,1,4,2,9,3,4,8,40,13,4,14,25,19,0,1,3,4,13,2,11,1,1,6,27,12,23,5,12,19,6,7,51,13,23,5,75,2,3,65,0,29,7,3,18,3,9,6,31,5,2,11,14,23,14,10,6,7,35,45,12,17,2,19,6,13,15,0,3,6,10,20,12,6,7,17,7,7,26,13,9,26,5,32,2,12,10,39,8,5,19,2,63,1,25,3,28,13,7,30,28,0,32,7,22,15,35,15,43,2,24,4,27,4,3,5,5,4,4,10,10,13,2,7,1,7,14,14,6,6,6,6,9,6,19,8,5,7,5,15,21,18,2,4,1,14,10,7,3,11,17,3,13,19,4,11,4,2,18,11,13,7,23,4,7,17,54,8,9,11,4,12,18,27,25,61,9,8,21,4,11,1,27,3,6,8,5,28,7,10,16,2,4,16,0,13,14,13,4,7,7,5,88,33,6,16,11,6,1,30,23,5,8,4,2,1,2,6,0,11,2,3,1,5,5,3,12,17,4,12,1,13,4,10,1,9,4,13,13,4,9,26,9,12,6,15,7,11,7,14,15,20,10,3,7,1,1,4,12,14,7,3,22,7,1,23,1,7,21,1,6,16,25,2,13,4,21,9,12,5,16,18,5,8,9,3,5,12,2,7,3,10,1,8,7,27,17,5,5,6,0,12,31,43,6,4,6,2,5,2,38,25,24,0,7,1,3,23,2,28,5,1,14,7,11,6,19,6,14,3,7,6,8,0,5,14,0,2,7,7,14,23,1,18,19,18,1,0,7,6,11,6,3,2,22,6,8,20,0,6,9,146,15,6,11,3,9,14,23,7,4,14,6,6,9,21,7,3,6,8,10,10,19,5,29,7,31,6,5,4,1,6,2,28,15,9,9,16,19,6,1,4,14,15,8,9,11,3,11,3,6,14,4,3,6,1,9,11,12,12,3,9,8,5,2,31,5,27,17,7,6,11,7,6,8,31,4,4,3,3,2,10,5,15,1,1,5,4,29,4,25,1,9,5,5,7,10,2,4,5,1,8,13,4,1,3,0,7,7,10,1,1,1,11,3,2,17,8,10,4,0,12,7,2,5,10,8,14,3,3,9,8,5,5,11,2,5,5,4,20,4,8,9,7,5,4,15,4,2,12,6,3,3,6,6,2,11,5,7,8,10,6,2,2,0,8,1,3,7,4,2,3,11,3,6,6,2,9,6,5,1,3,6,6,18,5,3,11,11,35,4,11,8,9,2,16,3,4,4,4,3,9,11,17,6,5,3,5,9,3,12,2,3,3,5,3,4,4,4,1,6,13,2,3,0,2,4,6,15,23,14,3,7,4,3,6,2,2,9,10,3,2,7,2,1,3,10,8,8,7,6,20,3,15,12,7,3,1,3,2,0,8,2,1,6,5,7,3,2,5,4,5,13,15,3,2,4,15,0,32,4,1,6,2,2,4,1,0,3,8,8,7,3,17,2,0,0,7,12,6,4,2,5,1,5,6,2,2,2,3,19,8,0,5,1,0,0,6,2,8,3,7,10,9,5,8,7,7,20,16,7,6,0,6,9,0,9,1,10,5,21,7,11,3,6,11,2,1,3,8,0,5
today,9,27,11,82,7,1,11,40,9,18,10,15,22,132,5,12,17,18,22,6,5,26,47,65,20,26,39,33,23,39,7,136,86,32,61,132,65,6,23,17,13,39,3,15,38,15,19,11,117,161,43,18,13,186,59,3,10,22,31,25,5,8,6,14,30,34,113,12,4,12,55,4,3,3,144,25,49,7,78,45,48,14,8,17,98,15,7,6,13,6,11,11,35,32,37,27,24,4,45,19,9,23,14,23,32,22,10,24,32,23,20,4,41,37,40,47,2,15,34,79,35,87,32,172,69,6,4,6,7,11,50,12,26,44,37,117,5,13,6,32,7,39,21,8,13,69,10,41,7,4,37,19,11,10,8,19,66,14,8,71,11,13,28,10,28,48,11,20,32,9,19,108,31,17,15,6,77,7,3,90,17,14,38,25,7,38,26,19,9,37,6,9,10,12,14,8,28,9,14,15,28,6,14,4,19,17,5,30,14,21,77,33,25,9,14,45,2,21,15,4,4,20,4,14,18,31,20,28,15,16,13,21,18,13,25,7,32,15,7,7,44,39,10,12,36,4,16,45,30,18,8,10,31,2,1,30,3,11,1,18,6,37,4,1,9,11,15,43,19,3,33,3,2,5,2,17,30,6,4,2,85,7,7,12,13,12,24,27,12,6,1,11,12,14,14,6,17,13,8,14,19,17,5,5,3,21,23,2,15,12,4,22,47,13,49,8,20,24,13,7,26,10,55,27,48,2,34,72,3,22,9,8,6,1,4,3,25,7,3,10,7,19,32,5,4,7,15,28,11,24,5,8,1,51,9,15,9,4,12,33,11,15,16,14,1,25,15,11,22,44,4,48,10,31,11,10,0,3,16,2,22,8,19,6,40,16,9,23,27,8,19,16,11,9,7,11,2,7,14,9,6,18,4,20,8,7,5,2,28,15,6,7,4,13,1,19,6,14,8,24,1,16,14,6,7,4,3,3,7,13,2,6,0,8,17,3,9,11,21,6,14,4,4,19,11,9,51,13,24,8,50,3,23,7,49,5,11,5,8,7,19,47,21,46,7,3,40,15,11,11,40,19,7,24,6,16,5,5,11,13,11,10,5,6,5,4,5,15,6,0,72,26,9,16,17,4,4,4,3,3,7,5,4,12,12,5,15,3,7,4,0,1,5,6,7,4,8,3,1,15,5,10,1,7,2,3,17,8,10,15,11,16,11,6,4,7,2,6,23,13,1,7,7,10,7,4,3,15,1,6,13,2,0,27,6,5,6,3,3,1,2,0,6,5,8,5,7,3,16,8,8,3,2,1,3,0,8,5,4,21,4,6,10,21,7,1,3,6,2,8,16,8,18,7,19,4,5,12,6,4,4,3,11,0,1,4,3,8,10,2,17,11,3,3,8,3,4,1,2,1,6,0,3,10,2,3,2,4,2,10,3,6,18,12,6,6,13,2,9,3,13,13,5,7,1,4,1,3,4,68,4,5,5,1,6,11,17,6,1,4,1,9,0,1,0,1,0,2,9,2,3,9,2,6,5,0,1,0,4,5,8,16,2,1,4,2,7,12,2,1,8,27,4,1,4,16,8,1,7,3,11,2,2,3,8,14,11,10,1,1,3,1,1,10,3,8,12,0,7,1,6,3,2,5,7,3,4,5,0,8,7,6,5,5,1,4,7,4,4,29,10,2,3,6,5,4,7,11,5,2,10,0,0,2,3,9,3,4,6,19,20,19,0,6,9,10,14,3,7,3,24,9,10,9,3,6,9,3,0,3,0,1,9,2,3,2,2,0,4,8,3,7,4,5,5,8,1,5,0,0,2,5,0,4,24,10,6,9,14,1,5,5,1,1,4,0,4,9,0,3,0,0,2,2,0,1,13,0,2,2,8,1,4,3,14,9,2,14,2,3,1,3,2,1,2,2,6,14,1,5,13,7,0,2,7,3,2,0,1,6,0,6,0,7,2,3,12,0,8,7,3,0,4,1,4,5,0,1,6,7,0,3,3,0,1,0,8,1,10,13,19,3,15,1,1,2,3,4,11,29,2,4,7,4,1,0,1,3,1,8,1,4,3,2,5,1,4,1,7,0,0,4,3,1,2,1,3,1,0,2,2,9,1,4,2,2,2,2,1,7,4,10,0,0,5,6,12,5,8,1,1,7,10,4,0,0,6,2,5,2,0,1,1,1,6,0,0,1,6,2,8,2,21,16,1,0,6,1,5,2,1,1,0,1,5,4,3,26,0,14,1,4,0,6,6,12,21,0,9,26
mark,1,11,3,48,4,11,1,21,4,5,16,11,5,62,6,4,0,4,5,3,4,26,7,21,9,1,10,7,3,8,4,102,61,14,30,51,30,4,8,7,2,7,2,3,19,5,13,5,150,16,13,7,14,26,4,8,25,26,5,21,13,4,1,10,10,1,55,4,5,20,9,4,0,5,49,8,9,4,42,14,33,1,5,9,86,3,8,1,28,1,9,4,1,12,20,5,12,4,30,3,3,9,11,6,10,15,4,1,7,5,12,5,3,5,3,12,0,15,30,58,17,22,2,56,6,8,4,2,6,1,6,12,2,27,7,42,10,1,2,16,6,15,18,13,5,36,4,9,2,10,23,5,8,2,4,8,22,7,5,7,5,3,6,2,5,2,2,11,10,3,8,41,16,0,1,3,88,4,5,15,10,12,7,4,4,30,22,18,13,44,5,3,5,1,1,2,5,5,5,11,15,0,0,4,8,3,1,15,3,13,49,4,6,2,1,0,3,2,10,3,3,13,5,14,18,54,34,15,6,10,7,5,3,12,12,4,19,10,7,5,16,22,3,5,13,1,5,15,20,4,2,13,18,2,0,6,4,0,2,12,2,3,14,5,5,16,6,5,9,0,54,2,17,2,2,0,6,2,3,2,42,4,1,13,5,1,6,7,10,1,7,7,4,0,7,4,24,6,5,11,13,14,3,2,4,3,24,4,5,1,0,11,22,5,18,5,11,14,5,1,24,6,13,5,39,4,3,12,0,12,3,2,3,5,7,4,7,5,1,11,4,4,8,9,3,10,16,53,9,2,5,10,3,7,8,0,0,9,14,13,4,5,13,12,6,2,12,3,3,4,0,12,1,5,9,9,4,6,18,3,16,3,17,7,5,17,2,9,22,1,16,2,4,9,13,7,25,3,21,6,11,3,9,2,3,6,0,5,8,6,2,6,8,8,4,2,3,6,2,1,3,3,12,4,1,4,0,9,7,13,6,5,8,5,3,3,0,5,1,7,11,12,5,8,6,1,4,6,16,4,6,6,0,6,47,10,2,3,9,14,7,13,23,28,3,17,17,10,5,2,9,0,1,3,1,21,5,8,13,5,1,23,7,5,3,17,5,0,4,1,23,16,4,5,5,4,2,4,6,4,7,1,7,0,7,0,1,6,12,1,1,2,8,3,1,6,3,14,1,2,5,13,6,9,2,10,5,9,10,12,2,4,1,4,9,5,2,9,18,11,2,5,1,3,3,6,8,7,7,1,12,1,3,37,5,1,20,1,4,4,9,5,18,1,4,9,6,6,14,19,4,5,13,2,10,0,5,2,2,9,6,3,3,15,3,18,6,4,0,8,8,18,7,1,12,2,2,4,31,8,7,1,0,6,1,16,1,18,7,3,18,22,15,2,10,1,4,4,3,1,1,0,1,5,2,5,2,2,6,14,0,13,12,12,3,2,12,1,6,2,3,1,4,9,4,5,1,3,5,118,19,7,2,3,3,8,15,3,1,12,1,4,21,18,7,10,4,3,11,10,9,4,39,9,15,0,1,4,1,5,7,13,10,5,5,5,3,3,3,7,7,9,6,12,2,15,6,5,3,4,7,4,2,5,6,7,5,3,0,5,13,4,2,10,15,18,1,7,4,9,4,5,7,14,2,6,2,4,3,12,6,4,3,6,4,6,3,2,12,6,4,5,2,4,9,2,6,7,5,3,7,2,6,6,3,12,2,8,4,8,4,14,2,0,9,5,6,7,9,3,8,5,2,5,2,4,4,3,5,5,2,5,6,0,12,2,2,12,3,4,4,2,1,4,5,6,3,5,2,2,8,7,7,4,2,2,7,2,14,2,7,1,7,1,2,6,6,8,1,5,0,5,18,6,11,3,2,3,6,3,0,6,6,2,2,4,6,9,3,3,5,1,2,1,1,0,1,4,1,10,5,15,4,1,5,1,2,1,3,2,5,1,1,2,1,0,1,1,1,5,2,5,0,2,3,4,8,5,8,34,5,9,5,4,29,1,4,5,3,6,4,6,5,6,1,11,3,0,6,4,2,5,4,7,1,5,0,9,2,9,0,1,4,4,1,3,2,1,5,2,4,4,5,6,6,3,5,2,3,3,3,4,6,3,3,2,1,6,5,8,1,9,5,1,3,4,1,1,4,2,3,1,2,0,1,3,7,0,8,1,3,0,2,3,1,12,4,0,1,5,0,1,2,7,2,9,2,2,5,1,2,4,1,5,2,0,7,3,9,0,3,3,2,3,0,1,2,3,4,0
union,9,115,99,544,35,40,21,1,30,18,94,29,24,221,40,61,17,33,52,34,13,119,60,104,60,45,63,85,27,75,52,350,375,34,170,265,151,11,8,26,26,68,13,9,115,54,69,34,1528,73,140,29,62,145,21,13,178,100,53,71,44,20,15,50,59,30,502,35,27,65,41,6,12,21,234,52,43,15,255,62,100,5,48,19,627,34,22,1,81,2,19,24,1,96,182,12,37,10,132,32,36,87,124,37,38,82,9,5,57,20,89,19,20,35,4,84,18,10,242,448,102,74,14,177,35,25,9,11,12,5,57,7,28,151,101,131,14,14,19,44,27,96,99,10,22,144,33,40,41,25,227,3,40,30,14,130,75,13,18,33,16,12,39,10,1,23,14,58,58,38,60,373,58,7,19,21,500,11,48,58,57,98,10,40,21,81,130,73,175,81,6,24,6,3,3,10,39,13,20,65,42,2,1,30,122,23,19,98,34,69,240,28,87,16,11,13,1,6,40,7,11,103,16,48,141,252,54,91,14,13,36,47,30,67,86,66,103,16,11,18,222,80,21,15,68,13,34,51,102,23,25,60,55,22,33,44,39,4,13,55,16,71,67,10,18,80,13,61,63,24,438,11,55,36,11,10,53,17,25,9,246,16,2,66,36,11,10,18,60,5,17,16,13,14,9,26,87,27,36,86,84,75,5,15,44,11,57,23,33,11,5,41,87,32,65,35,65,102,40,22,100,15,78,17,249,23,35,108,9,112,59,24,40,10,29,34,48,27,6,47,29,19,36,38,21,14,163,187,42,19,42,40,21,54,59,9,27,3,56,76,50,18,19,39,11,10,110,42,6,60,3,85,14,54,38,50,26,9,99,19,305,18,113,33,9,86,15,57,76,25,64,36,56,44,96,46,144,17,62,21,65,15,18,14,11,26,19,10,40,46,15,66,7,36,7,36,14,32,12,26,37,30,53,58,11,18,14,54,54,53,29,11,5,35,19,13,160,25,29,12,30,46,18,63,14,22,31,24,77,21,51,25,27,20,122,22,24,50,33,96,35,111,88,79,20,2,47,42,8,6,40,13,12,20,13,72,21,71,29,17,34,55,17,21,22,34,25,22,31,19,174,126,17,27,27,33,9,28,43,40,37,11,17,1,22,60,5,42,5,20,22,17,33,13,52,61,16,49,20,44,19,46,34,90,29,19,44,40,37,81,36,26,11,34,34,26,42,24,101,41,13,23,17,13,12,20,15,45,39,12,482,20,18,158,47,21,61,20,17,16,67,13,64,5,65,30,47,25,136,74,64,38,21,5,20,21,22,7,31,60,23,36,31,74,43,20,21,20,30,30,102,84,27,12,117,26,19,12,52,55,80,4,15,19,5,55,27,88,6,26,59,17,32,31,58,43,79,10,24,5,38,18,18,53,4,18,28,11,33,114,19,51,129,151,67,14,31,19,10,27,41,14,53,85,14,39,6,6,17,408,25,22,38,34,18,50,130,56,44,49,28,54,67,18,10,19,5,27,23,28,44,20,64,89,81,29,4,29,0,31,10,60,44,24,24,25,33,20,26,21,77,30,38,61,15,18,30,25,53,54,11,15,8,19,26,21,39,19,29,25,11,12,31,91,73,30,13,22,38,19,16,22,18,29,7,57,16,6,15,94,17,32,13,25,12,15,21,10,202,75,19,14,7,6,19,20,25,24,23,29,54,13,6,8,10,22,25,38,19,7,11,32,7,12,92,37,32,20,20,19,31,12,0,27,16,25,17,5,18,66,12,15,31,5,49,15,16,176,43,23,26,46,15,22,53,70,12,26,11,7,19,10,35,17,19,13,33,9,34,18,16,14,16,25,7,7,28,21,12,32,15,17,19,4,11,16,14,32,16,21,16,24,61,18,35,46,25,87,36,41,25,52,44,30,11,15,22,27,15,33,63,59,18,26,6,10,20,10,20,13,11,17,10,9,20,23,16,16,35,20,7,60,25,30,16,32,2,25,41,19,1,13,14,29,14,6,12,10,17,12,11,31,2,10,10,6,9,23,18,13,19,16,14,28,94,6,2,14,6,60,4,2,23,27,104,9,17,14,11,7,40,16,23,31,10,29,4,24,11,14,14,7,33,36,34,12,13,21,4,39,14,42,9,14,15,26,23,21,43,8,5,18,25,12,9,10,30,23,21,17,11,24,4,9,9,17,14,11,57,21,22,29,15,24,12,15,6,22,29,43,22,35,15,24,22,18,45,17,17,4,12,11,19,5,0,3,3,21,10,9
address,14,33,4,70,12,9,4,30,1,1,13,10,9,32,2,10,3,10,6,1,5,15,11,15,9,11,8,13,15,13,3,73,43,7,27,30,21,1,2,4,4,4,3,5,14,10,17,19,167,22,23,1,5,23,2,3,16,14,15,7,8,1,3,13,6,8,37,0,2,5,6,0,0,6,43,9,13,3,25,15,13,0,7,2,81,4,2,6,28,1,6,0,3,8,16,0,11,1,11,1,8,11,10,3,3,20,1,3,2,0,15,1,6,5,5,10,6,2,23,48,10,19,3,36,6,6,4,2,0,1,7,7,10,16,10,30,1,2,6,2,4,12,15,2,4,47,4,6,2,1,18,2,7,1,3,7,13,4,3,13,9,2,1,0,2,9,2,11,14,3,8,37,12,3,4,4,66,3,3,28,9,6,3,15,3,7,7,6,24,27,2,5,1,3,3,1,10,2,3,4,20,2,5,5,12,2,1,6,3,18,35,3,14,3,3,8,7,10,8,0,0,1,0,13,16,26,9,12,0,2,6,0,1,5,15,2,9,8,2,4,23,22,5,3,3,1,5,4,13,5,7,5,21,0,5,4,1,1,0,6,0,14,12,7,6,12,3,3,4,2,33,1,2,2,0,4,9,0,6,3,19,0,0,8,3,9,25,19,3,0,7,7,8,2,2,6,19,12,2,7,7,17,0,0,2,5,9,2,3,2,1,5,11,5,10,4,3,20,3,5,17,4,17,1,16,2,14,27,7,14,2,1,2,2,1,8,8,8,2,5,2,10,9,4,3,4,16,20,10,6,1,6,0,10,9,1,3,1,6,10,5,3,3,6,3,4,11,4,1,8,4,13,2,8,1,8,4,0,5,2,27,1,8,13,3,11,2,7,10,2,5,7,31,8,19,3,33,3,21,4,15,2,5,5,3,0,2,0,7,7,3,2,0,2,5,3,3,3,1,2,3,3,8,6,1,2,3,6,5,4,25,5,3,13,3,7,4,6,5,2,6,5,4,7,2,3,3,2,6,3,3,4,5,3,13,1,1,6,3,12,9,12,13,13,3,2,10,4,3,0,5,5,3,2,1,1,3,13,5,3,2,0,2,3,3,2,4,4,1,1,23,27,2,2,2,4,0,6,2,1,2,2,0,3,2,1,2,3,2,2,0,3,4,1,6,9,3,3,1,4,1,8,1,6,2,7,14,1,4,17,4,4,5,2,3,4,2,3,14,3,3,6,1,3,4,4,3,5,2,0,8,3,2,20,0,0,7,1,4,7,11,1,4,2,12,2,2,3,12,17,3,3,4,1,2,6,0,2,2,4,2,9,1,4,6,3,4,2,2,6,10,13,4,1,5,0,0,0,26,5,5,0,1,1,4,9,6,8,4,0,12,7,4,4,2,1,5,0,4,0,5,0,1,14,1,1,23,1,6,14,3,11,8,11,3,1,2,3,2,1,4,0,2,20,3,32,2,6,3,96,9,3,6,1,5,7,8,3,3,7,1,4,7,9,3,1,1,5,7,7,6,3,28,14,14,1,1,8,0,1,3,7,3,9,3,3,2,2,3,3,13,6,7,1,6,4,3,0,2,4,12,0,5,2,3,2,8,2,0,5,2,14,0,11,5,12,4,4,4,2,5,5,2,6,2,8,5,0,3,5,3,4,0,5,2,1,1,1,22,1,5,7,2,1,4,1,5,4,1,3,5,5,0,3,1,6,2,6,2,0,0,8,3,3,8,4,5,5,1,5,2,0,1,5,2,6,3,2,2,3,0,1,3,0,5,2,1,13,2,6,4,2,0,1,3,12,5,4,3,2,1,5,1,3,1,9,7,1,2,0,0,0,5,7,1,7,3,14,3,2,2,1,20,5,1,4,1,0,1,4,0,4,6,2,2,6,9,12,2,6,3,3,1,6,1,0,1,3,4,6,11,15,3,0,8,0,3,0,6,4,2,2,5,1,2,3,1,1,2,9,0,2,2,1,0,2,2,5,14,4,3,11,4,3,2,3,2,4,7,4,1,9,1,1,1,9,3,7,1,3,2,9,1,11,3,5,4,1,1,9,1,2,5,2,3,7,2,3,2,3,8,4,1,1,1,3,6,18,3,1,1,4,6,1,5,2,1,0,7,3,2,4,0,1,0,4,2,0,8,4,0,0,1,3,4,2,3,0,4,1,2,4,1,2,5,6,0,0,1,3,2,2,1,2,3,1,0,2,2,4,2,2,2,5,2,0,6,2,12,0,5,1,0,2,1,1,0,3,1,4
old,2,10,2,36,5,18,5,18,1,1,4,7,11,52,4,5,3,9,1,2,1,10,9,14,11,8,10,8,3,11,5,63,53,3,33,31,7,7,8,10,2,6,1,2,8,4,5,1,86,20,14,0,11,37,14,5,21,9,5,10,6,4,0,3,13,3,45,2,5,2,12,2,0,2,35,10,16,1,44,18,21,1,7,10,50,9,5,0,11,4,6,3,2,5,19,1,5,1,15,5,14,4,11,5,5,5,3,7,6,3,6,1,4,4,8,20,0,2,12,55,18,16,4,62,18,3,1,0,4,1,9,6,8,14,12,37,0,1,1,9,3,17,23,1,7,16,7,12,9,9,24,4,3,3,9,4,25,2,7,16,7,2,11,1,0,16,3,5,19,3,33,55,9,3,5,2,67,1,4,22,14,5,8,10,1,10,15,11,10,28,2,3,7,2,0,2,6,3,2,6,16,0,0,5,7,5,3,12,3,9,28,6,10,4,12,9,1,1,6,1,2,12,2,9,9,26,17,12,3,1,4,9,9,10,9,6,9,2,3,1,18,17,6,1,15,2,3,17,15,1,3,6,10,0,3,8,5,6,1,18,5,10,1,3,2,19,2,8,4,4,39,3,7,3,3,1,8,3,3,0,28,1,3,12,6,2,7,9,6,3,1,1,3,3,3,4,8,2,3,5,9,3,2,7,3,5,6,6,4,0,3,0,4,2,11,1,5,9,28,1,12,6,9,9,24,1,5,19,6,6,2,5,3,1,4,5,9,2,1,4,3,4,16,5,3,3,18,19,5,9,4,7,2,18,9,1,7,8,2,7,6,5,7,7,2,6,8,5,2,3,1,5,4,7,3,5,5,4,9,3,19,1,13,5,8,28,1,13,14,1,6,4,1,4,6,3,18,2,6,5,5,3,4,0,8,5,5,2,9,4,3,6,2,7,1,2,0,4,4,0,2,8,8,9,3,1,2,7,4,7,2,1,0,4,2,1,0,0,6,2,9,2,4,8,2,0,14,2,15,6,9,3,4,2,22,0,2,6,4,17,6,9,15,30,2,0,16,9,1,4,24,2,0,2,5,19,6,1,9,8,7,7,4,2,4,4,2,3,0,0,29,18,6,4,8,4,6,2,3,1,5,3,4,3,32,2,4,2,1,2,0,1,3,3,6,3,1,4,5,2,6,4,1,7,1,6,8,4,6,9,6,4,3,6,7,5,8,6,21,10,2,0,1,14,2,0,3,9,6,0,17,0,2,14,1,6,5,2,0,4,7,0,5,1,3,5,4,1,11,13,3,2,3,1,0,0,3,2,1,6,7,3,4,9,4,11,1,3,2,8,9,5,5,3,2,6,7,2,9,5,6,2,3,0,1,4,0,5,7,5,5,2,0,2,6,5,9,7,1,1,6,0,2,1,0,2,0,4,6,13,3,3,15,9,6,1,5,0,3,1,4,1,3,6,5,8,1,2,3,48,6,2,0,3,4,4,7,6,1,5,2,10,5,5,0,0,0,1,1,4,5,7,16,6,6,0,1,4,0,1,0,7,0,4,0,1,1,5,2,9,6,12,2,3,1,5,1,0,4,5,4,2,3,4,2,5,7,4,0,1,3,1,1,4,9,1,0,3,1,7,2,6,6,13,3,1,4,0,2,6,1,3,4,0,3,1,20,1,11,8,7,3,9,11,8,3,9,4,2,0,4,0,1,1,2,3,3,5,2,14,13,8,1,0,7,6,2,2,6,4,5,2,6,5,2,3,3,0,6,5,0,1,6,4,3,1,5,10,5,3,6,7,4,0,9,5,1,0,0,0,1,1,3,2,4,4,2,3,5,3,6,4,3,3,1,0,2,1,1,3,0,2,1,1,1,0,2,0,0,0,4,2,3,0,0,1,0,9,3,1,0,0,1,0,1,1,3,3,0,4,4,6,3,2,3,0,2,7,2,4,1,1,3,1,3,5,5,3,0,5,2,1,1,2,2,4,0,2,2,17,1,3,0,2,2,1,5,2,3,0,4,9,6,5,4,2,1,1,2,11,5,3,2,4,0,0,3,1,2,6,2,0,4,1,3,0,4,3,5,0,3,1,3,3,1,1,3,2,0,0,0,2,0,2,0,1,2,3,2,1,6,6,4,0,1,3,6,4,6,1,1,3,11,0,2,1,2,1,5,3,2,1,1,0,1,4,4,0,1,0,3,3,6,1,1,1,3,1,0,5,0,0,0,4,2,1,3,0,7,3,1,1,1,0,0,4,3,2,3,5
republic,28,125,11,268,22,10,16,94,13,4,1,24,21,126,3,29,25,26,7,7,3,67,11,50,30,16,14,33,14,41,17,268,284,26,100,125,131,2,3,14,12,20,32,9,44,33,32,26,831,119,53,14,50,59,12,13,81,35,2,41,77,6,8,20,21,21,191,1,28,22,4,4,12,17,111,18,19,14,124,45,46,0,44,15,614,17,9,0,98,5,15,15,0,64,129,3,36,9,80,5,17,58,56,9,30,35,2,1,12,8,33,8,3,27,0,72,30,7,136,195,44,69,8,86,15,13,4,5,3,1,19,8,5,97,28,39,38,7,9,21,9,78,78,8,6,142,17,43,9,15,96,1,20,7,12,20,35,9,47,13,7,4,13,5,4,10,9,55,29,28,55,176,34,2,6,20,294,5,10,50,29,23,5,17,5,35,50,25,80,184,4,3,4,1,0,8,16,10,8,10,12,2,2,22,74,19,3,30,30,44,94,4,59,7,0,2,2,1,22,7,1,34,12,22,40,107,41,41,5,5,26,32,4,22,43,14,48,4,4,32,105,42,5,12,31,6,14,26,67,12,19,19,55,5,6,20,32,3,8,11,1,44,58,17,9,33,9,11,24,21,189,7,31,12,9,0,36,5,36,3,71,10,3,45,22,2,4,6,19,3,15,24,1,4,3,11,109,13,17,27,57,34,0,4,8,3,76,4,17,1,11,6,39,10,47,12,21,81,36,9,161,13,43,5,119,16,12,49,7,63,2,12,15,8,20,25,25,25,5,26,11,25,10,29,7,11,93,120,25,10,13,10,19,31,43,3,29,8,33,45,15,8,6,36,22,4,59,19,4,14,9,25,1,16,10,29,11,3,48,9,113,5,59,43,2,38,5,38,50,7,57,5,26,86,63,15,88,4,78,10,52,3,7,4,11,14,9,25,32,18,33,76,3,22,26,12,18,24,7,7,10,28,37,23,2,13,10,15,28,48,11,15,13,37,8,12,4,44,17,0,29,39,29,34,9,6,13,20,45,7,30,24,2,10,86,8,2,44,8,36,32,45,65,46,4,4,13,27,7,1,34,1,7,4,2,46,3,60,27,4,14,33,35,11,23,24,14,18,17,12,119,68,10,8,8,12,4,26,13,4,20,4,2,0,15,2,1,35,6,7,2,10,12,5,16,15,11,12,3,6,8,57,5,44,21,13,35,4,40,44,11,13,10,20,8,7,16,29,73,10,7,17,2,7,1,18,39,36,34,17,80,8,7,67,10,8,58,4,8,21,36,8,39,8,27,12,34,14,64,66,14,18,16,6,4,15,8,12,10,24,2,24,20,43,15,32,14,13,3,15,43,61,10,4,19,11,13,3,225,39,37,3,7,41,45,22,7,44,4,8,43,49,40,17,46,24,34,0,14,8,16,0,4,19,5,11,15,4,19,81,0,37,35,54,31,4,8,9,7,24,17,9,16,47,44,39,0,14,8,596,57,7,8,7,11,23,58,63,28,47,16,12,110,36,61,47,24,26,43,34,28,16,330,28,122,15,10,11,73,10,29,34,31,19,23,15,43,18,5,19,47,17,26,37,21,15,18,29,14,22,17,13,18,7,10,6,43,10,8,19,11,17,11,48,33,45,9,21,40,4,14,31,24,23,7,49,13,4,8,45,13,28,0,14,14,0,16,14,94,9,29,15,4,5,9,20,16,15,8,15,13,8,1,21,3,17,17,10,11,8,6,27,21,5,62,4,39,14,2,31,4,14,5,35,21,24,0,3,8,18,0,8,19,0,33,11,8,208,3,28,12,13,5,17,18,20,13,10,12,11,15,18,21,24,8,7,10,11,34,7,5,71,30,32,4,17,6,13,11,17,24,6,45,13,4,5,5,9,6,17,16,20,24,13,10,21,34,41,22,6,31,23,2,18,2,21,8,15,4,32,55,51,33,4,3,6,9,2,13,6,25,4,2,5,10,16,6,5,9,13,8,14,4,4,10,12,13,25,34,4,31,13,7,22,27,17,12,8,13,12,15,38,0,17,31,40,25,12,11,6,14,12,4,24,11,7,87,27,21,32,2,7,10,9,39,17,5,12,3,4,16,32,10,9,4,17,6,124,30,2,11,1,12,15,8,4,6,8,11,7,11,18,4,3,0,27,26,12,8,17,1,15,3,4,9,7,8,10,30,8,1,2,3,4,1,17,6,4,12,20,9,16,6,8,26,23,2,10,11,29,7,9,11,0,4,8,23,5,30,0,7,11,7,2,1,2,0,19,3,6
washington,32,52,14,169,10,15,11,29,10,7,24,1,23,90,9,8,12,32,20,4,5,23,30,40,18,21,13,26,11,30,8,197,103,12,33,60,33,8,0,3,3,4,17,10,24,13,24,19,363,45,38,6,7,21,29,2,30,27,7,15,16,11,2,15,21,10,112,6,13,21,14,6,2,9,67,13,26,1,96,24,34,0,9,11,250,7,4,3,48,4,5,8,4,19,32,2,29,2,19,7,28,23,21,6,11,23,0,4,8,6,19,12,11,20,3,22,8,6,79,83,30,28,20,92,14,4,2,3,4,6,15,6,16,44,20,87,6,8,3,14,4,30,26,6,3,63,13,29,7,6,49,8,18,6,8,23,34,7,4,10,10,6,3,4,0,15,3,13,11,10,27,66,33,1,10,5,116,2,10,31,27,14,5,19,3,23,17,16,32,90,1,5,3,2,4,10,45,7,19,9,14,0,1,11,11,6,7,23,12,8,82,22,33,9,6,14,7,7,8,5,2,16,8,9,27,62,27,21,5,10,12,22,3,29,13,2,20,6,1,3,41,33,10,13,8,3,10,20,50,2,11,7,20,5,2,15,5,4,5,26,3,19,17,19,7,54,11,2,6,7,76,3,23,5,6,8,11,4,10,5,47,1,1,18,8,8,9,16,15,4,9,21,31,9,8,3,30,9,4,10,21,40,1,2,15,5,24,4,8,5,2,25,32,10,34,12,10,35,29,3,60,3,22,13,36,8,30,38,9,42,7,3,6,3,4,11,20,12,7,11,5,21,13,10,7,5,30,55,10,18,7,13,9,37,13,1,4,4,7,24,18,11,8,22,4,4,25,2,9,19,5,21,3,24,8,15,6,2,17,1,45,2,33,11,11,18,8,22,36,1,12,6,29,17,30,12,57,1,22,5,23,14,7,3,3,13,1,2,21,9,2,18,2,21,14,12,1,8,2,1,1,8,22,7,3,5,3,14,12,20,15,7,5,16,11,8,0,31,5,2,14,16,7,9,1,3,13,6,26,9,8,12,10,7,69,12,2,13,12,23,13,17,24,17,15,0,22,12,9,2,8,5,3,15,7,14,3,29,19,6,4,12,10,13,8,13,9,6,6,5,40,30,7,4,8,3,7,13,5,12,8,7,9,0,15,6,0,21,5,3,2,4,10,4,10,17,4,5,2,2,2,11,2,16,4,10,19,2,15,14,2,13,5,7,6,9,9,15,29,5,8,14,0,7,1,19,4,20,26,12,35,5,4,46,11,4,20,1,9,7,23,1,26,2,7,5,11,8,28,32,6,11,11,2,10,5,11,3,2,12,5,16,4,9,6,8,8,1,5,19,17,17,12,0,29,11,5,3,90,13,16,2,4,14,16,14,0,18,4,8,17,41,15,2,36,12,12,5,3,4,5,0,2,6,2,7,16,11,16,27,5,23,11,20,17,4,12,4,4,9,9,21,3,41,8,16,3,11,4,219,28,0,4,4,12,12,24,7,4,12,5,13,31,32,14,14,15,15,7,10,12,2,38,9,60,4,9,8,0,8,8,29,4,11,18,4,4,1,5,11,13,10,20,19,5,12,12,4,7,4,16,9,7,12,10,17,14,2,2,8,13,24,3,18,13,17,9,5,10,5,12,13,8,21,2,9,3,3,2,14,0,16,1,6,7,5,7,3,50,18,14,6,11,8,13,4,10,16,3,4,6,4,0,18,5,6,3,17,9,2,2,13,8,7,9,7,131,2,10,12,10,1,6,12,3,9,1,3,6,6,3,2,4,3,15,2,9,5,3,11,6,72,44,6,7,20,3,12,2,12,4,2,8,13,4,2,4,1,20,5,5,15,4,7,2,13,2,17,6,7,7,2,73,20,17,3,4,17,5,3,8,2,11,3,3,3,8,22,7,7,20,12,4,12,2,3,2,18,3,13,31,22,6,1,2,6,4,1,4,4,13,1,7,6,3,8,2,11,11,8,9,0,4,0,3,3,19,14,22,2,10,6,2,7,29,5,7,3,0,9,7,22,2,4,7,31,0,15,14,7,4,11,4,7,4,10,8,14,2,22,0,2,7,7,6,7,10,7,2,2,7,13,6,7,5,11,3,32,7,5,17,8,3,7,2,0,9,1,2,33,3,8,1,0,1,3,4,3,10,3,4,8,7,2,6,5,2,6,10,6,8,4,2,1,2,14,2,0,6,9,6,4,7,5,11,6,1,4,7,3,0,6,4,0,5,3,2,3,28,4,5,2,7,1,15,0,6,1,7,2
begin,13,28,8,133,7,22,5,24,9,11,21,23,1,115,10,10,13,14,16,11,12,38,63,54,22,32,29,43,22,38,9,202,102,19,60,142,68,8,25,14,6,18,6,22,34,7,27,26,189,101,44,21,12,89,54,1,15,27,46,35,8,5,13,24,31,18,131,17,1,23,30,9,14,7,152,26,44,4,113,35,87,13,23,23,151,19,17,13,39,4,15,3,22,23,31,21,27,7,57,12,38,63,19,12,33,34,13,32,16,14,35,9,44,33,28,48,3,8,47,101,39,53,43,202,35,8,13,14,4,14,36,19,13,59,31,164,0,7,18,21,16,49,45,12,6,100,8,24,9,13,56,22,21,13,22,42,59,13,9,54,25,12,12,4,20,33,17,29,39,15,51,87,32,16,12,8,117,9,3,92,33,7,45,37,10,30,27,18,10,48,4,11,11,11,12,9,28,20,27,18,35,6,7,13,18,26,15,23,18,43,56,29,37,7,13,37,20,28,15,5,9,11,2,10,31,63,47,32,9,8,20,35,32,29,44,20,50,14,20,4,55,38,16,7,22,8,6,33,62,9,16,20,27,4,4,16,3,11,2,19,1,53,13,3,11,33,18,23,24,6,70,14,24,8,1,9,25,30,3,5,89,8,10,15,20,10,21,24,8,9,8,9,19,19,8,5,29,15,2,31,32,17,5,5,4,15,25,3,15,10,8,32,43,30,25,17,14,43,18,6,27,12,47,24,45,5,22,63,6,27,8,2,3,6,7,15,32,10,3,14,5,27,25,9,10,15,12,47,23,31,10,5,2,57,12,3,10,4,13,56,22,15,33,17,4,12,16,8,26,32,7,38,7,31,16,25,4,8,15,6,57,7,38,11,27,45,17,21,29,9,14,12,26,10,25,11,23,3,34,3,11,18,6,8,5,7,9,4,36,14,3,13,9,18,10,16,7,16,5,16,7,9,24,14,11,7,2,10,7,23,12,10,2,7,15,3,6,19,24,19,9,13,16,12,3,13,61,17,31,7,41,3,17,6,52,6,7,4,6,25,30,30,25,45,14,4,47,20,13,6,45,19,6,14,13,22,10,10,26,17,14,13,4,6,13,8,10,16,8,2,114,35,8,6,11,6,13,2,7,2,16,13,10,5,10,7,31,9,7,9,2,1,11,10,15,6,12,6,6,14,5,9,4,17,6,4,16,2,14,14,6,10,8,10,22,5,7,8,47,20,2,8,4,27,15,14,7,14,4,7,14,4,3,44,11,5,20,5,5,6,6,7,11,7,14,8,12,3,18,18,9,8,19,3,8,1,0,3,9,28,7,7,15,10,7,3,9,8,3,14,12,17,11,3,15,3,4,7,23,9,15,3,7,3,4,19,9,11,13,4,21,16,9,9,10,2,5,5,4,3,12,0,6,11,6,7,5,4,15,26,16,13,14,10,8,2,12,4,6,6,8,11,9,23,5,29,10,10,11,101,22,12,10,6,8,16,20,13,3,13,4,11,8,8,4,1,2,4,4,10,20,9,15,11,8,4,5,8,16,6,21,39,5,15,7,6,4,6,4,12,16,21,8,11,10,34,3,1,5,5,14,6,4,4,7,17,22,10,0,5,4,19,7,14,21,24,29,2,5,8,8,8,1,16,11,9,13,7,4,19,7,7,3,9,5,7,29,6,22,9,25,5,12,20,20,7,15,16,6,2,17,6,8,14,10,12,9,11,7,17,13,14,5,12,20,16,30,10,12,5,9,10,10,18,6,14,9,3,3,8,1,2,10,5,3,10,5,2,6,9,11,5,2,4,8,13,15,3,3,3,8,9,3,9,11,10,10,5,9,2,4,4,11,21,7,6,7,8,11,10,1,4,13,12,8,3,6,9,2,5,7,7,8,15,7,10,7,12,3,6,0,0,1,8,7,13,13,11,7,5,13,14,3,0,12,4,6,2,3,5,5,4,2,5,1,2,3,4,10,11,4,6,5,3,6,7,3,3,7,5,1,9,2,3,4,3,11,3,4,7,12,19,4,2,4,6,4,9,6,21,5,1,7,7,9,7,4,9,2,13,6,6,10,6,4,9,12,6,10,8,3,2,3,3,4,3,1,11,2,2,2,6,4,4,2,10,6,2,3,18,5,8,21,2,14,13,14,23,26,2,8,9,3,5,4,10,7,5,13,3,5,15,0,7,2,5,3,5,3,7,5,4,26,13,2,1,7,6,5,3,11,5,0,3,5,5,4,19,4,13,3,7,1,9,13,15,9,4,7,14
nation,25,129,60,611,130,132,62,221,32,52,126,90,115,1,52,87,50,137,87,62,33,214,161,204,114,128,172,144,97,136,91,1040,798,138,333,770,710,31,63,93,79,174,34,34,216,114,109,103,1586,441,265,80,176,764,132,71,297,96,105,179,156,126,26,99,140,96,775,43,68,66,126,26,28,37,863,147,154,44,503,217,272,11,77,98,1103,79,65,14,147,11,39,73,26,200,352,40,114,29,319,107,55,172,161,88,125,169,31,41,60,36,161,55,82,111,50,214,25,16,356,918,298,185,69,480,92,65,45,28,21,17,182,45,97,315,223,409,131,23,53,174,73,266,182,34,53,484,43,178,94,70,412,22,87,81,67,120,311,117,117,196,49,52,79,16,64,68,41,170,162,59,119,689,137,49,46,81,910,36,81,316,157,120,106,136,28,189,215,171,208,339,25,79,59,33,36,39,93,82,48,203,151,23,35,47,236,136,38,153,95,231,433,83,125,64,47,51,12,58,80,22,31,189,31,84,236,459,189,204,47,65,78,96,83,110,281,52,246,78,66,57,370,215,47,58,196,44,46,234,284,45,72,113,193,28,28,106,40,18,16,90,21,270,85,16,55,135,89,130,160,45,735,51,64,57,33,48,195,59,34,12,511,65,32,115,85,28,74,101,133,26,11,41,36,36,28,70,158,37,47,183,210,118,13,19,68,35,282,32,75,18,23,147,225,94,174,54,106,187,88,68,318,76,229,73,633,36,115,230,28,167,29,74,75,26,80,77,171,42,30,71,79,74,111,88,61,52,186,309,100,89,55,62,52,232,141,28,35,65,108,187,114,68,151,149,35,57,210,82,51,145,25,181,40,116,86,101,43,31,150,37,428,20,241,78,98,221,64,126,149,42,269,59,54,59,149,98,234,13,168,30,178,51,40,50,45,81,44,67,168,100,62,80,35,94,83,95,43,57,55,70,51,74,184,84,37,56,37,105,76,117,27,25,11,49,72,52,48,96,103,54,114,119,55,173,34,57,165,81,224,47,192,35,81,42,432,69,49,70,75,131,123,205,315,267,55,26,168,113,80,29,166,63,20,62,36,184,99,84,154,71,83,115,67,69,76,44,49,46,55,13,751,212,49,79,95,35,44,120,52,52,99,68,28,8,24,47,55,79,22,29,25,40,37,31,49,71,37,63,15,82,46,95,38,127,39,34,131,51,106,155,81,75,49,70,55,47,46,98,267,94,37,70,38,82,48,39,60,110,73,28,116,21,21,231,58,65,235,23,47,53,103,16,65,49,76,79,78,57,181,253,47,29,40,22,44,34,12,36,41,98,38,63,76,172,83,80,37,40,23,84,214,191,65,27,159,37,50,34,254,129,100,24,55,29,39,114,30,102,36,23,170,77,50,64,158,56,62,27,34,29,42,16,32,81,28,22,40,53,89,178,35,96,134,146,54,21,117,43,44,43,74,28,47,93,53,88,42,27,42,1260,86,63,43,18,59,79,166,166,62,68,17,48,61,135,59,19,48,54,47,61,111,54,197,97,117,48,26,18,27,48,33,148,79,47,66,52,120,53,18,45,85,134,60,85,38,59,61,35,52,35,59,33,21,54,46,65,96,72,24,17,34,25,38,123,78,132,51,60,79,56,32,27,50,76,27,50,44,23,19,106,61,75,27,46,26,17,148,54,139,94,73,36,50,63,129,36,86,122,43,36,71,10,18,24,17,56,46,75,26,45,39,114,15,22,105,103,88,31,66,62,83,44,33,75,31,71,41,20,45,56,39,20,81,16,83,39,37,69,45,63,49,52,24,36,57,124,21,35,19,16,38,39,71,27,74,29,79,54,89,38,26,23,72,37,40,25,36,73,10,59,31,18,97,25,14,22,52,37,24,27,42,54,74,68,70,62,69,182,95,36,27,27,24,41,33,38,50,81,12,80,137,90,58,28,18,18,63,21,40,24,27,63,27,44,26,40,57,12,65,39,33,17,30,54,42,37,29,94,75,115,11,19,20,21,29,21,36,28,48,26,56,69,21,21,38,44,32,18,39,112,27,24,58,67,24,12,22,24,14,112,23,23,42,30,56,15,14,67,38,20,40,57,25,31,41,46,38,80,28,11,26,48,36,30,23,14,24,45,38,63,28,100,17,18,16,65,85,49,57,22,11,30,26,32,18,14,15,49,52,17,20,40,18,7,21,130,26,19,12,41,78,48,75,65,29,45,43,39,33,27,4,39,20,26,39,31,70,66,120,27,30,31,31,37,12,28,20,24,26,57
preservation,0,22,5,74,10,5,6,40,2,4,3,9,10,52,1,10,6,11,4,3,7,19,7,8,14,4,6,7,4,3,3,75,67,3,26,46,30,3,6,6,3,2,1,2,10,7,12,4,162,3,20,4,10,23,6,0,26,13,1,13,4,4,1,6,7,2,68,2,1,6,4,4,2,2,34,20,10,1,32,11,13,1,9,3,88,12,17,0,7,0,1,1,2,7,24,3,11,1,19,6,13,9,10,8,11,8,1,2,9,2,8,2,3,4,0,13,0,2,28,37,18,4,4,29,1,6,4,0,2,0,22,0,3,21,10,21,2,4,3,4,1,10,12,4,4,19,4,12,5,3,44,1,4,12,7,13,15,7,9,9,2,14,3,2,4,5,2,7,8,4,6,48,12,7,1,5,105,3,7,22,9,18,1,6,9,10,13,6,9,18,3,7,3,0,2,3,8,1,4,5,7,0,0,2,16,6,12,23,3,10,37,1,15,1,0,0,0,0,9,3,1,9,3,5,25,45,9,8,4,2,6,10,3,6,15,8,21,3,2,1,41,19,1,3,2,2,1,7,14,3,5,4,8,3,8,4,4,1,2,6,0,10,11,1,3,16,6,0,8,7,62,4,4,11,3,0,11,8,7,1,38,2,2,9,3,1,3,14,11,0,1,0,8,1,1,2,14,0,5,6,14,22,0,0,0,1,13,1,7,1,1,20,6,2,7,4,8,16,3,11,15,9,13,3,30,7,7,6,2,9,5,7,2,2,4,9,6,3,3,2,7,2,15,7,7,4,23,28,12,4,5,6,5,33,8,3,0,1,6,9,13,4,6,12,2,1,5,3,1,10,3,15,6,6,4,5,4,2,5,5,28,1,21,6,2,43,4,9,9,2,13,1,9,2,17,5,22,2,16,4,15,2,5,0,5,2,1,0,7,5,0,3,1,7,0,2,0,1,4,0,0,1,6,3,0,4,1,5,10,4,2,0,1,6,3,0,0,4,4,3,4,35,2,4,1,2,1,7,23,7,6,4,2,2,27,3,1,1,4,13,2,14,20,13,3,0,8,5,18,0,8,2,3,6,1,10,8,6,8,8,6,6,2,1,4,8,3,1,5,1,30,23,2,5,7,3,3,9,5,8,11,3,3,0,2,4,6,1,3,11,5,4,5,15,13,8,0,7,2,6,9,9,4,13,7,4,8,2,4,15,2,4,1,2,7,3,10,7,20,15,3,3,0,2,1,7,3,9,2,4,48,5,4,25,3,1,21,2,6,3,10,0,7,3,8,9,6,2,17,15,11,5,7,0,3,3,4,4,8,7,4,8,9,10,5,0,5,6,3,4,12,17,3,1,6,5,3,0,3,4,11,1,3,1,2,12,7,19,3,2,7,10,3,4,15,3,16,0,4,1,5,2,3,3,3,3,9,4,11,16,0,14,15,14,6,0,3,5,2,6,2,2,2,15,4,15,1,0,2,80,10,3,10,5,1,10,11,3,0,11,4,6,4,8,0,1,0,3,5,2,13,3,6,5,10,13,4,8,0,9,1,12,2,9,6,6,5,1,7,5,4,2,4,4,2,7,1,1,2,8,0,4,2,3,8,4,8,5,3,3,1,5,1,16,10,5,1,1,1,5,3,0,0,7,0,7,5,1,1,6,4,11,1,1,0,1,22,1,14,8,13,5,7,6,17,6,9,3,1,1,16,3,1,2,1,5,2,10,2,2,2,5,0,2,10,4,5,6,6,3,14,5,1,7,9,6,0,1,10,4,3,2,3,0,4,1,4,1,4,4,3,4,0,3,3,16,2,5,0,5,2,0,2,0,0,0,5,2,7,0,4,2,1,3,0,1,4,1,1,7,1,1,3,0,0,3,1,4,3,5,2,2,14,5,4,5,7,11,4,3,2,3,3,10,3,0,3,2,5,8,3,11,2,1,7,1,4,3,4,2,3,2,2,2,2,4,12,3,4,2,5,6,1,2,1,0,1,1,5,2,1,1,3,1,4,0,5,0,5,6,1,6,0,2,1,2,4,0,3,1,1,3,1,4,3,0,0,2,2,14,0,1,2,1,3,1,2,2,1,1,8,2,1,5,0,5,4,1,2,2,3,0,4,0,3,4,2,4,1,13,3,6,3,3,1,4,5,9,5,3,0,2,1,1,2,2,4,2,6,2,3,3,5,0,2,4,7,6,3,5,2,8,2,1,0,4,0,10,8,1,0,5,1,0,4,3,2,2,3,0,4,0,2,1,0,1,1,5,2,0
liberty,5,15,13,67,8,12,4,61,10,5,29,8,10,87,10,1,13,28,13,15,6,35,40,33,27,8,26,16,14,17,14,121,127,10,50,107,84,4,5,20,6,51,3,1,20,10,15,14,231,42,33,7,21,66,17,17,34,4,6,32,2,5,13,9,31,11,182,9,4,5,22,3,9,9,86,23,32,1,62,49,18,0,16,5,204,3,3,0,34,0,4,11,0,26,42,0,6,4,31,7,4,24,24,9,13,18,5,2,2,7,10,1,6,15,0,17,1,1,25,109,31,24,14,48,20,9,6,0,5,3,16,5,18,37,22,39,7,8,3,19,6,20,18,1,16,63,9,18,11,2,75,1,12,8,4,32,50,7,30,11,2,3,15,1,2,6,6,20,18,10,7,94,34,4,2,5,148,3,12,34,14,36,0,7,5,16,14,23,25,34,1,7,6,1,0,2,6,6,5,27,24,1,3,4,36,8,3,20,7,30,82,4,16,4,8,1,0,0,0,0,1,23,5,12,17,106,28,24,6,3,10,2,6,35,31,9,22,4,2,5,80,32,3,7,21,3,8,16,35,5,5,8,29,0,1,12,11,1,1,9,9,21,17,0,9,10,5,11,25,4,96,3,11,7,7,4,29,5,2,1,82,10,2,20,7,3,1,2,16,2,3,0,16,2,1,4,18,7,2,27,38,12,0,4,16,9,20,4,11,1,1,26,17,6,11,7,13,35,9,6,61,10,32,1,112,8,6,36,3,23,7,3,14,3,11,13,16,1,1,9,9,4,12,10,6,3,30,27,15,10,29,18,6,20,29,0,14,5,11,20,21,3,4,13,6,7,13,16,5,19,2,19,11,12,23,5,9,5,36,9,88,9,43,20,12,24,7,13,21,10,53,5,5,6,21,9,35,3,36,3,25,3,2,5,12,13,3,3,13,15,8,12,0,6,11,13,1,13,3,3,7,3,19,12,7,1,6,20,5,14,2,1,0,8,7,3,1,5,8,5,16,26,3,21,4,8,11,8,51,5,24,2,2,7,60,21,10,11,11,15,27,40,28,41,5,22,13,16,7,1,50,3,3,8,11,30,14,13,12,2,10,18,2,4,11,14,4,20,3,5,44,17,8,14,9,2,5,5,7,11,6,7,5,1,3,12,2,14,4,3,1,11,9,4,11,5,3,11,3,10,5,48,15,51,11,5,19,11,9,21,13,19,7,22,22,10,5,10,41,12,2,3,4,1,5,3,20,11,4,8,74,1,4,38,6,7,21,0,2,8,17,1,7,11,18,13,9,8,35,41,12,8,4,0,6,4,2,4,3,6,0,6,11,18,9,7,4,6,3,12,45,17,6,3,37,6,6,3,27,26,19,4,6,3,3,16,5,16,10,3,22,21,7,23,31,8,20,1,8,1,7,2,2,9,3,8,2,5,10,40,3,16,30,26,13,4,11,4,4,6,13,11,27,17,1,4,1,1,5,105,31,3,6,1,18,9,32,12,4,11,3,6,7,6,3,2,3,3,4,10,8,5,37,31,18,11,1,4,0,3,1,15,4,3,13,6,8,6,1,9,17,17,4,6,1,5,9,5,5,10,5,6,1,6,4,8,15,6,1,4,12,4,3,25,12,11,7,12,9,0,3,10,4,6,3,4,3,2,4,9,8,11,0,6,3,0,8,6,15,9,14,2,2,0,5,5,7,3,3,7,10,0,0,1,1,8,3,6,8,1,3,10,3,1,22,10,9,3,4,4,10,4,3,13,7,18,4,3,1,12,2,6,5,0,5,3,5,15,9,8,8,5,1,7,19,14,8,4,1,2,5,1,10,0,15,3,11,12,11,1,0,1,1,3,2,0,2,5,1,14,4,0,1,0,0,1,2,0,3,1,3,5,32,9,5,11,7,32,21,4,8,11,7,19,2,13,7,13,0,10,9,33,10,2,5,0,8,1,4,0,2,15,4,1,7,12,8,3,13,8,1,4,3,1,5,7,1,13,8,2,10,2,0,3,0,2,2,0,3,3,5,6,0,1,11,4,2,0,3,7,5,1,1,12,17,4,0,2,2,10,2,0,12,3,10,2,3,2,2,2,5,5,3,4,0,2,4,7,1,2,2,0,4,9,5,1,2,4,6,8,6,13,0,5,3,3,6,3,7,8,0,5,11,0,2,0,6,6,2,1,0,3,2,1,1,5,1,3,3,2,14,5,3,5,3,4,0,4,1,7,2,8,0,1,5,5,8,0,14,4,7,3,3,1,0,1,2,3,6,16
finally,10,20,12,97,12,17,0,17,3,3,25,12,13,50,6,13,1,14,17,4,4,29,39,29,14,17,19,23,13,26,13,134,89,17,34,81,41,4,9,3,7,15,4,11,23,15,15,9,170,46,47,10,14,48,14,7,34,17,23,18,11,9,2,19,18,8,66,10,9,5,18,0,8,2,84,8,27,5,58,30,26,4,9,4,140,12,4,2,29,1,8,13,4,34,31,12,12,2,26,4,6,23,17,14,11,18,2,14,12,2,31,2,22,19,25,21,3,2,57,80,13,42,14,79,11,3,3,0,4,6,20,4,12,33,26,77,5,6,6,11,7,30,29,2,4,56,5,15,9,5,38,6,13,3,8,13,32,8,15,36,12,6,7,0,9,28,6,28,19,15,10,76,23,4,13,5,87,2,6,37,18,5,17,35,4,19,12,14,39,48,5,5,3,8,3,8,16,5,14,6,20,1,2,6,18,6,4,22,11,18,55,12,24,9,8,29,8,14,14,4,5,10,7,13,23,45,7,15,6,4,6,7,20,10,31,13,23,8,5,9,53,22,7,11,9,0,7,29,23,4,14,16,20,3,5,6,8,2,4,7,2,31,23,6,1,13,5,21,21,6,55,10,15,3,2,4,22,6,9,0,55,6,5,2,9,1,15,7,4,3,5,8,21,7,1,5,22,4,7,13,26,17,1,2,7,3,16,1,6,3,4,13,17,11,32,10,12,26,11,2,30,2,16,5,50,2,12,47,8,30,21,2,6,7,6,11,16,1,2,3,3,16,18,3,5,6,27,41,14,25,6,20,3,20,8,8,6,3,8,37,12,2,9,9,1,9,15,10,22,25,5,36,2,17,8,13,6,1,7,4,32,2,15,9,14,15,12,10,23,0,18,2,11,13,18,11,23,1,32,5,10,13,3,11,6,4,4,3,5,9,2,5,1,9,17,11,8,6,3,13,4,8,9,6,2,5,1,4,9,9,4,3,1,14,8,1,4,24,15,7,13,12,4,12,1,3,30,12,10,9,22,0,16,2,26,11,7,19,5,16,15,10,12,25,2,7,21,13,4,1,19,16,0,2,0,13,8,6,10,5,5,12,1,7,6,26,1,9,2,4,68,25,4,7,9,4,1,7,2,2,6,2,1,7,11,15,3,11,16,2,0,1,5,8,5,15,5,6,2,13,0,12,7,10,5,7,18,8,9,10,8,6,7,4,15,6,7,10,37,13,3,0,5,2,7,5,7,9,10,5,37,1,0,22,4,4,22,0,3,6,14,5,9,4,8,6,4,7,18,24,5,4,8,2,2,6,4,6,1,12,1,8,4,12,3,6,5,6,2,10,14,20,10,3,8,1,3,9,34,15,16,2,8,4,8,7,4,18,8,2,18,31,11,6,11,3,4,5,5,4,4,6,0,16,5,5,6,5,7,30,2,7,15,11,5,2,5,6,6,1,3,5,6,13,4,16,5,7,5,113,24,1,6,0,6,10,27,15,8,12,4,5,24,12,13,5,5,17,6,5,9,4,28,35,26,3,1,3,4,4,13,12,8,4,8,4,7,4,2,8,7,15,5,6,2,9,5,3,6,7,1,7,3,2,7,6,9,5,3,2,4,8,4,10,9,13,19,5,11,4,3,1,8,14,2,4,4,3,3,6,1,7,2,4,13,1,10,1,23,1,7,3,4,10,2,2,7,2,2,3,7,2,1,3,1,11,4,6,1,5,4,8,4,3,9,6,7,1,1,10,8,2,6,12,7,11,6,1,14,8,3,1,9,1,3,3,6,23,3,7,5,6,0,4,7,7,5,3,2,3,1,1,10,13,14,2,5,5,14,3,0,3,2,12,2,4,1,13,2,5,0,1,5,2,1,4,6,4,10,4,7,3,5,3,8,2,3,7,7,3,3,6,6,21,1,4,5,20,1,9,18,10,11,1,1,6,3,2,8,3,6,3,5,2,6,7,1,5,7,4,2,0,3,2,4,5,3,8,15,1,13,7,3,4,13,7,5,4,9,1,10,4,8,1,0,8,3,7,3,8,2,6,9,2,9,6,9,2,1,12,3,10,1,7,6,7,1,4,2,0,7,10,5,12,0,0,1,13,5,1,3,7,9,2,1,2,0,3,1,0,1,7,2,2,1,9,9,0,9,0,4,14,1,0,2,5,3,3,12,3,5,2,1,5,4,3,3,1,7,1,1,2,9,11,4,2,4,9,2,4,0,4,6,0,5,4,5,12,12,5,2,2,1,8,2,5,10,2,1,8
hand,17,38,15,158,12,18,4,33,10,9,26,32,14,137,11,28,14,1,20,11,6,57,27,50,39,21,26,48,17,44,8,248,173,29,67,130,81,21,24,16,16,17,8,7,42,29,29,20,320,66,56,11,23,74,31,5,78,26,21,21,18,13,4,20,28,18,214,7,11,14,20,5,12,12,192,22,56,7,117,57,62,0,22,14,363,45,26,0,47,10,14,12,0,44,81,26,40,12,43,24,13,41,37,18,19,48,9,8,17,13,24,16,13,49,8,38,6,12,82,250,63,48,24,117,17,8,2,4,8,2,23,6,16,79,40,129,19,5,11,10,10,51,31,6,4,101,21,26,20,14,118,5,36,21,5,30,51,13,11,41,16,7,23,6,3,21,9,21,32,12,18,194,39,7,23,11,276,6,20,71,35,32,9,49,7,54,76,24,31,68,2,13,13,2,3,11,22,14,22,27,47,14,8,10,36,29,17,52,25,32,104,22,37,10,12,25,1,3,26,3,12,23,11,22,47,131,45,45,15,22,22,20,26,66,66,35,42,24,12,17,99,47,15,19,36,14,10,79,57,13,22,35,30,12,14,27,8,6,6,33,9,28,14,8,14,53,11,21,23,3,170,27,61,9,10,7,24,15,6,3,119,16,1,28,29,8,8,17,43,9,13,18,28,11,10,8,57,9,11,27,49,30,1,10,33,3,25,17,12,2,2,28,37,21,65,20,22,44,31,10,52,12,57,18,90,9,27,54,4,55,8,11,23,2,21,24,26,6,8,13,16,12,19,26,11,17,38,62,19,22,32,29,6,77,23,8,7,25,22,53,38,23,27,46,8,10,53,11,13,34,4,44,17,26,20,26,20,13,16,19,96,3,48,15,18,86,9,23,53,20,35,11,24,12,23,16,51,8,27,3,22,9,0,6,12,23,9,5,34,17,9,12,8,28,23,14,7,14,8,5,7,15,35,18,5,7,3,13,14,35,48,8,4,13,26,5,1,15,12,7,19,27,21,14,1,5,36,15,47,31,21,6,12,13,71,9,8,11,24,34,32,52,43,66,11,4,35,11,35,4,31,11,8,13,4,42,10,26,36,22,18,20,19,12,13,14,15,13,7,4,72,58,12,13,24,7,12,16,9,23,17,5,13,3,9,70,17,20,9,7,4,12,2,11,26,28,7,20,3,15,7,35,14,30,16,9,24,20,24,50,17,23,5,21,5,21,12,29,61,36,8,5,10,25,28,7,3,25,18,14,53,8,9,69,7,9,21,15,14,8,23,3,15,8,20,13,26,13,48,41,18,12,17,1,3,4,23,11,11,25,11,18,20,26,14,6,13,9,3,29,38,40,20,6,67,10,7,3,35,29,24,2,9,8,18,34,6,16,19,5,35,26,13,7,56,18,16,13,13,9,13,46,9,41,5,10,20,13,13,30,51,29,50,39,13,7,34,12,9,16,40,18,19,22,3,49,5,4,9,185,20,18,12,8,11,20,75,9,5,20,7,4,6,17,4,4,1,12,7,19,19,16,28,25,18,15,6,5,3,8,7,44,14,11,14,9,19,6,3,6,23,29,16,5,10,14,16,4,19,24,7,6,4,14,16,12,19,17,6,4,6,21,9,19,22,13,8,12,12,8,7,10,5,21,8,13,15,7,11,19,22,27,19,12,11,3,14,5,28,12,14,7,10,11,4,11,19,23,9,9,28,14,6,18,15,27,9,9,4,40,48,13,7,5,20,43,23,7,7,12,21,11,3,22,4,9,10,11,4,7,2,4,14,22,14,13,9,12,23,11,9,27,16,10,12,28,10,6,4,8,2,16,12,5,22,12,22,11,21,3,12,2,3,18,4,10,4,9,6,14,4,3,1,18,4,7,8,10,38,12,12,4,27,4,12,22,9,46,15,4,2,17,7,22,12,13,14,2,4,14,12,25,16,10,8,10,12,13,5,2,6,12,9,8,10,8,4,6,14,21,6,6,24,27,5,12,3,9,12,2,6,17,8,2,16,2,8,13,6,4,6,13,2,3,6,4,2,0,12,10,12,6,7,17,9,14,1,16,7,13,5,13,11,19,24,4,5,32,12,2,6,4,11,10,1,7,6,12,3,27,6,3,8,5,3,6,6,9,11,24,3,22,9,5,23,32,22,15,77,0,4,8,6,8,8,15,6,5,17,4,8,14,5,3,9,11,11,1,8,6,9,7,9,6,11,6,3,11,8,3,5,8,9,39,6,13,12,6,15,4,6,5,6,2,2,5,11,4,5,6
the american people,5,39,17,103,10,22,5,52,6,1,7,20,16,87,4,13,17,20,1,9,4,20,54,59,21,34,27,40,19,28,8,111,100,15,50,105,57,1,4,10,5,23,4,13,29,15,10,9,147,81,28,23,17,81,17,4,24,15,40,16,7,7,8,9,24,21,100,13,8,7,16,0,6,5,87,21,41,2,61,40,19,6,8,17,155,11,2,9,17,2,10,4,13,26,34,11,11,2,25,5,2,21,12,16,11,21,4,19,7,4,20,4,18,20,23,19,2,7,30,82,23,45,41,92,10,9,5,1,4,3,34,2,10,34,38,83,6,5,6,16,6,30,20,0,10,52,8,9,8,3,25,9,8,6,4,26,41,11,9,36,26,7,16,4,15,34,6,16,16,6,14,88,23,8,11,2,64,2,11,49,22,14,19,20,1,23,17,17,20,21,9,9,3,7,14,2,15,9,9,8,20,3,12,6,27,12,1,27,10,24,71,26,28,5,14,47,23,25,14,2,8,22,3,10,22,35,17,22,4,10,11,4,16,10,24,11,17,9,3,11,44,15,9,5,20,4,14,24,18,9,9,11,24,1,3,24,4,5,0,16,3,19,11,1,4,4,7,34,16,1,58,6,3,8,3,7,23,1,2,2,71,6,1,3,9,2,11,10,11,4,1,3,16,10,4,5,11,7,6,18,16,12,2,4,7,9,16,4,9,1,1,1,27,12,25,5,9,13,8,5,20,4,29,5,46,2,18,90,11,20,10,6,7,1,3,9,16,3,2,3,7,16,27,4,3,5,13,27,9,21,3,16,5,19,11,1,8,2,11,23,8,10,4,6,6,14,19,6,19,21,2,34,6,15,9,12,5,1,30,7,34,6,25,5,8,12,6,15,14,11,16,9,13,6,23,10,19,2,18,6,14,12,3,9,6,4,3,2,14,7,6,3,2,11,11,11,5,9,5,15,4,5,15,10,3,3,3,11,9,8,2,4,0,3,13,6,8,8,10,8,11,6,4,8,2,7,19,11,10,8,31,2,11,9,40,3,10,8,4,6,9,31,24,14,6,5,29,13,6,9,24,10,2,5,10,10,9,12,5,10,6,8,8,4,9,8,3,10,0,0,51,15,9,9,14,3,2,5,8,10,18,3,0,3,3,9,1,9,7,5,1,0,2,2,15,5,5,9,4,12,3,6,3,8,2,2,11,2,1,8,3,14,5,6,6,3,3,9,29,11,6,2,2,1,5,3,4,7,3,5,25,1,0,19,2,5,12,3,6,3,8,0,3,3,8,6,6,4,15,12,10,5,0,2,5,1,2,0,3,11,3,2,5,16,6,0,4,9,2,14,12,24,8,4,8,0,1,4,10,17,10,2,4,0,3,11,2,18,4,1,10,2,5,6,6,6,5,2,8,0,1,0,3,12,4,0,6,1,12,14,2,4,18,17,2,6,13,2,15,2,2,10,10,5,5,6,1,3,7,78,10,1,5,1,1,11,15,8,1,4,3,5,1,7,1,2,1,2,6,5,2,3,9,2,10,4,1,0,2,4,4,16,9,5,5,4,6,6,4,5,7,22,1,4,4,7,4,3,11,3,5,2,0,2,8,4,21,8,4,2,4,1,2,16,12,5,9,5,11,5,4,1,7,6,4,5,1,1,4,9,3,3,0,1,1,1,8,1,8,2,5,2,5,2,4,4,6,1,8,2,17,2,0,1,4,10,5,9,0,1,2,19,0,4,10,8,11,1,1,2,6,4,6,4,2,9,8,4,0,3,1,6,11,1,7,0,3,4,4,3,8,0,0,3,0,7,0,5,4,6,1,2,5,1,16,11,11,6,10,2,2,1,1,3,2,2,2,12,0,3,2,0,6,4,1,1,11,5,1,1,3,7,18,6,10,7,13,14,2,7,1,0,1,11,2,0,2,4,5,5,35,11,2,2,0,2,5,1,2,2,1,5,1,8,1,4,1,1,8,4,0,3,1,3,4,4,3,8,10,1,0,2,2,2,0,0,4,0,4,4,11,0,2,1,4,4,0,4,4,14,5,3,7,4,10,1,0,2,1,10,0,5,1,2,3,3,3,2,5,1,1,3,5,0,2,3,4,1,1,1,1,5,6,4,3,3,1,1,9,3,2,7,0,1,1,5,3,4,2,2,1,10,6,2,0,1,3,2,2,2,0,1,1,0,10,8,1,3,3,0,7,4,15,13,4,2,3,4,3,1,0,4,1,0,8,0,4,10,9,2,3,1,1,7,1,6,5,2,1,10
friend,1,18,5,37,7,6,3,34,1,2,7,4,11,62,3,15,4,11,9,1,4,21,22,24,6,16,9,19,8,13,8,85,71,11,37,80,61,4,7,8,5,51,5,2,28,13,10,5,110,69,19,10,11,67,10,11,21,6,12,13,5,4,1,9,10,15,70,7,5,12,8,3,3,7,80,11,16,2,27,17,16,2,9,5,72,6,8,3,10,1,10,4,1,16,16,1,11,1,20,0,0,5,12,6,14,10,5,11,3,3,12,1,10,7,2,16,1,0,25,104,16,13,6,31,12,5,2,1,1,1,14,2,12,25,15,46,9,6,3,12,1,9,15,5,2,25,7,12,8,8,22,2,11,1,0,8,30,6,9,28,5,3,5,3,7,6,1,6,17,8,6,50,21,3,6,3,79,8,6,19,12,4,8,11,1,11,14,7,9,12,0,3,3,4,2,3,9,6,7,5,9,0,1,8,15,5,3,18,1,15,45,8,9,4,3,9,2,9,5,1,0,11,4,11,15,49,19,8,0,7,2,6,6,9,10,4,16,4,5,6,41,34,13,14,9,9,7,12,22,2,6,10,21,2,1,11,5,0,4,9,1,19,5,1,3,3,0,15,15,5,49,1,6,5,7,6,13,1,3,1,31,6,2,9,4,4,3,2,7,2,4,1,5,3,1,3,13,2,4,14,16,11,0,1,8,4,14,1,3,0,8,4,17,11,9,4,3,23,3,3,30,9,26,4,26,1,8,25,1,13,3,5,9,2,5,5,12,3,0,4,0,14,17,3,0,4,10,21,14,15,3,8,2,5,22,0,3,1,7,14,5,8,13,12,1,9,10,4,16,6,2,21,1,8,7,7,2,1,12,6,28,2,10,6,11,9,4,7,22,6,12,6,7,1,3,10,17,1,11,1,12,8,3,7,9,2,0,4,14,20,12,9,3,4,5,7,0,15,6,44,2,5,8,6,6,5,3,6,5,10,3,0,0,4,4,3,9,4,13,3,2,9,1,17,10,16,14,18,13,2,20,0,4,2,13,6,2,8,5,13,9,20,20,15,5,0,13,5,1,3,22,3,6,8,5,10,2,7,9,5,2,1,1,3,8,1,2,11,2,3,38,7,2,8,11,2,1,5,7,4,0,3,3,0,0,5,0,6,1,0,2,3,3,0,8,3,5,7,0,8,1,6,1,3,2,4,10,0,10,7,6,3,5,4,7,2,4,9,25,1,6,2,2,1,7,3,0,9,5,0,18,4,2,20,2,3,8,0,2,2,7,0,4,1,6,4,5,5,13,18,6,3,3,2,2,0,6,0,3,7,1,8,4,15,4,1,4,4,3,10,13,12,6,1,3,5,1,3,12,16,13,0,6,4,0,5,1,8,2,0,7,6,2,3,6,1,6,1,1,1,3,0,0,6,1,4,4,1,5,10,2,7,7,8,1,3,7,0,3,1,0,4,1,7,4,8,3,0,1,71,4,2,6,4,5,6,12,5,2,10,2,4,3,1,5,1,0,3,4,6,3,2,29,1,10,3,0,0,0,1,0,8,6,0,5,2,6,5,0,2,7,15,6,3,0,1,9,1,3,6,2,0,0,2,3,6,11,3,0,0,5,1,3,9,8,6,5,3,4,3,0,2,3,9,2,4,2,2,2,12,0,3,2,1,2,0,3,5,8,2,6,2,1,2,6,3,6,7,5,5,8,1,0,2,0,8,4,3,0,5,3,10,0,3,10,13,3,4,2,1,4,10,5,10,2,9,2,4,20,3,2,2,3,0,2,1,2,4,3,3,3,1,0,0,2,9,0,2,2,9,0,4,3,0,4,1,9,0,7,5,6,0,1,3,4,4,4,4,0,4,5,3,2,3,0,2,2,1,2,3,0,2,6,5,5,6,4,22,2,4,2,3,0,2,3,0,4,4,1,8,11,10,13,2,2,1,2,1,2,1,1,5,5,6,2,7,5,1,7,6,0,15,1,4,4,5,0,4,5,1,0,2,5,1,3,4,2,1,2,1,5,2,3,4,5,1,3,3,1,22,5,1,7,6,7,0,0,0,4,8,4,4,5,1,2,3,2,2,7,2,5,2,1,5,0,3,5,5,1,0,4,4,2,4,0,1,1,1,6,2,4,6,3,2,0,0,0,3,5,2,1,3,2,1,2,1,1,0,3,3,2,1,6,4,1,6,1,6,4,0,17,1,5,8,2,9,0,2,2,2,0,4,2,8,3,1,2,6,9,2,0,3,1,5,0,1,0,1,1,11
press,1,10,7,81,2,5,4,13,5,1,3,5,12,33,7,6,4,6,4,4,1,18,9,15,25,10,5,6,3,7,9,88,52,3,31,39,22,3,12,2,9,17,5,3,15,10,19,4,111,19,22,1,8,16,2,0,20,18,0,11,7,2,3,5,12,9,55,6,6,1,1,0,6,2,60,9,5,6,49,12,18,1,7,4,114,6,11,2,18,2,9,1,3,12,30,7,5,2,33,3,9,15,16,6,14,14,7,5,9,1,4,2,7,8,3,16,6,7,15,59,17,6,14,44,8,5,0,6,3,0,12,1,5,25,11,27,4,1,6,7,0,16,14,5,1,26,5,8,5,4,20,1,9,4,2,10,28,7,4,10,3,2,2,3,0,2,0,18,26,5,1,38,14,4,5,7,98,2,5,35,6,9,2,13,2,12,22,8,15,24,1,5,0,1,1,4,15,0,6,6,16,1,2,9,10,7,5,16,8,14,43,9,14,8,1,2,3,4,5,4,1,9,2,9,24,39,13,10,0,3,6,8,8,18,14,6,18,6,2,4,45,19,4,3,7,6,5,16,20,7,17,11,10,3,5,2,7,1,4,4,0,12,5,2,4,8,7,4,2,2,47,6,7,3,3,2,7,4,12,1,28,2,5,9,5,1,3,2,6,3,1,3,18,5,0,4,24,8,2,8,17,14,2,0,3,4,11,2,2,1,6,6,19,2,12,7,5,17,9,3,13,2,21,6,26,2,23,22,8,8,4,3,3,2,3,9,9,7,3,7,10,5,7,3,5,2,17,24,14,2,6,4,1,14,3,4,4,2,4,13,17,2,2,14,0,3,32,2,8,4,5,11,6,6,3,13,1,0,11,1,30,3,16,6,1,22,3,16,10,2,14,15,7,3,20,10,39,5,16,2,8,1,2,4,1,1,3,4,20,9,2,8,3,7,2,8,2,3,1,4,0,4,11,8,1,2,3,7,4,8,16,4,1,5,1,4,3,8,5,5,8,5,2,4,2,2,5,5,17,3,9,4,3,6,20,7,0,6,6,11,3,4,14,12,3,0,13,6,2,7,11,3,3,2,3,4,3,6,5,4,4,7,2,2,6,7,4,3,3,2,24,38,1,1,11,3,1,12,3,5,3,4,2,0,5,6,1,4,2,3,2,5,2,7,7,12,1,6,1,4,2,10,6,6,2,2,14,4,9,6,2,7,0,1,3,3,4,4,14,12,2,3,1,0,3,8,2,5,5,5,13,4,4,23,4,3,10,4,2,10,22,0,7,1,8,19,0,2,11,23,11,6,6,2,3,6,1,1,4,14,4,9,8,11,6,0,3,1,0,3,5,17,7,2,8,1,2,1,13,12,6,1,6,6,5,18,6,6,0,0,10,13,6,6,13,4,12,1,2,2,10,6,1,19,1,2,4,5,9,12,10,24,11,7,3,5,3,3,5,5,1,0,0,8,5,14,3,0,4,62,3,7,4,9,3,8,11,6,3,5,3,2,4,6,2,5,0,6,12,10,8,4,17,11,19,2,2,8,2,2,2,15,7,17,8,9,9,0,1,6,6,4,2,7,4,6,2,0,2,7,2,2,3,2,5,2,8,3,0,4,2,3,2,13,8,2,3,11,4,3,6,5,1,4,1,2,3,0,1,4,4,10,4,0,3,0,8,1,11,6,3,3,2,7,10,1,7,9,2,4,4,1,3,5,4,3,3,5,3,7,7,6,2,2,3,13,7,3,5,7,2,3,3,6,1,5,7,3,9,5,3,1,6,7,3,7,3,4,3,10,3,5,2,6,7,6,5,6,2,0,1,3,7,6,8,3,5,5,13,0,4,4,7,10,1,1,5,4,3,3,4,2,3,8,4,1,3,6,4,3,4,3,9,0,3,5,4,23,3,2,9,7,3,10,5,3,4,2,6,5,11,12,0,1,2,0,4,5,4,2,1,0,4,4,4,1,3,3,3,3,1,3,3,7,3,6,1,6,11,1,3,2,3,2,9,3,7,2,5,7,5,1,0,5,4,1,1,1,6,0,2,8,2,5,12,0,5,9,0,11,3,1,2,3,5,2,0,3,0,0,5,4,2,1,1,4,2,19,3,4,0,5,7,6,3,2,2,3,1,10,4,5,6,1,4,8,13,3,22,10,0,3,3,7,2,2,2,3,4,6,2,2,3,1,1,4,1,0,0,4,3,2,3,2,4,0,0,5,4,0,2,2,5,5,1,3,5,4,12,0,2,1,3,1,1,2,1,4,3,4
place,20,101,32,497,26,26,26,119,15,10,67,23,38,214,19,35,29,57,20,21,18,1,40,72,54,45,44,43,33,61,39,531,469,48,183,201,120,30,61,13,22,34,23,20,74,60,91,54,947,104,147,25,47,131,34,15,241,71,19,51,64,23,15,54,94,23,307,32,27,55,37,27,26,19,292,49,62,20,279,74,141,6,64,23,722,64,65,4,93,6,37,19,21,103,150,31,61,14,117,70,41,86,104,58,50,112,12,13,56,20,72,23,40,62,30,114,21,25,232,482,117,93,62,250,36,21,18,22,18,12,47,16,31,143,88,157,23,24,16,45,10,114,115,14,10,426,24,42,44,42,219,12,51,31,24,69,108,24,40,50,30,15,27,16,19,32,21,53,73,36,73,307,73,15,25,31,581,14,34,143,69,40,42,71,15,74,108,80,109,194,22,32,25,10,6,14,68,18,40,42,99,12,11,25,106,45,16,142,50,66,241,32,86,15,17,19,10,11,74,15,22,50,24,44,131,332,73,79,19,21,41,65,51,98,115,97,101,30,39,29,263,118,29,25,35,25,20,78,144,43,42,63,49,40,35,57,48,21,17,67,27,105,82,23,22,147,13,31,56,19,466,53,88,15,18,5,69,31,41,18,183,25,10,67,36,11,26,41,46,3,26,10,75,26,13,42,141,16,27,70,81,110,5,18,44,3,56,23,26,5,6,56,101,24,133,68,36,139,52,23,150,20,90,29,192,32,32,133,13,102,28,48,34,27,27,47,56,29,21,47,46,37,60,53,21,26,175,172,58,29,45,56,27,117,69,30,16,35,48,68,58,32,28,62,12,7,140,34,33,80,17,76,12,64,27,115,34,10,48,27,200,9,146,29,16,104,26,63,124,20,71,13,44,48,84,74,195,25,160,13,89,17,14,13,23,19,36,20,105,37,10,45,22,43,29,35,28,24,10,19,20,55,50,41,5,16,12,41,39,53,59,11,13,52,19,28,6,66,51,15,40,72,18,46,8,25,42,24,126,27,58,14,21,20,156,34,15,39,20,107,41,90,114,117,23,19,68,52,25,5,60,23,22,13,12,45,19,62,51,23,33,58,11,24,18,31,29,19,22,10,218,112,10,22,32,36,20,61,28,25,39,20,10,10,36,121,27,43,30,19,11,17,48,26,55,50,25,33,9,39,13,55,35,93,27,23,84,31,53,88,34,27,23,29,29,17,42,38,119,53,20,9,17,44,31,44,23,63,50,23,172,22,32,172,27,31,108,22,27,22,76,11,66,7,56,57,48,25,106,105,64,32,51,6,36,19,36,20,16,62,37,44,45,57,35,10,15,35,14,43,83,104,31,18,64,16,22,10,148,66,71,11,20,11,18,59,18,92,14,29,109,48,58,28,103,34,67,16,29,13,53,35,14,91,19,23,32,23,48,110,65,62,87,81,31,22,32,22,13,35,43,10,37,95,31,99,23,15,24,504,97,19,27,18,24,41,131,50,23,51,27,31,37,53,25,27,5,32,40,33,50,28,136,88,75,29,14,29,7,28,14,85,51,37,32,32,37,21,13,53,39,48,60,32,33,40,42,28,47,54,33,12,12,19,30,21,66,30,14,7,18,28,20,92,62,70,37,38,34,33,41,17,20,109,16,42,16,13,28,32,38,49,19,21,16,18,60,14,96,31,35,29,13,35,49,19,50,28,15,32,30,19,9,35,12,39,31,37,17,38,31,44,11,9,57,60,51,29,35,28,26,12,9,67,13,42,53,19,65,34,16,29,42,20,31,20,42,93,23,62,19,58,11,21,17,52,10,19,16,30,24,22,46,18,15,11,31,11,64,22,38,30,76,32,15,22,15,29,13,39,15,12,17,58,12,18,13,25,49,16,29,16,55,12,35,30,36,90,30,16,33,44,13,20,36,33,35,15,17,40,76,110,27,21,8,24,20,20,23,5,39,19,44,9,20,35,19,18,29,35,6,17,21,44,15,27,15,40,31,12,2,26,19,12,49,21,14,17,24,24,24,46,4,9,27,34,9,32,18,18,26,17,19,29,44,8,22,65,15,56,23,29,25,22,54,17,18,33,21,13,27,27,32,46,6,26,9,48,15,38,16,17,16,22,14,11,25,18,11,25,14,36,14,21,27,55,25,28,152,22,11,19,17,17,15,14,34,17,62,16,9,36,43,32,11,90,22,7,17,20,30,14,23,17,28,22,9,25,25,23,18,33,17,50,20,11,12,20,56,7,11,15,14,3,4,18,8,15,7,19
let,12,47,34,187,18,47,7,60,11,9,11,30,63,161,7,40,39,27,54,22,9,40,1,181,19,92,57,140,48,77,9,326,187,51,70,697,78,5,14,20,23,60,11,46,76,30,54,18,220,257,88,43,48,161,98,7,47,10,112,46,2,8,3,26,66,36,224,24,20,12,63,2,17,18,185,42,117,5,134,85,55,9,18,33,157,42,6,22,29,2,13,30,24,54,34,35,29,2,72,18,5,43,26,37,35,53,10,52,35,18,70,7,42,68,85,75,1,8,54,155,40,155,92,235,17,33,6,6,4,11,104,25,47,85,66,253,22,21,37,32,58,66,31,14,16,173,44,44,12,10,94,38,25,15,27,56,118,34,14,167,25,5,32,7,29,141,10,35,44,21,53,202,77,15,47,5,97,9,26,150,75,31,51,85,10,66,43,28,29,46,18,24,3,27,20,6,43,18,21,17,67,14,18,12,26,37,2,44,24,16,176,56,63,39,49,134,48,63,21,5,15,30,1,22,49,104,39,33,16,17,13,21,40,27,66,8,35,21,12,15,92,44,26,49,39,15,12,122,64,36,20,14,54,4,3,31,4,8,2,27,3,78,10,2,13,7,21,83,49,7,91,19,8,10,13,36,35,7,1,5,171,6,9,28,13,6,56,59,30,21,2,24,51,27,7,5,23,6,9,30,62,12,4,4,9,19,42,3,38,11,4,14,63,38,91,12,35,27,19,8,44,13,66,26,122,1,29,154,12,44,36,18,9,3,18,14,55,5,3,7,18,52,68,12,5,12,27,54,20,105,12,31,5,74,16,8,24,2,18,68,34,14,18,7,12,34,20,21,65,94,13,98,7,68,15,24,8,15,47,4,65,7,25,6,41,27,30,30,53,7,47,48,26,13,24,30,16,4,18,3,28,31,7,17,3,18,29,5,28,38,9,13,10,12,0,26,22,37,13,34,4,7,46,6,21,4,6,11,6,18,8,1,1,19,34,5,22,16,32,9,15,13,6,32,5,7,69,27,32,14,92,4,56,17,67,13,23,8,7,11,59,64,34,81,15,12,74,21,7,16,83,48,5,18,20,34,22,7,28,18,15,19,5,17,17,5,6,30,10,3,90,17,18,12,29,3,6,6,8,26,12,13,11,15,27,25,5,12,20,10,5,14,10,8,15,7,20,11,4,18,2,10,4,25,5,2,28,11,9,19,14,21,11,15,13,22,8,30,49,14,5,10,8,5,3,2,15,19,7,1,54,2,2,47,0,7,7,2,8,5,7,4,8,19,17,15,12,7,26,26,9,3,7,5,5,1,1,7,15,29,5,7,10,49,11,11,3,3,4,36,27,28,20,15,41,8,10,15,5,21,12,2,15,1,2,8,6,13,2,8,32,4,6,9,10,4,10,6,3,0,2,16,1,42,5,2,0,2,8,23,11,8,34,20,4,17,11,4,17,6,15,27,24,26,3,9,12,6,15,79,11,4,8,8,6,34,17,21,10,7,6,13,9,3,2,1,0,10,6,3,4,3,2,30,10,3,1,3,1,0,6,24,1,2,9,3,10,7,2,2,2,65,4,2,4,14,15,1,14,11,13,0,2,1,4,10,21,19,10,0,8,4,6,24,12,10,24,7,10,2,7,5,2,10,2,3,11,20,4,16,6,7,2,17,1,1,5,3,9,20,10,2,11,10,4,3,22,12,9,9,18,1,1,3,9,15,5,5,1,14,8,31,1,10,28,28,27,4,3,1,22,14,7,12,4,11,15,2,1,3,0,2,17,5,9,1,6,2,4,7,8,11,4,3,12,22,4,4,3,0,3,12,6,16,35,4,17,14,17,5,4,3,2,3,2,4,6,49,2,14,6,1,2,5,3,1,45,4,23,6,15,3,11,18,23,12,11,33,4,3,2,8,16,12,6,19,5,26,4,17,50,11,14,2,10,6,1,1,5,3,4,17,1,8,4,5,11,2,17,4,0,1,5,7,15,5,1,4,17,1,0,2,3,4,0,2,5,5,4,2,17,6,32,3,0,1,4,11,10,29,8,1,12,8,6,4,2,4,1,16,2,9,8,9,7,1,8,2,8,1,2,1,8,0,4,5,3,1,0,5,4,15,7,3,6,1,0,5,2,11,2,21,1,3,10,7,19,3,6,3,0,18,7,4,0,4,5,0,3,3,0,2,5,0,8,5,0,8,8,0,5,7,21,24,0,0,17,4,0,0,2,4,4,8,8,4,11,26,0,22,3,9,1,29,6,20,27,1,12,36
say,42,120,47,348,39,65,21,104,15,14,50,40,54,204,8,33,29,50,59,24,15,72,181,1,61,79,66,95,53,104,25,505,255,45,146,285,141,7,18,22,19,63,15,38,111,43,71,30,656,219,143,35,36,182,86,18,94,59,96,39,41,14,11,40,62,43,321,15,34,37,47,12,28,24,272,50,103,11,193,89,85,6,27,34,414,62,19,17,58,7,32,24,46,79,108,42,43,11,70,39,16,64,60,52,27,92,10,53,30,31,64,4,27,56,61,65,23,12,236,301,89,128,75,286,68,35,15,11,12,16,62,25,35,121,101,214,29,11,25,29,33,109,59,8,20,215,33,50,34,25,138,29,44,12,13,78,130,15,21,99,37,11,50,18,24,79,25,52,64,24,43,284,78,12,33,21,351,14,33,149,89,23,45,78,13,71,89,48,63,132,16,18,14,19,27,9,79,22,19,32,105,7,10,19,56,41,6,47,33,49,230,52,91,27,56,109,43,33,34,6,7,65,13,49,74,212,76,71,24,26,23,44,46,57,85,19,78,15,8,31,138,67,40,29,41,16,12,90,114,24,31,29,76,13,17,76,18,16,9,49,23,75,35,21,19,52,30,41,58,7,314,18,55,17,9,26,60,15,22,17,163,11,8,64,34,3,38,57,48,39,9,26,52,15,22,14,78,34,28,66,67,55,6,16,22,19,50,9,46,10,7,30,68,26,126,21,44,66,27,10,95,23,97,38,189,14,38,170,30,78,46,30,10,13,19,24,47,20,5,32,22,37,91,11,5,20,71,127,30,80,24,28,17,83,53,11,22,8,24,96,50,21,22,28,8,29,103,38,40,101,13,96,14,64,32,51,15,6,47,17,228,15,87,25,44,73,41,54,64,5,69,17,64,60,64,28,93,18,49,8,57,25,11,26,21,15,19,8,41,23,11,26,6,27,30,28,18,23,19,23,21,17,58,28,15,8,5,44,26,44,32,12,10,42,30,12,16,36,32,11,44,22,17,25,5,10,59,30,62,14,73,9,33,25,103,25,22,28,27,47,60,70,61,107,16,26,72,37,14,10,84,33,17,22,10,71,19,43,63,31,17,29,9,14,20,14,22,26,12,26,184,74,17,18,23,5,13,38,22,26,29,20,9,20,30,42,9,34,23,13,8,11,16,17,22,27,20,18,44,30,10,51,8,53,10,14,68,26,34,49,29,25,16,31,30,22,9,50,80,40,10,8,14,22,16,23,7,32,25,21,125,13,31,83,18,14,35,12,16,18,29,8,40,13,20,23,34,26,94,83,17,26,32,4,19,16,11,14,17,45,13,42,23,61,13,22,20,12,11,34,33,60,26,13,67,14,23,13,97,45,51,6,22,22,13,46,12,68,9,11,62,42,34,16,68,21,37,14,24,8,17,3,10,56,11,12,12,20,30,56,16,36,71,62,13,14,19,10,12,23,25,24,26,28,8,52,15,17,6,369,55,19,14,21,23,24,56,39,17,40,16,17,44,25,14,20,7,14,23,20,31,16,66,97,70,14,8,10,17,13,16,51,24,16,28,22,19,25,7,14,39,49,21,27,16,18,13,12,20,23,17,6,17,19,19,20,21,29,17,8,11,19,24,46,33,30,40,16,34,18,17,13,17,45,13,23,17,10,3,24,15,26,5,16,8,5,28,11,95,24,19,12,7,24,17,6,27,24,19,25,26,6,7,19,18,34,23,18,10,51,44,57,11,10,32,40,23,15,15,14,13,10,9,37,10,24,20,6,22,14,18,4,43,20,41,12,13,45,27,30,14,18,6,11,47,37,13,15,4,14,9,8,19,11,29,21,18,18,27,12,12,7,16,10,10,9,13,47,18,31,33,4,21,29,9,11,32,31,12,12,21,13,19,15,31,17,16,39,21,14,8,18,14,22,13,21,27,32,8,26,53,49,22,4,11,9,16,16,16,7,9,21,14,13,6,15,13,10,29,12,9,18,30,17,12,12,16,21,37,18,11,24,6,8,13,3,13,15,16,18,29,27,17,15,13,32,15,38,29,34,9,11,13,26,24,9,7,16,5,33,10,10,16,25,33,9,13,13,13,9,14,16,9,27,8,6,7,18,6,10,14,8,14,19,5,5,7,14,11,24,14,35,6,4,10,24,38,28,60,9,4,14,21,7,15,6,6,7,53,7,7,11,5,19,16,21,13,4,26,8,16,27,32,25,9,4,9,15,11,12,3,9,17,5,26,7,13,18,40,10,3,15,4,16,0,20,9,7,3,20
matter,16,38,28,272,12,20,9,60,9,11,30,18,22,114,14,27,14,39,21,6,25,54,19,61,1,24,36,22,21,27,14,326,234,30,117,89,68,7,19,13,14,24,9,8,51,38,44,36,512,37,100,15,16,76,45,9,81,48,15,31,28,18,8,21,32,13,181,26,36,27,12,8,11,12,201,28,53,8,144,52,73,3,20,18,397,48,20,4,51,3,11,12,5,42,113,42,27,17,68,28,27,53,59,26,29,75,19,13,26,11,25,10,6,26,6,53,10,8,128,256,98,31,23,99,18,8,5,7,5,3,31,9,31,101,49,113,32,11,14,16,14,68,51,8,11,151,19,48,38,22,135,10,21,16,8,55,104,12,21,30,42,11,27,1,5,39,8,57,56,15,22,188,69,10,12,20,325,6,30,92,65,30,6,50,12,57,83,61,131,83,5,18,5,4,8,5,30,19,11,30,78,6,9,28,26,16,17,54,23,61,169,16,49,16,19,34,6,4,31,5,5,42,11,31,55,241,66,48,9,9,34,25,20,56,55,33,71,22,14,12,129,68,15,13,29,14,16,34,92,13,45,30,28,13,18,34,22,4,5,32,41,30,50,9,18,98,28,18,21,13,274,14,51,8,6,11,33,21,21,11,128,33,11,32,32,1,26,29,41,7,10,10,31,18,9,11,67,19,9,49,42,49,1,8,47,4,40,17,22,3,3,66,35,12,71,27,27,100,28,8,48,24,64,36,128,19,42,46,14,49,15,32,19,19,17,46,39,14,11,18,15,19,25,23,10,12,72,103,44,16,19,42,13,96,43,26,13,11,21,54,56,12,15,49,6,4,63,34,30,45,6,31,11,34,51,53,18,15,38,11,117,5,80,43,17,73,29,38,51,3,45,7,28,30,64,20,135,14,54,11,49,4,12,3,16,22,14,4,41,20,9,12,5,63,15,9,8,23,10,0,18,28,64,28,12,8,3,38,11,27,14,9,1,13,9,11,2,32,15,19,36,29,17,15,5,9,25,22,70,20,28,12,11,3,116,18,2,17,32,52,27,43,59,92,18,10,32,14,18,14,56,14,3,9,8,75,5,34,55,33,16,29,5,16,18,21,23,5,21,13,111,69,5,6,19,12,7,27,15,31,38,15,4,5,20,29,11,28,15,14,12,13,15,21,32,40,9,25,28,15,6,35,16,59,22,5,59,48,32,55,20,17,10,33,21,15,27,21,70,69,5,8,12,13,15,23,6,34,30,36,54,6,13,63,19,20,49,8,13,28,60,6,40,6,25,24,31,17,59,85,25,13,26,11,25,9,13,21,9,42,3,31,11,35,25,28,9,24,10,15,42,78,26,14,132,12,13,12,93,38,36,3,18,9,20,48,16,61,29,9,85,59,27,16,67,14,23,6,23,9,25,11,7,29,12,10,13,24,29,50,14,62,91,46,14,10,52,11,6,19,29,10,33,39,20,45,12,9,33,266,29,14,18,7,13,13,62,51,14,28,10,10,19,42,8,10,10,24,19,16,39,13,61,82,46,14,12,21,14,12,18,49,27,26,20,18,17,6,4,26,33,26,19,17,18,14,13,4,13,28,37,4,16,25,14,8,35,13,8,7,7,13,9,28,31,25,12,17,25,20,13,16,14,35,14,16,18,10,5,16,15,30,7,8,12,8,25,10,48,10,37,8,13,25,20,16,15,21,11,18,14,10,1,10,9,21,10,22,15,31,37,24,4,8,29,25,13,20,21,25,17,13,15,31,6,29,15,6,14,15,4,9,27,12,29,16,15,35,8,24,10,33,21,15,52,23,33,8,4,18,9,11,20,10,7,8,11,8,49,6,1,3,6,36,12,11,12,16,11,19,13,14,15,22,21,10,15,16,6,5,19,13,25,11,11,25,14,53,10,15,9,23,13,28,10,7,12,12,16,39,47,41,23,7,14,4,17,11,11,0,14,14,23,8,6,13,22,9,15,31,27,11,10,24,15,17,7,10,32,16,17,6,14,6,20,11,19,8,7,16,10,17,0,6,7,9,6,15,7,11,9,9,5,18,18,8,10,7,8,35,13,16,21,12,23,8,7,5,15,11,14,14,11,13,9,6,12,28,9,6,17,5,16,9,6,11,9,8,14,22,8,15,10,4,6,28,14,17,24,9,1,9,8,8,8,6,5,10,12,11,9,7,12,14,5,15,16,10,6,7,8,11,17,13,13,8,7,13,19,6,49,10,7,8,19,6,14,7,20,8,8,10,10,2,3,5,3,7,3,12
ask,13,62,36,355,21,26,1,45,11,8,16,21,32,128,4,8,17,21,34,16,10,45,92,79,24,1,29,57,26,49,8,303,162,27,61,176,51,11,13,9,16,31,11,31,51,16,62,19,249,149,67,21,25,68,86,16,43,59,121,21,16,19,5,22,38,27,149,13,8,29,52,3,11,8,218,24,89,9,105,34,76,9,20,18,227,36,10,19,34,5,21,9,24,26,59,20,24,4,64,9,15,37,27,30,27,54,10,35,22,18,28,6,18,33,46,37,13,7,94,134,34,100,69,156,27,6,4,7,13,5,45,11,23,116,48,142,18,8,19,14,16,67,39,9,4,117,15,38,11,11,67,22,24,8,14,50,79,20,9,132,32,9,20,10,38,56,13,39,47,25,42,137,45,17,15,9,123,2,21,130,45,14,34,43,5,36,55,25,58,48,9,9,8,10,17,4,60,19,20,19,57,14,6,16,24,32,3,33,16,21,152,29,79,32,23,62,33,37,21,7,11,21,1,7,64,94,23,30,19,21,15,30,51,17,45,18,47,18,13,10,77,37,19,11,23,15,10,54,73,17,17,14,37,12,2,30,11,10,7,34,13,42,20,3,5,55,20,29,24,11,108,43,27,12,4,19,51,16,2,8,117,13,8,16,14,5,39,44,28,18,8,13,45,29,10,12,57,17,20,35,41,37,4,6,8,14,31,12,15,5,17,27,54,28,71,11,26,29,34,4,56,13,37,35,90,7,23,96,10,38,33,15,27,7,10,34,43,7,10,11,12,47,37,15,8,13,32,64,32,73,10,11,6,65,16,2,23,5,13,62,47,22,25,17,7,20,36,11,44,54,2,86,8,34,15,46,10,6,27,4,103,13,40,5,25,41,19,31,24,5,41,14,28,32,21,10,48,2,38,5,27,14,9,21,8,6,8,1,41,24,4,19,7,26,27,14,14,15,14,16,13,14,42,17,8,5,3,22,14,22,7,12,11,17,48,12,9,15,22,10,12,18,4,21,10,10,42,10,38,9,48,8,21,19,35,15,11,11,18,22,22,20,22,57,16,5,37,26,7,11,53,38,9,13,9,32,6,15,27,5,4,20,7,7,8,7,13,6,13,9,82,35,10,18,13,4,1,24,7,4,10,7,3,13,18,11,7,16,10,12,5,4,10,4,10,20,17,8,9,19,10,16,3,14,4,10,37,25,17,28,15,6,7,13,9,8,5,30,42,18,4,8,7,11,17,15,21,19,9,13,26,4,1,46,6,13,18,4,7,21,17,6,11,9,21,10,10,10,30,29,13,7,52,9,7,4,12,9,16,42,5,11,9,22,7,18,5,10,3,16,22,22,28,12,44,1,6,8,49,26,22,6,9,6,13,15,5,23,9,11,27,44,15,7,24,8,16,3,8,6,9,1,8,22,10,4,13,7,12,12,10,46,33,14,17,13,27,5,19,9,14,6,10,24,10,60,6,29,12,140,28,4,3,17,9,19,29,13,13,13,7,9,9,7,7,12,2,9,7,14,16,7,38,11,18,1,3,6,7,5,7,27,5,10,6,5,15,7,5,11,15,25,9,19,14,13,7,10,16,23,24,8,5,7,18,9,26,13,2,9,5,14,0,28,22,12,29,4,16,6,6,6,7,31,7,8,3,6,4,14,9,11,12,5,8,3,37,18,24,4,21,1,15,25,5,4,26,21,5,7,10,5,10,22,6,21,6,5,10,12,5,23,5,10,36,17,23,2,7,8,6,5,4,20,3,8,24,7,5,6,1,7,10,5,14,7,2,6,9,11,12,22,8,2,22,22,3,9,4,6,3,4,9,11,10,8,8,4,21,1,4,5,5,7,3,4,8,14,4,8,5,0,11,10,3,7,23,28,5,5,13,2,12,9,10,6,13,26,2,10,9,6,1,9,5,7,3,21,7,15,28,45,9,2,10,2,9,6,3,2,6,6,4,5,4,4,4,4,4,25,9,0,8,6,7,4,3,3,15,4,6,4,7,5,16,2,8,3,11,7,22,11,24,5,4,23,3,32,16,31,8,8,20,4,4,8,8,8,4,32,11,26,9,16,7,8,8,10,10,3,2,5,3,9,7,2,2,20,3,5,8,20,4,10,0,5,0,10,11,14,5,13,17,3,8,26,18,28,26,1,4,12,3,12,4,4,0,6,17,4,6,4,5,3,17,11,5,7,5,4,2,5,16,15,8,3,10,6,16,1,3,8,5,11,6,5,7,20,19,20,0,7,3,11,10,8,14,4,6,21
stand,5,26,15,144,25,39,10,63,8,10,14,13,29,172,6,26,19,26,27,9,5,44,57,66,36,29,1,66,40,69,19,213,167,61,80,185,81,6,22,18,19,70,8,21,72,22,22,12,264,169,76,36,35,158,25,6,57,20,54,35,13,17,6,19,43,29,196,13,11,12,15,10,15,11,194,36,61,4,117,58,39,5,6,24,189,12,12,3,28,3,21,16,5,72,45,16,31,9,53,13,4,36,22,26,20,37,10,5,23,11,49,6,25,22,13,69,2,5,75,150,48,78,16,116,34,17,13,4,7,1,51,23,11,80,59,125,24,3,23,37,26,42,36,4,14,128,18,25,20,7,95,8,25,6,10,18,83,10,21,78,11,3,16,2,4,50,10,35,30,11,25,175,54,9,37,6,152,17,22,80,34,9,23,50,5,62,39,34,39,59,7,12,7,12,7,8,13,20,11,24,31,1,3,13,32,29,10,19,15,28,114,41,38,9,36,32,5,10,31,0,3,37,4,17,36,118,37,42,20,6,17,14,25,14,66,13,57,9,10,22,94,40,12,21,33,2,12,78,43,11,13,14,35,3,5,23,9,0,4,20,5,81,8,5,4,24,9,56,37,4,116,10,6,10,7,11,38,10,8,7,131,9,8,39,16,3,19,25,38,7,4,16,17,5,3,12,31,21,11,26,44,19,1,5,14,6,45,7,15,6,2,22,44,25,16,15,23,36,3,13,53,9,60,20,130,8,19,94,4,44,30,12,11,6,15,10,39,11,4,15,8,24,28,9,8,19,34,69,19,32,18,13,10,46,19,6,15,4,13,71,30,8,17,26,4,17,29,23,25,78,11,101,8,61,14,28,7,4,40,6,77,7,54,19,35,30,15,30,22,8,41,16,15,12,25,25,50,7,15,7,40,32,9,25,8,6,13,5,26,27,6,23,1,25,17,39,19,24,10,49,9,16,29,12,15,9,10,11,17,12,5,3,2,29,13,3,7,27,35,11,19,23,16,37,18,16,65,26,27,21,57,5,31,3,58,10,22,22,14,32,37,38,43,94,28,22,58,17,12,9,56,22,11,9,18,40,10,16,33,12,12,24,6,20,15,10,5,27,12,6,98,35,11,20,24,6,4,4,12,14,8,9,6,6,5,11,9,12,4,4,4,9,4,11,17,9,9,13,3,18,21,16,12,27,9,6,25,12,17,32,23,15,16,21,18,16,4,19,32,14,9,5,9,14,9,7,8,13,5,6,58,4,6,41,6,15,27,1,4,13,21,4,14,5,14,10,21,13,43,43,17,6,11,7,12,7,14,9,10,28,7,8,24,50,12,18,5,11,10,19,34,40,27,9,21,5,9,16,23,14,9,2,4,5,3,25,8,23,9,2,32,7,12,10,37,9,18,3,12,1,10,1,9,26,4,6,6,2,13,25,12,22,34,27,5,7,14,8,17,9,20,14,30,11,3,9,5,1,13,145,18,14,12,10,17,29,23,25,6,9,5,15,11,20,3,0,2,4,6,8,17,6,29,49,15,5,2,4,0,7,7,26,8,10,8,10,29,10,5,10,7,42,4,14,6,11,12,3,22,4,19,6,3,4,10,9,19,41,8,3,5,3,9,19,18,61,44,8,10,16,8,14,13,33,9,9,5,5,8,20,6,5,4,8,8,4,25,9,18,12,8,6,7,10,19,4,7,16,10,9,31,5,1,7,7,8,5,11,6,5,4,15,1,3,28,18,14,2,8,4,28,6,5,17,10,16,7,2,6,11,1,2,10,1,12,7,10,9,11,7,13,6,8,5,17,13,5,4,0,5,11,2,15,8,25,11,16,5,11,3,4,10,8,8,5,4,14,20,2,4,2,5,9,8,4,2,11,6,8,7,7,6,23,14,8,6,6,24,9,6,3,9,8,14,3,7,3,12,5,13,16,8,13,2,8,9,10,3,2,2,2,7,4,3,7,5,7,6,13,6,0,2,4,6,8,4,2,10,15,30,0,4,6,3,0,1,5,7,4,7,14,4,6,4,2,1,4,6,6,42,7,9,21,9,9,1,6,3,1,17,5,0,15,4,5,2,3,8,10,3,9,6,2,6,12,1,5,8,2,3,5,4,3,7,1,2,2,9,9,9,4,24,4,1,5,4,7,4,4,1,2,11,11,7,4,3,10,7,7,4,2,7,2,0,6,3,0,0,13,5,16,9,25,20,2,4,16,6,7,4,6,3,3,3,7,6,10,25,10,18,5,12,2,12,0,2,11,4,8,29
together,11,50,20,216,21,33,7,85,13,8,33,26,43,144,7,16,23,48,40,19,6,43,140,95,22,57,66,1,29,67,14,308,209,55,81,294,109,6,12,17,18,43,21,35,79,19,33,41,314,189,85,63,37,158,55,5,38,31,67,43,15,13,12,35,57,43,191,19,29,24,31,13,13,11,273,28,81,11,142,67,60,17,16,19,256,11,15,11,59,8,18,15,17,52,60,21,34,4,60,28,17,36,24,29,24,53,7,17,27,19,41,9,41,57,48,57,6,6,102,160,41,128,44,191,20,18,7,0,8,5,55,21,22,66,76,310,12,12,14,31,18,104,41,10,8,146,20,32,18,20,69,10,20,14,14,30,132,22,12,120,20,8,26,13,22,74,22,32,46,20,30,223,49,18,30,7,160,9,9,111,44,18,37,66,7,47,39,27,35,99,15,18,8,18,4,7,24,17,8,13,42,4,8,11,29,43,9,45,22,29,110,48,45,12,16,48,21,30,19,4,24,41,2,33,43,85,37,40,14,9,21,20,43,22,46,24,39,11,9,13,81,51,15,22,33,6,16,86,52,18,13,35,44,8,8,41,8,11,3,31,10,63,24,4,11,44,27,67,37,4,110,18,38,6,9,25,32,14,8,5,105,8,4,21,14,5,43,37,19,18,8,16,21,19,10,12,47,6,11,41,38,27,6,7,8,18,28,5,10,4,1,21,77,37,43,17,32,61,19,13,64,10,57,28,71,6,28,102,11,55,26,17,7,3,14,12,45,9,7,14,8,31,51,11,7,16,38,87,24,52,10,17,7,43,19,7,9,8,22,60,36,21,27,20,13,35,29,18,47,77,6,78,9,56,10,31,7,7,42,2,66,3,56,16,23,37,9,29,37,9,22,40,32,17,31,22,42,7,26,5,26,24,7,19,6,9,10,3,26,29,8,11,4,18,4,23,20,16,12,33,15,12,29,9,16,7,14,12,13,20,16,8,14,19,44,6,12,24,31,9,15,20,7,33,4,11,74,14,28,17,65,5,44,24,68,5,21,8,20,26,36,42,36,61,13,8,51,8,7,12,52,18,4,10,10,41,10,22,29,16,10,16,14,15,13,7,9,31,8,5,119,42,6,23,26,8,7,10,12,13,28,8,3,19,20,15,13,7,10,9,1,3,9,3,11,13,15,16,3,20,8,9,4,20,9,5,29,5,14,25,17,9,12,15,15,23,14,17,25,17,4,7,14,14,13,7,12,16,7,6,63,3,1,55,13,9,24,7,4,5,20,6,13,6,20,15,20,7,44,31,21,4,19,1,3,6,7,3,4,40,0,18,19,44,13,8,9,2,2,28,26,33,26,12,27,5,11,12,32,20,16,6,7,7,5,12,8,28,11,5,24,14,13,10,8,8,21,10,3,5,14,3,5,38,6,5,13,8,11,35,12,21,26,20,13,6,12,6,14,11,18,19,7,25,5,40,11,3,16,155,8,14,9,11,4,32,21,12,12,12,5,14,19,22,5,5,10,11,8,8,13,10,38,18,26,8,7,17,5,5,28,30,9,9,16,7,15,7,5,20,16,53,12,12,6,23,12,3,13,13,14,7,7,5,14,12,27,12,3,12,5,22,10,34,19,46,27,6,8,17,15,3,7,23,11,6,7,11,0,17,10,16,5,7,6,6,47,12,24,15,14,6,12,22,10,7,24,14,14,3,25,12,11,14,9,9,10,16,6,14,9,29,8,10,21,27,21,5,4,8,25,8,7,13,6,10,6,6,5,13,2,8,18,5,14,6,6,30,13,13,21,12,6,4,9,22,5,8,5,3,4,9,8,10,25,17,20,13,18,10,5,12,7,11,3,6,10,25,5,8,5,3,21,15,14,2,16,6,13,7,16,9,12,7,17,15,15,33,7,11,10,6,2,12,1,4,7,20,11,16,37,19,4,7,5,6,10,4,4,6,8,10,0,17,6,6,1,5,11,14,8,14,10,6,8,4,4,13,12,9,1,9,3,8,13,0,13,8,4,7,26,10,3,8,5,13,9,6,6,44,8,11,18,12,11,3,6,7,9,14,7,12,10,20,12,9,3,9,8,6,8,11,8,9,6,8,8,22,6,2,10,10,6,7,5,2,13,9,5,16,5,15,9,4,2,11,6,25,46,4,12,9,11,9,2,11,3,16,16,4,2,12,1,4,3,7,1,2,9,1,12,19,27,32,7,5,10,4,17,2,2,10,7,4,3,5,9,28,12,17,6,8,6,16,6,6,11,6,5,26
speak,5,35,8,78,13,23,3,27,15,3,14,11,22,97,4,14,13,17,19,8,3,33,48,53,21,26,40,29,1,40,6,133,107,33,42,124,52,5,9,12,9,30,5,7,36,12,10,9,144,85,40,17,16,93,13,7,38,3,55,15,9,6,1,15,23,18,126,3,6,16,14,1,6,5,81,13,41,1,61,34,20,2,4,13,114,16,8,0,17,1,6,13,2,24,33,11,26,6,31,14,5,21,13,26,7,30,1,5,16,7,18,3,12,14,7,19,5,5,31,99,33,54,26,71,18,11,4,0,1,1,39,6,18,48,38,59,7,0,7,8,9,39,21,3,3,65,11,15,8,11,46,4,8,4,4,13,55,9,17,36,8,6,8,2,1,21,12,15,26,3,6,127,24,6,22,6,106,8,9,54,15,13,14,32,1,28,31,20,13,43,4,14,2,5,5,2,14,8,9,7,26,5,1,5,10,20,3,14,6,8,74,21,17,7,15,17,3,9,12,1,8,19,4,9,17,63,20,24,18,4,14,11,12,19,42,8,23,3,8,15,46,28,10,12,9,2,5,41,9,6,12,6,27,8,0,16,4,3,0,9,3,42,4,2,3,6,4,31,33,3,88,2,9,4,2,8,14,4,1,1,73,7,0,16,8,3,9,11,13,4,4,7,2,4,1,5,22,13,5,19,22,6,0,6,9,2,13,4,6,1,3,12,25,10,16,8,6,10,6,5,25,13,31,11,59,3,14,55,2,29,13,17,3,4,5,10,16,5,2,5,2,12,26,4,5,10,17,37,10,19,5,9,6,35,11,2,7,6,3,36,8,3,11,18,2,17,13,12,15,44,4,41,0,28,12,17,7,3,20,4,40,2,34,9,20,26,6,19,14,1,19,7,24,8,12,13,18,6,13,4,22,14,1,15,11,8,4,8,18,14,4,12,3,20,11,19,11,11,9,20,4,7,21,12,2,4,0,4,5,17,16,8,2,18,9,1,7,12,15,3,10,5,1,12,3,5,31,14,20,9,27,2,20,11,30,11,17,10,4,10,26,19,25,42,12,9,30,7,3,1,33,12,3,13,3,17,13,17,16,8,10,8,3,6,6,7,2,15,2,7,60,24,14,10,16,3,4,5,2,7,18,8,5,4,6,7,4,9,3,5,0,9,3,2,10,8,5,13,3,12,4,12,4,20,5,7,14,2,12,24,7,12,7,12,7,5,2,13,27,6,4,1,7,4,6,4,18,10,5,6,32,2,4,27,7,14,12,2,15,11,9,1,3,3,8,6,10,5,14,20,6,1,4,1,7,0,6,8,3,12,3,7,8,15,6,3,9,7,1,11,25,22,17,7,11,2,2,4,6,10,7,2,3,3,1,19,4,9,2,3,28,3,8,2,14,6,4,6,6,0,8,1,2,11,3,5,4,9,9,12,6,15,9,9,3,2,12,9,6,1,14,12,12,9,5,3,3,2,2,90,13,2,10,3,6,13,15,10,5,12,2,5,0,3,5,0,0,2,6,4,6,4,25,39,7,2,2,2,6,10,5,20,6,5,4,7,7,1,1,1,11,34,7,3,4,5,7,1,16,6,4,1,3,5,0,9,9,14,0,1,1,6,3,12,9,6,20,1,9,3,6,3,4,9,2,6,7,2,1,6,2,5,3,5,1,1,4,1,13,10,13,1,0,10,8,4,6,7,4,7,10,2,1,8,2,3,3,4,2,8,8,8,2,3,16,12,14,8,0,1,10,6,4,19,1,7,6,3,10,7,1,1,5,1,6,7,4,12,3,7,0,4,2,2,4,10,1,8,0,2,1,2,4,2,12,1,5,2,11,4,1,1,2,4,3,1,4,15,1,7,0,0,1,4,0,7,10,1,4,2,5,2,6,4,13,4,7,11,1,3,3,6,8,3,3,3,1,13,2,1,11,14,8,1,0,4,3,2,2,2,3,7,4,3,2,4,5,2,8,9,0,7,3,3,5,2,0,5,12,1,0,0,4,2,0,2,2,2,8,2,11,6,5,2,1,12,0,4,4,20,0,1,9,5,2,7,1,6,1,6,5,1,8,3,6,3,3,1,6,2,2,4,4,1,1,2,2,2,1,8,5,2,2,2,6,2,4,3,11,4,2,17,4,0,5,2,1,9,14,0,2,12,4,2,3,0,1,2,9,1,3,2,4,0,1,7,0,2,4,2,3,8,18,11,1,6,7,3,0,2,1,3,3,4,9,8,4,12,7,6,2,7,2,8,1,8,9,1,1,19
day,22,71,29,286,22,39,8,75,13,11,41,30,38,136,3,17,26,44,28,13,7,61,77,104,27,49,69,67,40,1,27,323,179,55,101,200,86,47,21,19,24,45,10,24,98,19,25,17,443,147,75,24,28,141,43,6,66,55,51,40,12,11,2,32,42,38,160,12,9,23,89,5,16,8,161,25,80,11,165,63,90,7,22,25,283,45,27,4,103,12,52,11,16,70,67,16,33,9,81,23,11,51,48,31,22,91,13,15,40,14,57,6,15,45,21,68,30,11,140,192,47,93,25,242,36,19,13,5,24,13,45,16,28,94,85,163,12,9,17,20,26,77,68,11,9,176,29,34,14,21,92,12,44,17,11,46,85,17,10,81,54,5,27,20,25,56,30,31,48,18,39,224,36,17,40,21,223,11,9,82,36,24,34,55,8,38,37,13,31,94,6,18,19,18,16,10,18,17,23,20,41,11,4,15,30,31,17,23,36,28,151,55,64,15,30,46,13,23,39,4,26,47,7,18,72,175,37,52,23,22,7,35,71,28,43,24,60,7,23,22,122,50,41,23,29,4,18,85,68,17,13,22,40,30,10,26,16,15,4,46,7,82,31,27,19,68,11,49,37,5,184,20,104,9,6,20,33,27,17,2,206,11,4,22,17,3,29,35,34,4,15,28,56,26,21,12,64,17,18,32,47,35,10,18,11,10,21,13,10,6,11,20,69,23,93,35,24,46,22,8,58,6,71,32,84,8,17,137,12,60,35,28,15,9,8,13,51,8,5,30,12,35,42,11,16,25,74,85,30,39,13,20,10,43,25,4,19,7,30,112,15,12,20,16,4,17,39,12,40,86,13,97,13,49,15,49,17,9,33,5,127,4,58,16,49,63,5,30,59,5,34,21,25,29,36,33,66,5,49,10,17,25,18,20,15,8,21,2,25,20,8,25,2,11,14,33,29,13,11,39,5,17,28,15,11,6,4,20,24,29,43,46,27,61,20,7,10,33,40,14,40,10,6,21,8,8,76,27,35,26,63,18,34,9,79,24,27,23,17,40,37,66,40,109,12,12,63,22,14,7,77,21,4,6,8,31,22,17,31,7,15,26,1,10,13,8,11,34,5,5,147,84,13,22,23,7,3,27,21,10,24,9,3,12,16,38,3,17,12,6,6,4,6,7,22,27,19,7,6,16,10,25,6,38,5,9,37,12,33,31,29,11,17,10,23,18,11,21,72,28,13,2,23,11,11,19,8,14,19,7,74,11,13,108,5,14,19,9,11,19,20,18,32,6,11,19,22,14,47,33,10,14,35,3,16,18,17,10,7,57,6,26,18,38,6,13,9,11,3,22,31,41,37,14,30,6,9,10,44,19,28,1,13,8,14,20,13,23,7,11,58,18,32,12,39,7,18,3,10,2,10,12,6,64,7,6,11,7,8,32,41,28,21,28,22,4,15,13,27,8,23,9,14,33,7,48,5,16,11,231,19,14,2,3,9,40,53,26,12,31,4,21,28,22,10,15,3,15,7,25,21,11,51,51,54,11,3,11,1,3,10,43,12,15,9,11,20,10,9,8,28,47,30,25,8,32,25,7,19,15,16,8,4,5,13,15,20,23,14,12,7,80,17,25,14,37,35,3,16,12,21,8,3,38,10,15,10,2,6,29,9,19,14,8,11,1,23,11,30,8,19,7,4,13,12,3,31,10,12,9,17,25,25,41,19,34,10,11,7,58,40,19,46,37,26,33,17,8,3,17,22,9,8,21,2,20,9,5,15,16,3,6,28,11,22,2,9,82,6,31,6,12,7,5,21,29,8,25,5,6,2,13,12,27,24,12,17,15,17,8,14,6,20,24,2,4,5,17,12,13,5,18,9,10,0,6,27,20,16,15,34,7,16,9,19,10,8,51,10,14,11,18,11,12,6,21,12,13,3,16,27,37,12,3,6,15,3,12,19,2,1,8,8,3,4,6,12,10,17,8,10,12,44,16,15,6,6,22,22,5,5,51,5,10,13,3,9,13,8,6,19,21,6,11,7,20,1,15,36,36,10,10,26,6,40,44,9,21,4,23,7,31,10,45,27,35,11,2,17,3,8,6,13,5,2,8,4,18,2,8,6,6,7,12,7,10,7,16,8,9,6,35,26,15,10,28,18,41,111,6,4,13,9,9,7,122,17,6,31,5,11,17,6,7,19,21,7,13,11,5,30,15,23,22,13,1,17,13,8,5,12,6,7,42,10,6,9,26,12,11,4,9,7,12,1,1,10,19,1,29
arm,8,14,8,94,9,7,4,52,3,5,17,8,9,91,3,14,13,8,8,8,9,39,9,25,14,8,19,14,6,27,1,187,97,9,60,73,112,6,5,14,2,16,5,1,26,20,22,7,291,21,63,13,6,48,9,7,61,25,3,14,20,12,3,12,16,11,75,1,10,28,31,11,2,6,96,9,20,8,82,18,31,1,20,8,167,11,13,1,35,2,13,6,1,27,31,1,13,6,40,5,14,33,27,12,12,40,20,10,17,6,14,3,5,5,2,31,4,1,78,208,45,21,0,68,4,3,3,9,4,0,19,9,7,52,23,31,15,2,4,10,6,39,32,7,3,106,4,13,7,9,75,0,22,11,1,8,30,6,17,13,9,1,6,7,1,6,4,21,23,13,10,106,16,2,0,7,159,6,7,23,28,8,7,29,3,13,27,22,34,48,1,13,3,0,5,5,8,6,5,14,3,2,1,10,47,6,4,16,13,27,66,5,18,4,5,5,0,0,4,0,4,24,5,22,41,89,14,21,4,1,12,17,23,34,46,4,25,10,2,8,61,34,9,8,26,2,8,30,50,7,8,11,19,6,6,15,13,6,2,44,0,88,19,5,3,27,2,8,15,7,122,7,18,8,3,2,37,6,10,2,60,5,1,19,7,1,0,9,20,1,6,8,4,4,4,7,33,4,11,19,12,31,1,8,6,1,25,3,1,4,6,12,23,10,40,12,8,27,10,4,59,11,37,2,96,9,1,40,5,24,6,8,11,7,9,13,18,11,1,10,10,17,15,19,7,8,36,52,21,9,5,4,12,33,31,2,7,6,15,20,7,9,8,20,4,2,37,12,2,16,6,27,1,5,7,69,22,3,17,2,70,6,44,11,5,19,4,19,35,6,22,7,11,9,30,7,38,5,53,4,10,4,4,4,5,0,4,3,14,10,4,11,3,17,27,11,7,13,2,8,4,10,15,16,1,1,5,15,16,15,1,4,2,12,4,8,12,12,32,7,24,22,10,18,5,12,14,14,29,7,25,7,5,0,37,18,2,14,9,18,12,18,39,59,23,5,19,9,7,0,15,6,6,1,8,13,8,12,23,9,14,13,5,8,11,16,4,3,10,2,197,30,7,6,6,5,4,21,10,10,14,5,1,1,6,0,2,6,7,4,4,6,11,4,12,11,5,9,3,6,3,18,3,15,4,5,34,0,10,25,11,6,27,12,7,8,14,5,30,18,7,3,6,3,2,1,7,10,16,2,27,9,5,29,23,11,20,4,4,6,19,3,21,9,15,22,7,9,30,25,16,11,18,2,10,4,0,7,7,16,8,18,11,23,6,6,3,3,3,6,17,35,5,6,5,3,0,4,41,23,19,3,2,5,9,18,5,18,5,4,19,9,4,8,33,11,20,1,10,3,17,0,9,26,3,7,10,9,16,32,0,29,18,19,17,6,6,5,3,16,15,7,3,15,3,45,3,3,3,176,41,2,5,7,7,10,37,30,9,11,4,9,10,14,11,7,4,9,6,8,24,4,62,12,26,7,9,6,5,3,2,27,19,9,7,9,17,5,3,22,9,11,18,11,7,6,9,6,13,12,15,10,4,9,14,13,19,13,3,8,6,11,6,40,14,69,29,11,8,18,26,10,19,64,11,6,7,0,7,18,12,11,5,9,3,5,44,4,38,12,11,12,2,20,19,6,5,6,9,6,16,5,5,8,3,9,7,11,1,4,4,16,2,2,13,4,11,4,2,6,15,8,2,27,5,15,0,0,2,10,1,6,14,0,5,2,9,33,7,13,7,6,0,5,4,15,0,5,4,2,5,7,20,2,6,2,5,1,12,8,3,5,14,14,11,3,3,16,8,10,7,2,10,19,1,2,4,4,4,5,6,2,12,15,11,9,13,28,16,9,6,3,0,9,7,12,6,17,4,28,39,28,11,5,0,3,6,7,11,3,10,8,5,1,13,3,15,2,17,15,3,8,2,0,4,6,2,6,9,2,3,6,8,7,7,0,5,3,5,6,3,6,0,7,5,5,7,8,8,14,7,15,11,12,8,3,5,1,6,19,3,3,3,11,10,10,1,3,4,2,5,5,5,7,2,7,4,12,3,1,2,4,9,6,3,2,3,9,8,7,4,16,2,2,4,5,7,15,15,5,5,6,12,8,9,5,2,7,7,4,0,1,2,2,2,75,4,1,3,13,35,6,8,5,6,4,4,8,8,6,1,6,4,1,6,0,10,3,33,3,7,0,6,3,0,0,3,9,5,2
make,102,396,162,2453,140,136,102,350,73,63,268,197,202,1040,75,121,134,248,111,85,88,531,326,505,326,303,213,308,133,323,187,1,1797,213,777,969,606,184,202,89,139,164,95,128,594,207,412,323,3992,610,723,115,164,652,325,103,885,588,147,426,243,103,50,190,421,115,1369,135,178,332,325,130,107,80,1414,195,404,76,1150,363,797,33,230,135,3102,342,226,45,647,60,171,103,78,449,775,249,287,99,559,249,278,514,485,190,226,472,201,146,237,93,297,99,237,303,168,471,127,88,1124,2220,604,445,435,1373,177,76,59,82,91,50,244,79,106,797,325,1151,126,83,140,132,59,543,437,87,56,1110,98,248,241,296,930,84,253,127,82,494,553,147,137,416,291,67,176,80,145,256,116,416,386,126,300,1381,386,71,119,134,2286,73,164,817,496,188,172,350,102,353,530,354,493,858,52,96,116,36,87,61,363,134,184,217,526,84,108,221,371,190,98,554,266,356,1186,158,372,189,78,230,96,164,262,97,150,277,103,263,743,1612,447,412,132,196,245,313,346,331,471,317,517,184,184,158,1001,462,125,108,203,104,118,425,840,102,210,257,345,139,153,270,144,88,79,332,125,414,365,100,98,764,187,163,256,82,1815,218,649,100,63,89,349,342,195,103,996,82,61,259,161,61,241,279,205,57,110,86,262,152,82,154,661,138,142,252,358,637,74,82,169,87,375,101,143,60,50,280,471,165,736,257,264,599,192,106,686,127,443,219,824,100,152,545,75,468,100,224,104,109,138,258,275,131,76,196,148,209,258,169,90,125,536,803,205,217,217,213,80,639,314,118,106,110,251,520,356,214,180,276,58,77,464,118,215,324,73,330,94,239,143,573,134,66,199,109,921,62,685,171,139,578,133,365,448,57,329,78,231,168,481,156,845,98,525,83,313,76,82,50,129,90,127,55,367,221,62,201,85,261,149,160,91,135,94,75,73,183,322,204,60,82,65,201,160,220,224,119,124,239,85,85,28,270,190,96,256,325,121,173,39,83,252,122,494,139,309,82,120,97,757,166,32,166,172,470,212,331,443,484,150,95,315,224,203,50,358,96,53,67,77,280,74,230,442,137,115,185,73,70,163,167,171,89,78,67,1100,539,72,69,183,106,84,310,114,127,215,111,84,99,182,382,117,224,109,68,75,82,116,120,191,241,94,144,110,139,85,292,124,281,94,80,370,142,268,448,166,112,131,173,160,120,178,185,523,321,73,54,46,149,144,159,56,254,212,124,441,99,142,625,122,153,414,71,103,152,348,80,613,118,235,232,158,151,619,565,182,123,523,84,140,182,166,105,92,338,139,252,177,226,107,121,99,138,71,207,342,437,201,89,309,89,96,119,776,313,272,57,64,79,134,310,116,327,208,122,389,458,266,112,535,110,258,92,139,93,198,130,94,338,137,102,108,185,216,451,228,337,409,299,154,66,175,190,69,183,187,85,161,285,119,557,118,128,124,2308,342,79,115,103,114,190,488,227,111,231,66,128,251,287,129,87,65,175,144,173,280,128,591,483,469,65,70,165,103,103,196,429,215,127,163,126,196,87,92,215,230,212,233,205,115,217,111,86,217,225,123,87,114,123,144,146,259,127,64,80,69,204,91,313,251,454,175,101,148,170,149,100,100,467,79,148,137,67,78,150,130,263,80,97,108,123,394,87,541,117,230,86,101,195,183,103,191,185,103,139,139,176,106,270,171,215,115,187,94,277,268,226,81,108,328,276,205,108,168,213,141,81,40,238,72,189,173,54,316,148,149,96,188,102,175,104,105,240,122,244,149,186,127,102,251,339,116,131,69,153,102,113,171,115,96,95,106,95,284,112,130,58,202,137,79,80,71,166,98,186,100,75,131,256,196,100,244,163,142,93,207,113,131,89,112,114,135,356,120,104,115,91,88,204,109,188,121,200,124,178,248,415,135,92,100,104,86,128,103,52,136,86,118,91,86,96,99,76,73,313,102,92,146,180,91,72,86,163,167,96,112,126,71,64,226,90,132,110,96,107,100,328,90,80,101,158,102,92,137,105,117,102,84,139,96,67,66,138,95,269,79,182,88,277,167,85,82,152,81,66,108,110,63,155,57,107,69,264,87,110,107,134,113,103,63,68,73,108,81,210,61,187,197,82,143,373,198,361,660,72,63,108,71,78,139,130,112,82,333,82,71,128,91,130,47,257,119,99,47,94,147,92,92,85,107,84,75,70,126,88,147,105,117,151,118,112,124,112,276,74,64,71,100,45,36,77,86,120,62,56
country,58,209,93,1226,176,86,61,375,43,53,284,103,102,798,67,127,89,173,100,71,52,469,187,255,234,162,167,209,107,179,97,1797,1,175,598,795,491,104,171,75,116,147,100,58,336,188,243,133,2838,469,503,82,227,547,169,60,582,272,98,207,217,94,38,141,241,93,1208,114,124,185,152,44,77,57,853,181,245,57,819,293,621,19,157,96,1969,235,192,1,348,25,106,92,26,297,596,136,201,72,417,236,80,318,289,138,166,320,98,59,199,62,209,64,114,166,68,327,63,46,560,1698,394,297,272,762,102,47,42,45,36,20,210,63,78,473,255,536,87,47,52,143,48,427,332,47,36,780,95,202,235,138,607,32,205,134,102,174,414,102,123,228,143,60,110,29,48,157,81,253,275,127,227,997,274,36,94,105,1679,41,138,440,236,134,91,216,59,328,411,220,357,700,24,75,138,38,39,41,168,71,114,128,424,32,38,130,325,112,71,420,134,300,765,122,260,105,68,105,26,33,141,32,54,190,69,133,393,982,340,268,90,119,169,172,184,196,383,235,326,122,141,104,720,362,77,92,181,86,79,265,417,55,128,272,235,95,123,173,124,16,61,231,44,313,168,43,60,352,100,116,180,101,1232,84,306,60,51,27,227,115,99,32,759,64,70,235,165,48,80,121,166,52,49,65,105,75,23,91,366,53,53,188,295,254,16,34,132,31,239,56,91,30,42,181,340,104,373,172,247,432,182,58,537,106,305,115,583,58,111,365,55,330,52,114,95,59,91,118,244,105,60,147,106,124,224,120,91,74,510,638,165,119,136,133,75,341,220,73,59,66,158,259,194,99,139,258,86,51,343,97,112,240,47,294,67,185,104,263,93,62,188,82,589,28,417,161,95,314,81,236,315,62,238,59,104,129,311,149,516,56,336,65,262,67,55,53,89,103,82,74,356,170,47,149,178,221,82,127,75,103,61,58,76,115,162,116,42,39,55,143,109,167,147,47,33,101,78,57,21,153,140,53,185,244,70,208,46,66,163,101,401,118,216,58,80,58,621,79,47,97,117,287,132,299,300,347,93,21,260,163,84,24,255,55,27,75,35,202,66,178,204,67,90,151,59,59,130,59,139,97,66,46,769,356,63,60,208,94,61,176,100,156,146,69,59,26,52,391,124,174,53,67,58,64,83,66,181,183,63,109,78,106,46,212,82,187,77,60,296,77,184,269,118,88,89,98,83,106,83,123,410,169,72,63,44,162,102,82,74,245,154,74,338,55,49,433,84,82,419,54,65,93,201,32,202,29,168,147,171,76,322,372,114,104,107,40,75,76,186,71,55,189,129,128,201,235,112,82,76,113,48,170,259,344,119,53,301,80,83,88,434,204,220,39,74,40,64,231,61,203,59,74,312,156,128,101,266,101,203,47,72,52,156,126,49,206,63,81,79,94,166,368,173,244,267,216,103,38,118,86,79,112,135,51,83,205,120,246,56,68,54,1695,123,55,119,50,68,150,362,156,87,149,68,78,140,235,97,49,38,105,116,120,193,92,551,156,242,80,47,67,36,77,62,311,124,98,111,107,154,64,63,118,119,134,121,164,80,110,108,62,160,119,129,64,67,78,83,95,198,91,38,44,38,78,78,282,166,263,98,93,63,90,92,52,82,212,54,153,108,53,30,206,91,156,57,65,46,56,207,98,329,169,126,62,42,93,109,55,152,121,70,81,144,62,34,91,65,117,90,130,61,197,174,134,31,28,274,222,172,76,146,111,90,64,64,195,51,144,138,29,141,109,47,63,135,57,127,79,74,236,87,125,109,109,53,69,105,200,57,69,67,49,54,48,86,47,75,44,82,100,171,61,158,65,158,71,66,42,51,102,49,106,77,61,95,101,47,53,71,59,142,72,84,68,168,78,86,127,123,267,93,77,57,54,46,75,75,86,80,88,58,139,216,241,104,86,46,47,93,52,77,11,85,46,69,64,64,102,58,47,70,125,52,94,62,196,62,75,40,130,123,108,28,50,40,66,60,49,73,51,106,69,81,142,31,50,84,55,57,44,49,88,79,52,59,89,76,39,51,139,60,167,46,103,75,75,131,54,58,109,60,54,94,105,48,138,69,64,57,166,55,72,43,37,67,91,52,62,64,57,60,132,46,145,58,34,77,151,138,118,239,44,31,70,57,49,35,46,64,53,133,53,27,82,71,55,28,175,63,28,38,88,149,57,86,86,56,95,55,100,84,84,55,84,44,131,69,94,112,82,147,41,54,56,77,30,11,43,34,49,49,35
serve,2,31,20,141,31,32,14,34,7,3,26,12,19,138,3,10,17,29,15,11,3,48,51,45,30,27,61,55,33,55,9,213,175,1,96,157,79,10,11,19,17,35,5,14,48,15,24,30,185,109,54,16,25,109,18,4,62,21,52,23,15,14,1,20,23,20,141,11,13,19,22,0,17,12,160,21,41,5,88,51,91,4,7,13,140,16,26,3,30,5,13,9,4,55,61,17,25,5,64,27,6,39,18,29,19,51,6,4,27,1,27,8,13,30,12,31,8,6,72,126,61,92,8,126,16,14,12,0,11,4,33,17,14,62,61,104,12,8,20,13,15,44,24,8,5,101,11,22,14,7,60,11,15,14,3,29,62,10,6,66,14,11,15,5,4,48,14,33,35,5,20,157,36,7,30,7,148,12,16,90,16,14,32,43,3,43,33,23,28,54,5,9,8,9,5,2,13,18,19,15,37,6,0,4,23,30,9,41,15,20,137,35,22,12,14,19,1,11,32,5,4,17,7,18,35,90,40,21,14,10,12,35,18,18,63,13,30,16,11,16,75,33,8,17,31,9,7,86,67,16,16,19,31,6,2,18,9,7,4,32,18,79,13,3,6,48,19,48,25,3,125,8,15,11,7,11,34,8,6,3,108,5,4,18,13,9,34,42,19,8,0,14,8,9,2,6,32,8,13,14,45,28,1,2,11,2,28,12,9,7,6,17,42,28,43,23,33,32,7,5,32,9,42,16,70,6,22,75,6,29,20,13,13,14,8,13,33,10,7,21,8,23,31,13,8,12,45,51,26,35,13,16,6,48,13,9,12,11,9,39,24,17,19,19,4,12,26,17,20,70,10,90,6,56,18,108,9,2,29,8,40,5,43,13,63,20,13,25,25,2,34,21,19,18,29,27,31,6,33,4,15,21,2,16,7,4,12,7,20,24,6,11,4,17,0,21,17,8,10,37,5,21,18,7,7,6,5,7,11,18,9,3,2,23,17,5,13,20,25,6,16,10,5,15,6,6,54,13,16,21,43,1,33,5,48,12,18,7,6,15,29,39,19,118,25,21,49,18,4,2,51,16,6,16,3,36,0,20,26,13,13,18,1,23,8,6,19,21,11,5,107,28,10,13,32,2,5,10,8,8,9,11,7,6,6,23,12,7,3,4,3,7,2,7,18,9,15,15,0,15,1,13,6,26,9,7,20,8,11,24,14,19,11,15,10,20,7,15,41,20,3,4,8,11,16,6,6,10,9,3,27,6,2,42,13,10,27,3,8,8,17,3,15,7,13,9,21,11,36,41,10,7,8,4,7,3,6,7,2,34,6,11,17,42,14,13,6,6,2,45,31,33,17,9,18,6,8,10,17,12,10,4,5,2,3,14,12,20,11,4,28,9,27,4,18,6,9,2,9,3,11,3,4,19,7,6,2,9,12,43,8,14,17,22,9,5,16,5,12,9,13,6,32,17,7,15,3,2,13,109,16,7,3,3,8,25,41,9,2,10,4,3,6,9,1,4,3,4,7,5,24,10,13,28,9,7,7,5,1,3,5,34,3,10,8,22,21,12,3,3,15,37,9,4,6,16,9,5,9,8,9,4,4,4,10,7,10,36,5,3,13,7,7,14,12,78,38,2,7,11,11,13,3,55,7,20,9,11,9,12,5,10,5,8,7,6,33,4,12,7,7,7,4,9,6,4,13,11,14,10,14,4,1,11,4,16,4,8,6,19,14,23,1,3,28,12,6,6,18,6,31,5,4,23,5,8,15,6,1,4,0,2,7,7,13,7,5,19,6,7,6,18,12,6,11,12,3,4,0,15,4,5,10,4,22,5,11,6,15,5,8,3,9,9,6,5,8,16,1,9,1,8,4,25,1,1,18,9,9,5,7,1,15,17,10,4,12,25,4,4,1,7,10,27,7,2,8,7,4,5,8,16,10,3,10,18,11,8,2,6,1,7,6,6,4,3,3,3,12,15,5,8,1,7,6,5,1,13,23,15,4,9,7,5,9,4,9,6,3,6,20,5,11,0,0,3,2,3,11,31,7,1,25,11,4,3,0,11,1,7,11,5,17,3,7,3,4,0,5,2,5,5,7,3,2,3,2,15,1,6,3,8,1,7,3,3,9,11,2,13,4,19,4,1,4,6,7,8,16,3,21,3,3,5,3,7,5,2,18,1,3,1,6,6,2,5,2,13,5,2,7,4,13,27,3,3,40,7,8,7,5,3,3,4,3,4,8,24,5,9,7,13,2,8,2,3,1,1,3,22
well,35,111,53,582,46,61,30,170,27,33,100,33,60,333,26,50,34,67,50,37,31,183,70,146,117,61,80,81,42,101,60,777,598,96,1,335,225,32,80,37,49,63,22,33,160,82,127,84,1051,171,220,42,65,228,79,53,276,121,44,97,69,46,17,62,110,47,505,49,43,66,64,29,38,21,486,78,136,20,372,131,238,8,54,53,887,79,80,13,113,13,44,21,26,109,294,50,92,29,130,74,53,140,117,56,49,121,42,29,58,25,71,30,48,91,46,133,23,20,248,691,217,122,77,303,48,20,29,14,16,13,67,31,53,225,103,310,46,31,27,57,38,183,105,16,16,280,41,76,84,51,278,21,55,32,22,139,178,36,44,94,63,19,52,11,31,75,19,112,117,19,87,406,125,13,22,39,748,29,46,243,151,65,69,97,15,174,181,121,144,166,17,26,49,9,36,15,71,22,42,90,148,10,22,55,121,60,23,166,59,132,387,43,105,55,49,56,33,33,62,14,25,115,34,69,190,445,133,142,28,39,63,62,71,106,165,87,119,55,41,34,297,158,47,51,67,39,31,137,209,34,58,89,103,24,51,97,37,20,12,103,45,122,79,18,32,135,61,52,79,31,606,38,117,43,41,17,131,60,53,22,313,31,22,85,56,15,35,70,69,20,14,26,91,32,11,52,166,28,33,94,105,145,9,11,65,9,101,22,41,16,13,72,132,37,170,73,122,166,63,21,210,43,149,55,275,26,67,214,23,107,28,57,43,27,48,60,82,26,23,35,35,39,83,47,22,41,180,211,77,65,57,55,32,124,108,38,20,46,71,113,97,55,59,69,17,20,183,64,63,91,16,120,33,75,54,181,53,31,72,36,249,22,181,68,57,129,43,73,101,22,133,35,63,58,146,56,226,25,129,20,94,36,25,14,36,42,36,15,111,75,23,52,29,95,48,49,20,43,26,29,35,57,80,54,16,25,28,63,48,68,60,14,12,43,30,17,14,41,67,26,73,90,39,59,16,29,98,34,145,36,88,33,29,21,213,50,12,34,50,129,82,123,185,210,40,45,136,55,46,10,127,31,25,33,19,141,29,48,104,45,34,64,29,32,46,37,51,20,35,23,379,171,12,30,69,38,22,80,30,46,79,33,21,16,33,94,38,69,26,31,30,23,26,48,63,74,27,53,23,47,25,106,41,108,41,35,98,66,65,131,47,46,40,60,51,32,50,58,185,106,26,17,25,45,67,46,22,107,57,36,160,31,25,176,39,67,117,24,20,47,117,25,83,17,82,88,68,37,141,167,51,36,59,29,30,26,68,25,24,102,38,61,57,115,49,57,37,44,28,58,115,132,57,24,143,20,59,48,142,100,83,23,26,20,19,87,25,89,32,37,118,88,36,25,135,44,107,42,43,14,63,26,13,61,19,33,23,36,82,128,46,105,163,102,54,22,50,35,32,65,73,32,36,93,22,106,20,18,41,571,99,37,42,20,41,62,162,81,29,71,24,28,43,54,15,22,15,35,57,47,84,49,172,127,135,29,17,37,30,28,28,107,52,33,45,45,76,27,19,34,56,62,47,44,20,40,39,19,42,55,27,17,25,30,48,37,76,29,13,19,41,25,23,122,87,135,47,21,45,53,43,33,42,145,27,44,38,22,32,53,42,78,32,31,27,13,121,32,151,51,61,30,26,89,70,34,64,39,39,40,41,20,11,32,22,64,24,52,27,61,54,73,5,15,79,62,63,47,50,44,62,21,27,67,23,55,40,25,63,55,27,28,59,22,53,30,40,110,44,61,26,48,16,24,78,85,34,30,14,28,23,24,30,29,42,16,50,25,69,29,47,20,29,33,30,18,25,38,10,51,29,14,19,44,12,22,28,39,48,25,32,27,63,25,41,50,39,104,41,30,16,30,27,36,24,34,39,36,36,48,73,101,36,29,14,21,25,20,22,7,35,15,33,24,19,40,33,18,36,49,38,28,29,54,15,18,14,54,49,33,13,20,31,11,27,24,24,21,31,19,33,44,9,19,30,20,20,22,20,44,35,23,35,37,30,11,10,42,22,105,25,30,38,29,56,10,15,22,24,17,48,31,31,45,14,41,14,59,20,26,28,18,27,38,16,20,22,23,22,41,34,61,22,21,36,67,51,55,106,14,33,23,26,29,12,9,25,24,55,30,10,15,18,14,11,85,21,20,27,32,37,38,46,49,25,19,30,39,29,24,16,31,19,45,20,30,52,22,72,20,21,14,24,13,7,17,22,21,15,12
u,30,101,57,439,98,132,51,265,30,31,125,60,142,770,46,107,81,130,105,80,39,201,697,285,89,176,185,294,124,200,73,969,795,157,335,1,482,40,69,105,66,224,29,64,239,100,103,75,1051,587,312,105,160,653,144,46,247,55,229,145,78,100,25,85,178,153,800,73,81,69,199,25,59,31,779,158,239,51,491,262,281,27,66,106,877,98,86,30,157,11,62,91,40,177,324,41,123,33,267,99,32,178,114,117,151,191,25,87,86,48,151,32,105,141,103,233,13,31,249,747,227,307,115,585,79,101,40,26,25,28,253,73,117,271,235,496,66,39,70,143,88,266,126,38,49,460,71,127,63,39,392,43,100,68,63,127,362,105,80,374,70,25,70,30,73,151,34,162,155,65,135,720,219,51,96,50,750,31,87,361,156,137,120,179,28,216,236,131,142,228,24,57,64,45,48,33,86,61,52,81,125,11,26,69,191,124,35,144,100,150,546,114,134,65,124,194,59,79,65,18,46,138,32,106,191,306,163,174,55,45,76,71,113,103,260,64,199,70,67,62,363,230,60,101,148,24,56,266,207,47,48,117,197,26,45,120,30,19,20,80,21,294,54,9,40,53,64,192,160,35,619,34,83,40,28,71,132,51,27,11,544,26,23,117,66,26,88,87,108,54,18,55,55,51,19,50,151,28,53,141,152,80,11,31,48,36,208,22,78,20,35,49,219,87,197,40,137,160,51,34,245,63,246,65,330,17,96,352,26,151,78,60,54,19,75,49,206,37,21,50,59,119,184,54,41,42,146,293,102,143,45,108,18,168,67,39,44,21,90,220,104,71,99,107,48,104,144,81,103,243,31,244,23,162,36,99,49,23,163,33,336,27,210,79,85,128,49,109,178,32,151,83,57,52,129,112,140,17,125,31,129,80,34,59,46,62,56,55,187,114,44,93,64,90,59,105,55,89,43,109,31,67,112,45,39,38,33,71,77,102,43,19,12,63,103,29,46,80,124,39,67,108,48,171,47,47,197,92,164,54,238,34,112,58,289,33,68,32,61,102,127,193,225,239,40,57,222,105,24,60,212,77,35,53,47,122,67,46,108,55,34,124,52,54,60,25,49,77,41,32,532,123,62,75,121,16,42,54,53,67,63,31,36,20,22,75,31,80,28,25,42,36,40,28,85,47,41,84,9,79,30,48,31,82,32,29,122,24,58,117,64,66,53,55,41,57,36,112,206,64,43,33,44,38,70,28,77,64,57,24,157,18,10,206,21,52,164,28,28,32,76,10,42,27,86,77,70,22,140,196,80,30,33,14,45,18,34,22,47,84,47,58,92,180,80,67,26,30,27,130,146,160,95,24,120,30,39,25,179,148,65,23,40,28,9,94,34,84,26,22,141,52,34,65,95,32,83,27,23,17,53,37,24,107,15,33,32,35,65,166,77,61,142,105,33,28,66,35,48,34,60,68,36,62,41,58,37,22,26,585,110,49,34,27,26,98,150,91,45,85,37,41,41,55,26,26,8,46,65,41,68,35,137,48,68,35,9,17,35,32,43,146,84,42,57,38,99,65,25,56,42,183,30,59,23,45,54,12,88,54,67,5,6,14,33,50,125,72,6,21,49,21,18,114,69,77,78,47,56,34,50,25,25,48,24,52,32,21,19,80,55,165,27,51,17,9,93,33,114,81,45,36,35,61,87,42,67,71,43,47,122,35,5,22,10,42,32,55,21,38,28,90,12,26,106,107,51,24,26,32,79,32,26,32,30,90,39,14,22,34,23,19,38,14,35,33,31,41,51,53,50,11,6,25,52,65,18,22,13,11,26,47,36,27,113,75,72,55,85,16,45,28,52,42,20,21,39,91,18,56,31,11,35,7,10,27,67,32,51,30,38,35,77,59,83,71,52,174,53,24,21,26,25,34,23,41,45,69,8,72,114,71,42,16,20,18,34,19,16,21,40,22,24,28,28,26,23,2,52,12,4,14,46,56,54,40,11,66,58,60,10,12,9,13,18,15,27,18,48,23,59,39,28,26,24,32,41,12,26,123,19,19,61,48,43,22,15,36,19,95,8,23,44,37,50,41,15,20,43,11,28,37,23,39,22,26,37,34,14,18,14,22,27,30,22,6,25,34,19,49,21,80,16,21,57,78,115,35,92,15,24,39,38,37,26,8,11,28,53,40,1,20,17,11,15,60,10,7,10,30,88,34,75,84,17,32,44,32,22,20,9,29,13,51,25,27,44,83,48,48,30,39,28,45,3,35,34,15,38,77
peace,7,86,32,301,77,65,30,151,21,7,131,33,68,710,30,84,41,81,57,61,22,120,78,141,68,51,81,109,52,86,112,606,491,79,225,482,1,12,51,65,23,235,30,18,146,77,83,41,1111,309,231,78,128,644,48,65,188,60,37,81,96,80,28,50,77,42,516,23,55,31,42,18,16,17,487,59,69,30,441,99,154,5,54,40,630,31,36,7,155,3,29,47,9,177,213,12,64,7,238,54,15,86,96,48,73,129,13,10,33,17,76,24,39,54,8,111,9,9,187,554,161,97,26,279,36,33,21,24,10,8,98,24,65,166,143,175,52,16,33,62,30,179,124,16,21,263,30,73,45,31,276,13,79,44,20,30,177,34,62,103,29,8,27,7,7,19,23,103,82,82,63,360,104,20,17,47,589,9,49,148,73,148,40,62,15,116,113,73,132,213,14,41,12,24,7,27,46,43,26,69,27,4,8,35,190,52,14,46,64,140,257,38,56,23,27,10,7,11,26,9,16,89,36,59,138,225,75,110,20,11,54,60,52,74,165,40,131,42,26,21,240,112,29,44,151,11,38,134,145,26,33,66,166,17,27,55,55,12,16,67,5,217,49,8,30,62,17,97,100,36,492,21,40,35,19,48,128,29,28,1,249,20,9,69,41,23,22,20,82,19,28,38,18,19,12,43,113,27,33,136,152,70,1,6,32,12,185,10,26,4,19,26,140,63,69,20,48,133,33,44,222,36,150,15,318,20,52,164,24,104,14,27,58,18,42,26,120,39,7,66,62,43,83,29,19,26,146,240,63,41,33,41,20,108,79,3,32,27,50,134,33,44,45,69,29,22,174,50,33,40,13,102,15,31,27,81,49,15,75,31,283,31,164,54,30,86,16,91,122,18,195,33,24,39,99,67,157,17,175,28,78,34,14,28,33,13,14,78,86,120,37,51,17,53,81,77,25,75,41,49,20,36,81,48,12,26,28,55,72,94,27,15,17,32,31,31,37,77,90,34,90,96,35,107,26,70,111,88,125,29,151,39,42,23,219,40,24,36,39,68,96,173,211,164,45,33,113,45,18,6,103,26,6,33,12,89,57,46,97,36,37,81,36,26,45,30,39,40,30,16,820,117,27,39,70,30,15,49,47,37,36,30,13,4,18,30,8,43,18,20,14,14,23,7,44,62,28,36,8,57,37,80,14,106,16,29,90,3,65,89,56,50,32,49,45,32,50,54,148,24,22,17,7,5,18,20,40,65,48,14,94,22,8,166,33,52,118,10,20,41,67,7,39,25,47,51,53,24,119,193,53,33,28,8,35,19,9,25,17,51,16,47,36,80,31,37,19,26,16,60,107,124,27,8,35,12,16,15,219,120,88,9,42,31,23,87,15,104,19,15,68,34,49,56,59,25,69,7,13,16,31,15,16,66,14,29,28,28,46,126,7,53,78,73,26,13,39,27,21,43,22,15,15,106,41,94,18,15,9,757,114,44,32,4,22,37,124,76,25,53,14,31,24,73,50,25,23,40,44,47,88,20,325,26,64,28,7,17,16,37,12,103,83,30,47,39,56,44,18,49,71,77,41,51,20,24,38,16,37,45,48,19,24,27,12,56,49,61,3,16,19,31,35,102,58,185,70,40,68,26,48,20,56,82,30,34,20,15,7,81,58,45,8,25,23,14,112,23,152,48,40,34,16,41,56,34,39,40,13,21,56,11,7,15,8,36,24,55,11,17,13,70,10,9,74,43,39,36,11,57,43,23,17,65,46,65,7,17,50,47,33,22,55,9,43,21,15,110,27,25,39,18,2,19,4,51,4,15,27,20,19,28,29,18,41,26,47,17,63,25,13,39,19,29,17,22,17,36,23,29,32,14,62,12,10,13,35,10,16,18,13,41,33,79,46,60,54,193,45,22,28,13,13,23,15,17,19,52,14,65,68,77,30,14,6,19,44,7,29,15,13,18,12,33,25,30,15,12,85,27,3,15,8,8,33,53,17,33,44,33,3,11,27,30,33,8,28,21,44,18,15,24,7,32,28,21,39,10,17,92,20,22,41,49,16,25,38,18,9,75,11,19,12,19,33,13,10,23,16,14,33,52,16,29,29,27,34,66,21,2,14,15,31,31,11,6,8,17,27,18,22,42,7,16,8,29,29,22,44,14,33,36,21,26,14,15,8,26,48,29,1,14,12,9,17,49,5,5,8,26,42,27,25,43,30,34,6,22,16,31,3,16,13,4,17,9,48,20,96,5,28,21,27,23,1,6,2,18,20,54
purchase,15,11,6,98,0,6,4,11,1,7,2,8,8,31,3,4,4,21,1,4,3,30,5,7,7,11,6,6,5,47,6,184,104,10,32,40,12,1,87,2,7,3,1,3,16,8,19,6,214,10,42,5,17,15,4,3,52,14,2,9,8,0,3,6,14,5,79,6,2,7,40,1,5,2,72,9,9,4,97,10,83,3,18,3,219,45,30,0,35,5,12,7,6,38,50,20,16,10,34,16,17,26,42,14,5,23,14,3,23,8,26,4,7,14,3,32,7,6,67,165,33,11,16,80,5,1,3,3,6,2,5,4,4,47,18,22,2,5,7,9,3,25,36,8,2,51,5,9,17,24,80,1,16,7,4,11,10,3,2,8,52,4,5,6,2,9,8,10,19,12,19,52,30,1,3,10,136,3,9,32,23,4,11,10,5,25,35,11,18,26,5,7,20,3,0,6,25,4,6,7,33,9,3,12,29,2,6,38,29,38,65,0,18,29,2,1,3,2,12,1,12,12,2,5,36,120,17,24,17,24,14,23,36,16,43,39,27,9,22,3,45,38,4,4,4,13,3,12,44,5,12,35,16,18,14,11,5,5,5,17,5,13,14,12,7,30,2,2,5,4,104,44,80,5,6,0,16,25,10,3,36,3,12,8,13,6,9,2,12,3,3,4,15,4,6,12,39,4,6,18,29,34,3,12,10,0,10,3,6,7,2,13,32,2,106,26,16,36,20,4,23,6,11,2,32,5,2,17,2,28,1,17,3,6,1,14,14,3,4,18,7,8,27,4,5,4,27,37,16,15,24,10,6,56,12,6,2,9,10,24,19,9,6,18,6,1,24,1,3,9,1,21,13,5,11,14,3,9,3,12,46,2,48,5,0,157,1,22,24,3,11,4,16,7,33,13,40,7,17,2,6,1,2,0,11,8,8,1,23,13,2,6,14,11,11,3,7,7,5,3,4,2,6,10,1,3,4,3,9,20,49,15,5,17,3,0,1,5,4,4,8,16,5,11,2,3,13,2,22,13,12,5,3,11,30,2,0,3,13,25,10,8,21,4,4,1,32,13,6,1,10,3,4,1,1,3,3,12,14,6,1,9,3,1,9,5,17,7,1,0,27,31,3,1,15,15,9,17,4,11,25,5,12,6,8,39,15,16,12,6,9,2,5,4,12,6,5,14,12,9,2,19,4,9,6,7,20,4,13,31,12,8,0,4,9,5,6,2,40,40,4,3,0,30,45,6,4,19,13,2,7,1,8,57,1,7,15,4,5,7,18,11,23,2,14,14,11,4,50,35,13,12,35,1,4,6,21,1,1,29,21,9,10,8,7,2,9,7,1,7,18,14,13,7,15,6,1,19,19,10,16,4,5,5,3,16,9,10,13,6,18,10,2,3,9,11,22,10,2,3,24,27,1,35,10,5,8,10,8,20,51,9,17,8,2,1,9,9,4,13,6,1,2,21,6,46,11,8,8,121,9,10,7,0,7,4,51,2,2,35,4,9,7,7,4,1,0,17,10,6,16,4,17,8,23,3,4,3,4,20,3,23,5,9,7,5,5,3,4,2,13,12,19,10,9,11,11,4,8,15,4,1,1,6,8,12,15,7,18,2,1,26,8,24,31,13,2,4,5,5,23,3,5,12,0,11,20,0,3,8,2,29,43,5,21,4,20,5,39,18,7,4,18,11,2,4,21,9,11,11,11,14,11,11,8,9,6,10,5,66,53,6,33,9,29,39,14,8,16,24,8,2,5,13,3,6,22,4,34,15,12,10,9,17,9,4,14,1,10,13,6,5,2,5,8,18,1,4,4,2,2,5,6,3,3,3,3,6,7,4,25,1,3,11,7,1,7,4,6,17,4,9,0,4,7,3,2,12,29,9,17,6,5,1,5,7,4,12,7,2,1,7,1,1,8,20,9,2,7,9,5,28,2,9,0,3,10,51,2,9,5,4,3,3,10,13,5,5,4,10,6,7,55,28,1,8,6,6,4,7,0,13,0,0,9,3,9,0,5,5,7,14,2,2,6,3,3,2,11,1,7,4,2,4,0,1,0,29,7,18,6,18,4,25,5,3,4,4,2,1,5,5,11,21,1,5,1,3,2,13,7,7,12,10,5,9,6,15,5,26,2,12,18,18,40,45,21,27,125,3,2,4,2,3,6,41,5,1,23,5,44,13,7,10,5,14,7,2,3,7,2,2,8,7,1,1,3,7,5,3,2,2,7,84,2,8,7,5,9,1,3,0,10,0,7,10,8,7,0,0
price,0,6,8,137,0,23,8,8,2,8,3,0,25,63,6,5,9,24,4,7,12,61,14,18,19,13,22,12,9,21,5,202,171,11,80,69,51,87,1,5,15,15,1,11,24,15,23,19,125,26,67,12,28,80,7,5,109,18,7,20,6,7,7,13,37,19,111,41,13,22,54,0,4,4,155,20,37,9,115,25,235,54,16,15,168,31,49,6,37,6,34,15,44,44,46,51,39,16,62,78,11,19,44,20,26,30,39,9,30,13,18,10,44,27,10,50,5,13,57,272,33,12,42,161,13,0,7,23,9,8,27,5,12,64,30,50,0,14,12,17,8,58,44,11,2,74,6,19,29,17,52,3,26,11,21,20,46,26,6,40,114,16,13,11,19,15,9,16,45,24,20,90,30,10,8,19,188,4,16,53,27,4,32,24,1,57,59,28,11,43,5,12,68,6,6,13,22,4,17,8,71,8,8,11,52,5,12,41,28,40,77,12,21,40,8,6,6,7,20,2,12,26,12,7,73,143,42,47,2,63,9,20,89,70,40,50,39,20,93,3,67,58,14,4,10,19,5,30,56,4,13,85,18,19,18,20,13,9,7,26,7,24,11,3,7,30,2,4,18,20,132,15,59,2,5,5,37,31,17,2,66,7,50,10,21,13,14,18,13,3,3,5,10,10,12,14,34,8,13,20,44,30,7,8,40,4,19,2,7,25,5,11,54,17,120,35,36,63,27,10,16,7,38,4,22,0,20,37,5,39,1,26,12,3,10,7,18,5,10,30,21,9,27,5,15,4,49,47,19,24,12,22,1,87,21,8,2,0,24,54,42,14,13,37,5,2,33,10,8,22,4,52,20,16,16,11,3,26,8,15,48,0,78,16,7,175,1,55,32,1,14,3,3,3,22,18,60,6,37,5,17,4,9,5,6,5,13,1,47,21,4,5,51,10,0,2,6,6,7,2,3,5,26,11,3,8,4,2,8,28,25,20,8,7,2,3,0,2,13,11,14,12,11,17,3,5,13,11,28,37,21,10,11,4,31,6,0,3,6,49,17,24,25,19,4,0,65,29,6,9,23,5,2,4,1,14,1,3,26,19,10,32,0,1,6,5,25,2,2,0,105,56,0,3,24,11,17,23,13,13,19,6,18,5,14,36,77,16,17,13,10,7,9,9,15,11,12,17,28,14,0,14,12,15,1,3,42,30,21,32,18,5,3,5,10,6,3,11,39,72,4,6,2,98,108,6,6,27,9,4,9,6,18,47,8,13,24,12,21,3,22,10,12,5,9,17,12,6,63,43,16,10,8,0,7,5,74,14,9,38,59,19,23,21,5,2,15,9,11,11,10,17,21,4,69,12,19,78,5,9,25,16,3,2,2,30,1,1,20,12,52,7,1,7,29,5,20,47,6,8,18,28,6,26,7,7,4,9,2,39,45,14,24,20,7,5,9,12,0,13,16,2,1,18,7,20,20,6,9,69,0,28,15,2,3,9,70,5,2,25,5,2,2,2,5,0,0,9,11,11,12,9,11,13,10,8,6,1,1,10,6,31,6,8,13,4,3,8,6,0,7,18,15,0,3,10,13,0,21,12,1,1,1,14,8,3,37,6,5,0,1,9,11,44,48,10,4,4,5,13,14,0,2,8,0,3,21,1,2,18,6,34,65,9,18,1,8,7,6,17,19,2,9,8,1,5,23,7,12,6,11,14,12,23,27,12,8,13,8,62,99,14,6,24,21,103,3,12,61,17,5,5,34,17,4,8,39,7,7,7,4,6,11,15,17,15,15,1,8,18,13,5,0,6,9,20,1,7,6,0,7,6,15,6,5,2,5,6,20,6,55,0,3,4,6,3,8,4,6,11,4,6,3,14,5,4,7,9,23,8,20,6,4,10,6,17,2,36,4,3,3,4,4,3,23,18,12,12,1,8,5,17,3,6,4,3,17,53,7,2,5,6,2,2,9,7,8,1,14,16,3,4,11,32,12,12,0,2,4,0,0,12,1,0,5,8,7,7,4,7,2,7,4,6,10,3,0,0,11,9,11,3,2,4,2,8,0,14,7,20,7,34,1,16,3,7,4,3,9,6,5,13,1,49,0,4,1,2,9,11,4,4,7,8,8,8,12,15,1,17,5,20,22,14,39,24,21,37,62,1,0,10,2,5,5,8,2,1,33,4,40,5,2,6,20,2,6,2,1,3,8,0,67,6,1,1,4,6,3,1,1,6,18,52,8,16,4,29,0,1,1,4,5,9,12,21,16,3,1,0
strength,1,7,5,54,9,17,7,26,4,10,14,3,14,93,6,20,3,16,10,8,2,13,20,22,13,9,18,17,12,19,14,89,75,19,37,105,65,2,5,1,6,36,3,6,23,8,13,6,102,70,32,13,15,85,3,1,18,18,16,12,9,9,5,10,7,12,81,7,3,5,19,1,7,0,89,13,12,4,43,23,46,5,6,12,97,7,6,2,16,2,11,10,2,18,22,7,7,5,54,6,3,7,14,10,12,18,11,5,9,5,11,2,21,14,2,27,3,2,18,85,20,28,12,61,10,10,11,3,2,1,24,6,8,31,21,33,5,0,6,8,6,23,12,1,3,34,3,18,2,7,59,3,8,14,5,25,19,8,8,23,7,3,2,4,9,9,11,11,15,10,16,69,15,8,8,3,85,6,8,35,13,12,12,17,4,16,18,10,9,31,2,1,6,2,3,2,17,17,11,7,6,0,4,4,31,12,5,17,9,12,36,10,3,3,3,8,8,9,5,2,2,11,7,14,26,26,16,10,12,8,11,11,13,13,25,6,14,4,3,8,29,23,10,6,13,6,4,23,18,2,3,8,10,5,3,3,6,4,1,18,2,39,13,2,11,27,7,27,13,4,43,2,11,8,5,4,8,10,1,2,46,1,3,12,6,3,12,6,16,4,1,4,1,5,2,1,18,4,5,6,16,8,2,3,3,4,15,2,6,4,2,6,24,13,15,4,8,20,4,11,24,2,15,1,31,2,7,25,1,15,10,3,9,1,6,8,11,5,1,7,7,5,12,9,9,5,12,20,10,6,10,8,1,15,6,3,5,7,7,18,5,4,5,9,5,9,11,7,10,15,2,33,4,12,4,22,4,0,22,11,25,3,23,12,7,12,3,17,16,4,15,7,7,2,18,9,17,1,9,3,12,6,5,6,2,9,4,9,9,15,3,6,2,8,8,12,8,9,3,19,2,10,14,4,2,4,11,4,13,9,1,4,5,8,5,3,7,9,23,2,9,7,6,11,6,3,35,18,21,10,32,1,17,3,26,8,10,3,6,6,10,18,19,39,10,2,35,7,2,2,10,6,1,5,12,6,8,4,8,2,4,18,7,5,9,9,7,6,1,2,77,16,6,4,19,2,1,8,15,2,7,2,4,1,1,3,8,10,0,2,1,4,2,1,6,5,3,3,2,8,1,7,2,16,6,5,5,0,10,17,4,8,6,4,7,11,1,7,10,5,1,1,4,4,6,1,3,9,3,0,11,0,0,22,7,2,11,2,3,2,8,2,4,5,14,8,8,2,19,13,11,6,4,1,3,1,1,2,2,11,2,8,6,22,13,12,0,4,3,6,16,10,5,2,11,3,5,1,19,8,9,1,5,5,0,14,3,19,2,2,12,1,2,6,7,6,5,1,5,1,5,0,1,4,5,4,4,4,7,13,5,10,16,12,6,4,1,7,5,2,10,3,4,11,3,22,3,2,0,65,4,7,3,2,2,6,24,9,0,3,5,2,2,6,2,5,2,4,4,9,4,5,42,3,10,3,3,3,0,3,1,9,10,1,3,6,4,8,3,5,7,18,8,4,4,8,4,0,3,3,4,0,1,2,4,4,9,12,1,0,3,2,0,7,11,35,12,8,8,11,5,4,4,17,3,3,5,1,1,14,4,10,1,4,1,1,34,3,18,12,4,3,1,6,8,2,24,4,13,2,11,2,8,4,5,9,1,8,5,1,0,8,0,2,12,7,6,4,7,5,13,4,2,5,3,5,3,3,0,4,4,1,8,1,6,4,6,26,9,5,8,5,3,1,0,11,1,3,4,0,4,2,5,1,8,7,8,1,8,5,1,0,2,1,0,2,1,3,1,2,0,2,0,6,0,1,13,1,1,6,2,3,11,7,6,14,4,19,6,4,0,0,2,2,0,5,1,4,5,7,3,8,3,6,0,4,5,0,2,4,2,3,1,1,3,8,0,0,5,5,4,1,1,2,3,5,0,3,8,0,2,0,4,2,0,4,1,4,8,3,6,4,2,4,3,5,0,3,7,16,2,2,7,3,7,0,0,2,1,5,1,2,4,3,6,5,2,1,20,6,9,2,3,1,1,3,4,0,0,1,0,1,4,2,2,1,3,4,2,6,7,3,4,0,0,5,5,11,3,2,6,2,3,4,2,1,2,2,12,1,0,4,0,0,1,1,3,0,2,0,8,7,10,8,1,2,2,4,2,1,5,3,0,0,3,5,7,9,8,5,9,4,8,6,1,2,1,2,6,8
burden,3,20,7,79,5,13,2,26,4,2,12,3,6,79,3,6,7,16,5,5,9,22,23,19,14,16,19,18,9,24,2,139,116,17,49,66,23,7,15,6,1,15,1,7,25,7,14,11,150,36,30,4,24,52,17,6,74,10,7,14,9,9,3,13,20,11,104,8,2,7,10,2,8,5,95,9,24,5,49,20,87,3,6,6,182,27,15,1,23,4,6,3,5,16,58,24,19,3,14,24,7,27,23,16,19,15,16,6,17,4,16,4,14,29,4,28,0,4,38,128,41,27,146,85,7,4,7,3,6,0,17,1,6,39,17,55,3,4,10,5,5,27,13,3,3,56,14,18,15,14,38,5,21,1,2,29,32,7,6,30,25,6,15,1,5,10,4,17,24,3,8,95,25,7,22,7,179,5,6,44,17,13,8,19,3,16,32,9,16,24,4,3,11,3,6,8,6,6,11,17,24,8,3,15,18,7,7,37,9,26,47,9,10,11,11,12,5,14,10,5,7,25,2,8,35,54,20,29,3,14,13,9,50,2,39,33,21,9,10,9,54,23,4,9,18,17,4,22,28,7,4,23,20,12,8,15,0,5,1,7,5,24,5,1,4,9,5,14,21,10,125,5,26,3,3,3,10,18,2,0,53,7,2,12,9,2,9,20,16,2,0,2,11,10,3,7,35,2,11,24,19,12,3,3,15,2,18,0,2,4,0,34,29,9,95,16,21,20,12,7,29,7,25,6,27,3,6,24,2,21,8,20,5,5,1,6,15,4,9,9,4,11,21,18,17,6,24,28,11,24,19,11,3,30,13,2,4,4,22,28,21,9,11,31,5,6,23,6,15,23,2,45,6,16,9,15,3,8,9,3,54,1,44,4,6,13,0,14,11,6,12,2,7,5,19,4,28,6,16,2,12,6,2,3,3,12,10,1,23,12,1,3,8,11,20,12,3,7,5,9,1,11,11,6,1,3,2,9,4,8,7,4,2,5,4,3,4,12,14,5,18,29,15,17,1,2,26,3,22,19,23,6,8,8,35,2,5,13,7,26,14,23,15,24,4,2,28,10,7,2,36,5,4,11,2,23,5,6,31,3,6,8,3,4,6,4,9,9,2,1,57,21,4,7,11,1,3,16,10,11,6,4,9,12,5,12,10,5,11,6,13,2,5,8,8,7,12,7,2,10,3,16,3,12,6,5,15,12,14,11,5,9,2,9,6,5,3,13,33,16,1,5,2,14,10,8,1,17,6,4,22,1,6,33,2,5,35,8,6,2,20,2,20,3,12,16,8,10,20,24,13,2,10,6,5,2,21,9,12,25,13,11,15,11,9,4,5,3,3,10,17,21,16,7,28,7,1,4,4,9,19,5,7,0,6,15,1,8,12,3,17,7,4,7,16,12,19,8,8,9,6,3,2,14,4,11,1,20,7,16,20,5,13,16,1,5,13,12,4,4,26,2,3,15,3,16,8,0,7,57,9,4,3,3,5,9,25,19,2,6,5,0,5,11,3,0,0,4,6,2,10,12,3,22,7,2,4,5,3,1,17,19,2,5,4,13,16,4,4,3,12,15,6,3,7,3,6,3,59,11,2,5,0,3,4,2,14,6,6,2,4,1,5,19,12,8,7,7,12,4,1,2,5,8,1,1,7,3,1,6,4,11,8,9,4,2,6,6,16,8,8,2,1,1,5,5,18,10,8,14,11,7,1,2,0,12,10,5,0,21,17,22,2,2,11,25,9,12,12,2,9,2,9,6,3,9,12,2,16,18,2,6,10,6,11,4,4,0,8,15,6,3,0,4,7,25,3,2,1,3,9,11,4,3,8,5,2,7,18,3,18,2,2,7,3,1,9,5,1,18,2,1,3,2,0,3,5,2,2,8,5,1,12,3,5,4,3,11,3,3,0,5,4,6,1,11,10,6,0,2,9,5,7,10,3,6,6,3,3,2,4,6,11,1,6,5,9,3,4,7,2,7,27,21,4,5,2,4,7,1,0,7,3,1,7,4,1,7,1,3,5,4,5,3,5,4,2,0,6,6,26,3,4,4,1,1,0,13,11,12,6,7,4,11,6,2,4,18,5,0,2,5,2,15,0,1,1,3,6,3,4,7,8,4,3,5,2,2,1,10,4,72,7,15,7,28,37,11,32,2,2,4,0,2,3,5,2,2,16,1,0,3,8,2,3,5,3,0,2,0,5,1,4,19,2,5,3,5,1,4,3,6,1,8,2,77,14,11,10,1,1,3,2,4,2,13,5,7,1,4
freedom,7,31,14,89,25,39,7,68,4,6,20,4,18,174,2,51,15,17,23,51,17,34,60,63,24,31,70,43,30,45,16,164,147,35,63,224,235,3,15,36,15,1,4,9,30,19,9,13,230,213,51,34,47,261,43,15,36,14,48,51,8,18,10,7,35,15,235,12,7,11,32,5,7,8,216,30,32,4,76,80,40,5,8,24,156,4,5,5,16,2,9,15,5,33,37,8,12,0,81,17,4,18,18,8,30,45,3,8,15,9,33,6,24,23,10,32,2,2,57,90,41,68,13,108,28,25,4,3,7,3,47,8,49,64,64,82,10,17,27,51,16,42,9,4,15,84,16,33,14,6,90,17,12,8,10,17,62,11,41,70,19,3,30,3,1,17,13,41,21,16,26,116,39,8,11,7,100,5,11,80,20,30,26,27,6,39,29,24,18,39,1,6,4,8,4,12,9,13,12,31,12,2,2,10,51,27,5,28,18,23,109,23,31,9,12,24,3,15,6,3,9,18,5,15,26,63,38,22,9,5,11,12,16,19,41,4,48,16,10,5,90,36,16,25,40,8,25,42,24,7,15,15,59,0,5,15,6,0,4,22,2,59,7,2,6,8,13,52,56,6,88,5,3,10,5,23,36,3,3,2,117,6,5,32,9,14,10,11,19,5,0,4,7,6,4,7,16,10,6,27,39,9,1,7,4,6,39,7,9,5,12,12,40,27,12,4,24,35,11,11,57,11,35,16,116,2,14,91,9,43,17,5,8,5,4,16,38,13,0,15,9,10,46,17,2,7,25,54,18,28,10,20,8,32,10,3,32,4,5,35,10,13,20,23,11,24,25,18,21,41,7,84,5,29,19,11,13,1,42,5,90,7,19,23,37,27,13,19,18,15,54,24,6,3,21,31,26,3,25,7,32,25,1,10,3,13,8,1,20,30,11,28,5,16,14,23,5,14,6,48,5,12,38,7,6,6,9,14,6,18,2,1,1,13,26,4,11,7,45,9,11,15,8,40,23,27,42,26,15,16,58,3,22,7,53,9,31,10,11,5,24,45,51,62,6,4,58,14,5,2,63,12,10,16,10,25,13,10,10,3,11,34,3,12,19,4,3,17,7,4,82,14,16,38,27,2,5,9,19,13,6,8,3,4,1,2,4,7,4,4,3,10,5,4,10,12,13,12,1,20,8,20,5,37,4,4,14,4,15,19,9,8,12,12,8,10,4,10,29,11,5,4,4,5,6,6,17,8,3,4,57,2,2,22,5,5,25,6,9,4,4,0,12,2,13,7,11,0,41,63,17,4,0,3,5,4,1,6,6,22,3,10,10,45,13,4,4,1,3,21,27,25,20,3,22,7,7,11,19,22,9,3,6,1,1,12,1,16,4,2,24,7,8,22,11,3,11,5,1,1,10,0,4,9,3,1,6,7,13,28,1,8,27,27,3,2,10,1,5,5,6,9,10,16,4,12,7,5,3,120,14,8,13,6,4,17,22,17,4,12,2,14,5,5,1,0,0,4,3,7,7,4,4,10,10,7,0,3,6,5,4,20,5,3,13,4,15,19,2,5,9,42,7,6,3,1,8,2,16,5,13,0,7,1,6,10,21,11,0,3,10,0,8,18,8,9,11,7,8,2,4,4,7,15,10,9,2,7,3,39,9,8,0,15,4,2,6,8,22,9,9,3,3,9,13,3,6,20,11,2,26,0,0,1,0,12,6,14,1,2,4,12,0,0,36,44,4,6,5,6,16,13,12,16,12,19,3,2,3,5,0,0,9,1,5,6,8,5,7,6,12,2,2,2,10,7,1,2,1,1,5,6,9,0,27,16,13,6,11,5,2,18,0,1,1,3,14,2,0,5,3,1,2,2,2,5,14,1,1,5,5,2,24,42,11,14,5,74,11,3,6,4,6,11,8,7,5,4,2,11,10,14,9,4,0,3,4,2,5,11,1,13,3,4,9,7,12,1,10,5,2,3,3,0,15,10,0,9,12,9,0,1,3,2,1,0,2,1,5,6,22,7,1,2,0,0,6,3,4,58,0,4,17,5,43,1,19,1,1,6,1,1,13,2,3,2,3,5,7,2,7,2,1,2,5,1,10,4,3,1,3,7,1,5,1,1,6,4,8,10,3,16,0,2,3,6,5,0,4,2,7,8,14,4,2,0,5,8,3,3,0,5,6,4,3,3,2,0,1,7,15,8,24,32,2,3,7,1,7,5,0,7,3,0,5,5,8,22,5,4,6,7,5,13,2,2,7,0,5,64
visit,13,13,8,47,13,3,2,13,3,1,32,17,6,34,1,3,4,8,4,5,5,23,11,15,9,11,8,21,5,10,5,95,100,5,22,29,30,1,1,3,1,4,1,4,18,10,6,8,171,44,36,4,6,28,4,8,22,22,6,9,21,8,6,9,10,3,46,1,2,2,1,2,4,10,32,1,14,0,41,17,8,0,5,8,113,5,5,0,23,0,4,6,2,17,30,2,9,0,9,4,4,9,7,9,5,14,1,3,9,1,8,2,2,6,5,20,0,0,22,56,17,24,3,27,2,3,3,4,2,1,5,4,4,23,14,27,2,2,2,2,3,12,16,2,1,44,4,7,15,4,12,2,8,1,1,1,32,1,1,19,3,0,3,2,1,5,2,9,13,5,14,40,11,1,7,2,62,1,6,23,13,3,5,10,1,17,13,8,17,30,1,2,1,1,0,1,7,1,1,4,9,0,2,5,16,3,0,4,5,9,41,7,11,2,4,3,0,2,5,3,1,10,0,5,13,49,18,17,1,0,3,8,4,4,8,4,10,4,2,5,39,28,4,7,8,2,4,16,10,2,4,8,12,2,3,6,4,0,5,8,0,16,5,1,3,18,3,7,8,3,43,2,5,4,2,1,17,2,2,4,34,4,1,5,5,1,4,7,4,5,2,2,1,1,1,6,49,13,6,7,17,7,0,0,2,1,10,1,0,2,1,4,11,7,8,4,12,18,16,1,32,4,20,4,44,4,3,20,3,14,3,1,2,0,1,0,12,14,0,4,3,10,6,4,3,3,25,21,8,8,4,3,1,8,11,0,0,2,4,11,6,3,2,7,2,3,27,1,7,16,5,15,1,7,4,5,3,2,12,1,12,0,10,5,4,10,2,3,16,3,13,2,8,2,9,7,27,3,16,3,14,10,0,2,4,2,4,13,15,10,0,14,1,8,9,11,3,7,3,6,4,1,3,1,0,0,0,7,7,8,3,2,0,7,2,5,3,5,4,1,18,13,6,9,4,3,11,6,18,2,7,2,10,1,22,1,3,5,7,7,6,8,11,15,0,3,11,5,9,2,10,2,0,1,2,10,5,5,7,0,4,5,1,6,4,0,3,6,0,2,43,16,4,1,4,3,1,10,5,3,6,1,0,1,8,6,1,9,0,0,3,0,4,1,6,1,1,2,20,2,0,12,2,10,6,6,21,0,17,6,5,1,1,2,3,2,6,6,22,7,3,1,5,2,2,3,0,9,11,3,1,3,2,16,2,5,24,2,0,2,2,0,5,1,8,12,3,7,34,11,4,8,2,5,2,0,2,2,5,7,3,9,5,11,0,4,2,6,0,7,9,15,8,2,11,4,1,0,24,5,3,1,2,0,5,8,2,6,3,3,20,13,9,0,13,1,8,0,2,2,5,4,0,9,1,3,5,4,2,8,13,3,5,11,3,2,0,4,4,9,5,2,5,9,5,37,3,3,2,109,14,1,7,3,7,3,10,6,2,7,0,2,1,13,0,2,0,2,2,7,10,0,22,6,23,3,1,5,12,1,8,13,7,1,5,6,4,5,9,11,0,11,5,13,1,4,4,8,4,7,8,2,3,8,3,4,8,2,0,2,2,6,3,8,3,8,5,8,2,4,9,3,1,20,4,4,5,1,4,4,6,7,0,1,3,0,7,2,13,3,6,0,6,10,12,3,5,3,7,11,4,0,0,0,1,6,5,6,2,2,2,18,1,0,7,3,16,1,1,1,5,9,0,14,0,4,5,4,13,5,6,3,4,2,10,2,2,2,1,7,3,4,3,0,4,5,6,4,2,0,0,3,8,1,3,1,1,3,13,3,0,11,8,2,5,4,3,4,2,2,1,0,18,6,3,1,3,2,5,2,8,2,1,0,4,2,7,14,4,5,6,3,2,5,7,1,3,6,0,5,19,8,2,6,3,2,4,2,4,1,3,2,8,1,1,6,6,4,5,2,1,1,0,3,1,5,5,5,15,14,0,4,4,0,3,1,2,3,2,3,6,6,0,3,7,3,1,8,1,4,2,8,5,10,0,3,2,4,1,4,5,2,2,3,4,2,5,3,1,1,5,1,3,1,1,2,2,15,1,0,1,1,6,2,1,2,3,2,4,6,1,8,0,0,1,1,0,0,8,2,0,7,1,2,2,1,0,6,4,1,1,2,1,0,0,17,5,0,0,9,0,0,7,9,1,1,3,3,2,1,0,0,7,0,2,0,1,8,3,4,2,1,2,2,0,0,1,2,2,11
last year,3,11,7,156,2,15,3,9,5,2,9,10,22,34,2,1,11,7,13,2,3,20,46,38,8,31,21,35,7,24,1,128,58,14,33,64,18,3,11,6,7,9,4,1,23,9,34,19,77,57,30,11,12,35,41,1,5,21,30,23,5,4,4,7,20,12,50,9,3,8,62,2,10,2,72,6,32,4,37,23,56,15,8,14,66,9,3,14,23,2,10,6,28,27,19,28,14,4,36,11,19,18,4,9,7,22,12,21,14,10,17,5,15,28,29,30,3,3,37,49,14,40,32,140,13,2,3,7,4,4,23,4,7,34,19,97,2,9,6,18,7,25,29,0,3,71,9,20,11,5,18,6,4,6,11,35,25,10,0,49,27,4,19,9,45,27,5,15,10,8,11,72,22,8,16,4,40,4,6,55,16,4,42,24,11,17,19,11,8,26,2,2,8,6,8,4,12,6,11,5,25,2,10,7,6,5,7,22,10,11,49,22,44,10,9,25,35,29,9,8,5,7,4,9,21,44,9,29,9,16,5,18,37,10,14,16,7,10,7,5,30,15,8,5,10,5,5,31,42,8,11,12,17,4,5,8,1,7,2,16,8,30,12,3,4,25,17,21,9,4,31,12,16,3,1,7,19,18,2,8,34,9,6,3,13,12,34,27,5,5,0,8,27,12,7,3,15,15,9,6,12,22,5,6,5,10,18,2,12,7,8,6,28,14,24,15,16,22,3,9,15,2,17,12,26,1,16,40,1,19,11,4,2,1,1,8,19,2,6,5,2,18,15,1,2,6,10,15,17,34,8,12,1,21,3,3,4,1,7,28,39,19,4,9,1,6,6,5,26,38,5,37,5,22,2,25,3,4,10,2,10,4,15,5,15,14,16,13,6,2,7,9,20,14,15,5,16,2,12,4,2,13,2,10,4,4,5,0,13,4,1,6,9,10,0,11,8,5,5,16,2,5,14,2,6,1,4,2,3,12,3,8,2,6,9,8,2,9,16,3,7,6,3,7,3,4,20,10,10,7,25,0,26,4,13,8,7,2,5,11,14,13,13,18,4,2,30,7,8,3,17,9,1,0,6,5,5,5,13,2,2,8,1,2,5,1,5,9,1,4,35,14,1,4,7,2,2,3,2,2,6,3,5,20,8,6,14,4,2,6,3,1,1,5,4,3,7,2,2,11,0,4,2,3,3,3,14,4,4,10,7,3,7,4,3,5,2,5,9,8,0,4,4,11,10,5,2,5,4,3,1,2,2,14,5,5,6,1,2,3,3,4,10,2,7,6,3,3,4,13,5,1,18,3,1,2,1,1,3,32,1,13,4,8,0,3,3,0,0,6,8,9,9,3,13,1,4,5,13,10,8,2,4,3,2,3,5,10,7,0,8,10,5,2,12,1,1,3,3,0,2,0,3,6,6,5,2,7,7,8,3,16,6,5,3,3,7,4,7,1,6,4,4,7,4,9,8,14,15,41,13,2,1,6,1,9,7,7,2,8,2,5,4,2,2,2,1,2,0,6,5,2,2,11,7,1,1,4,2,0,5,15,2,4,4,0,4,7,2,2,6,15,2,3,0,14,2,1,5,1,5,1,2,1,11,2,3,3,2,1,1,9,1,8,5,10,11,2,1,4,0,3,0,5,1,4,3,2,2,7,1,7,4,1,3,3,9,0,7,1,4,2,5,0,1,1,10,3,5,3,5,8,6,4,3,1,2,1,5,12,9,6,3,12,12,11,11,2,8,3,7,3,5,3,1,2,11,5,3,2,0,0,2,0,7,6,4,1,8,9,17,7,6,1,2,7,7,7,4,6,1,3,0,7,6,3,4,8,10,2,8,3,0,3,0,2,4,8,2,3,1,5,6,3,2,0,7,5,2,2,9,5,4,1,8,4,3,12,0,1,2,0,3,3,5,1,1,11,9,4,6,5,1,1,4,4,4,0,1,2,5,2,2,4,0,4,2,1,3,21,7,4,2,1,0,0,1,1,4,0,2,4,4,2,2,8,9,0,2,3,11,0,5,2,1,2,1,4,3,9,5,1,7,2,2,3,4,2,4,4,2,8,3,2,3,1,0,5,0,1,2,0,0,1,1,0,6,3,4,0,1,8,2,3,1,5,1,1,0,7,7,6,7,3,15,9,5,14,10,2,1,6,6,1,2,5,5,1,9,0,5,0,2,2,10,1,2,8,1,0,3,1,16,7,2,1,10,1,4,0,2,2,0,0,7,1,1,9,1,8,3,8,1,7,5,13,9,2,0,11
believe,10,67,36,440,36,38,19,115,14,8,44,24,34,216,10,20,23,42,29,28,15,74,76,111,51,51,72,79,36,98,26,594,336,48,160,239,146,16,24,23,25,30,18,23,1,30,93,91,622,153,178,43,45,147,59,18,144,86,44,53,50,28,21,51,68,35,305,28,32,50,47,17,29,17,256,37,88,8,209,97,126,6,36,23,568,64,29,5,124,6,18,13,2,117,138,60,57,23,106,41,37,94,98,47,42,85,28,20,52,10,75,12,32,57,41,119,12,16,154,498,93,108,52,233,23,40,10,11,9,5,57,15,25,121,83,246,36,19,20,45,19,97,61,8,14,198,20,45,26,40,223,9,55,17,14,71,121,15,16,79,26,3,33,8,13,53,13,68,57,30,57,296,63,14,44,18,402,24,30,103,87,40,42,69,13,70,79,68,96,135,21,23,29,14,10,21,48,24,34,59,95,13,4,38,86,44,16,100,40,81,266,36,83,32,20,36,7,24,50,8,17,58,17,36,134,258,59,73,18,27,27,45,39,76,75,74,91,30,22,32,219,104,25,32,48,9,22,95,107,22,38,69,80,25,21,76,36,12,11,60,9,95,49,13,32,94,24,56,67,20,353,19,70,26,17,18,63,39,26,12,171,28,7,52,30,5,22,42,48,13,9,18,59,27,11,40,120,18,21,50,75,84,8,9,23,7,64,16,20,6,9,66,80,25,90,42,63,111,24,21,119,15,92,28,179,15,35,161,13,66,37,73,30,14,40,51,56,26,17,28,33,39,65,27,25,19,113,147,43,31,30,35,15,106,65,12,19,18,46,93,64,38,33,42,12,21,103,40,45,72,20,91,17,64,28,86,37,27,51,21,199,7,126,28,29,89,20,61,63,19,65,28,54,54,95,32,144,19,99,12,47,23,19,17,28,40,21,15,75,53,14,25,16,49,19,40,26,36,21,35,14,18,63,39,11,15,9,41,33,43,17,15,11,31,18,10,14,50,36,21,60,52,19,38,9,9,56,24,71,26,67,20,39,20,144,20,22,19,21,93,63,82,96,103,17,26,56,31,23,14,69,22,13,14,18,47,13,38,65,13,19,41,11,16,37,26,32,36,16,11,174,91,20,18,31,23,6,44,27,30,33,16,12,6,28,48,14,68,25,20,21,13,15,50,41,46,25,36,34,39,17,53,19,89,25,27,76,37,61,78,43,22,10,29,30,26,29,44,99,57,28,10,12,18,29,36,10,46,33,13,111,17,15,117,28,54,82,18,18,23,61,19,66,11,48,53,54,18,114,121,34,27,45,11,23,25,31,25,23,55,17,33,40,57,37,15,19,26,4,56,66,96,39,19,69,11,17,21,112,53,74,2,22,4,22,64,16,71,22,17,68,76,44,18,84,25,75,8,20,14,36,13,15,62,8,23,8,35,29,70,42,71,61,69,23,10,38,18,19,31,40,14,24,49,25,69,9,11,23,355,46,20,22,16,22,33,84,44,16,40,27,17,30,50,23,10,8,20,33,36,44,19,100,62,69,14,14,24,8,16,25,77,35,23,29,16,37,14,20,21,32,66,33,26,21,41,26,15,38,46,14,14,21,17,26,28,47,32,10,10,17,15,16,65,37,63,39,21,33,35,25,16,15,79,7,21,17,19,15,36,24,40,18,32,17,15,57,14,71,27,30,13,7,26,24,19,38,25,24,15,31,22,12,28,19,45,27,37,13,31,35,36,9,12,55,58,29,26,17,29,27,12,12,43,9,47,22,8,57,34,20,19,36,13,34,14,17,27,18,34,22,21,12,11,56,58,17,25,21,11,30,21,37,13,23,17,28,17,99,16,13,14,15,27,12,6,24,38,18,30,16,17,21,30,14,21,31,27,23,14,30,21,20,11,24,22,17,77,17,20,13,11,13,29,22,24,22,21,20,19,57,70,27,20,12,20,29,23,21,8,27,12,21,17,15,18,6,16,13,45,11,24,33,35,21,22,10,13,34,8,0,13,8,13,30,15,14,18,19,22,15,24,3,17,23,9,12,14,22,28,17,9,16,21,15,6,10,29,14,46,19,20,19,25,24,13,16,19,19,14,23,27,15,21,7,17,11,44,12,18,7,27,20,17,17,9,11,23,13,34,15,34,19,20,18,41,49,39,68,14,16,16,16,6,14,7,18,13,41,18,5,9,9,8,7,32,19,37,20,9,28,15,22,29,11,18,19,21,21,13,25,18,15,30,24,18,26,26,30,11,6,13,9,15,4,14,19,20,8,29
fail,9,39,13,201,15,15,5,54,10,4,33,13,7,114,7,10,15,29,15,13,10,60,30,43,38,16,22,19,12,19,20,207,188,15,82,100,77,8,15,8,7,19,10,9,30,1,37,24,499,37,110,12,29,66,31,17,76,27,7,18,31,26,4,17,20,20,155,11,11,13,13,2,8,7,120,35,31,10,109,49,51,1,17,14,356,15,20,1,39,2,12,18,3,43,83,23,36,7,48,13,11,41,54,22,17,38,10,9,15,7,27,5,19,24,6,53,11,3,108,298,69,21,12,70,13,9,1,8,4,4,25,9,16,59,43,61,14,8,4,10,8,57,36,7,9,114,19,16,16,11,105,2,16,19,6,28,50,7,25,10,17,4,15,3,5,16,8,48,47,14,20,136,30,1,3,25,279,3,25,35,30,20,9,27,6,37,47,43,73,91,4,9,7,0,1,7,17,11,7,17,31,2,6,21,35,20,5,46,26,38,120,17,49,10,4,10,0,2,18,8,2,30,13,19,67,138,39,35,7,6,23,21,17,39,51,24,50,9,15,12,103,45,16,19,28,9,14,39,64,10,21,38,27,7,14,16,18,9,10,17,11,45,39,6,22,41,3,13,25,10,194,12,30,9,10,2,35,12,18,6,83,19,9,19,20,3,7,11,21,3,4,12,18,11,5,15,53,7,12,40,37,38,4,1,40,9,31,5,10,0,1,25,49,19,38,13,31,71,18,9,70,19,59,20,131,7,15,39,4,39,12,23,18,11,12,21,38,18,11,16,17,20,32,29,4,5,85,94,34,8,18,19,9,33,40,6,13,13,14,41,39,16,12,31,8,7,55,16,19,9,7,32,13,9,18,34,15,7,31,14,112,3,55,15,5,35,11,32,48,9,43,7,32,32,53,27,99,9,39,4,31,6,5,2,6,22,11,8,31,18,9,10,4,26,52,13,8,10,7,3,8,8,36,27,7,6,10,29,26,34,11,6,5,13,7,12,1,20,12,9,28,38,14,29,3,3,11,15,60,11,26,11,2,3,73,23,4,20,13,53,20,34,42,53,12,5,22,13,24,6,27,9,6,4,9,21,15,33,21,9,9,24,7,24,26,14,16,16,5,9,147,60,3,21,16,9,11,24,24,36,24,8,7,2,13,36,6,20,12,10,8,13,7,15,31,31,11,21,4,19,4,27,11,50,20,14,39,11,27,38,24,11,5,13,4,13,17,7,78,20,7,3,8,8,14,10,4,33,18,14,51,10,9,70,15,18,50,7,9,8,40,9,37,8,33,26,26,13,35,62,14,14,18,6,6,10,5,8,10,18,19,21,28,32,21,8,9,17,6,18,49,73,13,7,28,7,11,7,87,27,42,1,14,12,15,30,11,53,14,6,42,22,9,8,58,16,26,4,20,8,28,4,5,33,4,11,20,16,33,28,6,22,38,32,7,7,15,10,6,15,21,6,25,32,17,41,6,5,8,271,48,16,20,11,11,18,69,44,16,23,12,8,28,26,14,15,7,13,12,23,34,14,86,61,37,15,5,18,12,6,8,43,31,10,12,21,31,6,7,13,23,24,22,20,10,16,15,11,17,17,8,12,7,12,19,6,26,9,8,9,11,7,3,53,32,27,13,16,15,14,18,11,18,36,5,5,17,7,5,19,8,17,7,12,4,5,26,7,58,21,10,9,1,14,16,7,22,5,13,10,19,3,4,11,5,18,15,13,4,11,17,20,5,9,15,26,9,12,10,11,13,7,4,20,10,23,16,8,13,17,6,8,15,5,11,9,15,29,8,20,7,8,2,8,12,23,10,10,6,11,4,5,32,4,7,6,15,7,30,15,8,5,14,22,7,10,12,18,4,19,13,3,15,13,3,6,16,17,11,15,11,7,24,6,8,14,18,36,32,4,13,18,9,22,10,17,9,17,11,15,75,35,15,11,2,5,8,5,15,3,10,10,7,13,15,17,9,6,21,9,1,7,6,14,20,5,4,12,19,6,9,5,8,9,12,5,6,4,12,7,8,10,2,7,15,13,6,5,6,6,15,13,8,16,10,4,16,14,2,44,7,8,9,17,23,6,8,14,5,8,18,19,7,11,4,14,5,22,11,8,15,3,15,8,6,8,9,2,11,16,12,20,8,2,5,25,21,5,15,4,11,13,5,7,6,2,4,9,25,9,3,5,11,11,2,35,2,6,10,16,12,19,23,6,12,7,4,15,16,15,10,8,9,10,12,9,23,3,64,9,8,2,6,1,1,3,3,8,6,4
propose,7,46,23,441,23,19,13,69,17,5,32,24,27,109,12,15,15,29,10,10,19,91,54,71,44,62,22,33,10,25,22,412,243,24,127,103,83,19,23,13,14,9,6,34,93,37,1,55,684,99,101,16,9,57,50,11,95,59,58,26,34,6,15,34,65,13,235,12,20,60,81,10,14,15,176,39,60,13,160,49,148,10,39,12,465,45,33,15,70,14,23,8,34,62,100,43,48,7,69,27,50,90,80,16,29,64,39,34,47,22,51,21,28,56,37,67,18,19,140,495,91,44,83,199,20,8,1,15,15,18,38,9,8,155,24,135,12,6,16,18,5,58,52,4,10,145,22,31,36,28,139,17,19,25,10,90,47,27,16,95,46,11,51,22,61,28,14,50,49,30,54,196,50,6,15,13,317,5,19,125,37,29,93,43,19,56,69,41,84,156,4,9,4,10,13,12,136,17,41,30,70,21,26,35,73,25,15,80,55,58,202,19,57,30,7,27,17,54,34,17,16,42,14,39,127,183,50,57,18,56,38,39,95,84,68,47,64,39,24,11,132,67,17,13,29,26,20,61,168,34,65,39,42,38,26,46,22,26,11,33,20,55,90,11,27,86,27,12,29,15,314,50,75,17,12,7,39,31,24,16,98,20,12,33,17,16,49,50,24,4,17,22,103,38,10,25,103,22,18,37,47,101,7,13,32,19,39,10,21,12,18,40,68,29,91,48,56,83,41,21,76,15,48,18,132,11,27,67,12,60,20,23,19,17,12,71,46,16,20,36,30,26,41,25,12,17,122,116,55,38,29,30,12,79,32,11,12,14,25,68,105,44,25,59,12,6,108,14,48,37,11,62,17,33,14,57,9,8,23,13,183,6,88,23,10,100,11,51,69,11,33,15,43,44,95,42,157,19,102,6,42,12,11,10,14,16,18,10,58,41,6,21,2,30,29,14,12,15,6,6,4,24,76,26,16,10,10,20,24,39,66,19,12,18,19,19,3,55,30,17,19,36,17,38,2,2,24,15,70,14,47,14,24,25,116,30,0,18,10,72,28,38,53,39,14,4,20,33,23,3,46,14,9,10,14,24,8,61,29,23,10,36,18,9,10,28,39,5,7,4,142,109,6,7,13,18,8,38,11,25,11,19,9,24,36,66,6,26,18,16,13,14,21,18,28,40,19,22,14,19,10,27,23,41,8,12,52,20,30,69,27,16,8,32,35,9,26,30,72,47,18,23,4,11,18,25,5,59,28,15,89,14,14,80,26,20,52,10,16,15,92,22,51,20,42,33,28,14,77,82,31,18,31,8,20,71,24,12,31,57,13,32,26,23,21,10,13,15,4,18,73,62,19,23,24,0,12,9,88,65,80,2,14,24,26,59,23,60,15,19,60,49,9,14,64,28,54,13,25,11,52,39,9,97,25,20,34,30,38,61,39,43,61,49,16,18,24,28,8,27,19,5,12,49,25,74,8,24,32,376,37,10,24,37,12,23,96,29,16,41,30,20,74,65,24,22,15,23,21,29,32,13,127,50,82,13,14,29,19,11,25,69,23,16,27,14,22,16,11,14,49,25,33,28,17,29,11,12,30,47,11,11,10,3,18,18,22,22,18,10,8,14,8,108,51,30,17,14,39,22,16,10,16,32,10,17,25,11,8,20,24,24,13,15,10,12,44,7,79,20,18,15,13,35,27,21,40,35,5,18,28,8,16,17,9,26,13,48,16,33,31,17,11,25,47,31,20,19,16,25,9,6,8,32,11,35,37,13,6,18,5,16,21,13,30,18,30,76,31,19,16,13,14,18,23,31,32,16,3,9,24,16,22,13,6,8,16,9,35,17,8,4,20,22,9,8,15,30,20,20,6,17,71,39,19,14,14,35,27,16,23,16,23,6,9,16,24,39,14,5,11,23,7,33,15,21,17,31,38,16,45,65,10,19,8,5,14,7,11,8,31,18,19,18,9,18,5,26,15,28,9,19,25,36,11,4,13,50,24,7,5,9,5,13,22,10,22,12,8,31,23,32,17,16,14,17,8,13,18,15,24,14,8,9,26,10,6,51,7,58,26,38,21,27,35,9,7,26,13,5,38,25,8,21,12,10,23,37,14,26,13,36,19,18,9,17,22,22,9,28,13,8,26,17,24,52,26,29,115,9,11,15,19,19,8,8,25,6,66,9,16,4,13,19,17,24,5,5,20,23,17,23,7,11,15,6,5,17,21,5,21,8,14,42,11,15,23,23,44,9,12,13,9,12,6,20,20,13,17,8
administration,15,51,22,292,11,11,5,34,19,1,26,19,26,103,4,14,9,20,9,5,4,54,18,30,36,19,12,41,9,17,7,323,133,30,84,75,41,6,19,6,11,13,8,19,91,24,55,1,348,36,65,19,13,50,27,4,67,45,11,29,37,12,5,13,49,16,109,4,8,21,98,10,9,5,138,16,26,12,103,36,103,7,11,12,307,20,17,7,50,5,14,9,16,28,69,18,22,11,79,29,27,50,30,8,30,36,12,23,26,8,50,15,32,35,15,33,3,6,110,139,55,36,29,183,21,5,6,7,8,7,11,0,3,94,33,135,7,12,9,28,15,61,60,21,3,107,5,31,17,18,104,7,10,29,14,127,45,35,9,53,45,7,11,3,46,20,9,56,42,8,25,106,38,8,6,12,177,7,11,93,39,12,94,36,11,28,48,34,59,88,1,7,11,1,6,19,29,17,34,15,78,8,9,23,36,36,15,96,24,92,96,14,53,9,2,14,6,20,47,8,6,24,2,19,79,186,40,28,6,98,28,47,64,57,37,41,41,33,17,11,104,52,9,4,38,26,9,43,101,8,17,19,33,12,7,23,10,12,4,36,14,31,31,5,6,153,38,6,21,11,127,19,48,16,3,10,26,50,11,12,94,17,19,23,19,13,46,30,11,2,9,16,19,15,13,27,51,25,4,24,39,53,4,7,18,12,29,18,19,10,19,60,47,31,32,28,31,95,15,14,46,12,24,10,86,7,35,43,5,39,8,18,9,8,6,17,21,11,20,24,17,16,27,17,8,11,53,46,35,21,27,19,6,54,36,14,11,11,25,43,87,31,37,31,4,4,32,12,34,22,10,57,15,26,12,100,15,13,16,10,65,7,54,20,10,51,16,22,33,5,44,12,27,9,43,9,53,11,42,6,30,4,4,10,10,12,11,2,19,31,3,11,22,22,23,22,3,6,1,9,8,9,45,16,2,7,11,23,5,22,9,13,3,16,16,8,3,19,19,10,17,31,20,10,4,5,10,4,54,11,37,8,14,6,56,14,2,10,11,33,26,41,42,46,15,15,25,21,20,2,12,11,11,3,8,15,3,13,40,4,5,16,1,11,16,6,23,5,10,17,98,51,3,12,11,4,11,23,14,7,11,9,10,12,8,23,23,22,9,7,4,11,8,29,20,17,15,12,12,25,5,20,12,58,12,6,30,26,21,32,11,6,2,9,37,7,10,14,33,38,4,7,2,9,13,16,11,12,21,10,37,8,10,65,17,21,29,7,15,7,25,8,26,9,14,22,15,29,39,50,6,9,22,14,8,20,33,19,14,59,8,41,14,25,8,5,14,1,8,14,37,39,22,5,30,3,14,2,30,24,33,23,6,1,18,34,7,59,24,14,52,63,35,13,37,9,27,7,20,9,24,3,7,20,7,11,5,11,15,68,4,29,36,17,12,8,31,32,9,8,3,5,16,43,9,50,16,14,16,165,52,7,4,17,7,12,40,34,5,20,11,9,5,20,5,1,1,16,15,10,21,2,16,71,27,14,4,8,5,4,11,48,14,15,14,16,20,17,3,4,16,22,23,9,5,18,11,2,27,17,15,12,4,13,15,11,35,6,6,9,8,13,6,36,14,40,8,10,7,22,14,6,11,28,7,19,5,3,11,22,7,23,4,14,8,11,37,4,52,10,21,5,13,8,11,14,21,38,12,11,9,14,41,22,9,25,14,19,10,26,26,22,8,16,28,31,12,12,10,17,10,10,5,16,6,20,19,13,24,7,2,7,15,11,20,16,4,6,9,22,14,16,17,4,25,17,14,12,5,16,13,3,12,9,4,15,12,5,19,15,10,6,25,7,4,10,8,11,7,12,5,13,16,29,4,6,8,10,0,7,17,3,17,5,3,8,10,23,16,17,8,9,15,7,10,14,18,9,8,11,37,44,11,7,13,12,9,11,7,7,6,5,18,14,5,3,3,5,14,38,13,6,8,6,5,4,1,7,8,7,1,7,8,5,9,10,11,10,13,2,4,32,7,2,2,3,5,8,11,7,6,3,6,20,7,6,3,4,25,30,38,24,5,10,9,1,1,4,6,13,10,5,9,4,8,11,4,14,13,9,14,17,10,8,6,3,16,5,9,28,8,10,26,11,14,14,15,46,41,2,23,13,8,7,7,6,7,3,16,6,12,12,4,18,12,20,9,10,2,3,8,5,10,8,4,5,33,6,5,4,17,10,5,1,6,7,6,28,17,4,7,16,11,7,29,12,4,6,7,7
state,305,781,314,3737,208,117,150,1528,167,86,831,363,189,1586,162,231,170,320,147,110,111,947,220,656,512,249,264,314,144,443,291,3992,2838,185,1051,1051,1111,214,125,102,150,230,171,77,622,499,684,348,1,685,1135,121,262,806,201,148,1327,674,102,396,656,216,63,322,400,117,2394,131,195,383,293,144,85,119,1269,299,326,104,1709,509,758,8,486,143,6224,391,249,10,1006,54,202,145,48,761,1270,179,400,100,761,229,327,576,855,267,240,645,72,72,324,117,446,125,117,317,62,694,247,118,2096,3564,822,405,272,1441,187,75,71,141,106,62,270,90,138,1083,471,841,199,92,122,167,68,822,809,91,103,1589,150,336,299,244,1871,41,420,189,84,976,583,112,404,243,162,71,134,100,85,124,90,397,446,270,623,2218,428,36,95,260,4008,77,262,517,493,368,134,324,145,363,645,471,1213,1526,87,136,149,21,43,84,272,88,216,337,453,45,44,322,736,237,150,619,313,679,1638,127,774,159,55,59,18,40,287,102,98,495,141,325,997,2512,541,599,96,229,300,353,325,610,654,344,696,180,176,180,1602,755,138,115,348,119,116,403,1067,154,253,441,444,189,268,350,276,84,130,411,64,635,661,225,138,964,156,159,371,129,2950,189,698,124,91,39,562,175,396,77,1282,127,46,407,246,72,89,154,313,60,253,184,261,103,135,239,1180,169,225,416,654,753,37,116,330,46,583,76,145,39,85,473,476,159,737,343,312,934,284,128,1564,200,597,136,1906,327,173,654,132,732,225,248,214,120,166,482,452,233,91,364,238,333,311,393,117,174,1237,1640,410,167,314,299,194,708,640,105,216,104,331,542,478,155,192,402,150,46,959,222,157,288,96,413,112,220,184,478,197,63,402,160,1774,128,907,333,84,1055,218,579,696,79,586,102,379,489,835,287,1654,97,805,126,610,81,114,55,122,134,132,142,633,301,78,383,174,319,422,231,183,240,98,79,105,210,503,442,52,133,100,391,340,436,458,250,106,474,94,178,50,522,206,125,400,604,181,397,63,144,193,170,819,156,349,163,102,145,1505,226,66,448,153,673,280,433,692,404,122,106,281,393,285,23,320,60,60,61,59,207,140,556,348,108,143,308,160,163,172,236,239,108,145,151,1784,834,46,148,206,210,78,401,211,247,302,88,93,54,282,720,83,344,162,95,84,140,240,160,287,386,142,187,89,214,129,612,232,710,251,157,616,165,455,643,234,89,117,192,248,156,298,158,1003,326,145,115,69,108,186,193,281,378,435,228,1778,182,246,1415,186,210,836,128,195,221,622,126,689,106,357,286,322,196,913,783,288,230,347,121,172,278,173,176,153,475,146,417,281,346,175,163,149,214,160,202,641,883,218,91,473,134,69,43,1837,463,593,68,139,257,258,466,168,704,133,154,702,448,396,195,902,270,455,70,178,138,268,192,85,611,62,175,268,207,340,829,322,501,564,635,280,67,187,207,69,267,155,72,251,711,260,770,99,179,139,10763,713,156,209,191,205,333,1037,571,258,422,139,286,761,831,316,311,156,278,238,260,422,143,1649,1031,1023,230,68,207,312,180,250,626,368,209,291,194,389,166,179,392,511,240,393,420,228,200,260,216,356,438,230,146,208,185,208,170,387,148,135,197,120,373,188,623,603,418,228,240,356,86,255,132,263,539,40,333,183,35,81,355,162,334,142,115,194,95,300,94,1476,273,254,236,90,231,313,100,261,161,87,218,245,127,72,312,117,293,193,264,104,343,314,268,165,147,613,270,292,168,144,332,162,126,34,590,112,342,177,55,390,338,215,127,300,127,312,182,177,1091,204,382,211,390,154,158,169,400,140,216,119,185,131,180,366,144,90,74,174,126,432,202,211,218,539,232,108,162,140,278,188,284,204,104,274,283,134,168,59,245,181,163,198,194,306,125,139,252,252,542,355,225,280,323,212,286,151,208,188,205,152,329,681,860,254,186,82,187,124,181,276,52,242,167,209,104,151,220,130,124,260,227,126,186,203,217,103,160,251,497,338,192,172,217,98,194,392,107,162,169,219,150,190,474,39,134,197,399,136,238,157,68,124,226,99,289,382,228,211,360,129,528,153,154,215,284,415,223,151,249,88,87,293,226,156,316,135,227,166,725,139,214,176,112,220,216,156,100,122,119,152,195,83,260,85,67,98,394,222,245,623,128,37,142,101,73,110,149,221,189,467,159,206,225,121,99,87,740,94,29,188,207,136,220,163,133,231,157,26,170,249,272,136,136,191,187,168,146,268,103,769,64,99,86,121,16,24,61,27,185,42,46
america,33,83,35,306,54,161,16,73,22,20,119,45,101,441,3,42,46,66,81,69,19,104,257,219,37,149,169,189,85,147,21,610,469,109,171,587,309,10,26,70,36,213,44,57,153,37,99,36,685,1,147,105,87,655,187,18,46,32,227,94,36,39,20,45,121,70,411,41,39,67,114,15,57,22,535,94,166,8,273,155,117,20,33,80,403,19,19,16,84,7,34,32,52,136,114,55,81,4,199,37,29,66,35,60,73,126,5,63,73,33,117,14,108,120,174,124,6,21,131,258,79,291,86,451,95,58,17,20,16,22,192,34,72,171,165,380,19,42,38,95,39,156,90,18,38,306,28,99,19,10,158,36,41,25,36,50,234,79,58,333,34,12,62,21,49,149,31,89,90,39,105,453,124,43,65,12,171,17,24,284,66,34,97,92,30,141,84,52,51,157,30,30,25,67,33,21,44,33,32,20,82,14,26,21,76,72,13,43,35,58,248,138,105,45,65,152,29,79,49,12,22,75,8,33,75,80,90,53,31,36,50,47,55,38,103,10,77,33,25,34,150,111,40,37,91,26,38,208,97,39,39,48,141,8,8,49,12,24,2,31,6,172,19,10,28,16,72,210,117,18,200,32,23,19,13,46,95,15,9,4,356,8,16,60,36,18,70,79,49,33,4,44,52,32,18,20,75,25,29,52,100,40,5,14,9,19,92,14,24,22,23,22,161,87,71,21,45,60,27,16,149,27,124,98,230,7,44,266,17,109,47,21,22,2,17,27,157,20,12,25,12,80,161,27,10,36,45,145,55,135,19,36,8,114,39,24,35,5,24,134,49,54,61,42,21,101,63,56,87,180,18,219,17,138,26,58,21,11,92,12,96,31,58,60,104,62,37,52,86,17,79,77,42,45,46,81,39,5,43,4,64,94,5,59,17,11,23,22,125,96,34,155,56,44,15,70,57,41,31,126,15,40,69,19,41,9,16,9,19,61,8,5,0,43,62,29,19,60,103,11,49,38,24,118,64,54,222,71,51,34,163,12,116,34,198,21,102,26,17,26,97,106,82,129,29,22,155,77,19,28,152,57,24,36,32,33,37,25,57,34,11,42,39,28,34,16,24,86,5,5,230,45,32,46,83,21,12,21,23,10,27,13,5,18,38,27,26,9,11,6,5,2,9,6,18,10,28,8,3,36,15,18,6,41,2,11,76,4,32,30,25,26,49,9,21,29,3,38,89,8,19,27,20,33,34,8,26,31,20,8,41,5,9,94,6,12,74,5,21,16,30,10,21,13,35,9,26,9,73,83,34,9,4,14,17,8,13,8,6,75,8,17,38,129,21,20,13,9,3,75,53,46,57,21,30,3,17,13,112,40,18,3,22,14,11,35,12,14,10,5,54,22,20,17,27,10,18,15,7,4,8,6,8,47,9,8,17,14,20,66,34,13,52,31,10,16,31,7,35,12,31,38,9,24,19,23,10,9,14,489,39,18,23,8,16,57,37,51,6,44,7,57,71,79,19,15,12,20,8,7,20,6,65,16,53,3,3,14,27,9,28,84,14,16,14,4,31,29,16,53,18,139,13,60,13,25,20,16,21,18,39,1,8,2,22,42,37,38,1,7,9,10,4,31,23,21,73,7,19,12,10,5,10,21,23,39,6,22,6,41,10,16,21,11,1,4,14,9,39,12,16,21,25,45,20,14,23,53,28,2,39,1,1,12,12,31,8,38,13,15,8,30,4,22,65,88,57,8,12,17,50,37,17,17,8,26,17,5,9,11,2,5,14,2,29,13,3,6,15,28,28,5,1,15,8,26,5,16,8,2,6,15,11,9,65,21,41,19,28,5,19,213,28,12,19,6,14,45,4,16,9,5,23,10,12,7,66,16,10,5,24,15,21,39,33,20,21,59,14,16,12,3,3,8,11,19,9,42,3,29,49,36,9,7,10,13,8,6,3,15,11,19,2,25,8,7,14,4,31,13,4,1,6,0,7,20,8,11,38,43,6,15,11,6,3,6,13,2,30,8,114,10,56,10,2,19,11,24,30,93,4,10,59,33,7,2,67,19,4,20,5,21,18,5,14,20,13,14,22,2,9,27,1,20,7,4,29,28,4,0,8,34,4,17,5,4,7,1,7,4,8,32,0,0,10,7,22,6,4,4,13,36,20,7,8,3,18,35,17,7,1,4,4,2,16,21,0,0,20,35,43,14,52,73,5,14,36,4,30,6,15,6,3,6,4,0,13,90,25,41,10,21,2,54,16,14,66,3,41,123
could,30,80,50,464,44,43,13,140,23,14,53,38,44,265,20,33,47,56,28,19,22,147,88,143,100,67,76,85,40,75,63,723,503,54,220,312,231,42,67,32,30,51,36,30,178,110,101,65,1135,147,1,45,57,230,30,35,220,58,42,53,66,45,9,56,90,37,413,33,53,64,76,13,19,25,304,61,112,24,317,128,137,11,64,47,738,103,62,14,133,7,39,41,10,139,205,54,90,7,147,39,44,107,126,73,47,106,27,34,61,23,92,25,47,52,31,138,28,12,255,1072,173,101,70,292,45,30,7,22,13,9,74,21,32,169,151,191,32,16,29,32,25,159,93,22,11,301,32,73,63,43,305,18,70,28,27,79,157,32,47,91,70,21,60,9,24,66,14,85,91,47,73,395,109,13,41,41,579,20,44,172,140,41,50,116,21,99,171,96,182,219,15,42,27,10,15,19,65,31,34,56,119,7,16,47,95,47,46,112,60,93,313,65,109,51,40,47,19,23,48,11,22,85,34,70,170,388,128,133,33,33,36,66,80,109,143,75,144,35,45,42,360,138,35,40,63,16,26,117,186,30,42,104,79,24,32,84,41,10,25,61,22,154,82,7,28,118,11,59,94,30,367,33,99,8,17,17,73,33,32,11,236,27,17,67,59,12,31,52,98,18,23,39,54,28,15,59,157,24,34,80,100,76,6,9,52,8,63,26,17,17,11,60,131,27,143,65,79,177,60,21,150,23,171,21,253,26,33,169,26,107,56,56,46,20,37,51,86,31,12,58,54,56,60,65,23,29,183,227,78,33,50,40,24,175,86,30,20,19,67,125,71,25,53,88,29,14,214,50,38,109,17,130,25,48,46,111,37,20,76,28,154,7,141,55,33,131,24,93,130,28,98,27,44,57,109,49,227,25,132,16,65,21,22,21,20,10,39,14,88,45,23,34,43,49,68,59,37,44,35,53,21,34,66,56,10,25,13,68,57,81,60,20,13,46,17,31,22,91,49,27,55,64,46,71,8,15,82,68,160,37,83,29,43,18,195,50,24,57,38,123,73,90,96,136,23,21,93,54,30,5,71,38,15,22,18,80,29,42,102,43,50,82,14,35,49,37,50,32,21,14,409,151,20,46,60,17,21,56,36,35,49,32,13,15,42,114,26,62,21,25,23,19,40,34,43,71,26,37,67,44,17,41,25,106,34,16,154,34,77,120,55,20,40,33,39,39,35,63,155,105,22,10,28,24,38,27,23,76,50,19,138,20,24,168,24,57,116,22,28,28,77,15,74,21,64,46,60,45,137,158,37,30,53,26,15,42,47,35,37,57,26,68,69,75,36,52,25,35,22,54,102,130,59,17,66,32,25,35,200,85,92,9,29,36,38,70,31,163,29,21,133,84,33,20,114,34,63,30,26,9,57,48,10,107,13,28,36,25,53,89,78,50,94,93,20,22,31,29,14,44,31,18,41,74,32,93,25,20,30,658,98,28,54,25,58,54,160,76,49,53,14,30,42,81,37,37,6,53,46,43,64,32,280,79,93,36,8,19,12,28,28,102,72,16,32,26,61,25,24,53,75,42,53,51,35,35,63,36,45,58,27,13,26,29,47,32,77,46,21,30,19,23,26,98,69,96,51,37,58,26,47,26,36,99,12,26,56,9,22,39,29,67,29,22,21,22,57,14,137,31,46,29,13,44,44,10,50,26,31,36,49,15,8,37,26,42,27,35,13,47,36,46,12,5,62,49,40,22,19,42,30,22,15,48,15,50,27,12,27,49,19,11,57,22,32,20,38,137,33,60,29,27,9,21,55,67,36,34,12,21,23,22,59,14,65,29,21,20,45,19,40,10,55,39,18,21,14,66,24,41,31,16,30,44,20,38,22,20,56,26,39,22,34,19,26,60,33,91,53,19,26,25,17,45,30,33,37,54,31,40,99,113,43,31,17,24,27,18,38,7,29,25,35,13,26,32,30,11,44,37,17,14,34,52,21,24,6,39,61,4,17,15,24,24,34,22,28,28,26,34,24,53,11,11,34,17,12,14,17,46,29,56,31,33,45,19,20,40,14,76,17,31,16,32,45,23,15,23,23,12,46,36,18,42,8,35,14,60,18,20,11,21,39,29,21,16,10,17,10,20,14,56,11,15,27,66,37,41,110,12,10,29,20,15,23,11,13,21,49,18,10,12,15,12,12,70,23,10,21,38,68,35,41,28,30,11,14,36,26,25,17,29,33,48,27,17,31,28,102,13,10,20,28,8,6,12,13,27,7,25
achieve,3,17,10,96,7,18,7,29,1,0,14,6,21,80,4,7,10,11,23,10,1,25,43,35,15,21,36,63,17,24,13,115,82,16,42,105,78,5,12,13,4,34,4,11,43,12,16,19,121,105,45,1,17,99,23,7,5,5,21,25,7,11,3,5,17,20,102,12,7,6,9,4,6,4,164,10,18,2,63,35,44,4,6,18,109,13,6,4,17,2,8,9,6,31,20,3,27,3,51,7,0,27,7,10,21,17,7,10,8,9,25,9,14,17,10,35,1,5,45,66,18,52,20,95,11,5,6,5,4,6,34,15,11,38,28,110,14,11,8,25,8,36,22,5,2,74,15,17,8,3,45,7,10,13,11,35,43,29,29,79,10,3,6,5,16,27,3,53,13,9,10,90,41,6,12,5,49,4,5,52,38,7,29,20,7,30,22,20,25,26,7,6,1,6,4,6,17,27,8,20,37,12,7,10,31,16,5,31,6,16,62,18,17,9,8,20,3,14,7,1,3,20,2,14,23,27,20,18,5,5,12,2,19,27,33,9,24,10,15,13,43,12,7,21,29,1,8,29,31,9,12,7,25,1,3,7,2,1,1,11,3,41,6,4,4,7,14,25,17,7,47,4,7,2,5,41,19,5,3,1,50,6,5,7,9,14,26,22,18,8,2,8,5,8,3,4,17,7,4,22,17,6,3,3,6,6,25,4,9,11,6,17,16,20,15,7,15,47,13,6,31,0,28,11,45,2,18,46,4,22,8,7,4,3,5,6,24,6,2,6,12,12,31,8,1,7,10,32,5,15,4,11,4,26,13,5,4,8,18,44,12,3,27,6,6,6,9,6,23,29,3,40,4,20,13,7,12,2,20,3,44,7,16,9,17,16,2,11,16,3,20,10,7,4,5,5,3,2,19,7,11,8,6,19,6,18,5,1,20,20,8,4,2,18,11,17,8,17,5,21,4,9,30,8,13,10,11,10,6,14,2,2,0,16,15,4,9,16,23,7,12,8,7,14,9,11,31,8,16,3,42,2,18,6,29,8,6,7,9,5,22,24,28,41,12,12,26,13,8,8,24,18,0,10,3,27,2,6,22,11,6,13,3,7,15,5,2,14,9,3,55,18,4,16,11,0,3,4,2,10,5,1,4,5,9,9,9,10,4,1,3,2,5,7,14,9,12,19,9,17,7,15,10,27,6,5,22,23,15,14,36,7,8,14,16,9,5,18,20,13,10,9,6,14,13,6,7,8,6,3,14,1,3,27,14,1,17,7,4,7,2,1,3,4,1,2,14,5,25,25,4,1,3,1,5,0,5,3,3,19,3,1,6,17,7,8,2,5,0,13,12,17,13,7,25,4,11,4,15,11,11,6,4,3,4,13,2,5,1,0,19,13,5,5,10,3,6,2,6,1,2,0,2,13,3,0,4,1,3,15,2,6,17,13,4,3,18,3,3,1,8,15,2,6,3,9,4,3,10,77,20,9,2,3,2,13,12,18,8,7,4,7,5,2,5,2,1,6,6,1,2,0,29,3,3,4,0,1,2,5,3,14,9,4,3,0,4,8,0,4,3,36,4,3,3,7,4,2,7,1,4,4,2,4,2,9,12,8,0,0,8,2,1,13,9,21,16,4,4,9,5,7,0,9,3,5,3,7,5,5,3,9,1,5,1,5,6,4,8,1,5,3,2,3,3,3,8,18,11,2,11,2,1,1,5,14,3,2,4,3,2,11,5,5,11,2,6,4,7,7,10,5,3,5,0,8,4,7,2,0,0,3,6,0,5,5,3,22,3,4,6,4,2,1,10,4,6,2,3,1,4,3,7,11,8,12,6,5,5,2,2,3,4,2,3,3,4,10,4,2,1,2,5,2,0,1,8,2,3,5,8,1,5,3,5,6,6,14,13,2,2,1,1,3,3,0,5,11,3,12,18,17,7,1,0,2,3,0,1,3,0,3,1,13,3,0,4,1,13,4,0,2,1,0,5,2,0,5,7,5,0,3,0,1,3,1,4,2,0,2,6,0,3,3,3,8,2,3,3,14,2,1,7,4,2,1,2,3,0,15,4,2,0,3,4,5,0,1,10,1,2,4,0,0,1,1,4,5,3,0,1,14,2,1,0,0,0,1,2,2,2,6,2,0,6,8,3,2,2,0,3,3,6,2,3,1,0,7,2,2,0,0,0,0,0,5,2,0,7,2,13,2,15,21,0,2,5,1,2,1,1,2,2,0,5,0,2,11,9,6,0,9,1,13,5,8,4,2,4,15
prosperity,1,23,6,157,28,13,14,62,5,11,50,7,12,176,10,21,14,23,17,11,8,47,48,36,16,25,35,37,16,28,6,164,227,25,65,160,128,17,28,15,24,47,6,12,45,29,9,13,262,87,57,17,1,121,21,7,76,29,19,58,22,14,14,17,34,9,186,12,12,9,12,1,9,10,135,37,18,7,104,33,122,6,19,7,200,26,16,5,47,0,7,17,0,42,86,20,31,12,69,47,4,34,41,23,24,31,19,9,22,8,23,7,35,34,16,43,4,3,33,143,49,47,21,113,9,11,11,5,2,0,45,7,14,37,42,74,9,9,8,20,8,61,30,11,7,89,14,41,17,13,85,9,33,17,27,19,48,10,19,40,21,14,10,3,6,14,7,35,41,22,22,120,28,16,18,14,184,8,14,45,25,26,15,33,8,49,49,25,31,56,5,11,28,6,5,7,8,9,8,21,69,6,10,7,47,25,11,34,15,32,96,19,21,11,11,10,13,9,15,4,8,20,11,11,49,70,30,46,7,8,13,24,39,13,57,41,38,16,35,13,84,53,10,10,24,11,15,53,40,14,16,38,41,8,15,20,13,2,6,17,2,32,15,1,5,32,18,29,33,16,159,16,33,8,1,6,16,15,5,4,111,7,2,31,21,9,13,13,22,3,1,7,5,9,1,14,38,7,4,30,41,27,2,2,21,4,41,4,23,8,0,16,43,27,19,17,31,54,46,15,44,18,28,10,57,2,17,56,8,26,11,15,12,11,12,12,39,4,10,24,11,8,25,8,10,12,43,52,28,30,18,17,3,42,15,11,12,6,23,50,38,16,22,22,19,12,40,14,12,26,7,46,7,34,12,12,12,21,29,23,104,3,46,25,8,51,4,28,36,7,32,17,13,5,42,32,52,8,33,8,21,11,10,8,6,38,8,8,59,39,8,25,4,10,10,22,11,15,10,14,7,9,29,17,7,3,6,13,9,24,12,4,1,11,14,3,2,15,15,4,18,27,13,31,7,9,38,14,46,19,58,9,19,16,64,7,18,5,12,30,16,59,46,26,9,8,48,15,6,4,34,9,5,3,5,22,10,13,21,7,15,44,9,8,22,3,16,17,17,3,49,51,6,10,27,8,14,10,21,29,27,8,11,5,6,21,20,10,9,10,13,10,6,7,23,23,7,20,8,16,11,18,7,16,10,4,24,11,12,41,13,12,4,15,8,7,9,23,49,30,5,7,5,19,22,10,19,28,10,6,36,1,5,69,9,8,47,3,16,12,19,3,12,4,24,13,15,14,30,61,11,8,4,2,5,7,26,4,12,14,19,15,14,30,19,9,14,13,5,26,18,43,14,4,56,22,14,27,13,25,23,7,6,3,8,30,7,11,12,2,39,16,18,21,11,11,24,9,10,6,15,16,4,20,4,3,8,18,17,34,23,32,25,29,4,3,8,12,4,7,13,10,5,21,8,16,16,2,8,127,28,15,6,1,8,18,36,16,3,30,8,17,10,3,9,3,1,12,13,15,10,9,30,5,21,10,10,4,1,9,9,38,11,14,12,10,24,12,1,4,11,29,17,8,11,10,11,3,10,16,8,4,9,4,10,11,16,14,9,4,8,0,5,31,30,8,12,9,9,8,8,6,4,8,1,10,10,9,8,24,15,13,7,8,9,1,5,14,42,29,11,2,5,6,4,6,24,21,5,10,30,7,2,6,3,18,5,9,10,13,14,27,4,1,27,34,14,14,33,10,23,11,12,7,9,23,18,5,7,18,3,5,11,6,18,7,11,4,7,13,13,12,8,7,25,17,12,9,12,0,8,8,13,13,15,4,15,6,18,6,21,13,2,8,3,5,5,8,4,10,7,6,6,11,4,1,10,8,13,7,12,6,18,4,9,12,8,41,14,9,5,2,6,6,6,15,8,5,3,7,9,19,7,7,4,5,11,17,4,10,8,10,1,7,5,11,7,2,8,12,4,7,15,31,6,18,2,4,15,2,2,3,6,3,4,5,5,6,7,3,11,10,4,10,6,1,9,4,8,11,9,4,5,17,8,3,7,21,5,16,7,9,7,7,8,2,3,7,10,2,9,11,6,12,0,6,6,8,5,2,8,1,11,5,8,3,8,8,9,23,5,22,19,3,16,19,35,12,25,8,0,3,5,1,6,4,5,9,11,7,7,15,5,0,2,3,10,1,0,5,4,3,15,28,5,5,4,7,14,14,5,7,3,12,9,11,11,23,9,3,3,11,18,5,4,4,8,5,11,13
world,18,74,31,327,47,186,26,145,23,37,59,21,89,764,23,66,48,74,81,67,16,131,161,182,76,68,158,158,93,141,48,652,547,109,228,653,644,15,80,85,52,261,28,35,147,66,57,50,806,655,230,99,121,1,87,39,107,57,110,127,74,95,21,71,178,85,574,40,45,56,88,14,40,23,660,80,132,26,306,168,210,14,51,75,482,39,62,7,93,4,47,69,47,160,159,45,82,24,288,75,29,95,66,65,83,119,31,38,79,38,114,23,102,109,52,182,9,15,152,513,132,190,57,463,75,70,25,19,21,9,149,43,104,216,171,350,36,26,51,133,48,201,137,23,38,333,51,128,70,31,245,35,60,54,34,24,246,43,66,226,49,9,52,21,28,93,23,134,105,53,96,452,133,36,61,29,431,29,32,232,72,58,78,92,14,130,121,78,67,175,29,23,56,53,22,37,42,46,41,44,122,6,33,27,135,109,12,87,54,137,324,108,87,54,55,81,24,47,44,7,31,74,23,58,123,164,115,126,33,47,62,33,84,104,187,33,124,51,64,34,217,145,44,54,183,22,43,198,136,36,48,78,161,17,9,92,23,17,8,50,2,222,26,7,41,70,38,162,155,33,333,31,41,23,19,50,86,35,9,5,355,16,23,70,49,35,69,52,63,24,4,33,23,40,17,38,75,32,36,103,89,43,2,10,32,15,135,10,34,23,20,35,182,89,81,32,68,125,60,46,134,40,146,40,285,8,82,272,22,142,42,37,27,12,31,32,159,28,13,47,37,58,106,47,24,44,102,217,81,58,33,59,16,153,53,21,43,19,40,157,57,48,81,77,24,84,116,61,53,145,23,200,34,92,30,71,21,15,81,21,182,21,119,51,79,108,18,105,73,23,107,40,18,30,61,117,60,14,92,27,107,147,15,49,25,32,32,35,260,95,32,39,56,55,34,81,45,56,28,102,26,49,81,49,25,18,35,44,40,71,7,12,4,39,68,27,63,65,107,24,68,53,28,128,51,59,208,96,129,54,167,19,84,29,212,41,65,39,50,54,84,174,157,192,39,22,169,60,14,14,131,43,20,46,24,60,59,28,109,52,39,70,42,36,57,19,50,63,19,5,558,95,40,71,106,25,27,26,26,25,40,41,29,22,35,40,20,40,13,16,20,21,10,8,38,38,39,28,12,64,40,37,12,72,14,11,80,17,52,79,45,31,51,38,40,39,14,53,138,27,26,70,25,45,113,17,50,46,31,9,36,8,6,118,72,23,132,7,28,32,27,7,30,26,47,34,49,20,107,153,42,17,26,6,26,10,38,12,16,68,31,32,51,108,33,29,29,15,13,81,96,86,49,14,92,12,39,28,100,79,46,17,32,16,13,56,14,53,27,4,116,25,24,41,47,27,25,31,19,4,21,12,19,49,15,16,38,24,34,92,61,41,47,52,28,23,46,28,28,26,36,23,16,37,22,59,26,11,18,615,48,42,13,4,25,62,82,113,16,71,6,47,15,39,19,7,11,23,31,29,43,18,117,30,27,18,10,8,35,24,43,92,21,26,24,20,56,41,14,30,48,130,23,54,18,42,22,10,49,17,72,12,12,13,18,47,46,40,9,9,23,13,12,57,39,69,53,21,37,24,27,10,15,36,19,24,21,13,5,124,20,35,31,23,4,8,110,18,60,64,34,31,25,66,63,21,42,63,37,9,52,3,3,14,19,56,17,27,15,31,27,59,7,17,75,99,32,7,26,29,73,27,31,24,10,32,27,10,10,15,1,7,25,13,44,35,19,62,26,33,25,3,3,18,13,36,8,10,16,12,17,12,27,8,71,40,58,20,51,8,32,25,10,19,25,13,20,41,8,25,8,6,40,12,9,4,59,19,13,18,18,25,40,53,58,57,29,105,35,16,3,5,8,15,18,22,14,70,7,42,43,47,12,17,16,18,21,10,6,25,5,34,9,40,16,16,36,5,57,18,7,13,17,34,23,33,5,41,48,45,2,22,9,9,4,3,20,10,20,19,72,11,16,20,12,17,12,5,21,119,15,2,59,53,12,10,18,24,6,65,18,12,37,6,31,11,12,12,31,9,10,25,16,10,32,9,35,11,21,3,17,19,13,23,6,8,20,15,11,22,20,64,15,4,17,25,29,22,29,6,10,30,23,9,11,7,11,35,30,9,6,12,4,9,25,48,12,10,9,36,43,24,66,67,12,18,48,19,27,7,5,15,3,45,13,13,21,99,45,25,24,36,26,31,5,11,29,4,45,98
child,14,35,23,159,13,59,4,21,2,14,12,29,54,132,6,17,14,31,17,10,2,34,98,86,45,86,25,55,13,43,9,325,169,18,79,144,48,4,7,3,17,43,4,41,59,31,50,27,201,187,30,23,21,87,1,11,25,25,76,22,6,6,4,13,50,27,146,23,20,17,123,1,41,18,236,36,104,3,78,55,65,1,11,37,167,25,1,4,31,3,10,13,19,15,19,12,32,0,41,22,2,37,11,31,24,46,8,36,29,22,30,7,16,26,72,45,3,6,99,88,59,87,101,189,26,17,5,4,3,19,83,43,50,82,36,284,15,13,4,14,14,47,22,6,9,115,24,68,6,5,24,46,16,21,9,34,69,11,6,179,28,8,38,14,19,87,31,18,63,14,27,156,43,20,19,8,100,4,7,160,46,18,54,36,3,49,40,29,44,51,12,6,13,18,21,5,39,7,26,17,45,7,15,12,11,49,1,39,21,14,163,60,62,69,34,118,8,35,3,5,11,34,9,18,49,91,39,24,26,33,25,20,42,31,54,1,44,27,1,13,78,24,33,13,23,10,9,40,116,14,21,13,40,4,0,32,4,22,0,27,6,15,12,1,15,24,105,18,21,5,72,28,14,11,5,11,50,8,0,0,203,7,12,18,9,15,91,152,12,18,1,5,21,25,17,4,22,10,3,29,32,27,4,4,10,11,24,18,72,15,14,59,55,36,73,0,30,45,12,7,33,9,51,195,81,2,55,132,6,26,7,18,2,2,5,17,35,9,9,8,5,41,82,15,2,25,25,33,30,189,10,14,6,76,10,7,28,2,15,39,54,39,36,12,1,37,13,20,38,43,5,65,9,76,14,39,16,5,23,11,28,6,21,15,81,51,9,37,80,29,11,13,20,3,9,23,21,2,13,3,13,25,3,5,5,10,20,4,8,14,5,13,4,31,1,6,1,7,9,5,5,2,19,8,59,8,4,8,5,18,0,1,0,0,21,5,3,2,6,9,12,19,3,3,2,15,59,14,65,24,26,3,27,5,45,7,21,2,32,8,32,44,41,31,13,1,90,17,20,17,121,25,2,28,29,42,15,5,31,19,4,15,3,7,25,1,14,35,13,1,23,14,4,25,21,3,4,5,7,10,8,4,5,27,17,3,21,6,8,15,0,4,6,4,8,4,14,14,1,9,19,13,2,3,5,3,22,3,8,19,23,24,7,15,7,5,1,22,51,23,2,6,11,26,13,8,3,41,2,8,14,0,0,36,4,5,13,5,7,9,6,3,24,5,4,5,13,7,10,42,10,2,10,6,5,0,5,3,5,28,2,12,6,20,3,9,7,2,3,22,3,20,28,8,104,13,35,15,6,20,11,0,19,0,2,6,1,4,1,1,21,3,2,15,20,6,8,6,4,2,8,0,4,14,5,5,2,3,22,18,0,19,22,16,2,8,16,11,9,5,17,20,7,9,1,8,24,1,22,73,0,7,1,2,4,5,8,17,10,11,14,2,1,0,1,2,0,10,6,3,12,6,4,10,8,8,1,0,0,0,0,22,10,6,13,2,5,12,10,4,6,43,7,1,1,8,6,1,6,5,2,1,6,5,2,26,13,18,4,7,4,1,7,15,11,4,7,3,8,3,1,9,2,7,8,10,4,23,1,24,4,12,7,9,6,3,1,3,24,16,17,1,7,1,0,0,13,21,8,4,12,0,2,7,3,12,7,4,3,15,6,36,5,8,23,40,38,3,8,4,17,10,21,21,2,12,26,2,52,6,15,2,7,2,10,8,11,0,1,13,29,32,20,3,8,31,1,3,3,1,2,4,5,5,7,13,6,21,13,2,1,1,2,3,1,0,2,24,0,4,2,1,1,7,0,7,55,3,2,2,19,8,7,7,4,3,4,18,5,5,2,9,1,9,8,8,2,7,2,12,9,9,7,2,19,4,8,7,0,10,1,8,9,4,3,8,8,2,1,13,20,3,3,1,8,1,3,0,7,2,0,2,2,0,6,0,5,2,6,3,29,11,64,5,1,2,3,7,10,17,7,4,1,8,1,1,1,0,0,18,5,10,6,3,7,2,7,1,6,4,3,3,3,0,1,6,1,0,0,0,8,21,0,7,4,2,3,3,4,11,5,61,0,0,4,4,17,7,2,2,7,8,21,6,1,0,3,4,8,6,2,6,6,0,4,1,8,6,2,0,3,0,16,17,0,0,0,1,17,7,1,3,2,1,7,1,3,29,0,162,10,4,1,9,14,37,19,1,38,5
humanity,6,9,0,49,9,3,8,13,3,5,13,2,1,71,0,17,7,5,4,11,0,15,7,18,9,16,6,5,7,6,7,103,60,4,53,46,65,3,5,1,6,15,8,1,18,17,11,4,148,18,35,7,7,39,11,1,37,6,5,10,14,19,0,6,5,7,57,1,3,6,3,2,1,3,61,5,16,6,45,14,15,0,7,7,141,1,3,0,16,3,1,6,0,18,46,1,9,3,21,3,1,5,22,11,8,10,0,2,1,2,7,2,4,2,1,19,2,2,26,75,18,17,0,21,6,6,4,1,0,0,7,7,8,26,9,23,6,0,2,8,2,29,21,0,5,45,5,11,11,9,38,2,4,8,4,10,22,7,15,9,5,3,9,0,0,4,4,24,13,10,3,55,10,1,0,9,98,1,10,14,14,12,2,12,0,6,17,15,24,18,3,6,1,0,0,0,5,2,4,15,0,1,0,14,16,9,1,5,4,24,34,1,9,7,1,0,0,1,1,2,2,14,0,6,16,44,21,13,4,2,9,2,6,11,13,1,17,5,1,5,40,16,2,5,17,10,4,7,17,4,9,14,25,0,1,9,6,0,0,9,0,28,8,1,4,2,3,7,12,3,83,2,4,7,3,2,16,2,3,0,48,7,1,10,6,1,0,7,6,4,1,1,0,1,0,12,13,4,2,18,22,9,0,1,8,3,25,1,9,0,0,5,7,3,9,1,7,20,3,3,31,4,21,6,63,0,8,25,2,14,0,5,10,1,6,10,16,7,1,3,6,6,13,9,3,4,23,30,11,6,7,3,5,13,11,2,1,4,9,23,3,1,6,10,2,5,39,3,4,8,2,17,2,9,4,10,6,2,21,5,46,2,22,11,9,19,11,16,24,12,38,0,5,1,17,7,25,0,18,2,14,1,5,0,2,3,4,4,18,7,7,3,0,6,45,12,0,9,4,1,7,4,11,8,2,1,5,10,7,9,2,0,0,5,7,4,3,4,5,4,14,16,1,10,3,6,8,7,25,5,9,5,5,2,28,4,1,5,4,20,11,12,24,26,4,6,16,7,6,0,30,11,4,2,2,21,13,5,14,2,5,11,3,6,2,0,2,4,8,2,84,22,7,6,3,8,2,8,3,7,7,3,1,1,2,0,0,5,2,5,2,3,5,1,10,7,5,9,0,7,21,13,2,11,1,5,14,1,5,16,11,10,1,0,7,5,9,10,38,2,0,3,3,1,1,1,0,10,12,1,4,4,0,27,1,5,18,0,1,4,17,0,9,1,14,6,14,3,9,23,1,7,5,6,5,1,2,1,3,5,0,13,4,8,7,14,6,5,2,2,18,22,0,2,7,3,5,4,23,18,12,0,4,3,1,8,3,12,2,0,5,4,3,8,20,2,16,5,1,0,6,0,0,5,1,5,4,8,8,12,0,8,20,13,0,4,7,4,4,7,8,5,3,9,7,3,1,1,2,99,27,6,11,2,7,6,18,20,6,11,3,0,2,10,6,1,0,2,8,5,9,7,31,11,9,5,1,1,2,2,0,13,12,2,7,5,10,4,2,5,7,6,7,7,5,2,5,7,4,7,3,4,4,6,3,3,15,5,0,1,0,2,6,19,24,9,3,9,6,4,6,4,16,15,1,4,0,0,4,5,4,1,4,4,1,1,6,7,26,1,10,4,2,8,16,5,4,3,3,10,0,0,0,0,0,6,9,6,2,2,0,5,2,0,13,5,5,3,1,5,3,3,0,7,7,16,1,1,27,12,14,2,5,0,9,3,5,17,1,7,4,8,0,2,0,11,1,2,2,2,2,3,9,2,3,4,5,4,7,7,0,2,1,0,2,4,8,6,0,8,5,1,1,3,3,2,3,0,1,2,2,6,5,5,3,9,11,21,5,2,4,2,0,1,10,2,4,9,5,12,26,10,7,0,0,0,4,0,4,0,1,4,3,2,3,11,4,2,8,3,1,0,0,0,6,3,1,6,9,14,0,0,0,5,5,0,2,3,6,2,1,6,4,3,8,6,8,1,1,8,3,9,4,7,0,1,0,1,1,12,5,0,2,2,6,1,0,2,1,4,2,1,4,0,3,10,7,11,2,0,2,6,12,4,7,2,1,2,9,5,4,5,0,0,0,1,0,2,2,5,0,3,8,1,3,1,1,2,7,1,4,6,6,4,0,11,1,0,0,6,14,1,3,6,2,4,0,5,0,8,0,2,2,0,3,0,6,3,29,3,3,1,4,3,0,0,2,2,5,6
duty,29,122,54,777,62,10,25,178,16,21,81,30,15,297,26,34,34,78,24,21,20,241,47,94,81,43,57,38,38,66,61,885,582,62,276,247,188,52,109,18,74,36,22,5,144,76,95,67,1327,46,220,5,76,107,25,37,1,118,11,52,91,38,11,118,114,33,470,90,66,75,67,22,28,38,363,44,87,21,355,91,296,0,53,20,1064,143,81,1,138,24,43,20,1,119,290,190,52,22,128,81,27,119,179,47,45,169,83,6,61,30,83,20,35,66,2,148,61,19,490,814,218,79,130,245,14,23,15,18,33,31,43,14,30,255,124,138,50,11,26,34,19,168,140,12,5,277,16,54,61,62,301,11,107,22,18,89,160,14,35,14,73,10,32,15,0,18,25,101,111,29,81,382,78,1,20,40,1023,24,46,142,95,48,5,68,7,137,177,91,162,233,19,23,62,0,7,19,45,16,24,86,134,8,19,70,126,73,13,215,69,103,429,14,117,150,11,2,3,2,94,9,18,95,45,97,288,599,123,122,24,29,87,67,123,82,135,505,167,47,83,34,329,189,42,12,39,23,28,109,246,46,44,250,80,94,72,91,58,23,40,90,22,121,92,24,42,204,29,21,118,37,799,74,264,30,15,5,99,58,70,14,274,23,10,84,54,9,15,67,66,11,32,13,95,37,25,62,219,37,45,121,127,225,15,16,61,10,96,40,24,5,10,60,115,18,306,102,120,173,44,31,213,58,128,18,264,24,16,128,21,119,23,70,69,44,51,48,64,30,11,59,56,37,80,52,26,18,259,291,84,21,73,73,51,164,116,13,25,43,48,117,88,35,19,84,13,10,180,34,34,40,24,133,16,46,35,168,158,31,81,47,404,9,269,66,15,73,34,101,134,29,118,11,70,62,175,76,366,44,151,14,137,11,28,7,16,30,29,10,120,80,14,32,58,92,73,39,28,49,11,3,31,40,82,59,5,31,18,67,51,80,42,42,34,63,16,26,2,52,27,28,78,204,44,51,4,9,29,23,140,57,60,50,6,14,203,31,6,74,43,212,50,116,144,137,37,28,141,42,18,4,80,8,17,13,23,73,23,86,85,35,46,60,13,38,37,51,71,14,28,20,268,196,9,22,79,42,25,84,41,59,49,29,25,9,16,92,9,83,45,26,75,32,28,33,105,119,25,71,13,48,24,69,39,144,30,30,104,21,70,202,50,31,9,85,55,41,61,51,212,64,22,10,4,47,70,38,13,125,90,31,231,58,25,225,42,70,162,45,49,47,137,28,151,22,77,98,55,56,171,187,68,71,66,22,35,34,231,41,18,79,136,81,100,69,46,25,37,33,51,63,132,163,39,14,82,18,68,22,261,67,108,8,36,20,24,130,33,221,44,112,138,85,75,55,190,52,136,51,51,56,55,33,25,105,10,53,37,42,75,147,62,137,133,122,40,35,30,44,21,63,75,11,52,89,49,145,26,21,20,840,111,16,71,19,37,54,231,51,24,103,56,27,101,73,37,32,5,21,35,67,120,78,126,168,166,38,21,44,26,21,19,115,79,53,58,137,97,21,14,60,67,61,78,33,30,35,48,24,288,137,12,23,32,30,57,27,68,25,51,18,33,62,67,152,74,157,46,45,36,49,59,24,24,256,30,38,42,24,23,54,58,64,51,24,22,16,124,46,116,26,45,19,11,68,57,40,101,30,49,64,55,40,20,61,65,52,46,57,18,234,274,53,10,46,98,155,41,45,33,48,32,15,17,79,26,72,32,22,59,64,20,39,68,23,48,39,69,71,51,110,38,66,17,50,34,116,7,46,18,42,24,29,62,27,15,24,37,36,113,28,335,16,220,27,34,21,29,39,20,47,29,30,20,102,10,27,21,32,44,42,29,39,73,24,43,48,45,123,45,34,40,48,42,48,41,36,39,31,19,43,82,137,45,82,12,38,56,47,63,13,86,18,58,15,41,35,16,23,34,59,24,16,41,46,22,36,11,61,58,8,22,32,27,24,53,17,23,28,26,21,15,28,2,21,49,44,20,25,38,23,38,54,24,42,55,23,13,78,83,102,19,31,29,73,114,29,27,53,21,7,40,50,32,299,12,47,7,74,30,29,41,16,63,55,37,25,26,38,34,32,19,104,38,43,46,102,26,82,250,24,21,35,23,28,24,27,20,21,65,25,1,8,41,28,20,152,21,14,26,20,29,38,31,19,36,22,3,55,45,26,9,59,74,38,49,39,40,7,124,3,27,29,27,2,1,17,0,29,5,1
report,22,69,30,665,19,22,26,100,14,9,35,27,27,96,13,4,17,26,15,6,18,71,10,59,48,59,20,31,3,55,25,588,272,21,121,55,60,14,18,18,10,14,22,21,86,27,59,45,674,32,58,5,29,57,25,6,118,1,26,87,52,8,11,73,52,11,115,13,14,38,31,22,13,10,77,36,29,13,176,49,248,4,36,10,405,58,43,2,212,17,39,8,4,87,114,39,43,29,83,28,60,71,67,15,22,102,34,9,65,21,46,12,35,34,1,59,33,11,185,236,78,28,14,376,24,2,10,2,8,5,20,7,5,149,28,199,12,16,7,26,2,78,81,9,5,156,8,39,56,60,76,2,38,21,12,62,70,14,8,11,63,13,16,15,6,7,9,42,71,10,61,150,29,7,3,6,398,6,17,97,50,20,11,41,22,51,94,51,75,114,2,2,21,4,5,7,72,13,38,12,70,16,9,21,43,9,11,128,25,55,188,19,43,21,8,12,16,11,91,14,33,28,20,59,142,203,198,80,15,19,32,66,65,43,69,125,62,18,26,20,120,93,18,10,15,14,19,40,140,6,44,23,42,56,49,31,26,13,13,112,19,55,153,21,14,433,31,16,22,7,295,29,208,8,23,3,33,150,126,61,84,14,5,41,23,10,17,25,9,3,40,14,42,38,27,18,117,32,9,37,43,161,15,19,13,3,35,31,11,18,3,23,103,11,84,153,29,142,25,12,52,14,38,26,54,14,28,50,9,62,12,27,6,11,11,38,25,25,13,45,13,40,25,10,28,22,88,102,30,6,30,14,8,77,42,31,2,13,38,142,49,46,21,25,11,5,63,7,32,21,18,35,8,23,13,200,30,10,18,35,101,4,111,41,6,143,15,41,68,7,32,13,59,33,103,13,213,72,92,49,53,6,11,3,17,5,13,3,47,27,2,34,23,64,6,22,6,15,5,6,2,10,47,20,7,10,13,42,25,39,34,58,38,85,6,8,2,16,36,15,48,59,19,27,4,6,24,12,150,14,28,16,7,7,109,9,1,11,11,63,33,31,75,59,26,17,31,27,28,1,36,3,13,1,10,16,7,40,44,10,7,24,7,3,26,32,45,6,6,24,289,179,4,1,23,27,19,33,14,9,28,14,22,0,30,38,9,31,21,6,19,11,25,12,40,75,13,16,3,7,20,31,12,39,16,14,34,2,37,75,11,6,9,11,24,21,24,11,54,43,15,9,6,7,18,33,36,30,39,24,31,11,8,127,36,22,82,12,14,32,99,18,61,11,34,41,28,25,83,79,22,29,94,6,31,13,19,8,7,82,16,53,14,16,15,8,14,13,13,20,30,64,18,17,75,25,2,20,73,36,61,10,14,6,17,54,9,47,42,31,91,234,90,12,83,34,56,8,12,29,66,8,22,30,17,11,28,50,24,68,19,176,45,31,23,6,19,43,18,57,31,3,23,91,30,523,20,36,9,373,54,10,10,21,11,43,65,10,3,32,25,9,22,22,20,6,7,16,19,20,40,26,77,66,67,9,56,53,19,16,49,74,33,43,84,28,20,8,22,52,17,17,77,53,17,65,16,9,10,36,18,15,34,8,51,42,57,15,11,59,1,81,9,54,38,149,34,13,8,38,27,7,17,146,8,37,15,4,8,29,12,56,17,11,24,39,167,16,92,21,32,21,23,42,31,10,40,28,13,26,15,78,66,139,101,78,20,60,21,78,73,35,28,53,50,38,39,21,61,28,12,6,4,36,14,32,16,19,87,30,32,8,37,11,29,21,13,31,26,60,23,59,31,23,47,39,18,109,32,23,20,7,22,41,9,20,11,16,36,32,22,6,17,19,16,18,32,27,10,33,9,45,25,113,73,4,8,28,21,9,57,27,21,9,13,13,25,46,13,52,34,5,6,22,18,31,17,16,65,30,18,61,12,23,32,18,8,39,11,10,9,3,31,5,5,28,9,20,19,140,50,9,15,23,15,10,5,10,55,6,14,33,32,7,152,18,25,92,15,12,13,42,0,11,6,48,31,23,30,10,13,14,19,40,13,37,11,14,19,78,18,9,19,72,26,29,18,14,15,18,9,14,18,16,16,22,8,8,10,22,31,10,12,34,12,31,23,20,13,68,19,15,97,22,26,45,27,129,257,17,24,9,9,16,32,48,72,24,84,13,40,34,19,27,14,61,98,40,5,13,6,2,8,8,25,7,0,12,58,8,97,14,19,7,23,10,10,4,15,3,14,8,73,3,1,13,2,30,5,1
tonight,18,42,25,125,26,31,5,53,15,5,2,7,46,105,1,6,23,21,40,12,0,19,112,96,15,121,54,67,55,51,3,147,98,52,44,229,37,2,7,16,7,48,6,30,44,7,58,11,102,227,42,21,19,110,76,5,11,26,1,24,1,6,3,14,34,19,111,12,17,6,59,1,11,5,125,17,68,2,62,40,23,10,5,21,52,7,2,7,20,1,22,10,27,39,9,19,12,2,51,2,1,17,3,24,13,52,5,17,19,11,27,3,44,44,75,32,2,1,34,40,17,111,29,179,38,11,4,2,10,11,53,8,23,42,45,132,2,13,12,19,13,44,21,3,10,91,17,32,6,3,17,20,16,7,5,21,82,22,1,117,13,5,17,8,21,64,11,20,30,8,21,143,21,17,23,2,10,6,8,96,30,3,34,34,3,35,20,10,7,49,7,7,4,14,10,9,25,7,12,3,32,5,13,5,0,22,3,11,16,9,83,34,29,23,29,69,21,28,16,3,2,17,0,9,16,28,13,16,15,7,8,13,21,11,28,7,12,7,1,12,30,22,13,8,12,4,14,53,21,16,9,9,47,0,0,20,0,9,0,8,7,48,3,3,3,8,18,70,29,1,23,10,0,7,2,17,30,3,0,1,110,1,7,14,17,9,32,24,14,12,0,13,14,21,6,2,14,17,9,6,24,9,0,7,2,14,11,8,12,7,4,10,45,13,29,9,13,3,6,2,17,5,38,32,53,0,18,99,2,17,26,9,3,0,4,3,38,1,1,1,3,38,58,2,1,10,1,23,9,68,1,14,1,34,3,3,6,0,3,31,10,8,12,5,2,37,12,10,29,85,7,83,4,60,5,19,2,0,24,1,15,6,12,6,46,16,14,16,12,8,10,15,32,18,2,18,3,3,9,3,18,24,7,29,1,3,3,1,9,12,6,3,8,7,1,21,14,10,9,25,1,4,24,0,10,2,0,2,1,9,3,1,0,14,42,29,8,14,18,5,11,6,0,8,3,3,63,18,2,10,45,0,30,19,20,2,19,3,5,1,29,25,10,42,10,5,67,12,1,8,62,13,1,11,13,13,9,6,8,11,5,6,1,6,6,6,2,20,1,0,42,6,12,19,19,1,0,1,3,1,2,5,3,12,10,9,3,1,6,0,1,0,2,0,4,0,4,1,0,14,1,0,0,5,0,1,14,0,4,5,4,5,10,1,6,7,0,11,16,2,2,1,6,7,8,2,3,3,1,2,8,1,0,10,5,1,5,0,7,0,0,1,0,1,4,2,8,4,2,15,7,0,0,4,2,0,0,0,2,19,2,9,7,26,1,1,2,1,0,12,9,6,28,8,9,0,5,13,1,1,4,0,2,0,0,2,4,6,0,1,14,5,4,1,4,0,0,4,0,0,0,0,1,20,3,1,0,0,6,6,4,6,5,6,0,2,2,0,12,1,10,14,1,6,1,8,3,4,6,33,3,5,0,1,3,20,2,12,1,2,3,3,0,2,1,0,0,1,1,0,0,0,6,1,2,0,0,0,1,0,4,11,2,0,5,0,5,4,4,4,1,41,1,1,0,10,4,2,5,0,3,0,0,0,3,12,10,9,3,0,4,0,0,5,3,7,35,0,5,1,5,3,1,10,7,2,1,11,2,6,3,0,5,2,0,1,2,0,1,1,1,0,2,2,0,2,7,3,5,2,7,0,1,2,7,11,0,2,0,2,0,7,1,6,15,17,14,0,0,1,14,10,7,4,0,3,7,0,0,0,0,0,3,1,7,2,0,4,1,5,9,2,0,0,0,2,0,3,0,0,0,2,0,0,19,2,8,4,7,2,1,2,0,1,0,2,5,21,0,0,0,2,1,0,0,1,21,4,4,0,5,3,1,11,5,1,1,11,1,4,0,0,0,7,1,0,1,6,1,10,14,5,3,0,6,5,0,4,0,4,0,5,4,3,0,0,0,0,9,4,0,1,0,1,4,0,0,0,5,0,0,0,4,0,0,0,1,0,10,1,27,3,22,0,0,2,0,21,13,34,1,0,13,1,2,0,2,0,0,2,3,3,2,0,1,2,3,0,6,0,0,0,0,0,2,0,1,0,0,1,1,8,1,2,0,0,0,0,1,0,0,15,0,0,6,2,6,2,4,0,5,17,3,1,0,0,3,1,2,0,0,0,0,0,15,0,0,0,5,1,4,2,20,18,0,0,16,0,7,0,0,1,0,1,7,0,0,29,0,19,3,4,0,13,11,13,9,0,15,22
progress,13,32,11,203,18,25,21,71,7,10,41,15,35,179,13,32,18,21,16,13,11,51,46,39,31,21,35,43,15,40,14,426,207,23,97,145,81,9,20,12,14,51,9,23,53,18,26,29,396,94,53,25,58,127,22,10,52,87,24,1,21,13,14,22,55,17,194,18,14,22,18,10,11,7,155,34,48,12,122,43,79,3,38,25,258,23,19,4,72,2,14,14,12,54,57,18,43,10,96,48,43,64,61,23,40,31,7,21,35,12,36,7,24,27,14,75,5,6,75,131,92,52,12,197,29,16,13,7,3,4,46,12,28,79,34,150,7,17,14,32,7,65,50,13,12,125,14,39,25,15,89,6,18,21,20,35,55,21,15,59,12,11,12,10,17,17,7,49,41,19,44,133,31,11,20,5,205,10,21,90,51,27,40,37,19,34,56,26,56,78,4,16,18,11,8,3,28,16,28,27,37,4,9,15,47,22,9,43,15,45,108,32,39,12,7,19,10,8,18,7,12,32,18,35,53,99,71,48,10,14,21,25,25,40,42,30,62,20,25,10,92,69,7,10,34,6,19,50,58,12,17,27,51,12,16,19,16,6,6,38,5,58,26,3,13,50,32,30,32,14,179,16,31,12,9,18,33,17,17,8,124,11,9,20,18,10,13,24,21,5,11,10,7,14,11,20,54,10,17,37,36,43,11,7,17,8,88,7,23,11,4,14,54,36,46,23,29,76,19,12,71,17,45,27,94,4,29,57,7,32,8,15,12,3,13,17,39,14,9,22,17,19,35,13,18,12,45,65,22,15,17,15,10,46,21,11,8,13,31,53,22,25,31,20,30,13,36,12,26,41,6,55,13,40,17,34,10,6,40,11,86,7,68,23,18,57,13,28,25,8,25,31,9,17,46,18,55,11,40,26,46,16,10,10,9,22,12,13,39,38,10,32,7,24,16,28,17,20,8,28,8,23,32,17,11,8,19,21,25,29,9,6,5,22,16,12,8,55,35,8,26,35,9,44,6,12,43,21,74,13,36,8,37,11,94,13,11,10,13,37,25,53,57,47,14,12,51,26,14,4,40,14,7,8,9,21,10,17,27,14,10,37,11,5,23,11,16,16,13,6,116,58,9,10,22,16,21,20,12,14,15,9,10,7,11,12,20,20,15,13,9,9,23,12,19,22,20,18,3,15,41,19,9,24,13,2,30,3,16,31,16,16,11,8,19,17,15,14,52,15,8,8,7,14,14,26,12,33,16,8,43,4,6,76,13,6,48,4,10,12,22,10,21,5,21,23,17,6,50,49,17,11,21,2,22,8,5,5,10,26,14,20,17,30,12,15,14,11,5,22,33,35,11,9,46,19,17,12,49,28,27,6,5,5,11,21,9,29,18,7,41,43,22,19,31,11,27,7,9,10,32,2,5,21,4,7,12,14,16,41,16,36,22,34,17,2,15,15,12,18,14,14,6,31,23,48,7,13,2,226,44,11,13,6,5,31,60,29,11,22,5,18,19,24,10,11,11,18,18,18,28,11,29,18,40,6,4,17,10,11,31,50,18,14,14,6,12,9,4,16,24,39,18,26,12,37,16,4,10,17,10,7,11,12,11,16,42,15,3,6,9,14,8,41,18,32,25,9,17,16,6,9,9,27,3,14,11,10,9,28,5,22,9,9,6,7,38,18,59,41,19,9,14,14,15,10,11,33,17,9,20,3,4,14,7,24,12,13,8,22,19,24,2,9,48,14,18,9,25,26,26,10,7,20,10,21,15,9,49,13,17,6,24,10,18,15,4,8,12,19,5,12,8,9,21,18,6,7,21,6,6,7,14,8,11,12,20,16,17,8,8,13,9,11,9,8,8,16,5,17,13,8,18,17,32,11,12,7,7,3,8,11,20,6,18,21,15,48,13,13,17,9,9,17,10,23,13,30,6,14,18,37,7,8,4,9,13,5,6,4,12,6,6,12,4,12,12,9,15,15,8,9,9,5,10,10,8,11,16,19,6,11,5,8,26,16,13,11,3,16,11,23,4,8,4,15,12,13,15,16,11,5,17,16,23,5,8,7,3,26,15,3,13,12,13,8,10,11,17,4,12,12,7,14,16,13,14,14,13,3,11,5,7,10,7,6,15,7,9,42,13,11,9,8,8,10,9,20,18,9,11,7,19,7,9,3,15,15,15,11,6,18,10,5,8,24,14,4,1,10,11,4,14,20,15,10,6,3,25,8,9,9,6,4,5,5,13,11,27,6,9,16,17,4,7,5,7,8,14,9
relation,10,46,19,196,21,5,13,44,8,6,77,16,8,156,4,2,11,18,7,5,7,64,2,41,28,16,13,15,9,12,20,243,217,15,69,78,96,8,6,9,9,8,21,5,50,31,34,37,656,36,66,7,22,74,6,14,91,52,1,21,1,26,7,16,54,3,126,2,22,16,6,3,3,4,92,14,13,13,99,23,64,2,33,13,450,13,15,0,79,0,8,21,2,78,109,6,35,10,120,24,12,41,49,19,23,40,12,2,16,5,22,16,7,22,2,50,9,3,133,215,59,24,9,78,8,4,10,11,7,1,15,2,5,81,49,34,18,1,5,9,4,68,59,3,3,91,5,37,17,18,130,0,18,10,5,27,21,5,24,12,10,6,4,6,4,4,2,18,32,22,17,124,22,1,1,22,269,2,10,33,31,26,5,21,10,38,46,38,104,137,6,2,8,2,0,5,16,8,9,15,17,3,1,35,52,20,6,30,11,65,108,2,34,4,2,1,0,1,14,5,6,37,12,13,70,103,34,30,7,5,37,26,19,29,31,19,42,12,11,15,93,60,8,3,30,8,14,19,49,12,19,31,38,7,12,16,32,8,14,16,11,38,45,6,11,66,10,11,26,13,217,9,30,7,6,2,31,17,46,6,69,16,3,40,21,4,4,3,36,2,13,13,12,3,6,16,84,16,8,47,52,50,0,0,33,2,55,3,10,2,2,24,28,11,36,28,20,62,28,9,83,16,44,15,156,17,8,22,4,44,3,11,20,8,12,19,32,22,7,14,24,32,21,31,14,10,119,101,15,19,19,14,8,35,47,17,10,8,10,30,29,17,20,27,11,2,57,9,11,21,5,17,8,9,8,24,11,5,26,9,86,6,65,29,5,53,4,52,35,4,39,7,22,36,74,21,114,5,41,18,52,3,7,2,13,9,6,39,64,33,18,22,16,26,55,17,16,16,3,4,12,19,25,21,1,10,8,22,20,28,10,7,7,31,4,14,6,44,17,6,16,41,10,43,11,5,9,10,53,7,26,16,1,8,101,21,1,17,8,46,20,20,57,27,10,2,18,29,17,0,17,1,2,1,6,15,13,34,36,5,7,17,23,23,17,8,16,6,8,5,127,66,3,14,13,16,13,22,20,17,17,4,3,0,19,13,9,22,7,4,10,3,9,7,18,36,6,16,3,11,13,26,16,44,23,9,23,3,25,36,19,8,1,12,16,13,12,13,57,19,3,6,3,3,12,8,5,30,47,11,44,9,10,78,11,17,81,4,10,16,59,5,33,7,22,26,23,16,51,39,9,24,29,6,11,8,23,11,13,22,13,25,13,37,13,6,12,20,4,15,50,73,8,2,54,6,1,4,140,36,38,6,8,11,29,39,8,43,8,11,33,25,28,14,52,21,26,1,12,10,23,1,6,22,3,22,17,14,19,53,11,42,33,41,15,8,17,6,7,11,9,4,11,35,25,46,5,9,6,434,53,6,5,10,9,24,63,49,4,26,9,17,44,60,19,13,8,19,24,22,25,15,104,29,57,22,12,18,19,15,14,32,34,21,21,14,42,12,11,34,18,22,32,46,12,8,23,10,15,28,47,16,15,10,19,13,29,11,6,2,11,17,12,55,35,25,9,13,11,5,16,9,13,38,4,8,8,1,6,16,17,13,4,11,18,8,36,11,82,10,15,14,4,12,20,5,14,13,7,5,8,5,2,23,12,26,21,29,10,10,9,17,11,3,32,17,15,9,9,27,5,10,1,18,13,23,6,13,54,12,27,8,16,2,11,21,9,29,7,22,16,17,12,10,18,25,10,19,13,2,9,20,37,6,7,2,15,11,25,13,24,15,34,8,11,18,15,11,5,25,20,9,8,12,10,7,6,13,3,2,11,12,15,3,13,14,22,40,40,18,19,14,3,12,5,7,14,13,19,17,78,30,10,12,11,13,13,6,13,6,20,11,10,10,10,19,6,5,25,23,10,8,4,5,9,8,17,48,29,29,15,2,6,23,25,15,20,18,18,11,14,16,0,13,22,36,8,3,9,0,9,12,1,39,15,8,6,16,16,43,19,10,13,8,15,11,1,16,4,5,19,31,2,10,25,10,31,73,24,6,13,6,14,18,7,0,8,7,11,18,4,19,3,9,7,24,8,6,45,5,2,5,3,14,4,6,6,16,21,16,5,12,12,9,2,46,16,5,6,18,3,11,26,12,20,32,0,10,12,22,19,8,5,5,13,5,14,9,93,7,5,6,5,1,0,5,0,8,6,3
other nation,4,11,3,54,4,8,4,20,1,4,6,11,5,126,4,5,9,13,7,4,2,23,8,14,18,19,17,13,6,11,12,103,94,14,46,100,80,0,7,9,9,18,8,4,28,26,6,12,216,39,45,11,14,95,6,19,38,8,6,13,26,1,5,15,17,6,71,3,4,9,3,3,3,3,92,13,18,6,48,25,30,1,12,6,157,9,8,1,15,1,5,10,2,22,55,4,14,3,38,8,3,14,20,14,9,18,4,2,11,1,18,2,4,4,2,27,2,2,68,115,32,25,3,38,4,3,6,3,2,1,7,3,3,30,28,43,9,2,2,7,3,34,27,3,4,50,3,12,11,3,38,3,8,10,6,5,16,9,23,35,3,4,8,0,4,7,3,26,15,8,15,74,17,1,6,13,118,3,6,33,11,10,10,14,0,26,17,21,31,35,1,4,5,2,4,3,2,9,8,22,12,1,0,6,31,11,7,12,11,29,57,3,15,13,3,7,2,1,8,1,5,18,2,12,38,48,15,29,4,4,12,6,12,11,23,12,18,16,6,8,47,20,3,6,25,5,3,26,35,3,9,13,18,4,4,16,10,5,3,7,0,33,15,2,2,6,2,10,16,8,126,2,9,6,3,4,16,6,3,0,39,9,1,12,6,0,4,3,9,4,1,10,2,7,2,11,22,2,11,22,27,17,1,3,12,4,42,1,1,2,7,11,25,15,12,8,9,21,5,4,45,3,39,1,86,3,4,23,6,18,4,10,10,2,5,6,27,10,1,4,17,16,18,11,4,6,22,41,8,4,14,2,2,29,13,4,6,4,12,19,10,5,16,14,0,3,28,14,5,27,3,20,0,13,4,4,6,2,18,5,56,2,28,13,3,12,5,15,15,0,34,8,5,9,15,25,49,1,13,3,22,8,4,8,9,4,5,7,47,19,6,1,9,12,19,19,14,4,9,12,3,8,20,14,5,7,6,13,12,11,2,2,1,9,13,4,7,9,15,5,28,21,8,22,6,6,20,10,34,6,19,9,14,1,55,9,5,10,9,16,14,25,22,21,0,3,19,15,5,5,11,8,3,4,9,12,13,7,23,7,3,10,7,8,10,3,8,11,8,4,82,27,2,12,15,7,3,8,6,7,12,7,10,3,6,2,1,12,3,1,3,7,3,3,18,13,7,11,0,12,3,5,6,19,4,2,20,0,5,27,14,6,8,3,5,10,7,11,25,5,5,12,3,0,8,3,8,17,21,0,2,6,2,30,4,4,39,2,1,3,14,0,4,2,11,13,7,1,15,32,5,5,6,4,6,0,5,4,6,5,4,5,23,21,10,5,5,5,7,10,16,33,8,2,6,0,4,3,49,24,19,0,7,2,8,17,5,5,7,2,17,5,1,15,24,4,13,3,5,5,9,2,3,6,0,5,18,9,12,19,13,9,24,24,2,8,7,5,3,7,7,3,5,6,7,5,1,5,4,156,15,6,3,4,5,25,25,24,10,14,3,5,3,29,4,4,6,3,10,4,18,8,23,19,22,12,0,6,3,4,3,17,19,8,10,6,16,3,5,8,13,14,4,26,2,2,9,9,7,6,8,7,2,7,2,5,19,7,0,1,4,3,5,15,9,7,5,8,10,5,6,3,3,13,4,4,5,2,1,10,7,12,2,3,1,0,24,5,15,7,8,6,4,22,30,4,13,12,5,10,9,0,0,2,0,13,10,13,4,11,9,9,2,2,23,7,6,5,2,6,9,9,4,6,6,9,4,0,0,4,1,2,8,0,4,10,2,7,3,4,4,0,0,3,1,20,0,6,9,0,3,1,13,1,4,6,11,7,12,2,3,11,11,7,7,6,4,9,3,10,4,0,15,0,0,3,8,4,2,4,4,1,8,10,4,4,10,10,15,1,2,1,0,1,12,9,5,16,4,10,27,14,7,5,1,2,5,0,2,2,2,7,2,20,8,9,0,3,19,3,0,1,7,4,3,3,0,13,8,1,0,0,2,1,2,2,7,2,6,4,3,0,1,2,14,1,2,0,0,10,4,2,5,15,3,0,16,6,3,28,6,2,3,1,9,2,3,10,3,1,4,13,2,4,8,2,5,12,8,0,5,3,9,5,2,0,2,6,1,5,3,17,1,2,2,9,12,4,8,8,0,7,1,3,0,2,0,15,1,2,0,0,0,0,1,32,0,0,0,17,4,5,7,9,6,16,2,2,5,5,3,4,0,19,3,0,12,5,24,7,2,5,8,3,0,1,1,0,7,7
foundation,0,4,4,41,7,6,1,15,3,0,8,2,13,26,1,13,2,4,8,1,3,15,3,11,8,5,6,12,1,2,3,50,38,1,17,25,28,3,7,5,3,10,6,4,21,4,15,5,63,20,9,3,14,21,4,0,11,11,3,14,7,5,1,39,5,5,55,3,0,0,4,0,6,2,58,6,13,1,22,5,15,1,3,1,67,3,6,0,15,1,2,5,1,7,14,3,6,2,20,8,7,14,7,4,8,6,4,2,3,3,9,2,7,11,2,6,1,1,13,41,12,6,2,28,2,3,3,2,2,0,9,3,9,24,6,19,2,2,1,10,1,10,7,2,1,20,1,2,3,6,21,1,5,7,2,10,14,7,3,12,2,4,3,6,6,3,2,6,7,6,5,22,7,6,0,2,44,3,4,11,4,8,7,6,2,9,8,8,5,8,2,2,3,1,2,1,8,4,3,10,6,0,2,5,9,5,2,14,2,8,27,3,7,3,0,2,0,7,6,1,1,13,1,1,7,27,6,8,2,5,5,7,4,4,11,5,8,7,3,2,24,17,1,2,8,3,0,6,19,1,4,13,7,1,1,6,5,2,1,4,2,5,8,0,4,7,23,3,8,5,58,2,4,3,0,5,4,2,2,4,28,1,2,4,4,3,4,7,5,0,1,0,5,2,0,2,4,2,1,4,8,7,0,1,6,3,13,0,4,0,3,13,12,9,9,5,10,16,4,1,6,0,9,10,22,0,3,9,1,7,0,2,3,0,6,6,9,3,3,8,6,3,3,2,1,1,8,17,2,4,6,5,0,7,11,1,3,0,4,6,9,4,5,3,2,0,13,6,3,4,1,11,5,7,1,7,6,2,3,4,17,1,20,3,1,25,3,5,6,5,12,5,3,2,14,17,10,4,15,3,8,0,1,1,3,3,1,4,5,9,1,1,1,2,0,3,0,5,0,2,0,3,8,2,1,2,0,5,1,6,2,1,0,3,0,2,0,4,4,1,6,4,0,9,1,4,22,2,9,1,14,0,4,1,22,5,1,1,5,6,5,9,12,5,4,3,9,5,2,0,9,1,2,5,6,8,1,3,1,3,0,13,1,0,1,2,3,5,0,0,26,12,0,1,2,1,0,2,7,1,5,1,1,0,1,1,1,3,0,1,3,2,0,0,2,9,3,7,1,4,1,6,2,6,3,1,5,2,5,6,1,4,1,4,3,6,5,3,12,2,4,1,1,5,4,2,2,5,2,1,14,0,0,12,3,3,10,0,0,3,6,2,10,2,7,3,7,2,12,12,5,2,1,1,4,2,0,6,2,7,2,2,3,9,8,2,2,3,0,3,13,22,2,1,9,3,3,4,5,7,4,2,5,0,3,3,2,3,4,0,7,4,2,5,4,1,5,0,3,2,8,0,0,2,3,4,1,5,5,17,0,5,13,7,2,2,3,4,1,3,6,3,5,7,3,13,2,3,2,25,1,8,2,0,5,1,15,4,0,3,1,0,5,5,2,1,1,1,3,0,5,1,2,8,6,1,4,1,0,2,3,7,3,2,7,2,6,0,3,1,7,6,5,6,1,3,4,0,1,3,3,1,0,4,1,1,5,1,2,2,1,1,0,11,5,4,5,2,2,3,1,3,2,12,2,1,2,0,2,5,4,7,3,1,1,0,2,3,10,4,2,3,3,2,2,4,5,9,3,4,4,0,1,0,0,10,0,6,1,2,2,3,1,0,8,5,2,2,4,5,2,1,2,0,3,9,9,3,5,3,0,1,3,4,4,2,1,1,3,0,3,2,2,2,1,5,0,2,2,0,7,4,2,4,0,0,7,2,8,0,0,1,1,2,2,0,0,2,0,1,0,1,2,3,2,2,0,6,1,2,2,1,9,0,2,4,2,8,3,1,0,1,3,4,1,4,1,2,1,1,3,3,0,0,1,1,3,6,3,3,0,0,5,3,3,4,3,0,5,2,1,4,0,3,0,5,1,3,4,1,0,3,0,0,4,2,3,2,1,2,0,1,3,2,2,3,1,0,0,4,0,1,0,4,6,1,0,3,0,3,1,1,4,1,1,0,0,0,2,2,2,0,4,3,0,0,0,3,0,0,3,2,3,2,2,0,1,1,0,5,1,1,2,0,3,2,4,2,6,2,1,2,2,3,0,0,0,2,0,1,8,0,1,0,0,2,3,0,0,1,2,2,3,5,0,1,0,1,1,0,0,5,1,0,2,3,5,1,1,1,4,2,3,0,2,1,1,2,8,4
lay,21,25,17,231,24,14,10,50,13,3,20,15,24,99,6,9,19,20,9,9,5,54,26,40,21,22,19,35,15,32,12,190,141,20,62,85,50,6,13,10,13,7,9,7,51,17,34,13,322,45,56,5,17,71,13,6,118,73,14,22,16,15,39,1,24,5,90,12,17,36,15,5,6,10,91,15,27,14,104,29,59,1,45,7,216,35,15,2,46,5,15,7,0,44,42,30,15,6,44,28,15,46,64,22,16,38,9,4,25,7,23,9,12,21,12,32,8,5,75,131,54,41,29,92,9,13,5,2,4,6,22,8,7,61,25,96,4,4,10,14,5,53,28,5,7,89,9,19,18,15,67,6,23,15,3,13,41,13,5,27,23,11,17,3,1,13,7,20,20,8,28,124,28,6,11,5,179,6,14,56,20,16,10,29,11,25,36,34,45,112,6,13,8,2,4,10,34,9,9,5,33,0,2,10,33,13,11,37,26,32,96,18,27,30,10,12,6,5,21,7,6,12,7,20,52,73,28,24,7,3,16,19,35,44,46,74,37,10,5,9,64,43,16,5,9,6,10,33,54,13,10,50,28,13,13,13,5,5,2,19,5,30,21,6,9,32,10,15,18,8,189,10,28,15,5,3,18,23,16,10,65,3,1,17,8,3,12,20,19,3,10,22,14,7,4,8,53,15,14,25,36,29,1,2,13,8,34,7,10,8,6,11,35,15,25,15,27,59,14,5,41,7,26,11,66,3,16,44,5,37,13,5,7,5,10,23,26,13,2,13,10,17,23,8,7,11,39,55,13,11,16,19,2,30,23,2,2,2,20,27,23,10,17,16,12,4,53,18,17,27,3,57,4,23,7,16,6,12,20,7,97,4,81,13,12,56,4,27,23,5,25,10,17,53,55,18,106,6,38,6,29,9,2,5,4,4,9,7,28,16,2,7,5,17,9,18,17,15,6,10,4,9,23,16,4,6,7,15,21,26,2,10,6,15,6,12,3,35,16,6,22,30,11,27,1,8,43,8,44,9,19,8,17,0,78,12,8,8,9,43,14,32,40,34,6,10,32,22,13,1,39,5,3,3,2,18,3,21,20,6,12,19,15,5,10,10,13,9,10,0,89,32,1,7,13,4,4,15,7,8,14,4,7,4,25,8,6,20,12,3,13,4,19,9,22,15,12,9,2,13,7,10,10,22,11,7,23,2,19,27,8,12,5,15,13,8,15,10,36,23,9,4,6,12,10,16,3,27,18,10,30,7,8,60,11,13,50,9,9,6,38,3,34,7,13,19,14,5,47,37,17,9,17,0,6,7,14,8,5,19,22,27,22,17,13,3,3,5,4,12,29,42,12,8,42,5,9,6,107,25,34,6,5,10,11,32,8,32,14,18,18,26,26,5,22,6,30,17,6,7,13,2,6,14,3,16,40,10,10,44,4,34,31,15,4,3,7,8,5,15,9,3,13,11,10,55,5,4,5,225,23,13,7,3,11,19,44,11,3,18,1,8,20,38,21,20,11,7,15,13,17,16,22,20,34,8,6,19,13,5,30,36,14,16,23,15,8,4,7,21,18,19,31,10,9,39,14,5,36,21,13,10,4,8,7,16,16,10,6,7,1,20,7,42,14,11,13,7,20,14,10,11,3,20,5,7,8,3,5,17,5,36,14,5,4,3,36,2,31,3,14,9,17,29,20,5,19,12,2,5,5,12,4,13,4,19,11,12,6,20,20,22,3,6,14,12,25,9,28,16,14,8,3,11,5,16,0,9,11,14,9,7,11,5,16,16,15,4,2,13,10,11,5,12,12,11,1,22,11,6,9,11,14,20,12,5,4,4,18,6,16,7,2,27,7,5,9,15,8,9,4,3,33,22,17,6,3,12,7,11,15,7,9,3,6,4,8,23,17,21,13,14,4,10,6,10,3,18,2,9,16,19,3,11,8,5,10,13,6,5,10,13,8,8,8,10,3,5,10,19,5,4,2,4,5,7,7,42,15,6,10,2,5,6,26,9,11,8,4,12,8,23,6,9,8,9,6,7,14,10,6,11,6,14,4,5,11,15,4,30,7,1,8,12,10,2,3,26,5,4,10,12,5,45,0,21,13,33,9,3,9,13,10,11,4,0,9,8,7,9,3,17,9,8,6,20,13,25,42,7,6,13,5,5,6,7,5,3,17,9,5,15,6,8,3,39,4,1,3,2,4,7,6,10,11,4,5,10,32,6,1,10,8,1,10,8,9,12,20,2,1,6,8,2,3,6,5,9,5,6
change,13,50,32,275,20,30,10,59,6,13,21,21,31,140,7,31,18,28,24,10,12,94,66,62,32,38,43,57,23,42,16,421,241,23,110,178,77,14,37,7,20,35,10,20,68,20,65,49,400,121,90,17,34,178,50,5,114,52,34,55,54,17,5,24,1,33,222,15,19,20,51,5,13,12,254,34,72,18,213,76,115,5,37,17,343,35,31,8,72,7,19,16,18,68,83,36,44,15,86,27,17,48,52,39,33,55,24,21,33,18,39,20,46,40,50,78,5,9,110,295,74,60,58,244,52,13,11,14,11,5,55,13,27,91,44,167,8,13,14,36,15,124,62,16,12,178,35,40,27,25,101,10,33,16,20,60,95,34,18,61,47,8,27,11,23,53,16,55,56,20,35,173,75,15,24,9,245,7,18,153,46,26,21,36,10,52,71,57,83,67,14,22,12,16,12,19,71,27,24,26,113,7,17,19,36,24,16,137,26,54,131,31,54,23,28,69,21,13,41,11,11,31,17,30,90,185,72,59,10,24,25,37,58,41,64,82,69,22,36,12,135,67,19,17,44,9,28,69,83,21,29,44,52,8,11,49,27,15,8,36,16,53,23,5,13,88,24,37,23,10,201,16,48,10,2,5,33,37,18,9,108,34,7,38,32,6,31,42,21,20,4,6,20,18,5,22,57,19,12,36,55,64,6,12,49,11,30,15,15,12,1,34,90,14,69,31,30,85,27,18,73,17,82,24,97,6,32,103,13,42,17,33,9,9,17,16,43,17,8,31,20,25,53,22,22,13,94,77,30,41,24,31,7,64,37,11,13,9,45,63,37,31,37,27,19,21,37,14,47,83,13,54,19,31,22,59,16,17,29,10,113,7,78,19,17,77,6,40,63,11,25,19,30,19,73,27,100,19,48,11,35,17,14,12,12,10,27,4,45,35,6,12,21,33,16,28,13,22,4,7,4,18,60,35,9,7,8,27,19,19,24,5,3,15,18,10,11,11,31,10,32,30,13,47,11,9,36,13,119,16,45,10,22,18,65,45,7,12,17,65,33,53,62,61,14,6,64,25,10,10,48,13,9,11,14,16,6,27,60,18,28,24,5,17,11,18,28,20,11,10,102,81,6,23,48,8,15,11,8,19,32,11,10,21,28,44,25,34,12,8,11,16,11,12,42,39,10,21,11,17,11,23,10,37,18,6,44,15,13,47,32,22,10,25,31,12,19,22,82,49,8,3,6,16,22,15,20,23,16,10,80,4,11,91,15,15,36,13,3,9,47,7,36,2,25,35,28,29,56,61,33,24,16,8,17,16,74,18,28,34,17,30,25,41,32,15,19,14,9,25,43,49,35,19,43,17,17,16,41,46,42,12,19,4,16,40,18,39,43,18,60,71,28,14,32,15,27,10,22,4,26,18,7,48,6,20,11,31,27,46,30,35,59,51,13,8,29,22,10,10,24,8,12,34,12,38,12,10,12,200,28,9,15,20,15,26,59,39,14,23,10,9,11,21,6,3,2,12,15,21,35,26,41,64,34,14,6,25,4,8,15,44,26,10,14,12,18,10,7,7,11,49,28,11,12,16,38,7,30,19,31,7,19,12,21,20,27,16,13,4,13,11,19,38,18,43,14,7,12,29,16,10,12,31,3,17,12,8,6,34,15,22,13,20,4,8,32,14,39,9,35,7,15,15,8,5,25,8,16,8,19,19,12,16,14,22,9,10,8,14,21,30,5,10,35,37,16,13,24,10,17,16,12,25,7,20,12,12,31,25,14,10,19,11,24,12,18,13,14,26,22,14,2,9,10,45,10,8,3,16,10,11,28,12,17,12,19,7,46,10,15,10,7,21,6,9,7,19,4,15,8,13,7,8,12,7,20,11,16,5,14,9,18,3,29,21,15,65,18,13,5,13,13,13,14,13,16,13,18,8,38,43,10,12,8,10,14,9,9,9,2,9,7,7,7,21,30,11,15,39,14,6,16,17,9,10,2,18,24,8,1,6,8,11,16,10,14,21,6,10,18,28,13,6,8,6,8,10,12,18,8,6,5,30,16,9,7,6,12,36,8,13,10,15,16,9,3,10,13,5,9,21,4,13,8,7,12,20,13,14,10,8,13,12,5,2,7,11,4,17,7,19,14,9,17,19,21,28,55,4,6,10,12,13,2,9,4,9,15,8,9,6,8,8,9,10,11,10,18,13,7,7,21,10,7,6,4,10,14,6,6,18,10,16,7,4,12,12,35,12,8,1,4,9,1,20,27,11,9,13
face,2,25,21,73,16,34,1,30,8,3,21,10,18,96,2,11,8,18,21,15,9,23,36,43,13,27,29,43,18,38,11,115,93,20,47,153,42,5,19,12,11,15,3,12,35,20,13,16,117,70,37,20,9,85,27,7,33,11,19,17,3,6,5,5,33,1,109,4,7,19,21,3,5,7,145,29,49,9,69,35,31,9,9,23,130,4,7,7,8,3,16,10,22,22,37,8,22,2,41,5,2,24,13,14,16,27,4,17,9,1,18,4,25,10,21,34,4,7,54,107,19,52,36,96,14,15,7,6,10,5,35,1,13,45,33,80,11,12,8,20,8,38,20,4,3,86,9,20,6,5,23,9,12,9,6,32,62,10,9,38,20,2,13,2,10,22,5,11,24,7,17,75,35,9,15,5,96,7,8,41,28,9,17,20,4,21,29,17,15,39,4,3,2,12,5,4,24,9,11,12,23,1,3,11,13,24,1,29,10,16,64,22,31,9,4,16,23,25,19,2,6,12,4,8,22,73,20,19,2,9,13,15,14,19,21,7,25,7,13,15,40,28,14,11,22,6,4,21,30,3,4,9,30,2,2,15,6,4,0,7,4,32,4,0,10,18,4,23,11,5,67,3,11,2,2,6,22,9,5,1,55,5,10,22,14,5,10,12,20,5,0,6,13,10,3,2,19,8,13,19,29,14,0,8,4,11,11,7,12,5,3,13,54,8,38,8,23,16,6,8,30,3,45,9,49,1,47,49,7,31,12,3,2,3,5,9,18,2,3,9,7,11,21,12,7,10,17,30,4,37,5,11,4,27,33,18,11,4,10,28,24,15,10,18,1,40,17,11,21,29,2,27,1,22,12,23,2,4,23,3,29,1,15,8,12,17,7,24,14,3,21,19,20,10,11,4,9,3,23,2,10,7,7,11,6,2,4,0,7,14,3,6,4,16,14,15,3,21,3,16,4,12,16,8,5,11,6,8,4,8,6,8,4,10,11,1,5,3,13,2,7,9,13,22,5,13,28,16,21,5,37,2,16,8,37,5,8,7,9,13,18,29,21,50,8,5,24,10,6,5,28,7,5,12,8,8,12,15,9,2,7,7,4,17,2,2,8,13,6,6,56,24,12,12,16,2,4,20,10,5,12,1,3,5,8,9,4,2,3,1,3,8,4,7,10,1,12,5,2,17,3,5,10,19,3,8,19,3,13,19,18,4,7,7,17,2,1,16,20,11,8,2,14,11,8,1,6,9,9,6,23,2,3,32,10,3,14,2,5,4,7,7,5,5,4,1,7,7,19,15,14,2,1,2,3,1,6,1,6,9,4,6,11,23,5,2,7,2,5,19,7,12,10,3,22,1,1,2,17,12,8,3,5,1,2,12,2,20,4,4,39,16,3,1,19,1,6,2,8,3,4,1,1,23,1,1,4,7,8,21,1,11,16,16,8,2,16,3,8,5,9,3,9,8,4,5,6,4,5,56,9,9,8,5,2,8,18,13,16,8,5,4,8,12,2,0,2,2,18,4,6,1,11,21,12,7,2,1,1,1,1,11,17,4,6,7,14,15,3,1,10,17,9,3,2,6,16,6,4,1,16,1,0,3,6,8,20,8,1,2,8,2,2,11,16,8,13,3,6,5,5,2,3,11,1,19,2,6,1,9,2,9,9,7,2,5,3,4,14,8,5,2,0,1,6,8,5,4,10,4,24,1,0,3,5,8,3,2,4,11,15,10,1,4,14,12,6,5,4,0,8,6,2,8,2,10,5,0,2,1,0,1,6,0,14,9,2,18,4,3,4,4,1,0,12,15,9,3,2,0,1,3,7,2,18,17,21,8,8,4,4,1,3,4,0,2,5,3,3,7,1,4,7,2,0,3,6,3,3,5,4,3,8,4,4,6,3,15,4,3,0,7,3,7,3,2,7,9,3,7,30,12,14,5,2,2,6,4,1,1,5,5,1,8,5,5,3,2,11,5,1,12,10,6,5,4,0,5,10,3,3,3,3,3,0,2,5,0,5,2,10,5,5,2,4,11,0,3,6,19,5,2,7,0,4,1,0,5,5,8,4,2,6,3,11,2,1,3,4,2,1,6,1,1,5,5,1,1,3,4,1,3,2,5,0,1,2,9,7,5,1,12,1,1,9,8,11,1,4,1,0,4,11,5,1,0,1,4,7,0,1,0,0,0,9,2,0,0,7,0,13,4,12,10,1,6,2,2,4,2,5,6,0,0,8,3,7,7,9,6,6,4,2,4,6,4,3,1,2,7
people,18,304,122,1100,97,113,55,502,37,45,191,112,131,775,68,182,66,214,100,70,55,307,224,321,181,149,196,191,126,160,75,1369,1208,141,505,800,516,79,111,81,104,235,46,50,305,155,235,109,2394,411,413,102,186,574,146,57,470,115,111,194,126,71,55,90,222,109,1,98,73,114,212,16,60,52,1038,173,279,56,704,272,382,36,110,124,2165,269,102,14,212,19,43,64,36,186,444,82,157,51,363,176,42,202,223,118,130,198,61,83,137,57,160,61,138,184,123,229,23,48,402,1275,302,266,248,600,108,72,35,30,28,12,186,73,170,362,250,613,106,42,61,159,65,318,205,33,57,619,94,183,159,92,622,51,133,97,77,208,377,58,152,275,118,58,111,25,55,187,61,192,226,106,157,889,272,40,64,80,1291,66,139,383,212,138,98,195,33,271,324,191,326,302,49,74,104,22,39,40,129,67,77,157,268,52,40,88,205,153,55,291,95,222,747,132,222,86,94,151,51,49,123,24,32,184,63,114,318,775,296,230,75,86,121,114,125,217,344,205,270,118,96,69,568,339,95,92,210,69,66,273,342,84,109,188,229,73,68,177,75,36,29,148,24,202,144,11,74,176,115,107,217,61,1022,64,174,72,31,37,212,90,52,14,676,84,33,178,109,42,162,184,156,68,22,34,161,51,30,68,248,56,58,170,223,179,7,35,108,51,222,40,177,23,29,134,258,71,321,93,238,332,125,70,351,87,299,72,582,34,116,347,52,296,115,87,80,46,95,145,194,43,33,71,102,108,249,122,76,58,351,415,168,105,97,158,70,337,187,25,136,70,144,282,192,72,119,157,56,72,282,96,129,214,32,277,51,179,89,135,54,42,200,74,643,45,303,111,73,273,67,165,271,68,176,75,159,92,238,146,348,31,254,38,148,50,38,50,59,132,61,46,176,156,50,123,51,136,132,72,35,94,50,47,48,60,180,122,37,56,50,92,93,128,108,27,17,77,49,43,24,48,82,42,81,174,63,124,54,65,174,67,275,73,185,59,104,75,444,74,47,99,79,212,144,328,338,236,64,150,260,96,42,37,266,71,33,63,44,225,94,228,139,71,102,148,63,80,86,108,74,46,61,32,487,270,57,91,99,48,62,105,88,106,143,53,48,67,55,205,74,138,40,75,48,62,59,35,122,166,75,123,33,97,63,182,66,244,75,55,168,80,85,216,111,85,45,110,98,67,63,110,411,157,58,20,39,70,101,50,56,159,68,28,696,44,26,342,33,60,134,31,83,74,139,25,127,25,107,135,139,74,281,316,117,46,69,26,76,54,86,48,65,121,53,90,104,189,110,92,57,83,39,136,220,249,87,28,179,67,50,70,191,209,169,29,55,27,32,176,41,213,63,64,217,94,59,104,193,81,145,32,73,28,106,119,25,179,40,42,49,75,133,218,127,126,258,264,70,38,101,53,61,45,142,72,104,160,54,100,50,34,73,1153,376,85,87,60,45,83,360,151,62,111,49,77,115,63,34,37,8,52,71,43,117,61,242,114,100,78,48,29,48,63,34,224,74,41,80,68,131,52,24,36,107,150,74,65,47,54,74,35,111,99,81,31,24,45,88,60,121,72,39,29,107,31,51,220,150,120,67,79,88,60,56,74,45,81,35,62,50,38,34,131,66,99,53,80,34,21,65,49,307,126,67,65,35,25,41,45,114,104,56,56,107,34,8,36,27,73,84,71,33,115,112,129,27,25,162,145,118,62,74,44,97,49,63,112,38,104,72,33,49,93,30,33,82,39,119,37,54,255,82,86,58,93,32,47,61,199,19,46,29,38,34,41,121,36,70,38,112,82,121,33,82,26,24,52,18,30,66,53,24,141,36,22,30,30,12,55,71,68,107,57,69,51,171,75,84,120,77,221,105,43,27,99,41,92,58,51,67,30,47,114,137,185,81,69,23,28,59,37,41,29,29,83,69,36,45,47,44,43,61,59,13,70,70,124,62,74,19,80,145,101,6,27,28,29,28,22,48,37,61,44,54,40,27,26,48,49,20,65,55,88,64,46,51,92,153,12,21,77,25,136,45,49,84,57,125,28,34,19,56,24,62,40,49,70,29,52,34,57,24,76,49,37,50,37,48,36,50,51,66,82,50,141,34,31,86,121,132,57,244,24,16,49,72,42,32,28,30,31,98,47,15,36,36,18,26,27,24,38,113,39,59,64,103,88,30,42,16,64,40,46,38,51,46,109,55,95,77,61,80,31,37,40,39,24,15,61,38,27,40,75
high,0,11,15,65,4,12,4,35,0,2,1,6,17,43,2,9,10,7,13,7,6,32,24,15,26,13,13,19,3,12,1,135,114,11,49,73,23,6,41,7,8,12,1,9,28,11,12,4,131,41,33,12,12,40,23,1,90,13,12,18,2,3,3,12,15,4,98,1,8,8,27,3,4,6,107,11,30,2,58,16,95,19,4,10,128,32,9,13,27,1,9,6,37,20,67,89,26,8,21,19,12,17,20,12,17,21,5,9,22,9,14,1,19,15,20,36,1,8,46,109,54,30,78,121,14,3,5,6,8,7,13,2,12,34,30,46,1,18,5,21,2,24,17,3,4,56,3,23,25,13,50,7,8,3,9,27,33,12,12,23,36,3,8,8,15,16,13,14,21,8,18,73,17,4,8,3,99,3,9,43,22,9,11,20,3,38,37,22,23,24,2,0,6,6,1,3,21,4,10,22,25,7,8,5,27,8,5,47,6,20,65,8,21,31,12,13,12,16,12,5,1,19,5,18,44,57,30,23,6,17,16,21,26,23,23,54,24,16,23,6,42,33,3,2,8,6,8,48,22,10,3,35,15,5,3,16,6,17,2,25,18,8,7,2,6,10,11,13,4,5,62,10,33,1,2,6,15,11,3,3,57,2,13,10,16,2,10,13,6,5,1,3,15,9,8,11,17,3,2,22,19,17,4,7,9,4,13,7,8,21,2,14,24,10,62,16,19,30,9,5,23,9,44,7,42,2,8,30,1,25,6,17,10,2,8,11,14,4,3,6,6,10,12,8,1,3,24,29,8,12,7,11,3,22,15,1,10,4,8,36,17,9,8,14,3,4,14,13,10,16,1,21,8,16,7,32,13,6,17,6,40,1,28,9,2,15,3,19,13,5,11,6,10,5,16,5,23,2,14,10,7,8,4,3,2,8,5,3,8,8,3,3,12,10,3,3,2,5,4,3,12,4,9,5,5,6,3,10,7,10,5,8,0,4,7,3,0,1,12,2,7,21,5,2,1,1,13,10,21,4,16,4,12,7,46,11,3,7,8,14,14,56,23,30,11,12,20,9,4,0,22,1,4,3,6,34,4,13,28,18,9,13,0,1,8,8,11,6,4,5,58,31,4,4,10,6,5,10,10,16,13,13,6,4,7,14,17,11,14,3,15,1,4,2,11,7,1,9,3,9,6,11,6,12,5,4,8,3,7,18,6,9,4,12,9,2,5,3,18,12,0,0,2,19,16,1,3,20,3,4,29,2,7,26,5,14,7,6,4,2,9,1,9,5,10,5,8,3,23,24,14,7,2,6,6,2,16,6,7,8,18,4,14,19,5,5,1,8,4,15,15,23,11,4,25,0,37,20,6,8,12,11,4,1,1,8,0,7,6,10,22,21,6,14,12,2,8,7,7,3,4,2,2,15,5,9,1,5,10,12,3,12,32,10,3,6,7,11,4,5,14,8,14,6,2,12,12,0,7,60,14,5,6,0,4,5,16,15,6,7,8,4,4,7,0,1,0,1,2,8,10,10,4,20,10,4,3,6,2,4,5,13,7,4,3,8,8,2,1,6,12,12,6,3,3,5,2,0,29,3,7,0,3,7,10,7,22,3,6,0,3,11,6,14,12,23,10,6,3,17,7,5,4,25,7,1,7,6,4,5,9,10,3,4,1,0,28,3,10,9,8,4,5,20,6,7,12,11,9,4,5,2,1,6,25,5,5,7,3,63,82,14,3,22,11,25,9,5,10,2,7,0,25,7,1,16,7,1,0,9,1,4,9,5,11,2,10,0,6,8,4,4,0,9,11,12,6,6,1,6,2,1,7,0,1,4,9,7,9,4,14,0,7,3,2,0,2,2,0,6,0,3,1,13,5,2,14,9,0,7,3,1,9,2,11,11,5,16,5,2,1,1,14,12,3,5,6,6,3,3,8,6,6,13,0,1,3,10,4,1,1,3,5,2,4,4,2,4,2,3,3,3,6,6,2,10,1,2,8,3,2,1,2,2,3,3,2,1,2,3,5,1,5,2,2,4,4,1,8,7,2,1,4,3,18,1,0,5,0,9,1,4,7,3,4,2,11,2,3,1,1,8,1,19,2,1,4,1,3,1,5,5,4,2,2,4,2,5,2,9,4,18,6,6,6,8,11,10,17,2,4,8,5,6,2,3,0,4,6,4,1,0,0,1,9,12,1,2,3,2,2,2,32,12,2,1,2,3,7,2,1,7,7,2,6,8,1,7,3,1,2,4,2,4,11,17,6,0,4,2
difference,5,11,8,88,12,4,5,27,2,5,28,13,1,68,1,4,9,11,8,5,6,27,20,34,36,8,11,29,6,9,10,178,124,13,43,81,55,2,13,3,2,7,2,3,32,11,20,8,195,39,53,7,12,45,20,3,66,14,17,14,22,4,0,17,19,7,73,8,1,16,9,5,2,3,95,11,20,8,71,22,38,3,11,7,157,7,8,1,26,4,5,9,0,32,52,19,15,0,31,14,7,10,40,12,8,30,8,3,12,5,9,4,4,9,6,35,3,4,44,103,34,17,10,53,3,9,1,2,1,4,12,3,16,26,25,39,21,3,5,10,10,28,29,3,5,65,3,13,6,4,62,2,13,3,3,12,30,6,14,13,34,0,7,5,5,14,3,14,20,8,12,64,13,3,5,9,136,0,18,29,12,8,0,15,1,19,32,21,36,77,2,9,4,1,4,2,12,2,4,7,29,4,3,23,8,6,2,23,8,21,48,8,13,12,6,23,6,4,9,3,4,16,7,30,22,35,16,14,2,9,12,11,13,13,24,13,39,10,13,4,45,23,5,6,15,3,8,10,27,2,10,15,32,2,9,19,9,2,3,8,4,20,17,4,6,20,3,14,12,4,135,2,22,4,2,1,6,8,16,0,46,3,1,9,4,3,5,4,18,3,3,7,9,9,0,3,34,3,0,18,20,16,0,1,18,4,20,7,13,2,1,6,20,8,19,17,10,35,13,5,34,9,25,14,65,3,5,28,8,9,1,14,2,2,8,7,25,5,0,7,12,11,17,5,1,4,59,51,12,13,8,8,0,14,24,3,6,0,8,18,7,4,4,12,2,4,34,12,3,10,2,16,3,18,7,7,3,1,22,2,46,1,28,19,3,20,6,10,19,1,13,3,11,14,32,9,65,2,9,4,40,4,6,3,8,2,7,3,18,7,4,7,4,11,0,7,7,11,7,3,5,9,17,4,2,3,4,10,12,17,7,2,2,6,4,4,4,29,4,3,12,16,4,18,2,9,12,14,23,8,15,3,6,4,56,2,1,13,14,29,19,20,29,26,1,2,20,15,4,2,26,6,4,5,1,11,6,17,19,8,8,14,2,11,10,4,11,1,3,1,48,29,1,5,21,5,2,6,4,5,6,3,7,1,6,11,3,20,3,2,2,9,10,10,12,51,6,9,0,5,7,13,7,6,6,7,14,3,7,31,8,14,2,5,6,7,9,10,15,19,3,5,2,14,4,8,6,12,40,2,22,2,0,34,13,10,32,2,5,8,19,0,12,2,9,7,11,10,32,24,8,5,13,1,2,10,32,3,3,7,4,8,5,19,12,10,3,8,2,12,32,24,12,4,30,6,6,14,63,15,21,2,6,10,9,15,6,29,10,4,20,19,19,5,21,6,20,1,12,5,5,1,11,9,4,15,4,8,4,25,5,10,21,13,2,7,14,2,3,6,5,5,5,17,20,13,2,2,3,130,7,3,11,0,6,13,25,19,6,9,8,8,20,39,12,12,20,30,18,7,12,13,49,12,24,6,1,10,8,1,10,21,15,6,7,3,6,5,3,6,19,10,10,6,10,5,5,6,9,11,2,4,5,6,1,9,14,4,0,4,1,5,7,24,14,9,6,6,6,3,7,3,3,6,4,8,9,2,0,10,10,5,3,4,4,1,6,5,15,5,7,1,4,6,8,1,12,13,5,3,6,3,4,10,3,8,9,7,2,24,18,10,9,2,11,24,10,5,9,34,11,3,9,3,6,12,5,2,8,10,0,2,10,2,19,15,7,17,6,9,14,9,1,8,10,13,1,5,2,3,5,6,9,6,3,1,8,1,17,4,16,3,9,7,4,9,2,16,3,7,7,4,4,7,5,8,4,2,3,3,5,5,5,7,9,5,6,35,9,2,12,8,3,9,1,3,9,10,1,21,28,13,11,5,4,4,9,2,4,1,10,5,5,3,3,8,1,3,17,10,1,7,6,6,8,7,12,16,12,0,4,5,6,11,10,6,16,7,3,2,4,12,0,5,12,4,5,4,0,8,1,8,1,4,2,1,4,5,1,12,2,0,3,6,9,6,6,9,11,4,13,42,1,14,3,5,4,31,9,6,5,2,14,8,0,5,0,3,4,8,2,10,4,0,3,6,5,22,14,1,0,4,4,2,1,1,2,1,9,7,0,4,3,1,6,5,0,0,4,9,5,3,8,7,7,11,0,6,11,1,0,3,5,7,3,0,10,4,17,8,3,1,4,1,0,3,2,3,1,2
line,10,20,4,137,4,12,20,65,5,2,22,21,23,66,6,5,5,14,7,12,1,55,12,37,27,29,12,24,16,23,28,332,185,19,66,69,31,7,22,5,7,11,2,8,50,13,60,21,383,67,64,6,9,56,17,6,75,38,6,22,16,9,0,36,20,19,114,8,16,1,23,11,5,8,169,26,60,6,106,29,88,5,27,15,215,6,23,5,39,6,18,7,3,44,69,32,39,7,78,17,33,88,48,9,22,38,10,27,28,12,30,7,8,15,5,31,9,26,85,400,69,38,17,79,10,1,1,3,8,11,17,9,19,87,27,102,11,3,11,2,5,71,34,5,3,90,8,18,43,31,72,7,8,14,8,44,39,20,7,23,36,6,11,10,16,22,15,26,34,9,56,163,51,8,13,15,235,5,10,73,49,14,5,31,10,30,37,29,68,95,2,2,19,1,7,6,22,12,12,16,32,6,5,15,47,5,4,26,19,77,100,44,40,17,2,13,7,9,9,8,8,43,3,44,64,151,35,23,11,24,15,29,30,44,41,13,33,24,20,23,77,50,28,7,16,6,8,41,58,6,15,18,22,10,14,27,17,4,1,45,13,51,23,11,12,62,13,6,22,5,197,13,31,4,3,0,34,24,14,3,69,2,15,23,20,4,11,17,26,3,9,6,27,10,17,5,38,8,13,18,27,57,2,13,8,8,24,11,7,3,3,27,39,5,52,20,22,50,40,6,37,21,28,6,100,16,20,41,7,113,13,16,14,12,8,16,19,7,2,9,25,17,19,19,5,80,46,97,23,21,11,14,16,46,54,39,4,9,14,35,37,26,21,34,11,2,55,10,7,26,5,33,5,29,17,93,29,10,15,6,68,7,69,24,7,61,3,32,30,4,21,8,13,15,48,8,48,26,47,4,20,8,24,10,5,11,8,2,48,16,16,60,8,26,7,47,9,44,3,6,12,12,27,25,5,12,7,15,9,34,7,18,1,23,12,12,3,23,12,6,21,21,14,25,6,19,25,20,54,12,24,4,5,5,123,6,2,8,14,23,12,27,33,59,33,12,14,30,11,4,34,11,4,4,2,40,3,23,29,14,6,11,27,4,8,8,18,3,11,7,191,28,29,3,7,13,7,9,10,13,22,24,5,2,59,2,17,29,20,8,14,7,12,5,11,15,8,6,12,9,10,18,5,16,3,10,46,26,11,40,16,7,69,11,27,16,10,12,44,20,21,1,3,14,11,9,21,14,21,21,21,3,11,58,13,9,33,19,10,10,27,11,29,3,33,16,23,9,50,52,15,16,14,7,23,19,14,11,9,48,4,34,42,26,2,19,21,10,5,11,34,22,12,9,35,8,14,10,71,14,18,2,4,0,7,25,7,13,12,1,33,36,18,8,53,7,11,19,5,8,13,0,12,25,4,12,37,32,13,80,2,40,27,36,33,5,17,24,4,12,19,4,6,19,13,35,8,7,7,232,33,17,6,1,11,11,33,21,17,26,4,25,14,65,9,3,7,15,15,10,10,16,65,17,30,8,3,14,17,9,22,59,11,28,12,7,12,2,13,47,26,16,13,80,12,22,6,6,19,15,23,13,11,11,23,14,41,14,7,4,3,16,9,14,25,96,19,4,8,17,22,9,3,65,7,29,32,7,8,7,9,13,5,12,4,56,48,17,72,7,33,24,16,39,26,6,27,15,12,9,26,2,4,21,9,21,14,31,12,22,12,8,6,15,53,7,16,7,16,18,7,17,3,7,1,17,7,7,11,13,0,4,13,1,8,10,7,23,11,20,18,6,11,9,54,26,36,12,3,3,8,10,17,10,16,3,3,12,21,8,8,17,20,8,14,10,7,11,37,10,10,8,14,23,18,13,7,11,7,12,15,7,6,40,5,9,3,21,13,5,13,3,9,11,8,40,12,16,5,17,27,35,18,4,10,3,21,4,2,9,11,9,4,2,4,10,4,4,10,18,5,30,9,2,6,4,9,22,14,16,3,11,4,18,23,9,13,2,26,3,26,38,4,8,4,16,13,6,15,21,21,6,3,16,6,12,8,5,7,18,7,8,11,14,8,12,16,16,11,9,21,16,2,7,8,4,11,8,7,0,5,4,9,4,1,1,19,2,6,15,8,4,7,0,9,10,3,26,13,4,17,7,11,10,6,3,35,25,19,5,4,16,2,16,2,21,40,5,3,12,121,5,6,5,11,18,6,3,44,14,55,9,2,4,9,10,4,9,27,5,7,1,16,1,3,7,4,10,1,0
million,7,31,13,229,3,55,9,41,6,12,4,14,30,126,4,22,18,20,16,8,1,37,63,47,12,52,15,31,14,89,31,325,152,22,64,199,42,40,54,19,10,32,1,62,47,13,81,98,293,114,76,9,12,88,123,3,67,31,59,18,6,3,4,15,51,21,212,27,9,23,1,7,9,2,124,12,66,7,130,44,195,28,16,24,209,47,35,11,163,39,45,13,87,85,140,36,49,7,87,28,37,87,53,10,56,45,70,70,176,120,53,3,74,70,132,97,11,7,122,189,51,179,165,623,35,4,7,11,38,56,28,13,43,124,34,198,11,24,6,38,8,57,102,39,4,114,16,63,27,52,53,31,27,22,14,106,42,33,4,154,59,12,45,83,121,60,48,24,28,15,39,203,52,8,7,17,120,15,12,123,37,21,102,31,9,43,71,32,12,130,3,9,22,12,30,6,46,11,94,21,67,24,21,9,35,24,20,67,19,29,96,27,58,44,25,66,23,65,43,11,66,35,5,13,114,110,42,63,109,580,15,134,91,34,59,101,61,18,22,6,87,48,36,15,19,34,8,44,149,18,19,55,33,117,3,30,14,84,36,58,18,36,14,9,13,87,46,22,12,10,162,92,283,7,5,20,44,199,14,8,105,5,30,32,70,12,106,73,8,11,9,11,38,85,59,7,78,21,8,26,21,70,50,66,20,18,36,8,39,17,17,52,121,17,228,33,53,61,40,17,46,8,39,58,55,1,27,60,16,39,15,32,6,9,11,40,14,8,35,37,17,14,37,40,24,7,63,35,69,97,21,22,5,71,15,14,15,4,11,152,43,36,25,13,6,11,24,5,32,47,11,81,16,30,11,91,7,9,19,30,49,19,80,2,55,86,7,57,109,7,4,9,23,7,33,13,33,7,33,9,11,10,8,4,10,8,9,2,20,14,6,7,23,25,0,3,17,8,6,9,4,7,27,0,11,2,6,8,11,22,59,90,70,13,13,8,11,3,14,4,11,23,16,19,8,6,36,13,39,28,49,2,25,5,59,4,5,9,9,41,18,35,34,56,15,5,90,25,15,21,63,17,1,10,4,17,11,5,33,10,15,20,7,3,13,9,15,13,3,9,170,65,9,11,16,3,17,24,12,4,36,10,39,78,18,133,35,10,10,8,17,3,7,1,16,2,18,5,2,37,4,23,2,9,2,8,24,39,41,17,15,8,5,8,17,11,3,6,44,43,6,6,6,18,34,4,2,25,20,11,18,2,1,61,8,12,18,9,17,5,12,1,35,7,3,15,14,4,50,34,28,4,90,2,8,4,3,3,7,158,11,20,8,13,6,15,3,6,10,18,11,14,15,33,24,6,7,27,18,15,13,11,9,2,5,7,5,14,7,5,37,21,2,10,21,12,17,2,2,2,21,21,2,38,20,6,0,3,7,50,24,17,12,18,4,6,16,64,11,18,5,8,6,28,7,41,24,28,23,158,11,15,1,7,3,24,35,15,7,10,3,5,23,9,8,0,0,7,18,12,21,7,27,5,26,3,4,15,20,13,15,36,17,1,8,44,13,13,5,9,13,43,4,18,6,29,8,1,20,4,9,3,2,3,11,13,89,6,12,20,1,19,4,34,36,26,4,2,1,17,5,1,1,8,8,14,26,14,4,19,9,83,18,6,3,5,42,19,15,31,6,1,7,10,9,8,69,41,12,3,6,153,198,46,52,18,4,15,15,54,32,26,15,75,38,27,27,12,45,7,18,2,15,13,12,31,66,8,7,6,2,2,14,60,18,13,10,16,24,17,4,5,7,8,6,17,9,14,6,1,2,61,5,4,8,9,13,4,15,9,42,5,1,17,3,2,7,12,4,4,0,34,9,5,9,2,14,12,23,11,80,34,8,4,4,5,7,45,5,3,1,0,4,6,24,68,11,11,3,22,9,45,4,26,21,7,9,34,2,12,2,12,8,6,2,8,3,3,4,9,8,1,15,14,10,9,0,18,6,4,4,11,3,3,1,0,10,1,9,23,21,21,40,5,7,7,3,2,60,35,7,1,12,6,13,12,0,9,30,13,16,156,4,160,1,98,4,11,12,9,7,4,8,5,3,1,1,2,4,23,8,16,3,12,3,13,26,19,1,13,4,22,68,79,72,108,78,238,368,2,11,13,17,17,25,56,6,4,63,2,45,9,6,14,56,14,14,27,1,5,6,4,32,21,7,0,58,7,8,3,7,6,35,18,9,16,5,50,5,34,3,17,9,7,27,57,38,1,7,7
harbor,1,8,2,83,2,4,4,6,0,2,4,6,9,26,4,3,0,5,0,3,0,27,2,12,8,3,10,13,1,5,11,130,44,0,29,25,18,1,0,1,2,5,2,2,17,2,10,10,144,15,13,4,1,14,1,2,22,22,1,10,3,3,0,5,5,3,16,3,5,11,7,1,8,6,39,2,7,3,36,4,25,0,10,4,69,7,19,0,21,2,2,1,0,11,14,3,4,0,19,0,53,19,12,0,3,27,3,5,5,3,8,7,6,2,0,23,1,0,43,60,10,9,3,35,6,3,1,6,3,1,4,2,1,29,15,74,1,0,7,3,2,12,9,2,0,41,3,5,13,25,36,2,2,7,1,17,9,0,7,1,11,0,2,3,2,2,1,7,16,2,28,45,12,0,3,7,67,2,7,18,16,1,2,6,15,3,13,16,11,31,3,2,1,0,1,0,10,1,6,5,0,0,1,8,21,2,0,12,8,12,25,1,8,3,1,1,1,0,4,9,2,5,2,14,22,38,7,25,2,7,13,15,1,16,6,8,16,3,1,1,34,22,12,0,8,4,1,7,26,0,5,1,5,8,8,10,6,0,1,9,3,18,19,2,1,29,0,1,8,4,64,2,25,13,0,0,17,28,11,2,23,0,3,5,6,2,1,3,2,1,4,0,9,3,8,6,22,1,5,10,9,19,3,2,6,0,11,0,2,0,4,6,10,3,5,7,14,15,3,1,27,4,19,1,24,15,2,9,2,6,0,6,14,8,4,5,12,2,1,10,2,5,20,5,5,7,9,43,9,0,7,5,2,13,15,2,1,4,13,18,11,17,4,4,1,0,10,1,0,3,3,7,4,3,4,21,5,3,3,2,34,0,28,3,0,8,4,8,22,0,10,0,14,3,20,1,23,3,20,2,10,3,7,1,3,1,0,2,8,9,0,16,0,10,8,10,2,3,1,3,0,7,6,6,0,5,0,4,4,7,0,2,6,4,2,0,0,8,29,2,12,21,5,4,0,2,9,9,8,8,14,1,2,1,50,1,0,1,5,9,4,6,8,19,1,12,3,7,26,1,15,2,13,0,2,9,0,3,5,3,5,4,3,1,4,4,9,2,2,3,56,12,3,0,3,6,11,9,2,0,7,2,3,1,9,0,1,6,6,0,0,0,12,1,0,3,3,4,0,8,0,15,4,10,4,7,5,0,7,13,6,1,9,1,5,0,9,3,15,12,5,0,3,0,2,8,1,11,12,5,20,2,7,38,2,6,37,3,3,5,18,4,11,4,9,5,4,1,24,19,5,3,49,2,5,10,6,2,5,26,2,12,8,4,5,0,2,3,6,6,10,17,7,3,6,4,0,0,17,7,8,4,5,0,5,14,2,8,0,15,4,11,2,3,8,2,22,0,5,6,7,0,5,2,3,3,3,2,9,17,0,14,13,5,7,0,0,9,3,11,11,3,2,12,3,23,3,2,2,93,53,4,1,0,6,9,11,2,3,8,7,10,7,18,3,1,0,4,4,7,22,14,13,5,10,3,2,11,5,2,21,23,7,8,2,6,2,1,2,54,2,1,12,18,4,25,3,2,4,14,3,5,2,2,1,5,10,6,0,0,0,6,0,11,12,13,1,1,3,5,2,4,4,27,1,16,1,1,1,2,5,5,0,4,2,5,40,6,14,3,3,7,5,34,21,3,10,12,0,4,9,2,9,13,12,11,2,10,5,7,1,3,2,3,14,4,13,2,0,6,4,2,1,10,8,6,2,1,3,4,0,4,6,4,0,1,1,0,3,5,2,10,8,3,8,10,3,4,4,2,2,6,5,7,6,3,7,1,13,12,0,7,34,7,3,3,0,10,3,7,0,3,2,12,43,5,1,2,1,2,4,2,0,6,11,1,5,5,5,2,5,7,1,0,6,8,3,8,0,7,4,27,3,8,2,2,4,0,5,3,4,2,4,1,3,2,3,4,4,10,4,2,0,0,3,5,2,5,7,2,0,3,2,0,2,1,3,2,4,5,3,87,0,0,4,10,4,4,0,5,0,2,6,2,2,1,2,4,8,9,1,1,5,10,8,0,16,22,1,3,5,1,5,6,1,8,7,6,1,0,3,2,0,5,5,0,4,3,3,61,3,7,3,1,1,1,3,28,18,4,9,3,0,2,5,2,11,14,17,2,0,18,8,5,3,43,6,1,0,19,14,2,0,4,0,3,6,1,10,5,3,2,4,0,5,0,3,1,6,0,1,1,1,1,0,0,2,15,0,0
safe,2,9,4,58,1,3,0,12,0,0,12,2,14,28,2,9,8,12,6,3,6,26,17,28,11,11,15,13,6,16,2,107,77,17,38,59,16,5,4,7,8,7,4,10,29,8,14,9,85,57,19,6,9,40,41,1,28,13,11,11,3,3,6,6,13,5,60,4,2,5,9,8,1,3,71,8,17,6,48,20,26,1,2,5,95,22,11,0,17,0,7,4,9,15,22,5,12,6,25,21,7,11,11,7,6,13,4,10,6,3,11,2,5,13,3,20,0,1,20,78,20,24,12,38,7,2,2,0,7,4,11,7,9,22,20,38,4,7,7,4,3,15,9,0,7,34,5,13,5,7,28,2,12,5,4,12,16,9,1,21,0,2,8,3,5,9,1,9,14,3,13,41,14,4,12,3,58,5,4,31,8,7,7,14,7,9,17,13,11,17,2,1,3,2,3,1,12,4,6,5,27,3,6,4,13,4,3,15,9,7,49,13,19,5,7,8,0,8,9,0,4,10,2,10,32,45,13,12,3,4,8,5,16,7,19,9,11,4,1,6,40,23,5,4,11,1,3,39,21,10,5,11,8,5,6,13,7,2,2,10,7,21,5,2,1,4,7,14,17,8,62,5,5,6,5,5,21,2,2,2,44,4,7,15,2,1,10,12,8,3,3,2,13,5,2,1,14,1,1,7,11,16,1,1,8,4,14,0,4,3,0,7,15,12,11,5,13,11,6,4,13,5,20,10,26,1,4,25,1,14,9,8,8,4,2,5,15,3,3,4,5,9,18,4,4,8,14,15,9,8,5,8,4,20,13,2,4,3,4,13,13,9,8,5,5,4,25,7,16,16,2,22,6,24,5,6,3,1,10,9,23,1,29,8,13,8,12,13,23,3,10,5,6,2,6,10,21,2,23,0,9,6,0,2,4,6,2,0,15,7,2,6,1,7,0,8,4,4,2,6,2,5,9,5,2,4,1,6,1,8,10,0,0,3,1,2,1,4,12,0,8,12,5,4,3,1,16,6,12,9,19,2,7,4,18,6,5,3,5,6,12,15,12,21,3,1,20,6,7,3,17,5,4,4,3,7,3,5,11,4,4,4,0,2,2,4,10,7,0,1,29,15,0,1,7,3,0,7,1,6,6,5,1,7,8,27,4,4,7,3,4,1,1,5,6,9,7,7,1,2,1,21,3,14,9,3,11,3,6,16,7,6,5,8,6,3,4,10,17,8,1,1,2,4,9,4,2,5,8,5,24,6,2,24,3,1,8,3,2,2,8,3,12,2,9,8,9,8,6,23,4,0,5,2,4,3,6,6,2,9,5,3,8,14,9,1,4,4,0,5,9,18,7,2,12,5,6,1,4,9,6,0,6,0,1,17,4,4,3,4,8,6,2,3,10,6,11,0,4,3,10,5,1,16,0,1,1,6,12,13,9,6,18,13,3,1,8,2,4,2,11,4,5,10,4,11,3,3,2,38,2,2,2,6,3,6,8,4,5,3,8,3,0,1,1,0,0,5,6,4,15,6,5,5,3,1,2,0,1,4,3,17,5,3,4,2,8,1,5,4,2,11,4,12,2,4,5,2,2,10,2,1,4,2,6,3,5,9,3,1,2,0,2,10,12,12,11,1,3,4,4,4,5,13,3,2,1,2,2,6,4,9,4,4,4,0,3,2,4,3,3,5,1,1,1,2,11,6,1,3,8,2,0,1,2,7,6,5,1,8,10,3,2,1,5,21,10,1,2,2,4,2,0,7,2,9,10,2,6,3,1,1,4,7,9,3,5,1,0,6,1,4,1,3,14,9,3,5,2,3,2,5,4,5,9,1,6,5,5,2,2,2,7,0,1,0,2,4,2,7,0,1,1,5,4,2,6,3,7,2,1,4,13,7,5,4,2,10,5,1,1,0,1,2,7,8,4,1,2,3,7,12,5,0,2,3,4,5,2,4,0,1,5,2,3,5,1,0,2,7,1,4,2,15,1,0,0,1,5,1,0,1,1,0,5,1,2,3,4,2,4,6,0,1,4,2,2,1,1,10,4,0,4,6,0,3,0,8,0,7,4,4,3,3,4,2,5,9,2,1,5,3,2,3,1,1,0,1,0,6,0,4,2,6,1,1,3,4,2,9,1,11,3,3,5,3,10,2,16,1,2,2,2,4,2,3,4,8,7,1,0,3,4,3,4,4,2,0,3,3,5,3,2,6,1,3,2,3,2,1,2,4,2,9,4,9,0,6,0,6,2,4,2,4,2,4,3,4,4,4
understand,5,13,11,53,5,3,5,21,6,2,17,9,7,37,2,9,2,12,5,7,2,19,18,24,12,8,11,11,5,8,6,80,57,12,21,31,17,2,4,0,5,8,10,2,17,7,15,5,119,22,25,4,10,23,18,3,38,10,5,7,4,3,2,10,12,7,52,6,3,8,2,6,3,1,54,12,16,2,38,20,18,1,6,4,77,11,2,1,10,1,9,3,1,7,13,19,11,1,11,6,3,7,14,5,5,8,3,6,3,1,5,4,5,4,4,17,5,1,28,62,16,18,13,23,3,7,2,1,0,1,8,2,1,23,6,36,10,0,7,3,1,17,9,3,0,30,5,8,9,2,17,2,6,6,3,13,17,3,5,9,6,0,4,3,1,16,2,7,13,4,11,53,17,4,6,7,53,1,8,20,10,4,6,13,1,10,18,13,9,17,2,5,2,1,4,0,14,1,3,3,10,1,2,4,16,11,4,12,4,12,42,8,10,11,6,27,10,4,9,0,2,8,5,10,17,58,13,6,0,2,8,4,10,8,15,21,6,1,5,5,30,15,2,7,4,2,2,10,16,2,2,7,9,4,1,14,3,1,0,4,1,13,6,1,4,11,3,3,6,4,43,1,10,4,2,5,10,2,0,1,30,2,1,7,6,1,3,5,6,3,0,2,5,3,4,5,14,0,1,9,12,5,0,3,7,4,4,1,3,1,5,0,8,0,8,4,8,17,3,3,23,7,11,2,38,5,10,29,3,11,3,4,5,1,4,17,7,7,1,5,1,2,5,5,1,2,12,23,5,11,10,5,4,16,11,5,6,1,5,16,5,1,13,2,2,2,11,3,5,13,0,9,1,9,6,13,7,3,8,7,14,1,10,6,8,27,12,14,10,0,15,5,13,8,10,7,17,2,13,2,7,2,4,4,9,3,3,5,3,6,2,6,0,8,0,6,2,2,9,2,5,2,8,10,1,7,2,6,5,9,1,0,0,2,0,2,2,5,5,3,9,12,2,5,0,5,6,6,10,3,8,4,2,1,31,10,3,5,5,10,10,15,5,21,1,0,11,9,5,4,6,8,1,4,0,14,1,8,4,5,5,1,4,1,8,2,4,6,4,2,11,15,3,4,3,2,1,4,3,6,8,1,1,1,14,5,2,7,4,5,5,3,1,3,6,7,1,3,1,2,2,4,2,12,3,4,9,5,5,13,3,8,3,6,3,4,6,13,16,9,2,4,2,3,5,5,4,9,6,4,19,7,6,14,1,5,6,1,5,0,6,3,10,2,4,12,3,3,11,13,6,1,2,3,1,0,3,2,5,7,4,4,7,9,3,2,2,1,0,8,5,21,6,0,11,3,3,3,24,5,3,4,0,2,0,6,1,7,2,3,17,11,8,3,15,1,7,3,2,1,6,0,2,6,0,1,4,2,2,19,3,7,12,13,8,5,6,3,3,3,1,8,15,2,3,6,3,2,3,62,3,1,3,4,5,5,6,3,3,7,1,3,7,15,3,1,0,0,9,2,1,4,20,25,9,2,1,3,2,2,3,10,4,4,1,2,5,4,0,1,10,5,5,0,3,1,5,8,8,7,0,2,1,6,5,4,7,7,3,3,3,3,4,3,9,10,4,3,7,4,3,5,2,17,1,12,8,4,1,5,4,3,1,3,1,2,7,4,10,3,6,1,1,3,8,9,5,3,1,4,0,2,1,2,5,7,3,8,3,7,7,5,0,3,9,5,10,4,0,0,3,3,0,11,6,1,1,3,2,1,3,3,2,1,7,2,3,21,2,8,2,7,2,2,7,7,1,3,1,9,3,0,7,0,5,7,1,2,10,1,4,4,4,8,0,3,1,8,1,3,4,1,3,2,2,3,3,5,3,3,5,1,3,3,4,1,6,9,6,3,4,2,1,1,7,6,6,3,0,7,17,7,5,5,2,1,2,3,7,0,3,6,2,4,3,0,3,3,2,1,4,2,0,2,5,4,2,7,9,1,0,5,4,1,4,1,0,1,0,3,3,5,5,2,4,1,2,9,0,2,1,0,3,6,2,2,0,2,4,8,1,0,1,3,7,1,4,0,3,0,1,3,2,14,4,1,1,2,0,0,2,2,2,3,5,0,2,1,1,5,4,9,3,0,1,6,2,6,5,3,1,6,0,2,1,0,2,2,6,3,0,4,2,1,0,11,3,7,3,1,3,0,1,7,1,2,1,2,5,3,0,9,3,0,2,5,1,1,4,3,2,1,1,0,1,1,1,1,3,3
must,12,159,92,800,68,144,49,234,43,35,111,67,152,863,34,86,84,192,87,80,60,292,185,272,201,218,194,273,81,161,96,1414,853,160,486,779,487,72,155,89,95,216,32,72,256,120,176,138,1269,535,304,164,135,660,236,61,363,77,125,155,92,92,58,91,254,145,1038,107,95,169,124,39,71,54,1,161,254,44,602,290,493,64,79,94,1513,150,128,51,167,16,61,55,78,228,460,140,156,41,482,162,53,218,193,130,165,181,70,92,99,54,200,45,190,203,136,227,21,50,480,1003,305,314,216,653,50,49,58,38,32,24,242,93,131,483,281,749,114,42,99,85,115,337,125,39,37,662,85,204,129,111,538,49,120,120,153,275,429,96,107,373,168,60,116,47,84,164,56,232,216,94,200,793,289,98,98,66,1132,47,122,664,273,118,189,226,29,328,284,226,242,246,50,58,69,42,55,60,225,115,61,152,304,57,66,81,252,167,46,354,93,233,675,124,246,111,40,106,97,161,87,43,76,192,30,148,279,680,186,293,58,83,134,108,192,223,358,146,298,125,122,88,454,269,105,105,178,57,65,369,352,68,68,234,188,26,45,111,58,21,32,151,71,287,79,14,114,217,156,154,137,46,807,82,129,41,31,83,281,101,46,9,651,89,49,129,91,32,180,192,150,60,11,28,113,75,31,81,177,33,57,195,214,134,10,19,97,102,252,33,122,38,36,185,367,137,276,80,182,270,122,71,266,53,356,167,553,22,205,303,40,232,65,94,70,40,77,83,180,47,37,72,113,90,176,106,62,73,253,331,152,136,107,107,36,397,162,78,67,77,129,299,230,119,230,177,39,81,184,120,178,211,30,268,89,175,110,146,68,36,128,65,509,62,330,123,106,192,89,190,202,43,211,81,98,60,150,138,248,33,241,23,112,75,37,48,51,84,54,11,236,150,57,92,103,163,79,112,27,76,40,72,80,87,177,103,58,55,25,110,78,141,53,28,9,39,79,41,32,43,189,60,108,145,75,115,36,51,274,69,306,97,275,28,124,64,372,87,37,61,131,172,128,226,235,415,74,92,212,163,88,30,230,139,17,59,42,287,42,94,186,106,98,127,53,58,70,73,76,72,66,16,594,238,45,55,97,25,39,57,60,111,128,48,39,44,62,163,109,74,47,44,40,75,44,68,80,91,83,122,50,118,51,110,63,195,84,44,220,128,111,249,151,86,64,120,85,63,56,123,371,166,51,30,64,274,126,50,52,126,81,42,244,22,35,275,86,56,204,40,51,37,96,26,90,75,105,120,87,78,188,278,97,43,54,47,51,21,105,34,68,140,71,88,113,236,61,94,64,60,19,116,242,204,114,33,332,44,105,64,89,184,107,39,66,19,41,122,40,159,68,37,201,136,36,52,219,55,96,41,64,34,47,45,43,137,51,37,31,51,99,161,104,101,258,143,74,61,178,73,44,56,141,58,83,101,31,107,72,15,72,639,127,90,34,25,44,65,200,188,50,70,33,47,24,59,17,8,9,42,83,51,100,102,134,128,73,83,24,17,24,37,49,173,71,61,46,42,116,82,25,67,72,198,50,87,37,69,53,21,76,39,43,34,25,44,66,123,115,76,27,19,66,29,39,178,112,110,68,42,52,80,74,54,36,141,59,62,48,54,35,73,103,89,50,65,20,19,173,74,139,69,100,41,33,121,75,45,103,140,67,40,115,30,23,62,47,93,85,57,27,76,69,167,7,37,144,149,121,36,120,46,122,46,65,85,49,94,72,34,66,48,16,27,88,42,82,50,35,45,56,82,47,61,28,38,127,142,60,36,15,28,49,37,103,30,88,77,93,35,122,19,62,29,61,57,27,26,43,71,19,67,28,21,26,29,29,43,97,49,36,48,59,20,69,69,57,90,44,133,79,32,11,37,32,68,37,53,76,76,20,88,138,147,66,40,43,22,74,41,20,35,25,44,48,51,38,59,46,18,70,77,31,44,31,114,54,43,10,40,55,24,5,42,13,17,28,7,31,32,58,17,59,28,35,17,37,25,27,31,47,132,49,16,69,62,55,12,21,38,18,139,47,55,49,37,97,11,30,42,55,23,26,38,31,43,25,24,25,19,27,40,35,44,27,33,27,17,38,22,23,80,32,82,49,19,69,80,91,57,132,15,28,52,50,53,21,21,15,38,64,31,12,51,22,25,12,68,26,29,57,64,75,44,103,102,26,14,38,45,36,19,15,53,26,57,36,50,56,129,75,74,46,54,13,63,36,59,68,13,49,57
look,5,24,10,149,14,25,8,52,9,10,18,13,26,147,20,23,8,22,21,11,9,49,42,50,28,24,36,28,13,25,9,195,181,21,78,158,59,9,20,13,9,30,1,6,37,35,39,16,299,94,61,10,37,80,36,5,44,36,17,34,14,13,6,15,34,29,173,11,11,26,12,2,8,12,161,1,44,5,112,56,52,7,16,13,235,21,23,6,26,1,12,14,10,18,67,21,28,7,39,25,10,25,30,28,30,39,8,4,17,7,29,8,15,28,21,49,4,13,41,181,53,37,18,118,23,5,5,6,9,6,72,8,15,64,31,93,6,14,8,30,5,54,27,12,10,76,9,29,22,20,72,10,10,22,8,26,51,13,21,20,22,18,12,2,6,29,7,27,31,9,18,132,38,48,7,15,197,4,19,55,31,13,12,28,10,41,34,39,39,57,5,22,20,7,6,11,36,12,12,16,47,4,5,10,33,15,11,48,14,33,110,62,27,11,13,35,5,9,17,4,3,24,4,8,35,78,27,30,10,7,19,20,16,43,52,16,45,11,7,8,107,54,12,13,26,11,11,33,56,7,26,25,44,10,8,34,2,5,5,19,1,33,37,4,16,22,16,25,29,10,156,8,27,3,6,3,20,9,6,5,95,21,6,23,20,6,22,23,22,9,0,7,19,16,2,13,40,9,9,30,47,38,0,4,14,2,39,5,11,0,8,40,30,10,40,7,24,40,15,5,42,14,36,14,56,5,21,47,9,37,9,12,12,14,15,18,41,6,6,16,11,13,32,15,12,23,47,62,22,16,7,16,8,56,29,12,5,11,20,37,35,15,33,22,4,14,36,16,17,41,9,22,12,20,21,14,2,8,23,12,66,3,53,18,10,66,11,24,36,12,23,71,17,21,42,27,53,9,22,6,23,14,13,10,8,16,11,2,38,15,10,20,5,18,5,16,5,13,8,11,10,5,43,17,9,3,4,21,13,20,11,3,0,9,11,6,2,25,9,6,14,30,15,40,2,19,31,17,37,17,18,6,15,12,98,8,11,12,11,35,26,33,37,40,6,8,30,21,18,6,44,15,7,11,5,32,19,15,19,20,13,17,9,5,16,7,16,6,10,3,86,31,8,9,16,6,5,16,10,20,32,16,9,7,14,29,18,18,9,12,5,14,8,10,17,14,9,14,8,7,14,21,12,22,5,9,27,10,18,45,15,12,6,16,8,7,8,15,55,32,6,1,5,9,13,14,9,22,8,9,32,7,3,34,11,14,42,3,10,12,33,4,18,6,23,23,15,15,35,34,20,9,15,3,5,9,5,6,6,15,11,18,20,28,21,12,9,10,4,18,30,36,15,8,27,10,13,2,37,29,42,4,9,1,6,34,6,27,7,5,37,31,9,11,26,10,21,9,10,8,21,9,9,23,5,5,9,14,23,38,14,15,28,34,6,2,15,4,4,5,15,6,9,28,11,23,8,9,3,141,15,17,22,3,3,15,38,26,7,14,12,9,11,22,7,8,3,12,11,15,19,6,39,13,25,5,5,13,5,9,2,49,11,15,10,5,17,4,3,12,19,29,8,16,8,13,4,8,5,10,12,16,5,7,16,5,22,12,9,5,9,3,3,33,21,26,7,13,9,13,9,4,10,12,5,12,14,8,7,15,8,10,5,17,6,1,27,8,41,20,19,11,16,14,15,11,17,22,7,8,16,5,0,1,1,12,8,12,11,5,5,20,2,7,16,20,15,9,15,15,7,12,8,14,3,22,15,4,10,12,6,9,15,3,6,12,17,13,11,14,17,8,7,5,21,25,9,9,4,6,11,4,10,6,18,8,31,7,21,5,6,9,5,8,1,3,8,9,2,8,10,2,13,5,13,5,19,5,7,6,3,7,12,9,8,18,10,34,10,4,3,12,6,14,10,7,15,15,14,5,15,22,5,6,14,2,6,11,3,4,6,9,7,13,6,12,10,6,9,16,3,14,6,16,9,6,2,5,11,14,3,4,7,4,8,1,3,5,14,5,10,14,7,4,2,4,5,10,8,13,8,5,5,14,7,3,0,14,5,21,6,7,13,7,14,3,3,8,7,6,13,7,6,10,6,4,4,9,7,12,8,3,3,8,4,11,11,6,4,12,6,10,0,3,7,18,26,4,26,7,3,8,4,8,1,3,4,8,16,8,3,17,8,0,2,9,7,2,5,7,15,11,19,14,4,12,2,7,10,6,5,14,4,8,8,9,8,6,6,5,3,6,4,6,1,9,5,6,6,8
go,8,35,26,232,16,49,9,43,13,16,19,26,44,154,10,32,27,56,41,16,5,62,117,103,53,89,61,81,41,80,20,404,245,41,136,239,69,9,37,12,24,32,14,32,88,31,60,26,326,166,112,18,18,132,104,16,87,29,68,48,13,18,13,27,72,49,279,30,20,60,66,7,17,16,254,44,1,13,189,87,131,13,25,27,311,60,34,10,87,6,27,19,50,63,83,82,53,16,72,40,31,79,34,26,36,57,28,56,45,17,43,8,34,40,60,93,7,19,121,348,138,98,119,283,39,14,15,9,17,12,65,23,34,128,66,271,21,16,24,29,20,73,57,16,15,167,43,32,39,15,97,29,29,20,24,62,134,17,21,113,44,19,35,17,35,121,32,49,72,23,48,246,81,30,29,13,218,13,23,154,63,19,50,70,17,69,82,65,46,95,24,32,27,14,18,7,53,15,40,20,85,17,11,16,36,28,26,55,25,44,213,108,78,39,71,116,25,29,21,7,14,53,7,44,62,154,92,85,23,22,36,41,36,31,91,35,78,35,17,25,131,92,37,27,38,9,14,93,103,17,17,80,49,12,9,55,15,11,5,38,11,77,13,3,14,39,38,29,30,9,181,18,56,11,9,20,42,27,12,9,194,14,14,23,52,16,61,74,21,28,10,13,56,29,11,13,72,10,17,40,57,41,4,18,21,18,56,12,47,4,5,47,77,22,124,32,54,60,27,8,68,14,83,46,125,13,54,164,5,37,24,22,18,7,26,42,52,7,14,19,15,31,81,16,12,27,52,77,29,87,8,22,5,83,41,13,19,17,33,82,49,35,36,53,6,24,41,37,36,67,7,72,13,53,28,49,12,14,30,16,105,12,76,16,35,62,31,27,82,12,35,97,34,32,33,30,56,12,44,7,23,19,10,16,10,18,17,1,34,20,10,19,19,33,19,19,6,26,21,23,14,20,59,14,16,10,9,22,13,27,16,11,7,24,21,7,13,19,27,18,28,30,25,37,7,12,72,24,70,24,41,4,30,9,88,22,13,24,27,79,33,70,72,106,10,45,64,34,29,17,77,34,6,25,15,52,22,22,62,32,16,28,6,11,14,20,8,15,11,5,169,57,6,19,23,4,13,20,5,17,36,15,12,23,22,53,35,28,22,16,9,12,18,21,22,33,12,28,4,20,20,18,16,25,10,11,45,32,22,39,34,17,8,30,11,17,14,22,65,38,10,12,27,24,33,11,15,31,6,9,32,5,7,68,8,27,54,5,13,11,18,14,29,10,22,21,15,11,37,50,46,10,18,4,9,5,21,12,22,33,11,25,32,50,20,9,12,19,5,30,33,42,22,16,49,31,16,14,45,31,24,5,12,9,10,42,10,25,22,11,57,55,14,29,65,7,23,11,19,2,24,22,3,25,13,25,7,9,18,45,19,28,53,30,17,15,27,13,16,8,26,12,18,33,7,24,11,12,17,168,81,9,15,9,11,20,56,27,14,34,4,12,25,12,9,9,7,16,13,13,27,17,30,64,18,11,4,19,11,11,20,63,7,8,12,13,13,13,7,17,19,43,17,16,5,19,8,12,22,12,23,4,9,23,13,20,34,33,10,8,9,15,16,34,33,33,27,13,13,23,20,8,5,33,18,11,17,10,6,17,14,28,12,19,3,1,49,10,33,15,25,12,16,44,37,10,28,30,15,7,23,9,7,25,19,18,13,10,5,40,47,62,7,24,31,37,30,12,20,3,20,8,13,25,5,10,23,4,9,16,7,5,23,9,13,9,14,14,15,21,16,14,9,5,26,40,18,12,2,5,9,8,10,8,18,15,25,12,20,7,29,8,18,12,5,3,13,30,8,18,4,5,11,19,2,18,32,16,18,14,10,8,16,16,18,20,10,33,13,6,2,8,13,20,19,11,12,24,10,26,30,24,15,11,9,9,8,7,4,5,4,15,7,12,8,8,14,7,7,13,5,26,19,17,7,7,1,21,11,3,1,16,7,6,6,6,8,10,11,13,33,23,86,3,7,11,4,8,18,39,14,3,10,7,25,15,0,7,10,18,3,28,10,13,11,11,10,20,20,9,11,5,9,24,9,3,10,13,5,11,5,17,9,6,7,16,7,10,5,12,14,36,10,5,12,25,34,20,25,6,18,8,21,11,6,14,10,13,18,5,7,11,6,1,17,17,4,8,10,13,17,8,21,25,6,6,14,6,10,4,8,7,1,23,17,12,8,14,11,20,7,10,3,8,6,23,26,7,8,12
situation,4,16,4,56,4,7,4,15,3,1,14,1,4,44,1,1,5,7,2,2,6,20,5,11,8,9,4,11,1,11,8,76,57,5,20,51,30,4,9,4,5,4,0,4,8,10,13,12,104,8,24,2,7,26,3,6,21,13,2,12,13,6,1,14,18,9,56,2,8,6,7,3,6,2,44,5,13,1,37,7,31,0,9,4,95,11,9,0,9,2,7,5,1,21,29,5,10,4,27,7,5,13,22,13,8,17,1,1,7,5,2,0,9,9,2,23,2,4,33,76,23,24,0,25,6,3,4,1,2,1,9,0,8,18,9,24,2,1,3,5,4,12,9,4,0,35,2,14,8,5,28,1,11,9,0,16,19,2,4,12,7,2,11,0,2,4,4,15,18,10,9,30,12,0,2,8,76,1,10,17,20,16,10,11,3,9,16,12,22,15,2,3,7,0,1,2,13,1,4,4,13,4,3,6,25,7,10,13,6,13,33,3,5,5,2,3,1,5,4,2,2,5,1,14,26,30,15,9,1,5,3,11,10,11,20,5,13,4,4,3,21,19,7,4,7,14,6,10,29,5,5,11,13,4,5,7,10,0,1,3,4,20,4,4,5,7,1,1,4,4,72,5,4,8,3,0,17,6,2,2,32,5,2,11,8,6,4,10,6,0,4,2,0,2,3,4,24,6,6,4,10,15,0,0,14,3,16,1,3,3,3,7,32,2,12,9,6,23,9,7,26,0,15,0,27,0,11,8,2,11,1,4,5,3,5,6,10,3,3,14,16,14,3,7,6,0,25,19,7,6,5,8,4,19,10,2,4,2,6,15,7,8,8,8,4,0,29,3,7,8,3,6,0,6,4,13,3,2,9,1,21,5,25,13,2,8,1,19,10,3,8,5,0,3,19,6,23,1,25,3,4,3,1,1,1,2,4,2,9,8,3,4,10,7,32,4,1,9,1,2,0,6,20,8,0,2,3,5,5,7,5,4,0,3,3,4,5,6,4,1,6,15,7,13,6,9,1,8,24,10,17,3,1,2,20,3,1,1,5,13,7,12,11,14,1,1,13,3,6,0,12,9,2,0,0,3,1,5,11,3,2,2,1,2,6,5,5,1,6,0,48,28,4,8,13,8,6,12,1,2,3,2,2,0,4,8,11,5,3,6,0,4,3,2,7,6,10,1,1,2,5,14,0,9,3,4,14,2,4,16,10,2,3,2,7,5,0,5,18,11,5,0,0,6,5,8,4,11,13,5,9,4,2,22,4,9,19,4,3,1,17,3,8,5,3,6,8,14,18,24,5,2,5,2,5,1,4,2,4,9,7,10,5,8,4,0,3,5,0,8,6,16,6,2,12,5,2,2,16,6,5,2,4,0,7,13,3,8,3,0,7,16,8,8,16,2,7,0,5,4,6,2,3,9,0,3,2,7,5,10,28,12,11,6,5,0,11,2,0,10,1,1,2,8,2,25,10,2,4,70,28,4,6,1,5,5,28,9,4,5,2,0,8,5,2,1,0,4,6,5,5,7,11,2,8,3,2,2,8,1,4,22,12,5,7,7,9,5,3,2,2,5,9,4,8,5,13,4,8,3,5,5,5,1,3,9,4,3,0,2,0,3,1,17,5,8,12,7,0,3,3,2,2,4,0,5,4,0,3,1,3,13,4,2,6,1,10,4,7,4,6,3,2,9,6,4,11,1,8,3,15,4,6,3,2,7,7,2,3,4,5,11,0,2,8,4,2,1,3,4,8,0,4,9,3,10,8,3,9,5,1,2,12,3,5,4,2,0,3,5,2,6,1,3,4,7,3,6,2,1,5,4,5,5,1,3,7,8,6,1,3,4,7,14,2,2,6,4,8,5,2,2,3,3,2,4,2,3,3,2,4,4,6,2,5,6,4,25,6,4,3,3,2,3,3,5,7,12,4,4,13,12,1,0,3,5,4,10,1,0,3,1,2,5,4,3,1,0,6,7,2,1,9,3,5,3,1,5,2,0,1,2,5,6,3,2,8,4,12,2,7,3,0,3,5,16,2,9,5,4,9,3,2,13,1,1,7,2,6,12,1,4,2,4,5,1,2,6,3,5,2,3,0,1,5,2,0,3,3,0,3,4,5,2,1,1,2,4,5,13,2,1,1,4,1,11,8,7,15,3,1,5,0,11,0,2,1,1,10,2,0,2,1,2,1,11,4,3,1,2,2,3,8,5,3,2,1,6,5,2,2,3,4,3,2,2,5,0,28,0,0,3,5,0,0,3,1,2,0,0
time,44,179,72,894,67,78,42,255,25,44,124,96,113,503,32,62,58,117,61,27,49,279,134,193,144,105,117,142,61,165,82,1150,819,88,372,491,441,97,115,43,49,76,41,37,209,109,160,103,1709,273,317,63,104,306,78,45,355,176,62,122,99,48,22,104,213,69,704,58,71,106,130,36,48,38,602,112,189,37,1,182,371,18,104,65,1313,171,119,15,263,20,97,39,33,192,376,107,132,42,275,86,84,166,225,91,114,206,60,56,117,51,126,49,71,116,59,184,40,42,396,1101,238,173,106,656,78,43,34,34,48,35,113,39,84,320,209,409,46,31,31,98,41,236,309,35,41,506,57,116,124,101,345,48,121,50,35,158,315,55,79,114,129,38,69,22,59,105,56,120,152,51,133,620,166,33,55,74,1067,22,80,290,183,89,65,119,36,151,268,169,253,379,31,68,48,19,36,41,122,61,100,73,207,26,27,74,166,77,62,219,74,197,494,98,180,53,40,73,40,66,142,16,48,126,40,102,329,622,186,223,43,89,90,150,143,133,253,154,193,62,72,49,446,225,77,46,85,45,58,210,308,69,82,140,169,71,69,116,76,41,24,179,14,211,111,48,55,203,30,77,130,42,849,75,283,51,25,17,133,107,72,38,386,55,17,120,92,22,53,86,112,46,39,45,175,56,31,63,265,43,74,138,180,212,24,31,84,18,138,35,51,12,22,74,250,50,322,88,118,248,87,36,287,41,235,42,377,25,75,224,44,193,41,111,60,26,64,120,136,35,20,165,82,90,136,70,61,34,296,358,115,114,80,63,24,216,146,30,48,48,99,242,151,60,84,123,27,42,286,77,80,126,21,117,39,74,50,174,81,34,97,45,486,31,331,97,49,265,36,182,239,29,147,62,131,94,220,99,346,44,222,36,128,42,54,35,40,49,58,32,140,68,19,69,58,105,90,73,34,55,30,27,35,68,122,85,19,33,41,70,91,110,123,58,35,80,29,48,10,75,99,43,96,138,42,118,22,14,130,56,244,61,117,40,59,41,351,58,29,72,53,169,93,201,191,229,58,57,125,95,51,31,107,54,31,37,43,107,46,107,137,51,48,117,38,48,56,60,77,39,34,13,654,264,21,41,106,55,29,138,64,67,75,47,26,22,67,180,30,86,57,40,28,30,52,40,119,124,49,72,24,53,31,131,57,132,36,41,123,50,100,178,98,52,41,57,59,53,59,54,253,116,34,26,17,35,85,79,49,119,112,32,245,40,34,307,51,62,131,33,32,63,194,51,113,39,104,122,104,49,220,196,101,47,115,17,56,34,74,43,50,108,46,80,88,160,89,43,53,42,46,98,139,220,92,43,127,31,44,41,238,117,133,22,54,42,64,178,33,168,54,47,181,141,73,52,186,50,110,30,60,40,88,93,14,203,32,57,44,74,103,179,151,148,153,125,46,23,67,47,36,86,64,32,53,119,48,172,38,45,40,953,142,48,55,39,32,99,262,110,56,104,57,48,107,102,46,47,21,60,81,68,143,43,261,149,192,45,24,54,38,61,49,166,91,52,76,42,89,30,31,83,105,107,108,91,49,86,45,33,88,81,22,39,31,60,71,70,114,93,38,34,38,72,56,185,114,217,73,62,42,52,76,38,48,177,39,35,83,24,36,88,56,110,65,39,58,37,196,38,182,92,81,60,46,113,90,49,93,67,53,51,82,49,29,78,49,53,49,70,37,148,121,100,40,45,134,131,76,46,43,58,63,27,17,105,31,88,67,20,91,62,21,21,71,47,61,54,58,99,63,69,49,70,21,41,57,117,18,56,26,27,37,39,79,73,58,26,50,36,88,45,59,24,47,49,27,32,31,66,40,75,34,33,63,67,47,31,39,43,83,41,68,49,72,39,56,55,57,184,79,77,58,48,46,40,45,72,62,32,37,55,157,131,45,34,25,33,49,59,40,22,36,40,42,37,37,63,43,26,59,82,29,28,122,100,35,63,24,59,71,27,28,67,29,31,82,25,41,24,34,59,32,65,27,20,55,72,22,22,65,44,34,31,42,66,77,35,41,102,26,151,47,61,50,77,79,36,27,39,32,43,56,63,53,46,22,37,36,87,38,55,30,29,49,44,42,30,41,42,36,58,34,86,51,44,59,141,110,97,260,40,25,47,44,61,28,52,36,44,140,35,50,28,43,32,25,123,39,35,23,53,68,41,60,37,43,33,29,40,41,43,49,49,43,102,35,26,47,31,131,25,34,21,43,7,13,31,29,35,19,34
see,20,53,21,198,35,45,14,62,15,18,45,24,35,217,11,49,30,57,40,17,12,74,85,89,52,34,58,67,34,63,18,363,293,51,131,262,99,10,25,23,20,80,17,23,97,49,49,36,509,155,128,35,33,168,55,14,91,49,40,43,23,25,5,29,76,35,272,16,22,29,44,4,20,20,290,56,87,7,182,1,98,12,31,37,405,43,24,2,57,5,18,17,8,57,119,33,40,16,90,33,14,62,52,42,24,53,16,23,31,14,55,10,37,44,30,80,15,19,111,299,106,112,64,193,30,17,11,12,10,10,75,19,40,93,64,177,25,6,16,35,13,92,66,9,11,207,28,43,26,28,106,9,49,20,14,49,118,21,39,87,39,10,28,12,11,57,12,59,65,25,44,236,80,22,40,12,286,12,21,113,69,26,37,69,10,76,75,56,75,101,8,24,15,15,12,7,43,23,17,36,92,18,8,19,65,34,7,77,40,63,171,38,51,13,28,45,10,21,37,12,10,39,15,38,68,186,83,58,10,13,28,20,37,45,85,36,71,29,21,34,128,72,22,31,41,10,14,95,85,31,23,42,67,17,19,46,17,7,7,38,26,83,29,4,29,46,22,46,58,14,232,10,26,22,7,17,48,21,22,8,199,24,12,41,22,7,41,45,40,18,5,13,39,18,7,15,78,15,17,47,73,23,0,8,34,6,49,4,28,13,6,43,60,24,70,27,59,73,36,10,89,21,89,29,149,11,39,131,10,52,23,27,14,7,17,31,53,10,8,28,23,34,56,36,16,26,71,110,36,41,19,41,8,72,39,23,29,38,36,83,50,15,34,42,13,25,62,36,35,105,8,88,13,56,41,33,14,6,58,19,137,5,71,23,43,77,17,40,66,15,69,27,33,28,73,42,91,14,65,3,44,25,16,22,25,22,23,8,57,26,12,26,17,35,20,34,22,17,23,31,19,22,61,36,13,26,11,38,18,26,22,9,7,26,21,7,10,31,34,16,28,20,13,53,10,10,54,29,69,26,55,10,30,14,90,15,28,31,37,48,60,49,48,118,8,13,59,38,23,17,67,26,13,18,15,67,15,30,59,16,24,35,19,16,20,15,13,28,9,4,133,79,10,26,39,6,4,25,19,31,31,15,8,9,17,46,23,36,16,12,12,9,13,25,29,29,16,36,44,23,12,38,13,60,18,11,62,34,21,49,25,20,20,23,21,21,18,80,82,64,15,4,9,34,31,15,36,27,24,15,52,15,15,78,24,16,56,13,18,18,44,9,17,3,23,31,26,18,63,89,21,22,20,7,9,6,19,12,11,32,10,19,41,57,32,30,15,12,11,42,48,75,34,20,73,13,15,14,73,64,35,7,6,10,12,39,11,43,11,14,66,40,23,12,46,12,31,22,27,4,29,20,5,39,7,15,12,10,28,47,31,29,81,41,13,8,30,10,12,15,26,20,27,24,18,43,14,7,12,287,41,14,20,9,22,27,58,37,27,20,10,11,7,29,9,6,6,11,39,18,24,15,93,41,38,12,4,12,13,8,15,55,27,14,12,10,35,10,12,11,24,54,16,12,5,23,26,5,36,15,15,7,7,20,19,15,40,15,7,8,9,10,21,41,27,33,27,19,22,19,9,7,16,43,5,37,27,10,3,18,14,27,12,20,12,4,22,14,57,22,22,7,12,14,18,15,36,12,10,8,22,7,3,19,3,24,13,16,6,23,21,33,7,10,42,34,28,12,11,13,28,11,15,29,0,19,17,11,19,18,3,7,23,24,17,9,14,58,10,20,12,25,9,15,53,33,33,12,9,6,8,7,24,4,37,22,19,12,39,9,12,13,13,16,7,8,8,22,8,19,16,8,9,16,5,11,23,12,20,10,20,10,26,6,18,20,10,67,27,13,15,9,8,16,7,16,23,24,10,25,42,38,15,12,9,8,14,8,8,6,10,9,7,15,12,12,24,7,18,11,6,11,6,27,10,8,6,13,30,20,5,9,9,3,15,6,10,20,9,11,21,16,8,7,12,12,9,8,11,30,9,9,11,32,17,9,3,19,10,21,8,11,11,17,34,6,7,14,16,9,17,8,10,22,10,12,11,24,8,17,8,9,12,7,7,7,4,9,16,6,9,32,7,7,16,25,24,15,37,11,1,19,12,7,2,3,8,7,21,16,3,5,8,8,5,24,3,8,13,9,10,13,37,31,9,6,11,9,13,12,10,12,16,25,13,16,17,19,24,21,8,9,8,9,5,17,13,9,11,26
increase,28,43,32,571,19,48,33,100,13,21,46,34,87,272,13,18,26,62,19,16,18,141,55,85,73,76,39,60,20,90,31,797,621,91,238,281,154,83,235,46,87,40,8,56,126,51,148,103,758,117,137,44,122,210,65,15,296,248,23,79,64,30,15,59,115,31,382,95,38,88,195,25,26,18,493,52,131,31,371,98,1,54,52,49,754,188,104,42,277,40,103,38,161,101,281,250,118,103,208,130,111,172,112,52,87,122,122,64,146,43,110,30,100,105,54,171,21,39,265,716,162,113,361,975,55,9,61,30,47,53,75,15,28,299,48,308,14,19,43,56,11,163,179,23,14,280,21,111,126,119,234,31,86,54,74,171,140,79,25,112,219,19,49,51,139,41,44,114,122,30,144,364,95,14,44,32,594,42,42,257,119,42,120,91,27,96,217,93,98,174,3,15,117,23,22,31,93,36,83,64,206,37,60,38,124,39,51,199,59,137,354,35,95,104,21,30,59,110,116,33,61,77,27,67,237,354,282,191,44,127,77,148,215,92,211,393,106,74,149,27,227,148,22,25,58,38,22,133,309,24,73,210,66,107,74,61,47,60,38,356,56,158,61,13,24,377,66,26,62,46,521,104,452,41,17,22,83,361,49,12,240,41,52,89,81,51,48,64,58,18,25,11,66,68,50,52,175,31,21,88,87,172,74,71,51,25,84,28,32,37,29,96,197,71,382,155,140,208,84,31,121,27,127,65,111,6,58,110,16,111,6,98,29,32,22,67,77,33,43,110,27,29,70,25,97,36,174,195,93,55,68,30,17,167,85,77,19,14,69,272,124,93,65,79,31,13,85,46,50,76,22,140,30,58,39,282,52,53,41,51,209,7,219,38,33,162,34,132,129,15,61,40,52,23,101,33,182,24,110,48,90,19,21,12,21,64,45,18,188,85,8,47,214,120,11,24,13,19,8,17,19,45,53,23,18,32,28,37,41,73,86,41,39,52,21,30,15,23,68,23,57,120,32,93,19,17,106,26,158,58,91,42,25,18,266,24,4,29,42,135,43,123,111,205,46,24,120,68,35,8,89,28,32,20,18,112,14,31,87,43,35,78,15,9,34,18,150,12,19,17,376,177,6,19,79,17,42,90,46,28,66,36,82,26,44,137,79,71,21,28,95,17,29,29,68,68,26,35,15,61,18,51,24,75,18,29,75,38,49,129,63,33,18,50,42,30,29,31,140,77,17,33,14,125,88,35,10,115,46,32,56,14,14,219,54,35,201,32,47,32,80,32,92,27,56,73,36,25,141,144,80,41,110,15,35,10,119,38,39,197,98,44,67,40,31,37,35,38,22,37,76,79,69,24,165,26,60,142,78,61,78,34,18,7,29,64,26,68,39,58,146,77,22,33,80,44,72,32,36,19,63,70,27,86,32,49,26,54,36,168,106,123,78,64,24,12,40,111,28,48,63,25,38,85,24,214,64,27,51,424,59,25,22,21,19,68,168,48,9,54,24,30,19,62,19,9,1,20,52,44,72,50,78,96,70,33,19,35,26,20,53,131,37,71,51,32,55,46,32,73,51,42,60,69,25,68,27,5,131,43,37,18,27,22,53,37,78,27,17,10,10,84,28,117,75,195,33,28,20,128,30,21,15,134,26,36,68,29,22,75,33,83,56,33,27,58,220,61,93,177,55,19,37,93,55,15,139,96,42,42,41,173,131,214,195,73,39,66,62,478,511,79,41,143,117,261,54,41,123,41,39,20,69,47,19,72,79,33,33,46,14,17,52,32,62,42,44,16,54,66,45,51,20,21,70,69,36,38,46,18,31,35,27,21,21,10,59,46,74,29,124,13,25,48,33,12,24,25,13,46,10,115,15,38,31,15,22,38,24,33,57,35,36,17,28,50,34,115,23,16,8,12,30,12,43,56,40,25,33,33,31,80,21,45,18,23,45,59,11,30,23,19,26,15,21,40,7,13,20,100,33,23,89,56,23,28,2,26,29,41,1,29,9,9,36,26,26,30,40,33,15,77,23,24,20,13,25,11,66,23,47,7,24,30,6,63,4,43,32,67,22,58,45,91,27,46,47,43,36,34,11,29,25,98,17,14,19,15,23,44,27,33,15,49,24,69,62,38,13,107,33,83,180,51,79,100,83,244,246,13,46,23,15,31,40,42,96,31,96,16,99,31,21,39,64,57,31,83,3,36,14,12,62,40,11,40,48,29,26,28,158,22,20,62,29,91,41,67,13,11,18,14,52,19,21,75,43,16,29,14
inflation,0,6,1,31,2,14,1,5,0,1,0,0,13,11,1,0,4,0,6,2,1,6,9,6,3,9,5,17,2,7,1,33,19,4,8,27,5,3,54,5,3,5,0,15,6,1,10,7,8,20,11,4,6,14,1,0,0,4,10,3,2,1,1,1,5,9,36,19,3,5,28,0,1,1,64,7,13,0,18,12,54,1,1,4,77,14,4,23,5,1,10,1,33,6,33,69,8,1,16,14,2,6,6,6,15,11,11,21,11,14,5,7,41,24,20,16,2,3,9,27,19,21,38,66,5,0,3,1,4,3,6,3,9,20,3,27,0,10,12,11,3,23,13,4,5,24,9,13,3,5,8,9,4,7,15,18,14,8,0,11,50,1,3,5,17,3,0,6,7,6,11,23,6,2,1,0,10,0,4,22,5,1,16,12,5,15,10,4,0,10,0,0,3,8,6,1,8,8,8,3,33,12,9,1,10,5,3,14,1,4,7,7,7,5,4,5,11,24,5,1,3,4,0,3,7,11,2,11,1,14,6,4,33,30,14,7,5,6,14,3,19,3,8,3,5,3,1,16,20,2,2,4,7,3,2,5,6,10,2,6,0,6,7,0,6,8,1,6,4,7,14,3,6,1,0,9,10,7,1,0,16,2,4,4,10,2,28,30,3,4,1,0,3,2,1,7,1,1,0,4,10,1,1,5,3,6,13,4,4,7,1,3,13,6,8,3,2,13,5,9,4,1,9,6,7,0,10,13,0,20,0,3,4,2,1,1,4,0,3,2,1,6,2,0,2,1,9,6,0,8,2,1,0,6,2,2,4,1,3,12,6,4,2,4,0,2,5,0,10,3,1,5,4,7,4,3,0,11,3,2,9,0,7,2,0,3,7,11,5,2,1,4,0,0,1,4,4,1,5,1,1,1,0,1,5,2,4,0,10,4,0,0,5,0,0,2,0,0,0,1,4,3,6,0,1,1,0,0,3,7,4,0,0,1,2,0,0,0,7,3,5,6,0,1,0,0,4,6,4,6,11,0,7,4,8,1,0,0,4,4,6,12,6,5,2,0,24,4,1,1,4,6,2,0,1,5,1,3,7,3,2,1,0,0,4,0,2,1,0,1,14,4,2,0,4,0,2,3,3,5,1,0,0,6,2,5,6,0,2,6,1,1,1,6,0,2,3,2,4,7,0,0,1,6,0,1,12,4,2,11,4,3,2,3,1,0,0,1,8,4,0,2,1,5,10,1,0,6,0,0,1,0,0,7,0,4,4,6,5,1,4,0,2,3,0,2,2,4,4,5,4,0,0,3,4,0,1,0,1,4,1,5,0,4,1,0,3,0,0,0,3,2,6,1,20,2,3,24,0,2,5,1,0,0,0,1,0,3,1,1,2,2,0,1,1,0,1,9,0,0,3,1,0,3,3,0,0,1,1,2,2,0,11,4,2,0,4,2,3,3,2,2,1,1,1,2,11,0,1,0,0,1,2,0,0,3,2,7,1,2,0,0,0,1,0,0,0,2,0,2,3,0,0,4,0,0,0,0,0,1,0,4,0,0,3,1,3,0,0,0,0,6,2,0,0,1,0,1,0,0,0,0,0,0,0,0,4,5,2,0,2,0,0,12,5,0,0,0,2,1,0,1,1,0,2,0,1,3,0,6,1,1,3,2,0,0,0,0,0,1,2,0,4,0,0,2,2,5,1,0,4,2,1,1,4,1,0,2,0,4,1,1,0,4,3,10,3,5,2,0,1,0,16,1,1,1,0,6,0,0,0,0,3,2,1,5,4,0,0,4,4,0,0,0,2,0,2,0,0,0,0,1,0,0,13,0,7,0,3,0,0,0,0,3,1,0,3,1,0,1,0,0,0,1,0,0,0,1,1,0,3,1,1,0,2,3,0,8,0,0,0,2,0,2,3,1,0,0,2,4,1,1,0,0,0,0,3,3,0,3,1,2,1,1,1,1,0,1,0,2,0,0,2,8,6,1,0,0,1,1,0,0,2,0,0,0,1,0,0,1,1,0,1,0,0,0,0,0,0,15,0,0,0,2,1,0,0,4,0,3,3,4,0,0,0,0,0,0,2,0,1,2,1,1,0,1,0,1,0,5,0,2,2,0,0,0,3,0,0,1,2,1,0,0,1,4,5,2,6,1,0,4,1,0,3,0,1,0,3,0,0,0,0,0,6,0,0,6,0,0,1,0,27,7,0,1,1,6,1,0,0,0,0,2,1,0,3,12,0,0,0,1,0,3,12,7,10,0,0,1
soon,12,32,2,195,7,8,5,48,7,7,44,9,23,77,9,16,9,22,8,9,7,64,18,27,20,20,6,16,4,22,20,230,157,7,54,66,54,18,16,6,6,8,5,8,36,17,39,11,486,33,64,6,19,51,11,7,53,36,5,38,33,12,3,45,37,9,110,4,11,27,16,10,2,6,79,16,25,9,104,31,52,1,1,9,287,35,28,0,48,3,21,5,2,32,73,19,33,10,54,13,19,43,62,14,20,35,3,4,18,5,31,8,11,16,12,37,7,9,108,208,44,19,14,94,11,4,1,9,5,2,29,13,7,66,15,45,12,6,7,8,3,52,37,7,0,93,8,19,18,17,83,7,21,14,5,16,30,10,8,9,17,10,10,2,5,14,8,21,27,19,35,93,35,9,10,11,199,6,14,39,32,14,8,33,6,19,37,25,44,80,6,10,11,2,3,5,26,4,12,13,30,2,6,26,38,12,9,48,12,30,94,6,36,20,5,11,0,3,19,8,2,24,9,31,49,107,25,28,7,12,12,26,26,36,43,35,50,11,7,6,67,46,15,6,14,9,9,16,43,9,11,28,42,17,10,20,14,2,10,26,4,49,35,1,5,43,5,9,19,6,193,17,26,10,4,7,21,14,10,2,54,11,3,18,19,2,7,18,10,5,9,9,12,12,0,3,71,11,8,24,30,23,0,6,8,6,19,6,6,3,6,22,33,5,59,21,20,55,23,5,75,15,34,4,67,5,5,44,12,20,5,8,9,4,14,16,22,21,4,23,13,24,16,14,16,12,58,86,20,8,17,14,10,54,35,17,12,3,22,36,20,11,12,32,10,4,51,6,5,19,6,22,3,11,6,31,13,3,10,11,116,1,59,9,2,79,6,35,37,4,26,4,16,20,31,8,64,5,53,3,29,3,7,2,8,7,8,9,39,7,4,29,12,10,31,17,9,16,4,1,4,17,21,17,1,4,7,15,21,27,15,13,5,20,1,8,1,30,14,8,17,26,11,33,3,11,11,15,54,9,17,12,9,9,77,16,1,16,2,44,28,21,45,26,13,0,23,27,12,0,16,5,4,5,5,16,4,15,39,11,14,18,13,9,11,12,17,4,9,1,82,51,1,3,8,8,9,22,9,10,20,7,0,5,33,37,8,14,8,11,9,5,32,7,15,15,11,6,1,10,5,22,5,19,4,7,26,5,29,32,15,7,5,12,18,11,18,20,80,26,8,5,1,4,11,20,20,22,21,15,23,9,2,61,9,2,40,4,6,10,23,8,33,4,25,31,20,4,39,33,21,23,20,0,9,13,8,13,11,21,7,28,16,14,7,6,9,13,6,10,21,34,6,6,21,11,4,5,76,23,28,3,8,8,9,29,9,21,6,10,27,29,26,8,32,9,22,10,8,12,11,10,8,26,5,10,32,11,20,69,23,28,22,29,14,1,6,6,2,15,5,5,6,40,26,39,4,17,0,296,38,7,11,8,11,23,41,20,12,28,5,21,41,42,16,14,9,19,23,16,20,5,72,18,47,7,3,28,3,13,5,33,13,16,14,14,21,14,11,26,16,7,27,17,12,29,12,8,10,18,23,5,6,9,5,18,47,14,4,7,9,14,14,35,27,26,12,9,14,4,16,10,13,32,5,14,20,4,5,19,6,17,8,8,8,8,30,6,53,16,21,26,14,16,13,2,12,7,10,10,14,10,1,21,9,13,14,21,14,12,11,26,7,6,33,17,22,9,5,23,7,7,2,21,6,18,11,10,24,12,16,11,9,6,9,11,8,29,4,25,16,12,1,6,11,22,1,6,8,5,4,14,16,5,7,3,11,5,28,11,10,9,24,19,11,8,4,13,19,11,7,4,13,29,13,10,11,11,11,9,11,9,19,6,11,7,10,41,20,13,27,7,2,10,9,14,18,11,3,14,48,42,11,9,6,6,4,5,8,6,20,9,7,4,12,11,4,6,7,14,0,8,6,11,10,6,13,37,19,8,3,8,4,9,24,5,13,6,15,7,16,27,2,17,11,11,10,11,12,4,10,13,3,16,5,9,26,18,5,23,9,12,8,23,21,4,11,7,7,4,17,6,11,11,9,9,11,41,2,9,5,6,12,7,2,6,17,12,6,11,2,8,2,7,10,27,19,19,25,8,1,12,2,7,5,10,10,9,20,16,0,21,6,7,1,34,10,2,5,9,6,2,9,9,14,16,2,6,30,14,14,4,10,22,7,7,11,6,37,2,2,5,4,1,0,4,3,11,6,2
turn,3,21,2,66,8,17,9,19,2,10,15,11,23,98,3,5,4,14,17,5,4,23,33,34,18,18,24,19,13,25,8,135,96,13,53,106,40,3,15,12,6,24,8,14,23,14,12,12,143,80,47,18,7,75,37,7,20,10,21,25,13,6,1,7,17,23,124,10,7,15,24,4,5,4,94,13,27,4,65,37,49,4,9,1,136,17,12,2,13,2,11,6,10,16,21,9,15,4,27,24,4,23,11,19,7,29,0,12,12,5,26,1,6,21,15,26,2,8,32,109,27,37,12,77,13,6,5,5,2,2,39,10,12,38,35,70,8,8,7,16,11,32,17,5,2,69,34,19,14,6,45,7,14,6,7,17,30,9,7,49,14,7,4,4,8,30,9,22,16,6,27,94,30,7,6,7,95,10,6,65,30,6,25,24,6,38,28,10,27,37,4,8,5,3,4,8,17,9,8,6,25,1,5,5,13,12,6,20,11,30,75,45,23,9,12,22,7,8,10,3,11,21,7,23,19,64,38,13,9,1,10,13,15,16,21,13,30,10,8,8,51,34,14,11,30,4,5,25,34,5,11,25,30,4,7,14,4,4,1,18,1,35,5,2,12,13,25,17,23,3,82,12,7,7,3,5,16,5,5,6,68,10,7,11,18,5,7,19,16,4,3,6,8,7,6,4,19,1,6,17,17,12,5,3,10,4,26,5,11,5,2,24,23,8,22,4,17,32,12,2,23,12,27,27,49,5,17,42,5,15,5,9,3,6,6,5,23,7,3,6,13,12,18,12,6,5,17,33,14,14,4,12,3,31,19,4,11,10,12,37,15,6,9,14,6,6,25,8,15,34,1,27,6,20,6,16,7,5,18,5,50,7,25,9,16,27,9,20,15,6,15,10,10,9,17,14,15,2,23,6,11,25,1,12,8,15,11,2,12,6,6,8,10,14,16,11,6,9,6,16,1,11,12,8,6,5,4,3,5,13,1,1,1,3,3,4,2,8,16,6,8,17,11,9,6,5,30,10,34,7,18,4,10,11,37,4,12,6,9,8,22,24,31,66,4,17,31,10,10,2,32,14,4,10,8,32,6,10,33,13,18,11,4,11,12,4,8,7,9,1,80,23,10,11,13,1,11,6,10,11,18,4,4,5,7,21,16,13,4,5,5,3,5,3,6,2,10,12,33,11,3,11,3,15,10,7,31,16,13,12,9,11,11,8,8,8,5,18,38,15,8,6,7,21,11,3,6,7,10,2,11,0,7,25,5,4,14,5,2,6,12,2,6,5,10,7,2,6,18,22,5,4,6,1,6,1,6,4,7,22,5,6,13,23,5,4,4,7,2,10,6,23,10,4,22,3,5,8,16,10,8,5,3,2,6,12,2,6,3,2,25,9,9,4,21,2,8,7,2,2,5,1,3,7,2,3,3,5,9,32,2,19,15,16,2,7,23,9,6,3,7,7,10,22,7,13,8,2,6,73,34,7,4,1,3,11,11,8,4,13,4,11,9,5,5,0,2,7,4,7,7,1,3,7,7,6,1,1,4,7,5,19,5,3,6,3,8,9,4,4,9,17,8,4,7,8,9,1,6,2,3,3,1,5,3,11,11,12,0,1,10,2,4,12,7,12,7,2,12,8,5,14,3,25,6,11,8,8,1,8,8,16,5,7,3,1,17,2,18,8,11,6,3,19,15,4,11,8,11,1,8,1,1,3,3,6,4,6,3,15,19,19,2,7,12,14,11,5,7,6,12,7,5,8,4,13,12,3,4,5,4,2,5,10,7,6,4,1,4,4,8,13,4,1,8,19,13,5,2,0,3,6,6,1,14,9,13,6,11,2,2,8,4,6,3,3,7,9,2,6,3,2,3,12,5,4,13,4,4,4,8,8,9,3,3,3,7,15,10,2,3,7,4,7,4,4,7,8,3,5,19,13,2,3,6,4,8,0,6,0,4,5,5,6,5,5,7,3,7,6,0,2,3,6,9,7,2,2,7,4,0,4,4,2,2,1,5,0,3,1,6,6,1,2,2,1,2,16,4,17,5,1,4,4,6,4,14,3,7,7,5,7,3,2,7,2,6,3,4,3,2,3,2,3,4,2,7,5,2,3,3,3,6,1,4,2,7,4,3,14,1,10,2,1,4,2,9,6,13,0,2,8,5,5,2,0,5,5,4,1,0,2,4,1,6,13,4,0,2,6,14,6,13,7,1,2,5,0,7,1,3,2,0,0,3,2,6,9,12,10,5,5,3,6,4,5,8,0,6,4
government,140,497,168,2265,167,98,86,627,81,50,614,250,151,1103,88,204,140,363,155,72,114,722,157,414,397,227,189,256,114,283,167,3102,1969,140,887,877,630,219,168,97,182,156,113,66,568,356,465,307,6224,403,738,109,200,482,167,141,1064,405,52,258,450,157,67,216,343,130,2165,128,157,215,209,69,95,77,1513,235,311,95,1313,405,754,77,287,136,1,479,245,71,652,68,137,105,64,522,1104,259,322,104,671,246,245,488,608,230,244,501,111,115,239,92,320,109,218,367,58,526,140,87,1133,2617,651,358,385,1072,131,74,74,105,85,43,184,79,113,757,360,780,165,91,102,118,53,570,534,64,60,1142,122,264,221,320,1358,33,308,154,129,807,458,92,229,221,229,78,161,56,179,180,59,400,393,197,311,1472,434,42,64,168,3127,61,181,608,416,245,152,327,116,386,568,393,824,1063,43,94,58,17,86,101,280,113,153,354,535,66,84,229,599,236,156,569,217,563,1350,100,434,174,57,82,91,144,263,85,116,341,103,255,739,1696,435,455,112,245,208,252,366,525,543,520,550,176,137,120,1155,565,113,120,293,130,134,384,836,120,211,358,351,161,179,242,227,75,89,249,120,394,407,115,158,773,143,128,245,124,2279,191,683,128,74,43,419,333,232,65,998,148,43,338,203,38,114,199,255,44,115,106,263,141,98,213,912,136,153,315,490,571,43,91,229,48,451,80,137,63,66,595,481,136,734,312,284,768,246,139,1017,150,441,120,1235,171,214,503,97,547,84,218,216,121,134,305,358,178,143,231,214,203,260,241,117,132,886,952,349,121,219,202,128,556,431,76,131,88,298,497,390,160,172,372,94,37,614,141,175,217,62,415,129,190,170,389,162,73,268,147,1113,72,734,260,71,621,124,462,488,109,491,80,185,221,595,209,1055,93,635,59,448,49,95,39,117,126,107,98,330,241,75,164,92,285,254,203,99,129,71,45,107,182,398,265,33,97,59,309,198,336,372,142,72,205,78,112,16,295,133,84,318,488,193,222,33,60,183,127,598,141,299,119,61,120,927,180,29,210,151,505,260,376,466,367,108,72,264,234,218,18,292,66,74,43,60,296,97,329,307,127,113,208,86,104,152,166,199,90,107,75,1058,683,47,106,143,151,61,362,140,164,214,89,102,39,162,473,92,309,132,84,122,100,119,164,277,317,120,212,75,148,78,389,171,515,194,122,418,196,391,507,192,107,55,174,191,131,220,209,767,352,105,50,53,167,131,126,186,329,378,190,790,128,86,838,144,187,479,124,152,155,416,81,406,91,274,276,264,181,694,689,235,185,251,103,140,134,121,117,108,305,84,276,225,312,162,118,120,169,81,201,488,611,196,89,399,64,122,69,999,368,418,89,100,119,181,371,132,522,159,149,442,385,264,108,602,183,346,72,162,95,228,162,71,481,60,148,161,182,258,559,429,410,495,474,162,72,270,150,70,190,228,35,132,586,182,493,125,133,158,3592,452,144,132,142,120,178,728,360,158,290,109,101,356,432,197,141,146,188,210,215,303,143,872,411,749,172,49,106,156,99,170,432,238,159,197,168,358,144,75,163,282,214,296,281,137,145,177,159,308,254,183,128,133,141,225,109,322,86,85,115,124,175,119,413,334,249,126,192,194,144,156,112,164,341,42,112,134,48,70,181,136,261,121,118,112,53,183,121,598,146,205,140,86,89,157,76,259,191,104,174,186,203,106,244,144,252,174,223,94,396,361,235,123,103,317,281,233,132,190,256,109,80,50,307,98,278,193,117,304,198,87,108,180,135,201,111,160,389,133,274,127,251,94,120,266,349,102,139,88,139,97,102,204,76,100,98,166,144,365,111,120,154,155,168,54,107,128,209,129,281,136,61,173,214,84,112,89,136,216,105,172,107,286,78,144,157,180,456,216,116,155,144,77,141,135,180,147,188,93,217,387,579,184,145,55,118,130,187,158,51,149,118,176,84,98,173,80,83,162,222,111,66,328,246,103,105,195,229,252,115,123,113,67,122,193,109,116,110,103,100,94,143,13,92,184,212,79,93,95,63,168,123,71,220,143,103,172,248,109,340,159,187,123,242,215,117,42,156,76,77,191,181,117,193,88,141,109,446,120,180,138,90,158,128,106,74,90,114,118,171,52,266,143,123,177,417,295,230,792,90,24,94,53,104,99,91,72,78,331,137,64,91,90,64,41,295,102,70,66,108,82,129,131,104,132,129,44,151,144,103,72,118,104,234,108,217,173,72,437,39,84,74,92,24,28,90,34,88,36,46
money,4,34,9,246,8,15,3,34,4,9,17,7,19,79,12,3,12,45,11,6,6,64,42,62,48,36,12,11,16,45,11,342,235,16,79,98,31,45,31,7,27,4,5,9,64,15,45,20,391,19,103,13,26,39,25,1,143,58,7,23,13,9,3,35,35,4,269,32,7,6,47,7,22,11,150,21,60,11,171,43,188,14,35,17,479,1,52,19,42,14,20,11,23,50,147,79,39,10,75,40,30,56,58,21,30,53,28,27,35,12,29,17,51,60,22,43,10,10,81,352,80,27,89,170,18,4,4,3,7,14,48,1,7,79,40,105,6,12,21,5,3,58,67,11,3,147,26,39,46,45,128,13,54,17,14,61,66,8,6,42,47,28,54,10,25,42,12,31,49,16,30,155,67,10,27,16,224,6,18,108,62,22,19,45,25,51,84,42,40,66,4,21,13,6,65,2,45,14,15,29,82,38,13,13,59,12,32,100,29,38,150,23,48,52,14,28,9,19,26,7,34,28,6,38,97,137,63,60,12,52,28,34,51,48,87,125,60,31,15,17,114,59,10,9,27,17,6,69,92,27,22,71,31,26,28,44,18,11,9,50,15,28,13,8,17,81,35,7,17,13,261,70,176,18,10,7,36,62,18,7,122,7,6,22,28,3,6,40,16,13,5,4,60,21,11,15,99,11,22,33,40,50,6,27,32,14,23,4,9,3,4,47,65,7,222,32,59,81,37,8,39,20,46,18,61,6,18,48,6,52,10,38,14,15,15,42,24,11,19,31,21,16,34,13,19,10,65,64,38,25,43,24,14,147,41,11,18,6,41,49,35,16,16,40,5,2,60,19,16,42,8,62,14,31,21,36,13,18,13,16,98,7,112,9,12,74,8,36,50,9,17,8,29,11,47,14,78,14,42,7,17,3,5,1,6,13,20,1,44,17,3,3,17,28,6,11,9,10,9,1,6,3,34,21,3,10,5,26,15,28,48,23,9,31,0,2,0,4,15,12,18,32,16,19,0,3,31,9,52,18,39,8,9,10,85,7,2,13,40,53,25,39,41,42,11,3,43,13,11,4,21,17,10,13,7,43,3,17,49,40,25,27,0,5,16,5,14,3,7,1,107,67,1,4,23,7,8,32,18,26,21,19,11,11,28,170,23,24,22,19,23,8,9,8,36,29,19,26,13,17,3,26,28,44,25,6,45,40,34,36,20,16,3,31,9,28,18,27,87,51,8,4,8,20,46,19,6,38,21,13,70,7,11,63,3,19,32,9,25,13,37,9,30,5,38,34,25,12,91,61,41,15,80,6,11,14,16,14,27,34,11,27,35,19,6,4,9,26,5,23,26,52,19,11,36,17,39,12,20,29,36,6,15,2,3,59,20,31,6,38,51,26,19,4,38,10,66,6,12,7,35,98,2,90,14,20,11,20,16,52,130,38,43,32,10,5,8,29,6,34,26,3,13,33,13,57,11,7,6,187,4,7,16,9,8,21,64,26,8,21,10,1,1,6,6,1,1,8,27,17,20,27,48,20,30,5,6,19,11,13,19,47,18,13,20,11,29,6,3,9,17,17,32,6,7,22,16,5,48,22,5,3,6,17,17,11,35,5,6,5,4,17,20,46,24,26,7,12,12,15,13,6,3,34,9,3,36,7,4,29,20,30,25,15,12,8,32,14,27,17,31,10,9,19,7,7,39,17,21,18,20,31,15,19,25,17,14,18,9,139,116,31,17,27,20,77,15,23,10,10,8,11,4,31,4,33,36,12,4,30,6,4,24,33,26,11,29,5,21,16,17,8,3,3,24,71,12,14,9,6,19,10,20,4,11,8,10,7,21,7,28,1,7,15,6,5,15,14,12,32,1,3,5,21,5,16,15,14,59,12,39,9,27,5,16,25,12,35,25,5,7,6,3,10,26,35,20,6,15,10,10,50,6,35,3,18,4,22,13,2,3,5,19,5,12,7,4,3,4,21,2,6,102,92,11,8,1,17,13,4,10,12,3,1,9,4,14,11,7,23,12,19,21,5,4,4,1,6,11,5,17,10,3,16,17,8,0,26,8,29,9,53,5,55,9,14,7,12,8,4,14,10,18,44,2,5,2,5,2,61,11,10,14,8,9,17,13,12,5,31,7,54,17,24,46,80,55,34,196,9,4,6,5,17,54,36,15,4,57,9,9,7,7,5,14,14,2,19,1,10,5,6,11,15,4,1,3,16,11,3,13,3,23,77,17,33,16,15,3,2,4,10,6,5,7,14,14,11,0,1
supply,4,11,4,156,3,7,8,22,2,5,9,4,17,65,17,3,4,26,2,8,11,65,6,19,20,10,12,15,8,27,13,226,192,26,80,86,36,30,49,6,15,5,5,3,29,20,33,17,249,19,62,6,16,62,1,3,81,43,2,19,15,8,6,15,31,7,102,9,8,23,35,19,11,2,128,23,34,9,119,24,104,4,28,12,245,52,1,7,37,6,16,7,15,36,67,30,31,13,53,41,32,43,47,14,13,35,15,9,23,7,22,14,16,29,2,41,4,13,67,252,40,14,22,117,18,2,4,6,14,5,20,3,5,79,35,71,4,6,5,8,3,36,38,13,5,65,7,21,29,39,62,3,7,21,8,32,35,39,12,24,28,13,9,9,22,13,9,29,28,15,37,90,32,10,3,11,196,13,10,100,32,17,13,32,10,31,60,22,22,45,2,8,27,1,1,7,39,11,16,22,45,7,3,17,49,7,54,66,14,36,90,4,24,20,2,0,5,0,15,10,14,15,5,24,80,99,27,36,25,41,16,43,45,44,66,51,39,16,40,8,94,56,17,6,19,11,8,41,95,12,19,72,23,17,15,19,16,7,2,29,4,45,19,8,7,89,5,6,20,10,160,23,79,7,4,2,37,29,9,4,84,15,33,24,26,14,9,13,16,4,4,5,22,15,10,9,46,4,5,18,26,37,3,9,23,2,14,4,15,3,5,22,54,8,69,24,25,52,18,21,40,5,39,5,27,3,9,34,2,31,1,11,14,15,12,20,13,5,10,20,15,20,50,10,24,8,46,66,27,4,22,5,8,80,20,19,5,13,19,47,30,23,24,28,9,4,42,13,15,16,3,43,12,17,17,52,8,11,12,13,46,5,80,15,4,75,4,62,45,6,13,6,7,10,21,19,56,14,60,11,14,1,8,2,8,7,8,2,65,16,3,14,18,27,14,8,2,10,4,11,11,6,22,9,2,1,6,8,9,23,41,11,5,15,8,5,4,5,19,13,22,28,15,30,7,4,22,11,53,15,18,9,10,6,63,9,3,12,9,44,18,23,32,57,16,10,44,20,68,1,27,9,9,5,7,10,3,9,27,12,15,11,2,3,11,4,21,3,2,2,125,46,1,5,13,8,15,22,20,10,22,8,11,10,17,59,21,15,15,11,14,11,8,19,20,19,5,16,4,9,5,22,17,21,8,6,38,14,30,39,12,7,6,11,16,27,6,18,59,35,5,4,5,33,43,9,4,16,12,8,17,5,7,33,20,7,46,11,7,7,37,6,34,12,21,30,16,4,56,46,21,8,33,7,15,4,22,9,8,28,36,22,31,19,14,3,18,13,15,17,10,23,13,6,42,12,13,20,25,32,27,8,14,1,3,35,4,24,20,13,34,26,15,5,29,14,21,14,4,12,45,28,15,53,18,20,6,14,18,37,59,24,39,21,9,8,18,17,6,25,15,2,4,39,10,55,8,9,9,145,38,8,14,5,9,16,67,11,5,19,9,10,4,21,7,2,1,15,10,15,33,23,23,10,25,10,4,4,10,12,20,57,15,11,10,8,12,8,6,30,10,17,24,17,17,20,6,1,12,7,12,7,5,3,12,11,27,14,3,3,8,10,7,34,24,78,18,10,4,8,17,8,4,31,8,39,13,4,10,32,16,27,28,6,4,13,60,12,39,12,15,6,15,40,22,12,24,16,15,7,12,9,7,25,14,20,8,24,5,39,33,29,2,9,20,29,23,12,37,15,17,7,6,16,13,13,21,10,26,16,5,8,19,23,12,17,18,6,16,22,7,21,5,6,11,24,11,7,8,5,9,5,10,4,3,8,8,7,24,10,30,5,17,9,18,1,7,15,3,20,2,5,3,29,13,8,10,6,31,9,15,7,12,6,10,16,10,28,14,8,2,7,2,8,16,15,8,4,5,9,10,41,11,13,9,8,13,15,4,5,6,2,6,11,6,10,5,3,5,17,25,7,28,42,7,7,4,8,9,6,3,8,3,3,13,6,8,6,4,11,5,24,1,4,9,8,10,9,9,10,9,16,5,3,4,8,10,28,5,21,9,14,7,16,12,12,9,12,11,5,5,6,10,33,2,9,10,1,1,12,7,2,6,10,5,11,14,16,1,13,8,16,13,11,29,28,16,31,68,3,13,3,3,10,8,10,6,11,27,4,12,15,8,5,3,29,11,6,2,11,21,6,7,6,5,2,2,12,6,9,10,7,8,27,10,8,3,12,11,3,7,8,17,0,0,4,0,2,4,0
spending,3,5,2,39,3,6,1,1,6,0,0,3,13,14,0,0,2,0,9,3,2,4,22,17,4,19,3,11,0,4,1,45,1,3,13,30,7,0,6,2,1,5,0,14,5,1,15,7,10,16,14,4,5,7,4,0,1,2,7,4,0,1,0,2,8,7,14,13,1,5,11,0,0,1,51,6,10,0,15,2,42,23,0,2,71,19,7,1,7,4,5,5,23,12,7,28,5,1,20,2,1,7,4,8,9,8,20,67,9,17,16,8,28,10,14,11,1,3,7,17,9,10,53,62,4,0,3,5,4,2,5,1,5,16,4,18,0,3,10,3,3,9,4,2,2,24,2,10,2,3,2,12,3,2,31,73,9,4,3,15,11,1,5,0,48,8,1,2,11,7,8,18,12,4,0,1,3,0,5,26,11,2,26,13,4,12,7,1,2,10,2,1,0,4,21,5,13,2,6,1,9,4,10,1,4,6,6,5,2,2,7,5,8,9,4,14,52,89,4,5,14,2,0,4,14,8,6,21,5,38,2,5,44,12,9,10,7,4,5,5,11,6,2,3,4,4,1,14,5,7,1,6,4,0,0,5,0,4,1,5,0,9,6,0,2,2,4,5,4,1,3,5,4,0,0,8,5,14,0,0,15,0,0,1,9,0,14,8,2,2,0,1,6,11,9,1,1,2,1,0,3,10,3,6,4,6,11,1,2,6,1,2,16,3,19,1,1,7,1,4,0,4,11,2,6,0,8,14,0,18,3,2,0,0,1,1,3,0,1,2,4,7,4,0,3,0,1,4,1,10,1,2,0,7,0,0,0,0,2,10,2,7,2,0,0,3,1,0,8,5,2,5,4,2,2,3,1,0,3,0,3,0,2,0,2,0,0,2,5,2,0,0,1,0,0,2,1,0,5,1,0,1,1,1,1,0,2,0,1,4,0,0,1,0,0,0,0,0,0,3,1,4,3,1,0,0,1,0,0,2,0,4,0,0,1,0,1,0,40,4,2,0,0,2,0,0,1,2,0,2,13,0,4,3,3,0,0,0,3,2,8,6,0,2,1,0,11,2,0,1,1,5,0,2,3,1,1,1,4,5,0,4,0,1,0,0,2,0,0,0,14,5,0,1,0,0,0,0,0,0,3,1,1,2,0,0,0,0,0,0,0,0,1,1,1,0,2,0,0,8,0,0,0,0,0,0,4,1,1,3,2,1,1,0,1,1,0,3,4,4,0,0,0,1,1,1,0,6,0,0,1,0,0,6,0,0,2,1,0,0,0,0,0,0,1,0,1,1,3,2,1,0,3,0,0,0,0,1,0,9,0,1,0,2,1,0,2,0,0,0,2,1,3,0,2,0,0,0,0,1,2,2,2,0,0,0,0,3,0,0,5,1,0,0,0,0,1,0,0,0,0,0,0,1,1,0,0,0,0,0,0,0,2,0,0,0,5,2,1,0,0,1,0,2,0,2,3,6,5,3,0,0,0,3,0,1,4,3,0,0,0,0,0,0,0,0,0,1,0,0,0,0,0,0,1,0,0,0,0,0,0,0,0,1,1,0,6,4,0,0,0,3,1,0,0,1,0,0,1,0,0,0,0,0,2,4,3,3,2,1,1,2,0,4,4,0,0,1,0,5,0,2,0,0,1,0,1,1,0,1,1,0,0,0,0,1,0,0,0,0,1,0,2,0,0,0,4,3,1,0,0,0,8,1,4,4,1,0,0,2,1,0,0,7,4,1,1,0,1,0,0,0,1,0,0,1,4,2,0,2,0,0,4,0,1,1,0,0,0,0,0,0,0,0,0,1,0,0,0,0,2,1,0,0,1,0,2,0,0,1,0,0,0,0,0,3,0,6,0,1,0,0,0,0,0,0,3,6,0,0,1,2,0,1,0,1,0,4,0,0,0,2,0,0,0,0,0,1,0,1,4,3,2,0,1,0,0,0,0,4,0,0,0,2,0,0,1,0,0,5,1,0,0,0,1,1,0,0,0,1,0,0,0,0,0,0,0,1,0,0,1,0,1,0,0,0,0,2,1,1,0,0,7,0,3,1,0,0,0,2,1,0,0,1,0,0,0,0,2,1,0,0,0,0,0,0,0,0,0,0,1,5,0,1,0,0,0,2,0,0,0,2,14,0,3,0,3,7,1,0,0,7,0,1,1,1,0,0,3,0,0,0,0,0,1,0,0,0,0,0,0,0,10,0,0,0,1,1,0,0,0,0,0,0,0,0,0,1,0,1,0,0,0,2,0,4,0,0,0,1
last,32,87,27,497,25,13,28,81,28,11,98,48,39,147,7,34,29,47,17,10,18,93,29,58,51,34,28,59,17,103,35,647,348,30,113,157,155,35,37,16,23,16,23,23,124,39,70,50,1006,84,133,17,47,93,31,16,138,212,20,72,79,15,15,46,72,8,212,27,26,39,163,21,17,10,167,26,87,9,263,57,277,5,48,13,652,42,37,7,1,22,94,17,30,115,191,48,72,28,120,38,50,85,93,24,38,85,63,16,91,30,110,13,46,42,15,106,61,16,264,416,114,83,55,666,35,12,8,21,34,17,33,17,14,144,54,129,24,20,16,29,10,113,180,28,17,220,28,53,59,76,140,14,70,18,7,46,95,20,32,33,60,9,26,39,18,28,41,59,65,30,80,242,51,6,14,41,434,16,17,111,70,55,16,51,24,48,97,58,127,287,12,13,27,11,10,21,27,17,83,29,86,4,7,39,77,23,7,96,46,61,205,22,75,25,8,23,36,16,45,11,74,55,23,40,135,250,141,123,30,52,36,121,97,54,82,178,110,22,27,16,191,101,36,23,29,27,19,65,135,14,27,83,64,92,34,53,36,32,23,107,11,97,102,59,30,241,15,12,38,12,356,57,341,12,14,6,61,163,74,8,126,23,7,42,39,10,25,24,33,11,84,43,37,50,47,35,191,39,16,50,78,110,36,46,31,4,60,20,23,7,11,36,117,18,164,97,33,141,59,6,148,16,72,20,131,18,18,67,20,96,22,43,17,10,29,53,53,18,29,65,19,37,40,27,20,16,118,167,36,28,48,31,15,78,60,26,15,10,49,215,53,37,27,40,14,7,111,25,30,26,16,53,8,20,19,142,24,10,22,38,157,10,129,36,7,125,10,91,124,11,69,20,48,67,113,21,198,28,115,19,61,8,11,11,24,11,29,11,71,23,5,25,52,36,42,18,29,25,9,9,9,35,35,29,8,10,12,31,51,68,72,93,113,151,7,17,5,73,29,10,46,49,17,34,9,13,43,22,127,41,39,25,21,14,183,34,6,31,21,108,54,84,91,100,19,16,46,52,27,4,62,7,16,13,23,37,17,53,50,14,22,39,19,18,31,13,38,16,11,19,261,141,5,15,22,21,13,50,19,27,34,14,40,7,39,98,15,40,37,15,22,16,46,22,42,74,19,33,5,20,12,64,13,71,22,31,54,21,65,70,24,13,10,26,31,20,36,17,108,61,12,14,7,20,28,35,87,46,38,29,71,12,19,173,14,36,102,9,19,18,62,19,81,26,38,38,42,30,113,109,28,21,70,15,19,29,32,20,15,116,17,53,27,40,26,12,25,27,11,29,50,91,30,22,57,25,7,10,222,44,72,10,17,32,38,62,24,68,26,34,80,71,71,24,90,26,64,12,23,15,35,35,8,81,9,19,28,31,33,87,56,83,60,58,30,5,23,21,12,38,35,2,22,67,34,185,15,43,13,672,85,20,24,13,15,77,108,51,21,45,11,27,100,79,49,45,27,46,28,41,47,20,188,58,101,14,16,31,42,13,47,104,48,34,48,30,34,20,33,63,50,23,60,61,39,47,39,16,30,59,50,24,162,20,32,27,52,19,8,36,11,156,23,76,53,92,30,26,34,26,30,18,26,76,9,25,32,7,14,43,16,60,27,11,27,17,96,17,84,22,21,17,11,49,45,17,55,17,9,30,29,140,83,210,79,58,22,41,30,108,105,52,73,42,57,83,51,14,26,50,13,11,4,48,8,39,38,11,37,24,19,10,37,28,30,15,11,45,34,39,33,33,13,25,58,31,19,57,35,25,23,39,45,45,15,14,17,28,58,25,47,23,41,39,12,22,11,45,20,38,29,57,40,50,42,15,12,34,34,23,55,37,21,6,21,21,32,81,26,33,53,15,13,28,27,44,26,47,20,37,68,94,24,35,4,24,14,48,16,11,23,7,26,7,16,35,19,25,21,79,16,9,29,49,13,20,31,32,56,12,36,59,17,17,74,28,34,29,13,14,25,36,8,11,29,111,14,30,49,15,17,22,19,47,28,103,29,56,39,54,12,64,31,132,22,142,29,20,18,14,30,35,29,30,13,20,17,79,23,26,25,11,30,26,13,47,20,29,20,19,17,32,230,70,51,110,63,144,313,16,23,20,15,21,17,100,61,26,89,12,81,30,12,16,32,107,17,45,12,27,18,12,10,13,40,20,12,19,35,30,74,11,26,63,31,20,20,8,56,6,5,4,40,4,4,27,7,38,3,4
6,4,14,4,49,0,6,1,2,1,4,5,4,4,11,0,0,1,10,2,1,2,6,2,7,3,5,3,8,1,12,2,60,25,5,13,11,3,5,6,2,4,2,0,2,6,2,14,5,54,7,7,2,0,4,3,3,24,17,1,2,0,1,1,5,7,3,19,1,4,6,39,2,0,1,16,1,6,2,20,5,40,1,3,2,68,14,6,4,22,1,27,6,27,20,63,25,7,1,12,2,3,10,7,1,9,7,17,5,14,1,14,1,7,6,1,8,7,12,34,58,9,4,21,84,10,0,0,2,7,15,3,0,1,16,4,12,0,0,1,4,4,1,19,1,0,18,1,2,5,3,13,2,6,3,1,18,11,1,1,3,12,1,6,19,49,3,4,4,10,3,12,17,6,0,3,0,54,2,2,8,7,2,8,5,0,8,7,8,3,8,0,0,0,1,8,4,11,4,10,3,9,5,10,2,2,1,3,7,4,5,11,5,9,2,2,4,5,7,6,7,3,8,1,5,6,17,5,18,3,44,0,9,11,4,4,10,5,1,5,0,12,10,1,2,3,3,2,0,20,1,5,9,6,8,4,2,1,21,2,7,2,8,1,3,1,6,4,3,4,1,39,9,46,0,1,1,1,12,2,2,10,0,0,2,9,1,4,3,2,1,6,4,8,9,13,6,21,7,0,3,7,31,11,21,3,2,3,4,2,1,1,2,8,0,37,9,3,10,10,0,4,0,6,2,5,0,1,6,0,8,2,4,0,0,1,7,7,3,2,8,4,5,2,5,3,2,15,9,5,3,7,1,0,15,6,2,1,0,5,11,15,1,3,2,1,2,7,5,4,3,1,4,1,1,0,8,1,3,0,0,11,0,10,5,2,9,0,6,10,1,5,1,8,6,12,3,10,2,8,1,5,1,1,0,5,2,2,0,4,0,0,2,2,5,3,0,4,0,0,1,0,1,3,0,0,1,0,1,2,5,7,10,5,8,1,1,1,4,2,3,8,2,0,3,1,5,3,1,1,5,14,0,4,2,6,1,0,3,1,17,7,5,5,11,2,2,3,3,3,1,1,0,1,2,1,4,1,3,3,1,1,4,0,0,2,1,7,0,1,1,25,8,0,0,3,6,3,10,2,1,7,1,4,1,3,11,1,6,0,0,2,1,3,1,1,4,2,1,0,3,0,2,1,3,1,0,4,0,10,9,1,1,1,0,1,2,0,2,12,6,1,0,0,10,3,1,1,4,3,5,3,1,2,18,4,1,1,1,1,2,7,3,10,0,3,2,0,2,5,13,3,0,9,5,0,2,10,5,0,12,4,3,1,2,1,0,1,0,0,2,1,8,6,1,5,0,0,2,16,2,3,2,0,1,0,12,1,5,1,7,9,8,6,5,4,3,3,0,1,2,1,3,2,20,4,1,1,7,0,6,8,5,10,4,3,3,2,3,0,0,1,0,1,3,1,13,1,6,2,34,3,1,1,1,0,3,15,4,1,2,5,3,2,0,1,1,1,0,2,3,3,0,2,4,6,1,1,0,1,1,0,8,1,0,3,12,5,1,1,3,4,0,5,2,2,7,0,1,10,3,4,2,0,1,1,3,11,2,3,0,1,16,0,7,5,3,5,2,1,1,1,5,0,6,0,9,4,0,0,5,7,5,9,2,0,2,5,1,2,4,2,1,4,5,1,3,6,3,2,2,2,5,11,12,9,7,0,3,3,92,96,2,6,18,2,12,5,3,1,5,1,1,0,3,2,1,6,2,1,0,0,1,2,16,6,3,3,1,6,4,3,6,5,0,1,7,1,3,3,2,0,2,3,1,0,1,3,5,4,3,6,0,8,7,2,4,1,7,3,3,0,2,6,9,0,2,1,7,5,4,4,2,4,1,1,1,1,2,0,2,0,1,1,1,4,12,2,2,0,2,3,5,1,4,3,2,3,4,2,3,1,3,2,3,0,2,0,2,1,5,3,0,38,14,0,0,3,3,4,3,2,1,6,1,5,2,1,0,1,2,2,7,0,0,0,5,0,0,4,1,3,1,2,2,1,9,0,6,0,8,5,22,1,11,0,20,7,0,0,2,0,3,3,0,0,0,0,0,5,5,4,3,3,1,1,4,0,3,1,9,0,17,7,15,4,19,18,23,29,0,1,0,2,2,2,3,0,0,11,0,1,2,0,2,14,7,0,1,0,1,1,0,2,1,0,1,3,1,2,0,1,0,0,1,0,9,0,2,3,0,0,2,2,0,0,3,3,2,1,0
month,8,27,11,109,11,11,9,19,6,6,15,5,15,39,1,4,8,14,10,10,9,37,13,32,11,21,21,18,6,52,13,171,106,13,44,62,29,12,34,11,6,9,4,10,18,12,23,14,202,34,39,8,7,47,10,1,43,39,22,14,8,5,2,15,19,16,43,9,5,18,45,2,7,9,61,12,27,7,97,18,103,10,21,11,137,20,16,5,94,27,1,10,44,40,47,49,16,9,54,2,18,28,31,16,46,21,23,5,32,7,53,4,23,20,15,29,19,10,75,117,31,29,24,174,39,3,5,7,74,13,19,2,5,39,17,58,5,3,18,14,7,56,51,8,2,85,5,10,37,13,26,4,33,2,6,11,44,2,4,19,19,1,5,19,52,11,11,19,24,9,19,103,13,16,9,17,159,7,4,39,22,5,8,38,7,16,38,15,17,82,10,2,5,4,6,9,14,6,42,1,51,11,7,8,16,3,12,16,14,18,62,18,20,25,7,12,8,9,21,5,13,15,5,7,22,77,36,32,14,50,8,52,40,23,23,37,34,3,25,11,50,23,18,9,7,7,8,26,46,5,10,23,22,10,14,14,4,15,8,26,6,52,20,11,8,46,6,8,12,6,65,16,92,2,0,5,19,28,11,3,38,0,11,19,14,1,8,7,13,6,24,9,17,24,18,4,75,6,6,6,27,21,14,13,6,4,9,6,2,2,6,6,21,8,53,29,13,36,15,4,39,5,30,3,20,1,7,47,10,27,11,14,8,4,7,16,7,13,5,42,6,23,19,13,6,11,23,38,16,10,9,3,3,22,25,7,7,4,12,57,15,8,5,9,2,3,35,5,10,26,4,19,5,16,2,22,7,2,11,3,37,4,40,7,8,18,16,22,28,0,13,5,6,7,20,7,23,5,28,7,7,4,1,4,8,2,13,0,17,5,1,8,22,8,8,10,6,7,5,8,8,8,9,3,3,2,5,10,15,15,11,12,9,25,8,8,3,16,15,7,23,7,6,21,1,14,20,7,27,24,20,5,10,3,41,3,5,10,8,35,23,36,22,42,3,2,23,9,4,7,15,10,0,2,1,6,4,11,17,10,6,9,4,4,7,29,9,3,10,1,73,35,1,4,8,6,3,19,13,9,12,7,10,6,16,29,2,15,10,8,10,4,12,3,11,22,9,5,0,13,4,14,1,4,3,3,11,10,31,14,12,1,10,4,6,8,6,16,33,17,5,4,5,1,10,17,4,14,13,13,11,2,1,60,5,8,17,3,4,8,5,9,24,3,7,9,12,4,34,19,12,1,16,3,5,2,26,4,5,28,0,23,10,16,1,7,5,7,4,9,9,15,24,4,17,1,1,10,35,6,11,7,2,3,13,12,11,7,3,10,39,20,14,6,59,5,11,2,2,3,12,6,4,32,8,2,7,5,3,18,26,9,10,13,11,5,1,6,10,9,4,2,0,26,4,41,6,14,8,145,15,1,8,1,5,14,22,11,9,16,2,4,38,17,10,5,2,7,8,15,12,8,52,20,52,1,0,5,6,2,6,37,13,4,10,8,11,6,2,9,24,19,10,9,5,16,8,1,10,14,10,6,2,4,0,12,31,13,3,7,6,34,7,18,15,29,18,6,6,5,8,6,3,26,2,11,13,0,4,17,3,7,3,3,7,9,14,9,18,1,5,4,11,17,19,3,17,8,4,9,4,18,23,52,29,14,5,3,8,84,84,7,28,20,25,23,11,3,5,7,7,1,6,12,10,5,9,5,7,4,8,4,9,2,10,9,2,22,4,20,8,7,1,0,21,5,6,4,11,7,7,12,8,6,9,7,6,6,13,5,13,4,6,16,2,13,4,22,9,3,4,19,6,21,0,0,7,7,4,7,7,8,6,3,3,7,2,22,3,7,7,0,0,5,4,13,4,11,1,17,29,24,5,11,0,1,5,16,8,4,9,4,1,5,1,2,2,3,5,6,1,4,29,12,1,5,3,19,5,7,7,29,6,11,35,8,19,3,5,6,9,5,5,5,4,23,2,5,31,14,4,10,6,4,7,17,2,11,15,11,4,16,3,27,5,24,9,7,3,2,5,3,1,6,6,1,1,19,9,16,1,13,3,7,1,5,3,5,7,5,7,10,32,7,9,38,10,39,56,3,1,8,4,7,4,10,9,6,18,3,1,5,8,7,25,12,2,9,2,5,7,4,14,9,6,0,3,8,7,3,7,11,8,26,3,5,2,8,13,2,3,2,1,4,3,6,5,16,1,5
example,6,5,5,54,11,11,4,24,0,3,15,8,3,73,1,11,13,12,4,4,1,19,30,24,12,9,16,15,13,11,6,103,92,9,21,91,47,7,15,10,3,15,6,6,13,18,8,9,145,32,41,9,17,69,13,6,20,8,10,14,21,10,5,7,16,10,64,6,9,7,13,1,4,3,55,14,19,5,39,17,38,1,5,6,105,11,7,5,17,6,10,1,13,21,17,8,11,1,28,17,1,18,16,17,6,28,8,5,7,1,22,6,8,5,3,22,2,2,27,87,22,22,13,56,1,3,5,2,1,2,13,9,12,32,18,39,6,0,3,13,7,30,16,2,3,50,6,18,12,7,40,2,13,6,5,27,25,6,17,25,8,3,4,2,12,10,9,18,28,10,10,83,23,1,8,11,62,7,9,35,12,11,17,16,1,14,28,11,12,27,0,7,2,1,3,3,9,7,8,7,23,2,2,5,20,7,0,25,7,26,48,12,7,7,4,10,4,7,11,2,1,17,3,5,17,63,5,17,6,8,16,6,18,15,19,9,13,9,7,7,52,23,3,4,16,2,2,30,24,2,10,21,22,4,5,15,6,5,0,11,2,32,11,0,5,10,4,18,10,7,67,2,14,3,3,4,8,9,5,9,46,2,6,22,12,3,7,6,9,0,0,7,8,4,0,11,21,8,5,18,21,13,3,2,10,4,17,2,6,1,5,10,15,9,31,5,9,22,5,2,31,7,23,8,45,4,7,30,4,13,11,5,4,6,5,6,19,3,2,5,8,10,12,5,5,9,22,27,11,14,4,6,6,19,9,5,4,4,5,21,13,6,10,20,2,3,23,4,10,24,5,19,5,10,12,16,4,3,13,1,23,3,18,4,11,11,10,6,23,4,18,4,3,2,18,13,20,1,25,3,13,10,3,5,2,7,4,2,20,19,4,4,3,10,2,15,7,5,3,6,2,5,11,9,3,3,3,6,2,38,1,2,0,6,5,1,3,9,8,4,14,14,3,21,1,2,17,7,16,4,23,1,6,3,37,3,4,9,7,15,37,15,28,29,5,5,22,8,4,1,21,4,0,6,2,13,9,8,22,2,5,10,3,4,13,2,3,6,5,5,55,17,5,8,12,2,1,7,4,6,5,4,3,3,3,15,2,10,7,2,3,3,3,5,6,9,6,13,0,5,7,10,7,7,1,7,8,5,7,12,6,5,3,9,0,9,8,4,19,10,5,2,2,7,7,2,11,24,6,2,28,0,3,25,9,8,17,4,6,4,6,1,7,1,4,7,3,8,16,15,11,2,3,3,4,3,4,5,1,9,3,6,8,22,11,4,2,2,1,10,14,20,4,3,27,3,5,7,14,12,11,3,4,2,3,6,2,13,8,1,10,8,3,11,21,8,5,0,5,3,11,8,3,12,0,1,0,4,11,22,3,12,17,10,4,1,3,5,1,4,4,5,4,19,1,5,5,6,4,79,5,5,8,3,2,7,17,22,6,2,2,1,16,12,3,5,3,8,8,6,8,2,29,30,8,4,4,2,0,0,1,16,8,5,5,6,9,5,1,5,3,13,5,2,4,3,2,1,6,7,0,4,2,1,4,3,8,5,1,1,8,0,5,6,8,13,7,4,7,3,2,2,3,9,4,2,8,1,3,11,5,5,4,6,4,2,3,3,13,11,5,2,2,3,6,1,9,10,6,2,3,2,0,2,3,6,2,9,2,6,5,13,6,0,18,9,10,2,3,6,6,1,4,10,3,13,3,1,9,4,4,2,5,2,8,6,6,15,6,7,6,7,6,1,7,8,1,1,4,2,2,3,6,1,9,7,7,5,9,4,2,2,1,2,0,4,0,4,0,4,2,4,5,2,0,2,4,2,9,2,4,5,9,6,4,12,3,20,6,2,2,7,4,1,2,5,2,8,2,9,5,17,8,5,2,3,4,1,4,2,0,2,0,3,3,3,0,4,4,4,1,2,2,4,2,6,0,7,6,0,0,4,3,1,2,0,3,1,4,5,4,5,0,1,3,2,1,5,1,4,3,4,3,5,3,1,0,6,0,15,3,4,2,1,3,3,3,1,4,3,4,5,3,4,4,2,2,4,3,2,0,6,6,9,4,2,3,3,1,7,2,8,0,0,1,8,4,3,4,0,1,3,7,1,0,1,2,1,2,0,0,1,2,1,2,4,2,1,1,2,6,2,2,5,1,3,3,5,3,3,4,4,1,2,3,2,3,8,5,5,6,5,4,4,1,10,7,2,1,6
percent,0,12,3,62,1,35,1,1,3,2,0,4,22,26,2,0,4,0,13,1,3,21,24,46,5,24,5,17,2,16,1,78,26,4,26,40,9,6,44,2,5,5,2,28,2,3,34,16,48,52,10,6,0,47,19,0,1,4,27,12,2,2,1,0,18,22,36,37,0,3,87,0,9,1,78,10,50,1,33,8,161,33,2,10,64,23,15,23,30,27,44,13,1,15,34,77,15,0,33,7,5,24,5,8,32,20,17,75,32,26,25,8,22,25,29,33,4,12,28,44,15,41,117,222,23,2,7,8,6,62,11,1,11,42,18,40,6,14,1,15,6,14,58,0,4,53,7,23,7,2,11,28,9,6,23,54,30,27,1,38,36,2,9,43,106,29,7,17,3,7,16,55,14,6,1,1,3,10,2,34,10,1,32,14,4,19,13,4,0,28,1,0,5,10,27,2,30,9,14,11,25,11,19,2,6,0,5,14,11,20,33,10,9,14,13,31,57,47,18,5,4,11,1,4,23,23,5,33,3,37,9,14,49,24,30,4,18,2,24,3,15,10,4,7,11,10,3,23,28,9,3,16,9,0,0,3,3,49,0,19,10,12,9,1,3,10,12,10,6,2,7,22,27,3,0,8,13,13,0,3,33,2,16,7,33,7,34,30,0,5,4,6,14,26,20,3,12,4,2,4,5,26,11,23,2,18,8,0,5,6,6,4,18,5,65,9,18,26,6,3,13,3,22,15,26,0,13,25,1,11,3,11,0,0,2,3,5,1,7,10,2,23,14,0,1,6,4,7,2,19,5,0,0,22,4,3,8,0,0,34,6,14,14,7,0,10,6,0,30,15,2,13,7,15,7,23,0,14,2,0,10,8,3,4,6,5,36,5,7,4,0,1,5,2,3,2,0,0,10,6,1,3,2,1,13,4,3,0,5,6,0,2,11,2,1,1,0,2,1,3,0,2,6,1,1,3,3,1,2,9,0,3,0,12,10,9,2,0,20,8,1,4,2,4,1,3,9,1,8,10,22,0,10,6,8,4,0,0,3,1,10,20,1,1,3,0,11,5,6,6,7,9,1,5,5,0,3,0,7,5,1,4,1,1,2,5,5,2,0,3,46,11,2,3,3,2,2,3,0,0,0,3,3,10,4,16,15,0,4,1,1,0,0,5,1,0,7,2,3,23,0,0,0,0,2,0,11,10,3,10,5,2,4,2,4,1,0,5,10,4,1,5,0,8,5,1,0,4,0,3,0,0,0,9,0,1,2,4,3,2,0,0,1,0,3,1,3,0,1,6,3,0,8,2,2,0,1,0,2,17,4,1,0,6,0,1,4,0,0,4,3,1,10,2,13,0,6,20,2,0,4,0,0,1,0,0,1,9,0,0,9,6,1,3,6,0,0,3,0,0,1,1,0,2,4,0,1,2,0,19,0,2,1,7,3,2,1,13,2,7,4,4,3,1,0,6,2,8,7,19,0,0,1,1,0,8,1,5,0,6,4,2,0,0,0,0,0,0,2,2,0,1,4,0,0,0,0,0,0,0,0,2,0,0,0,0,1,6,2,0,6,4,1,0,1,4,0,0,2,2,1,0,0,0,0,1,13,8,0,0,1,2,1,6,9,6,6,0,1,6,0,1,0,0,2,0,0,7,1,16,0,4,4,0,0,1,2,0,1,5,4,0,2,0,1,2,9,9,2,0,0,1,6,3,33,10,0,5,1,25,21,5,7,26,6,5,7,0,3,0,1,1,3,1,0,3,19,4,0,2,0,0,6,0,7,1,0,0,5,4,3,1,1,0,1,0,0,3,0,0,0,0,1,3,9,1,2,4,0,4,10,3,0,8,0,0,4,4,0,0,0,4,0,12,0,1,4,9,0,0,7,7,0,0,2,0,0,4,0,3,0,0,0,0,1,0,2,4,0,2,3,6,1,0,0,1,0,5,0,12,0,3,0,5,0,0,0,0,6,4,1,0,4,1,0,1,0,0,1,4,0,2,0,0,0,0,3,0,3,0,8,4,21,0,0,4,0,0,9,5,1,0,0,1,0,5,1,2,1,3,8,16,0,0,1,3,5,0,3,1,0,2,0,0,0,0,2,0,0,0,0,9,0,0,0,1,2,0,0,2,2,1,10,2,10,8,8,19,4,0,3,8,5,2,2,0,1,0,1,0,0,3,0,1,41,1,0,1,4,0,0,0,44,3,0,0,4,1,9,0,0,0,0,0,5,0,1,12,0,5,0,0,0,2,11,35,14,0,2,5
remain,22,53,25,348,34,32,12,96,8,5,64,19,23,200,7,26,34,44,26,16,12,103,54,79,42,26,72,52,24,70,27,449,297,55,109,177,177,38,44,18,16,33,17,27,117,43,62,28,761,136,139,31,42,160,15,18,119,87,39,54,78,22,7,44,68,22,186,20,32,44,85,11,15,7,228,18,63,21,192,57,101,6,32,16,522,50,36,12,115,20,40,21,15,1,158,38,47,12,155,22,27,78,92,37,25,63,33,14,68,20,63,18,28,26,10,173,21,7,184,420,97,76,23,311,27,20,14,21,20,2,52,10,18,108,84,147,19,12,22,15,13,90,88,6,14,180,18,31,36,32,158,4,74,23,14,45,91,11,25,63,24,4,17,18,32,29,19,56,61,28,38,262,44,10,36,21,341,10,28,102,75,34,31,46,2,48,83,53,102,168,6,21,10,12,2,15,28,17,24,29,33,13,6,41,76,29,24,59,49,64,172,35,72,18,19,19,8,25,53,8,70,44,16,38,99,243,47,72,27,39,28,70,70,61,63,69,109,21,12,29,181,87,14,26,29,9,12,88,117,19,27,55,40,34,30,22,25,17,17,47,5,129,54,12,12,81,12,69,64,7,284,42,184,17,10,10,51,58,38,7,120,12,6,41,31,15,25,23,41,6,17,27,20,28,15,20,105,13,26,64,106,81,16,8,32,3,65,8,6,11,7,22,74,27,101,56,34,90,17,19,128,8,62,20,188,10,21,110,16,72,35,29,22,9,24,32,45,23,19,39,27,45,43,24,16,13,118,153,50,40,46,24,19,93,58,8,19,10,41,135,40,19,16,44,12,16,87,37,34,69,13,107,17,44,10,60,13,8,38,33,193,10,83,27,37,180,12,62,94,6,73,25,27,33,77,35,173,18,81,16,46,35,9,21,13,8,9,24,48,33,10,32,17,33,43,55,34,36,19,40,5,29,37,29,9,12,8,28,29,55,33,33,32,46,16,16,22,66,45,15,54,44,13,41,4,18,65,31,90,31,86,19,40,14,111,25,23,24,5,77,33,53,76,77,13,25,77,33,28,6,46,12,6,7,12,20,10,30,49,13,19,34,5,25,22,32,32,30,11,12,232,134,12,18,39,17,17,52,19,14,39,11,8,10,19,45,9,28,19,8,13,8,18,12,30,59,10,24,2,28,12,45,15,55,20,17,67,12,48,60,49,10,19,28,30,22,23,21,89,60,17,7,10,7,33,23,11,38,43,14,86,15,20,141,19,18,70,21,10,19,57,9,52,13,33,42,37,13,92,69,32,33,60,16,7,18,19,9,18,93,15,40,21,49,13,11,12,19,15,31,77,80,37,11,30,7,1,16,126,40,49,6,24,18,24,51,19,72,17,5,65,55,39,16,82,31,49,3,26,12,28,13,7,65,18,9,18,24,21,59,29,58,61,37,20,6,17,26,16,20,15,14,14,57,20,87,12,20,17,484,60,24,12,11,16,50,96,46,15,38,17,21,57,52,29,22,13,34,38,44,39,22,119,67,118,19,5,20,24,25,26,47,36,20,25,34,34,13,18,41,52,44,42,40,12,49,21,17,32,29,20,12,27,23,18,19,50,37,13,10,7,55,28,81,56,53,44,12,24,16,26,15,18,62,8,28,24,8,5,22,10,30,22,12,23,13,34,8,116,19,35,12,12,16,27,5,54,16,11,23,24,55,33,83,54,24,17,15,15,40,32,19,24,29,56,27,18,22,15,52,26,11,4,37,8,38,15,5,40,30,26,9,34,23,29,17,15,70,26,31,21,17,5,15,19,42,10,33,12,16,7,15,33,13,23,8,15,17,37,13,28,12,28,21,5,18,15,35,21,36,21,8,25,24,23,8,16,25,20,17,50,54,22,15,24,21,24,53,42,11,21,21,15,24,11,24,21,27,12,22,72,70,18,16,7,17,11,34,16,5,28,13,16,8,16,16,11,5,37,34,7,17,22,13,11,15,7,45,30,8,17,18,16,17,28,13,16,13,13,16,21,20,1,12,22,24,18,13,11,31,9,13,29,31,22,16,22,21,12,46,11,35,9,64,30,26,5,18,6,9,23,38,12,16,11,19,20,62,23,21,12,11,14,19,12,8,3,22,9,16,10,25,73,44,36,92,52,113,199,16,11,9,7,15,17,40,31,17,50,28,41,23,18,10,9,41,20,6,9,19,24,15,16,24,22,10,15,22,24,27,8,6,12,9,28,13,20,25,68,15,6,13,20,13,3,12,3,24,3,28
interest,26,64,39,510,61,37,20,182,16,19,129,32,31,352,24,42,31,81,34,16,30,150,34,108,113,59,45,60,33,67,31,775,596,61,294,324,213,50,46,22,58,37,30,19,138,83,100,69,1270,114,205,20,86,159,19,46,290,114,9,57,109,55,14,42,83,37,444,67,52,69,140,14,22,13,460,67,83,29,376,119,281,33,73,21,1104,147,67,7,191,63,47,17,34,158,1,207,74,29,165,76,60,128,149,61,53,95,79,29,66,16,95,28,44,74,12,130,34,45,265,794,193,83,92,423,35,18,22,24,37,18,44,16,19,200,89,158,33,13,31,26,24,178,126,13,13,272,28,86,109,74,251,16,68,49,16,80,124,19,49,33,54,18,62,50,39,27,18,120,94,27,75,383,96,3,32,42,757,21,51,168,130,61,24,82,26,109,191,152,171,231,9,12,16,12,10,32,81,28,53,71,243,18,51,56,127,39,43,169,73,149,288,18,90,37,9,11,16,27,45,20,60,86,43,52,219,369,123,169,23,67,67,89,135,112,152,189,126,58,36,41,261,121,21,33,66,31,24,90,153,32,42,120,103,61,44,87,42,50,29,54,46,96,82,14,34,160,35,18,55,33,645,90,358,30,24,4,92,111,55,9,295,33,10,95,43,16,19,43,72,21,21,12,60,40,48,42,222,22,24,102,120,153,13,76,92,12,101,17,39,16,10,71,115,32,370,84,97,197,104,23,203,56,126,8,280,17,38,90,18,110,23,47,51,25,38,76,78,22,43,78,58,34,71,52,42,30,230,244,80,27,96,64,23,138,100,22,25,19,65,172,106,38,67,94,20,9,180,55,39,62,22,72,18,58,53,96,27,44,110,39,314,12,190,86,8,149,13,106,139,29,141,13,41,47,155,63,264,20,113,17,90,13,31,10,38,43,35,38,133,71,17,54,35,73,71,51,30,47,24,6,51,29,64,36,10,21,16,82,57,73,81,71,57,70,15,19,6,64,30,24,59,98,37,77,14,28,45,30,143,43,89,38,23,31,240,38,2,36,54,136,57,92,131,119,17,34,78,62,39,6,63,28,16,11,10,119,24,63,102,28,28,80,33,27,57,27,70,12,31,17,288,202,11,26,61,34,26,130,42,48,73,15,17,3,33,126,13,81,28,22,27,22,20,48,59,79,32,63,56,39,24,71,38,93,34,14,118,64,65,113,44,24,13,57,40,38,50,69,182,130,24,14,20,43,47,21,61,88,58,39,132,16,35,184,31,52,176,29,37,51,119,31,90,16,73,62,51,35,124,198,43,42,52,16,22,33,77,23,29,100,59,56,55,101,51,41,29,42,21,67,128,181,65,16,142,20,43,29,202,108,81,18,16,27,23,110,35,80,33,42,95,74,40,39,118,37,103,35,35,40,59,55,18,136,23,43,41,66,64,109,88,112,116,108,30,31,66,44,18,50,56,7,48,72,47,149,24,29,37,778,114,18,36,8,26,62,162,81,32,74,49,31,80,82,39,22,14,25,53,50,78,42,154,85,103,28,29,43,58,26,40,83,70,37,47,68,93,20,13,53,55,58,46,103,31,44,50,13,59,60,44,24,27,24,49,34,94,24,22,20,20,73,30,156,69,41,13,49,39,26,28,34,42,57,12,41,38,8,11,51,43,83,53,30,27,22,75,34,111,37,57,27,15,51,44,37,56,47,29,35,47,58,38,111,70,44,26,67,13,244,216,51,29,40,70,106,43,48,52,52,27,19,7,42,24,76,49,17,56,65,22,25,53,47,62,42,39,67,59,80,30,58,28,31,135,84,60,30,34,19,21,17,70,15,34,14,48,30,77,24,50,20,29,37,27,26,25,39,24,52,21,25,38,28,8,22,26,30,39,49,76,49,53,22,26,64,39,115,49,26,24,40,16,34,21,72,43,42,46,34,130,80,29,30,3,16,38,38,30,14,48,21,26,28,18,41,19,10,60,51,30,43,215,104,24,32,18,56,46,16,18,27,7,26,32,20,38,27,25,27,18,39,4,17,31,53,6,9,34,10,37,27,9,64,32,31,25,53,25,110,20,83,27,141,40,36,30,38,17,10,37,34,28,39,11,23,23,63,21,58,35,18,43,33,16,20,17,33,29,52,24,101,74,148,71,202,167,94,280,18,5,26,10,27,16,61,12,32,80,36,16,20,14,20,25,82,35,15,18,34,25,34,35,30,24,30,9,38,38,29,18,27,32,48,36,50,41,21,75,9,13,13,28,7,13,13,11,35,13,5
rate,2,2,6,176,2,27,5,12,0,1,3,2,21,40,3,0,12,26,11,1,7,31,35,42,42,20,16,21,11,16,1,249,136,17,50,41,12,20,51,7,24,8,2,28,60,23,43,18,179,55,54,3,20,45,12,1,190,39,19,18,6,4,3,30,36,8,82,89,19,32,36,3,5,19,140,21,82,5,107,33,250,69,19,9,259,79,30,28,48,25,49,8,77,38,207,1,26,15,59,45,13,66,54,18,38,45,65,45,51,27,38,7,43,46,25,46,16,18,108,282,71,34,215,201,23,1,6,5,15,20,28,0,5,90,19,85,3,19,11,9,5,61,32,6,9,87,8,47,53,32,99,16,16,9,21,61,43,4,1,31,73,10,16,28,38,10,11,11,40,17,29,155,38,3,7,3,221,4,14,95,38,13,19,48,12,35,73,42,31,52,7,4,16,4,15,11,36,16,15,16,96,8,33,12,36,8,13,68,15,24,162,22,30,56,14,14,17,29,17,5,7,25,6,27,63,172,65,53,6,47,38,33,119,38,44,173,21,18,36,8,65,63,6,5,11,13,4,47,58,14,13,78,9,34,11,18,12,27,6,31,21,12,14,3,12,66,15,9,20,13,124,24,133,4,5,5,18,56,7,7,42,30,6,14,24,8,2,14,7,8,7,2,29,14,19,11,59,16,13,27,28,53,6,25,24,5,14,5,6,12,0,26,43,10,137,29,26,56,30,11,27,4,35,11,70,5,11,29,3,29,2,24,14,15,7,28,12,10,9,17,8,18,23,14,26,3,54,36,11,14,23,4,1,51,28,40,3,5,15,42,46,14,16,33,7,6,42,7,17,29,5,41,7,23,17,46,14,26,9,8,96,6,68,12,11,77,57,28,28,6,9,8,20,3,25,12,77,5,27,6,28,5,7,3,8,7,10,0,32,11,1,7,18,17,1,3,3,4,6,0,8,3,19,15,2,9,11,14,4,21,7,9,5,12,3,7,3,3,10,12,20,42,24,12,2,5,11,8,43,15,17,2,10,6,64,25,2,19,15,69,20,35,16,45,4,2,67,31,10,2,24,29,4,6,1,34,5,14,28,17,18,10,10,2,8,19,21,4,5,2,38,52,4,2,20,3,2,22,19,15,16,9,16,8,33,35,21,24,44,8,36,0,9,39,28,30,2,10,12,14,3,17,20,23,24,5,24,29,38,25,37,7,0,24,20,12,5,9,41,49,11,1,2,26,24,7,0,23,8,18,6,4,18,66,3,13,61,18,13,7,27,7,28,3,7,35,11,3,35,59,16,4,13,6,3,6,80,10,13,33,27,28,28,22,7,12,8,8,4,19,24,26,23,8,20,1,26,40,3,9,26,9,6,1,4,18,3,8,22,19,67,119,12,12,60,10,18,32,30,8,12,13,11,48,14,23,13,17,8,48,31,31,43,31,6,14,12,17,5,7,17,5,3,15,7,22,6,4,20,104,1,4,9,2,7,8,25,11,4,14,9,0,1,17,5,0,1,5,14,11,23,18,3,50,20,2,7,8,0,3,1,46,6,19,10,6,7,9,4,0,17,19,16,6,4,8,4,1,85,18,1,8,2,12,12,5,20,7,11,4,3,21,16,20,27,16,0,1,10,8,8,4,2,15,2,9,17,4,5,6,12,11,19,6,4,8,7,7,6,10,27,3,7,9,3,6,15,16,13,10,5,17,18,28,34,14,12,6,11,179,174,19,3,32,13,40,20,22,25,10,5,4,8,15,10,15,25,7,2,7,2,1,7,8,10,10,24,0,17,42,4,6,1,4,94,26,50,18,10,1,15,4,19,1,15,1,12,9,18,6,38,1,14,15,5,6,4,12,9,15,0,9,3,48,7,4,9,10,11,26,18,14,7,1,5,4,1,18,14,3,1,2,21,13,8,18,9,30,5,6,4,34,12,21,4,6,11,24,12,13,8,10,6,5,1,2,2,1,4,26,4,12,67,26,4,13,1,13,2,5,0,11,4,0,4,4,3,8,2,8,6,13,7,7,5,2,1,6,24,6,9,0,0,3,3,3,0,16,6,15,9,21,12,18,7,0,12,2,14,11,1,16,11,48,2,0,0,0,16,12,2,17,4,8,5,16,13,12,6,16,5,58,32,15,18,32,17,17,54,2,1,16,4,10,5,7,17,2,25,3,7,5,0,7,22,13,1,10,1,2,0,2,25,1,4,0,3,13,12,3,47,12,9,8,5,35,6,6,10,3,0,9,2,2,24,23,11,1,2,1
reach,11,37,8,175,16,24,12,37,11,5,36,29,27,114,11,6,12,40,11,11,5,61,29,43,27,24,31,34,26,33,13,287,201,25,92,123,64,16,39,7,19,12,9,14,57,36,48,22,400,81,90,27,31,82,32,9,52,43,12,43,35,14,6,15,44,22,157,26,15,39,49,4,12,11,156,28,53,10,132,40,118,8,33,15,322,39,31,5,72,7,16,11,15,47,74,26,1,11,72,15,24,42,50,18,30,35,17,9,34,5,23,10,19,26,18,44,10,8,89,283,76,56,51,170,16,6,10,13,10,6,46,18,13,75,32,115,13,17,10,25,18,63,44,11,9,128,13,33,21,20,86,13,32,13,10,38,62,20,9,53,28,20,21,4,24,30,18,53,57,10,26,161,46,11,17,17,249,9,12,59,48,15,20,42,8,32,59,48,80,77,3,12,17,13,7,9,21,20,24,24,39,10,6,22,33,33,18,43,18,31,127,28,58,11,16,18,6,12,26,5,5,23,11,60,71,136,42,38,24,32,25,39,35,38,67,24,56,10,26,22,109,72,14,14,28,21,7,32,64,16,14,33,37,18,13,28,7,4,5,41,12,56,25,11,12,44,16,18,23,9,204,17,62,4,9,34,40,32,17,6,100,9,9,15,23,10,26,35,16,12,18,15,16,16,12,13,72,11,10,23,31,36,9,7,30,4,44,12,12,10,6,39,29,11,45,29,21,93,16,6,53,14,55,21,114,6,36,70,6,47,10,26,8,2,14,19,42,9,11,19,19,34,29,25,12,12,49,70,33,29,25,23,6,72,29,18,11,11,33,77,40,14,20,28,5,6,60,10,14,33,4,40,17,27,13,27,8,9,17,15,91,3,61,29,12,70,5,31,53,12,34,18,15,17,57,20,78,3,53,7,26,11,13,12,13,9,4,8,23,18,2,25,14,31,37,16,13,22,9,12,6,24,35,29,7,9,10,15,19,34,7,7,14,27,15,7,9,37,16,7,18,28,7,20,3,12,43,7,49,20,29,16,13,8,80,11,6,17,15,19,30,42,50,38,14,5,30,23,27,5,43,20,6,7,6,31,11,27,32,16,14,19,12,11,17,13,16,7,8,7,132,59,7,13,17,12,10,21,8,34,19,10,16,7,21,31,12,15,15,11,11,19,17,14,21,32,23,15,8,7,8,23,5,38,13,14,22,15,30,29,20,7,14,14,11,14,10,17,53,32,7,9,6,17,16,13,9,16,18,9,37,5,10,102,15,8,37,4,23,8,16,8,30,5,27,15,20,16,40,55,31,9,10,7,18,7,28,8,20,25,14,28,24,25,18,14,20,14,5,21,22,56,17,10,30,15,7,12,76,29,41,11,13,13,24,45,7,15,12,3,56,39,17,7,50,15,29,7,16,10,16,4,7,31,9,16,16,13,28,40,19,21,37,32,10,4,17,14,7,13,12,13,35,50,19,61,11,10,14,263,29,15,20,5,12,17,70,36,8,26,8,11,22,31,11,16,19,11,19,19,25,12,73,44,43,18,7,11,8,18,17,35,20,10,11,8,27,10,6,16,24,39,26,16,10,17,11,10,15,16,22,12,9,17,17,13,36,15,4,15,10,22,10,54,38,61,28,12,11,9,32,13,11,34,6,18,16,7,8,15,14,24,12,8,16,12,34,6,46,25,21,9,5,13,22,9,30,21,5,15,20,13,27,40,24,24,18,11,9,48,35,25,9,15,36,34,33,6,17,25,9,8,11,19,7,23,15,4,18,21,6,3,24,8,12,12,10,12,7,14,16,11,6,5,9,31,11,9,5,3,13,9,20,20,13,2,15,11,27,9,18,1,14,18,10,36,5,28,7,19,4,5,41,21,8,13,9,16,10,7,19,14,16,6,8,10,14,40,28,8,7,5,12,27,9,23,14,89,12,15,72,35,19,6,8,2,7,14,7,3,14,2,15,8,12,11,7,8,26,25,8,8,10,12,13,3,14,18,15,7,8,14,10,9,22,10,20,13,14,4,18,35,16,10,13,14,9,13,14,15,6,18,8,18,2,13,2,25,6,43,10,13,10,23,11,20,6,6,10,12,9,9,6,9,15,11,7,31,8,10,12,10,4,17,4,10,12,8,6,22,13,22,17,4,25,13,24,29,31,3,4,13,14,8,10,8,19,11,19,12,14,7,5,3,7,34,12,16,10,14,13,9,25,9,6,7,13,8,6,10,9,8,5,17,10,16,10,17,37,15,9,4,7,3,4,10,4,9,6,13
largely,0,8,5,62,3,4,4,10,1,1,9,2,7,29,1,4,2,12,2,1,2,14,2,11,17,4,9,4,6,9,6,99,72,5,29,33,7,10,16,5,3,0,0,4,23,7,7,11,100,4,7,3,12,24,0,3,22,29,2,10,10,3,2,6,15,2,51,8,0,7,7,0,6,1,41,7,16,4,42,16,103,1,10,4,104,10,13,1,28,1,9,1,0,12,29,15,11,1,20,15,5,22,14,5,8,32,8,4,11,3,8,4,4,10,0,17,1,2,36,63,26,17,13,70,4,0,5,2,3,1,6,1,3,28,4,40,2,2,3,5,1,19,13,1,1,27,3,9,25,14,22,2,10,2,5,19,17,6,5,2,19,2,7,2,2,3,4,12,23,6,14,37,16,2,5,3,100,6,4,23,18,2,4,16,3,12,25,8,10,22,2,3,25,0,4,1,13,5,7,13,31,2,1,6,24,2,9,50,2,14,44,2,13,7,0,1,1,0,17,3,5,13,5,6,27,67,31,28,6,9,11,11,28,11,15,34,22,8,16,6,36,26,3,1,3,2,3,16,24,2,9,18,3,11,6,2,10,1,1,27,11,10,8,3,2,51,4,0,9,18,45,16,43,4,3,2,8,21,3,2,33,3,5,17,3,2,1,5,7,0,5,0,6,5,4,4,27,5,5,4,9,12,0,6,10,3,9,3,5,0,5,6,21,4,29,22,13,31,10,5,20,7,12,8,24,1,3,9,0,13,3,10,2,3,7,13,10,7,0,8,1,2,9,5,6,3,14,18,13,1,7,5,8,15,10,7,1,5,6,24,11,5,13,7,8,2,13,6,8,6,4,9,3,11,5,40,4,5,10,5,13,6,21,13,0,44,2,10,18,1,13,1,1,1,14,4,18,4,13,5,14,2,3,1,5,5,3,1,26,15,1,10,25,15,1,5,0,2,1,0,6,10,13,8,3,0,1,4,2,8,14,6,1,9,1,0,0,2,1,3,10,12,3,14,2,4,9,3,28,8,9,4,1,2,26,13,2,1,3,19,6,10,18,16,5,10,18,8,9,2,15,2,0,2,5,8,2,5,18,7,1,8,2,2,12,2,10,1,4,6,27,23,0,1,12,3,5,18,2,9,9,6,6,0,5,28,13,18,6,4,9,8,5,6,7,8,1,7,0,4,1,14,1,8,3,5,9,1,2,17,3,4,1,7,6,3,2,4,24,12,3,1,3,12,15,5,1,8,7,2,4,5,3,27,7,5,29,3,5,3,7,7,14,4,7,14,9,3,17,16,4,2,12,8,5,1,11,5,4,18,13,8,8,7,5,3,5,4,3,5,7,10,7,5,19,8,0,7,1,9,12,2,5,1,5,9,3,8,10,4,18,16,10,2,20,3,6,5,5,2,8,1,3,13,3,7,2,9,4,25,21,21,7,8,5,1,10,2,5,6,8,4,6,9,4,22,7,0,5,57,20,2,6,3,3,5,25,7,3,14,1,3,0,7,1,1,3,2,4,9,16,11,22,22,17,2,9,3,2,4,2,22,2,5,4,4,8,3,2,7,8,3,9,10,5,7,0,1,5,1,7,1,2,3,10,3,11,3,3,1,1,11,0,11,15,7,4,0,0,14,6,2,1,11,4,3,6,4,3,6,3,12,6,3,6,6,16,6,14,7,4,1,3,8,9,2,12,10,2,8,6,7,7,23,17,10,2,6,9,39,55,6,4,6,22,19,6,5,16,5,10,5,7,9,1,7,13,2,15,1,3,5,3,6,7,4,3,3,4,4,2,2,2,6,12,9,17,5,4,16,8,3,5,2,3,3,8,6,9,6,13,6,5,6,5,1,2,3,2,7,1,8,1,8,5,3,2,8,4,6,7,6,7,1,5,6,5,18,5,0,0,1,5,2,9,9,3,3,5,2,6,7,5,4,1,1,5,12,1,2,0,3,3,5,3,2,2,1,2,16,4,5,7,15,4,3,0,3,4,2,0,5,3,0,12,4,5,2,6,2,1,3,1,3,0,3,0,5,1,2,9,0,2,5,0,8,9,6,3,7,8,7,4,8,2,2,6,3,5,4,5,0,5,16,2,2,6,2,0,6,7,1,3,5,9,10,10,3,2,12,1,8,12,5,10,13,13,15,23,2,4,3,5,0,2,8,8,5,5,0,18,1,2,12,4,12,7,14,3,5,4,4,4,8,0,2,4,6,6,1,21,1,1,11,1,6,0,0,6,0,2,2,4,0,0,1,1,5,4,1
continue,20,79,31,409,29,45,30,132,11,15,80,19,57,319,19,31,26,43,25,20,33,117,72,70,68,64,53,60,31,81,40,559,417,64,130,267,238,34,62,54,14,81,9,36,106,48,69,79,761,199,147,51,69,288,41,21,128,83,51,96,120,38,20,44,86,41,363,21,31,78,87,19,25,11,482,39,72,27,275,90,208,16,54,27,671,75,53,20,120,12,54,28,33,155,165,59,72,20,1,48,47,97,120,44,61,84,40,24,64,20,80,21,66,62,38,172,21,18,152,452,128,106,72,373,26,10,35,24,23,13,83,18,28,164,72,270,25,22,27,27,19,129,106,14,8,250,16,73,42,46,172,14,68,43,38,110,110,33,53,114,38,22,28,26,51,52,23,150,64,33,71,270,84,30,35,29,394,22,19,164,59,57,113,62,19,104,115,73,99,164,8,18,20,12,15,19,61,39,40,29,86,15,25,49,158,37,27,112,30,118,240,36,51,21,17,32,32,72,45,31,32,58,23,42,156,230,88,102,36,45,58,45,109,86,96,93,110,46,50,35,220,102,30,26,75,34,21,106,198,20,39,72,79,21,21,44,42,15,15,83,13,146,42,12,33,100,48,56,54,26,323,63,100,24,5,23,69,73,21,9,170,24,28,40,30,22,51,44,55,13,20,19,37,52,24,31,113,23,23,63,132,90,15,18,37,8,111,17,37,23,16,44,123,61,106,36,53,138,46,24,129,29,79,42,171,5,65,95,14,103,23,40,23,18,31,49,63,29,18,50,28,35,63,32,25,22,133,172,72,32,32,48,16,140,67,30,48,21,38,131,66,57,60,68,10,24,83,20,32,65,12,161,25,52,21,65,26,8,56,26,264,14,124,53,39,106,13,76,91,13,63,37,28,28,70,33,111,10,95,25,66,32,15,20,21,18,28,20,123,65,26,42,52,46,57,81,27,30,19,54,15,25,74,28,16,13,20,31,29,48,45,17,11,41,23,25,37,75,52,39,51,72,25,80,29,37,107,35,86,31,100,18,47,11,137,30,18,28,22,62,42,65,89,90,31,27,92,42,22,8,68,34,14,14,10,58,19,36,58,27,29,75,11,21,36,26,30,29,17,16,314,130,20,38,48,14,16,44,32,22,25,16,19,28,16,107,44,44,16,18,15,12,23,11,47,40,30,39,3,34,14,57,17,46,14,13,72,24,46,64,52,13,39,21,34,19,22,32,110,65,31,20,18,38,49,22,18,55,41,16,77,16,23,141,22,35,92,22,19,37,48,13,56,17,29,35,40,19,95,91,50,30,52,19,29,8,28,16,19,80,26,41,45,60,26,26,20,24,10,34,59,95,41,10,46,12,20,20,111,56,57,22,23,20,31,50,18,71,33,14,74,58,37,30,72,22,39,16,17,18,24,47,14,59,12,19,23,26,46,84,58,55,66,60,19,13,49,17,17,36,32,13,22,73,29,66,30,17,32,486,66,25,19,14,10,65,110,62,20,32,12,25,52,41,27,16,5,23,28,45,32,21,146,44,75,22,12,22,13,16,30,69,41,19,30,32,37,36,14,33,47,61,43,35,16,39,38,13,41,29,37,19,23,16,19,26,69,25,17,16,26,27,22,84,48,83,55,22,17,24,30,15,26,59,15,20,40,8,12,64,16,40,23,27,22,24,66,18,85,48,33,21,26,28,32,13,48,62,28,17,45,28,44,49,28,34,26,29,25,58,49,49,17,23,69,47,40,24,39,38,29,20,10,31,22,35,40,16,51,30,12,18,34,17,32,27,16,63,30,27,30,24,11,14,20,40,10,16,19,17,16,22,29,37,28,16,29,17,43,19,18,24,34,28,9,11,17,39,22,35,23,15,28,36,18,18,16,19,36,15,34,20,32,23,18,29,23,100,29,19,20,16,15,23,17,16,33,41,15,46,78,64,31,23,12,15,16,18,23,22,19,16,7,25,24,14,15,8,20,27,13,21,39,26,21,28,11,60,34,33,15,26,17,23,23,12,22,27,28,20,21,27,14,18,26,27,13,12,23,43,23,11,28,33,22,27,18,20,13,49,24,45,13,42,23,23,11,25,31,12,19,26,11,22,21,15,29,38,23,29,17,21,14,18,14,12,27,19,15,43,11,31,51,27,46,54,44,54,109,13,6,23,16,29,22,32,12,19,31,22,17,13,12,18,18,43,20,15,15,19,50,17,32,28,14,36,23,16,11,21,15,24,12,39,14,17,23,60,77,17,11,27,20,20,14,26,11,27,14,33
industry,4,12,3,151,3,19,3,32,1,5,5,7,12,107,6,7,4,24,5,0,3,70,18,39,28,9,13,28,14,23,5,249,236,27,74,99,54,16,78,6,24,17,4,11,41,13,27,29,229,37,39,7,47,75,22,3,81,28,2,48,24,8,8,28,27,5,176,19,14,17,28,0,21,6,162,25,40,7,86,33,130,14,13,24,246,40,41,2,38,2,2,17,7,22,76,45,15,15,48,1,9,40,32,22,29,36,22,16,24,10,28,4,36,51,37,38,7,7,63,202,65,39,95,128,23,3,11,5,3,2,21,4,13,57,40,98,6,15,10,16,5,70,26,6,9,85,20,25,36,14,71,13,49,35,11,43,65,30,10,38,24,11,18,5,15,23,12,30,43,13,12,151,36,4,12,12,203,8,18,93,35,22,15,46,1,46,49,35,23,43,7,10,54,4,1,6,30,14,11,24,99,10,12,17,44,9,8,55,21,50,116,19,29,19,10,15,5,4,13,4,17,25,14,21,47,138,41,46,10,17,37,20,48,39,49,37,47,37,50,9,88,47,7,5,45,11,16,42,56,10,18,69,19,10,10,22,13,2,5,36,35,17,25,1,14,52,20,9,31,10,186,8,28,12,3,7,37,15,9,4,127,2,8,25,20,12,8,20,15,6,2,7,21,9,3,15,40,16,9,33,34,24,7,5,28,3,40,9,18,4,9,35,35,26,42,24,65,63,42,11,41,8,37,12,58,8,25,54,1,49,0,28,12,16,7,8,33,9,18,10,10,9,32,10,8,6,67,59,27,22,21,9,9,58,25,23,4,8,21,41,57,28,33,32,31,6,28,9,15,29,4,31,19,30,13,30,8,18,17,12,55,6,72,17,21,36,4,34,27,15,11,1,10,7,25,23,72,4,30,14,21,11,2,4,18,26,7,4,81,21,5,10,30,33,6,13,4,4,2,1,10,21,27,4,14,7,5,3,8,22,22,3,0,7,5,1,0,8,6,12,24,44,12,38,3,3,34,11,69,20,27,6,14,14,60,8,0,8,7,31,24,26,52,50,23,6,65,21,9,2,40,6,6,11,9,47,7,13,23,23,14,20,4,3,17,6,29,5,2,4,78,40,3,3,37,5,17,25,18,16,29,6,13,8,10,42,41,21,11,10,15,6,8,21,22,15,9,16,2,5,9,27,10,27,4,4,31,9,22,44,6,19,1,16,14,13,6,14,53,38,7,3,11,37,42,9,2,35,8,9,11,2,13,39,18,16,78,10,19,7,33,7,23,5,15,27,12,8,32,61,13,11,6,3,13,6,39,10,8,22,32,28,29,28,16,10,10,10,8,11,24,41,14,13,117,17,20,46,26,27,29,21,10,1,7,20,6,18,16,13,21,36,8,9,27,6,24,26,8,8,26,15,5,24,10,12,6,14,15,43,26,25,27,29,10,7,21,13,5,17,24,4,6,25,10,25,47,0,13,104,25,11,5,1,7,19,40,31,11,12,2,9,1,7,2,4,4,10,7,15,21,13,7,12,14,12,10,8,1,6,2,50,15,9,20,7,11,16,5,4,11,16,17,16,13,9,9,0,31,4,12,6,5,10,22,14,16,11,4,0,4,9,9,41,28,14,0,3,16,25,4,6,9,8,6,10,7,16,6,13,6,20,19,11,4,0,9,3,11,25,24,6,13,11,16,2,25,38,26,10,18,7,0,7,5,9,17,18,8,33,30,27,0,8,28,46,14,15,79,11,15,9,11,21,3,24,35,10,20,20,17,9,16,15,26,16,9,1,12,6,17,6,5,11,27,29,13,11,12,9,5,6,14,7,7,5,17,14,17,4,27,1,8,6,6,0,8,3,3,17,8,5,5,19,8,5,13,3,15,12,5,5,20,1,17,16,13,39,14,9,7,6,5,5,23,12,15,4,6,15,2,21,8,7,10,9,12,17,1,3,4,8,9,10,8,9,12,5,6,16,16,7,9,32,7,7,1,5,10,1,2,3,2,2,4,8,7,9,3,7,4,4,3,6,10,3,6,4,9,8,26,9,3,6,2,1,0,28,6,20,20,11,6,5,9,2,1,11,10,5,5,14,4,22,6,4,0,9,4,20,9,6,5,3,1,4,17,11,7,12,7,45,1,5,18,24,21,12,24,4,0,7,7,12,5,3,6,1,30,3,3,3,6,11,4,8,9,0,3,7,7,7,14,9,9,7,2,8,15,6,0,6,0,16,9,32,10,17,1,9,7,9,16,2,15,21,25,4,10,4
construction,6,26,7,234,2,9,3,36,8,14,17,28,38,55,13,4,6,13,2,0,9,41,5,16,27,15,4,17,5,11,14,278,80,6,53,32,15,17,11,3,7,4,4,19,37,11,50,27,327,29,44,0,4,29,2,1,27,60,1,43,12,3,7,15,17,2,42,12,7,33,37,53,7,3,53,10,31,5,84,14,111,2,19,4,245,30,32,1,50,3,18,1,5,27,60,13,24,5,47,9,1,49,45,5,18,36,4,12,22,14,25,9,27,22,9,25,4,10,87,186,35,17,9,125,16,0,6,4,19,4,12,3,4,84,21,246,3,7,21,10,2,19,56,7,7,74,5,13,23,16,107,4,17,21,6,67,21,12,2,20,64,5,7,7,12,12,3,10,18,13,30,160,27,1,4,2,191,10,9,81,42,10,25,34,66,22,45,36,33,109,3,7,9,1,6,5,45,7,30,10,25,2,4,16,39,11,16,31,6,54,90,9,18,13,2,9,6,7,12,29,4,15,8,25,80,61,36,30,7,18,39,47,13,33,15,17,31,21,10,4,64,50,7,0,8,5,9,22,74,5,16,21,15,11,20,8,7,5,3,35,6,16,27,13,15,99,1,7,4,6,119,27,58,9,3,1,29,37,17,7,49,2,1,19,16,5,9,10,10,7,3,4,18,20,10,14,37,15,9,9,20,64,21,6,9,1,14,3,4,6,9,22,30,3,46,33,27,51,20,7,13,4,37,24,70,19,20,21,8,25,0,23,7,10,8,77,24,10,20,14,6,6,21,13,9,14,34,76,67,12,8,5,5,69,27,10,4,3,13,25,43,17,14,16,9,0,22,8,3,10,8,18,7,10,4,54,5,3,12,6,70,7,64,16,0,80,1,18,33,2,11,15,19,17,51,10,79,5,33,8,32,4,9,0,3,7,17,0,12,12,0,9,2,22,0,2,16,4,0,0,1,14,31,7,2,5,8,23,6,17,13,11,3,17,3,7,0,18,35,15,8,36,35,3,1,4,44,5,27,23,14,7,6,4,82,5,0,5,11,25,8,18,21,16,7,8,34,16,47,0,15,2,15,0,15,12,2,14,19,12,4,17,1,9,5,13,22,0,1,1,107,62,2,1,2,15,27,27,4,5,14,5,11,4,25,21,1,21,17,12,2,1,11,8,26,20,9,13,6,12,3,17,14,27,9,3,28,8,10,41,6,2,2,9,11,4,21,4,26,34,3,3,1,1,17,22,4,22,23,17,55,15,14,52,6,5,60,8,15,8,29,8,30,8,38,22,15,4,44,51,27,18,64,0,12,12,1,10,8,41,20,26,19,4,4,3,4,3,3,11,24,40,11,9,26,10,9,5,86,7,24,13,5,4,15,40,30,16,12,14,31,46,11,11,36,11,21,2,12,5,26,11,10,20,12,8,19,7,21,22,7,37,13,11,17,9,7,35,2,27,15,2,7,26,2,84,22,12,13,159,12,3,6,6,8,20,41,8,4,25,6,6,23,29,11,7,2,6,14,15,29,14,18,27,27,1,4,34,39,13,106,43,10,6,11,7,7,6,17,67,16,9,21,72,11,85,5,9,5,24,12,6,17,14,18,8,30,7,2,9,4,14,3,25,31,22,5,10,5,11,11,6,1,25,3,15,9,3,1,12,10,19,6,13,11,6,125,6,54,18,20,16,41,83,23,7,34,26,5,12,16,7,11,13,9,17,7,16,15,16,7,11,1,19,37,27,31,7,8,13,4,3,6,9,29,25,7,7,8,15,0,1,13,4,3,10,2,2,13,14,3,19,10,15,38,29,49,12,11,4,4,7,14,6,4,3,11,1,25,12,1,35,19,14,4,6,6,7,10,20,2,5,5,31,22,6,3,16,10,3,11,9,5,9,10,10,16,10,7,7,7,5,3,9,9,49,19,17,17,10,9,48,1,16,4,7,4,8,5,9,6,1,5,16,3,7,4,10,4,33,11,15,19,6,4,5,7,12,15,5,3,25,4,6,11,13,18,5,4,29,17,57,6,12,2,10,9,1,18,2,9,6,8,3,1,0,26,3,1,24,12,20,12,10,16,6,12,29,2,8,20,6,8,8,5,12,7,6,5,10,13,5,9,6,11,13,11,11,3,47,12,8,12,5,4,17,5,47,30,5,15,5,4,7,16,4,32,35,65,6,22,20,1,3,9,80,21,7,2,26,5,11,5,3,1,8,10,6,14,1,11,7,6,6,9,7,5,8,4,0,7,12,7,5,33,1,6,18,4,0
already,6,38,22,391,18,23,9,87,11,4,58,23,63,172,9,24,23,41,21,5,15,86,43,64,53,37,36,36,21,51,33,514,318,39,140,178,86,26,19,7,27,18,9,18,94,41,90,50,576,66,107,27,34,95,37,5,119,71,17,64,41,14,14,46,48,24,202,17,10,88,87,19,11,7,218,25,79,13,166,62,172,6,43,23,488,56,43,7,85,10,28,18,24,78,128,66,42,22,97,40,49,1,67,19,39,68,52,42,59,23,64,17,33,53,23,93,10,27,170,408,117,84,79,205,22,12,18,11,14,10,49,12,18,142,41,203,14,8,15,21,6,88,75,17,8,191,13,36,65,39,164,16,42,27,24,86,82,16,23,61,44,12,39,14,22,46,18,61,69,21,50,256,82,23,25,21,361,11,21,127,76,28,36,66,24,51,83,71,70,130,9,10,17,8,15,14,57,20,22,23,94,11,10,30,65,26,25,80,34,81,220,32,89,19,12,30,17,24,28,19,31,63,14,52,124,256,64,49,36,47,40,57,70,77,86,49,87,38,24,28,156,82,20,23,38,16,20,52,152,13,29,52,71,20,19,38,27,7,17,51,10,72,42,6,22,124,22,11,48,23,329,43,78,15,14,8,51,49,29,12,147,15,19,38,30,14,26,48,32,10,14,10,36,23,18,22,117,20,22,47,55,93,12,10,28,17,61,11,13,3,7,102,76,22,117,50,43,93,38,18,97,25,54,33,133,13,40,81,9,60,9,31,24,20,21,39,52,23,21,38,29,25,36,32,33,31,105,130,43,20,44,40,11,109,63,17,6,10,40,63,62,36,33,38,12,6,69,28,35,47,16,55,13,35,23,101,22,6,41,12,164,10,112,32,11,114,24,48,58,7,49,13,45,33,86,16,110,22,87,12,53,10,14,9,16,18,19,11,52,39,9,47,19,38,13,38,17,31,9,10,6,19,66,30,4,13,20,31,40,36,22,17,10,22,18,15,7,34,32,25,52,40,27,39,9,15,40,15,84,15,68,11,19,8,143,23,4,21,30,75,36,43,71,69,29,18,57,46,42,10,55,10,7,8,14,30,14,37,56,22,16,35,18,9,25,24,39,19,22,17,193,104,8,13,24,12,13,35,17,23,28,19,10,12,39,51,21,28,29,10,20,13,21,20,43,29,22,30,10,26,13,45,27,69,19,8,50,30,47,61,30,18,23,25,23,11,17,19,86,56,19,12,8,39,22,16,8,33,27,29,63,12,16,95,27,21,84,6,26,25,46,20,55,14,35,48,31,22,91,95,32,22,53,11,15,15,19,19,23,60,14,37,32,35,27,14,26,20,7,38,54,85,14,28,51,12,9,8,91,53,45,11,10,8,19,49,19,48,22,13,80,92,34,22,54,16,34,18,34,9,41,14,11,50,14,24,22,26,33,97,39,69,67,39,36,9,37,37,20,36,26,12,18,44,25,85,13,23,27,328,44,24,18,1,17,41,74,34,12,56,14,17,36,46,14,15,14,32,20,20,58,16,68,53,58,18,11,15,9,19,11,68,34,33,31,24,29,21,17,28,35,27,31,44,18,51,20,9,35,32,44,12,13,17,26,27,36,23,16,7,10,28,14,78,45,68,35,12,19,33,23,8,20,50,14,26,29,7,14,24,19,40,19,13,16,19,64,17,74,29,53,23,22,37,28,11,55,38,22,17,30,30,22,37,15,33,20,30,29,35,32,36,13,13,42,31,24,15,36,27,17,17,6,32,12,24,22,10,37,19,14,8,24,6,27,20,11,11,25,31,13,36,10,17,62,46,22,26,9,9,11,17,21,7,24,10,23,15,54,13,17,10,26,22,15,8,12,36,24,22,7,13,26,36,18,14,19,28,9,19,21,20,30,14,21,22,18,55,28,16,12,23,14,25,13,31,18,30,14,36,42,67,25,13,21,11,24,21,13,17,19,10,10,14,12,15,13,18,21,32,18,14,34,29,9,17,6,22,33,19,16,17,7,18,18,12,20,15,18,19,20,31,21,18,12,16,15,12,15,22,23,12,17,16,24,8,15,25,21,52,13,51,15,56,30,12,15,18,9,19,7,20,15,16,8,16,10,26,9,13,12,12,16,19,11,10,15,13,5,39,19,31,29,16,38,50,56,50,90,12,25,12,16,22,15,20,19,13,46,18,24,16,14,13,9,41,22,13,6,20,34,15,24,13,11,6,22,15,25,10,17,11,13,24,17,32,21,27,27,14,9,15,21,7,13,17,9,27,8,8
however,16,77,31,374,28,14,11,124,10,11,56,21,19,161,10,24,17,37,12,12,16,104,26,60,59,27,22,24,13,48,27,485,289,18,117,114,96,42,44,14,23,18,7,4,98,54,80,30,855,35,126,7,41,66,11,22,179,67,3,61,49,20,7,64,52,13,223,20,40,48,53,12,11,14,193,30,34,22,225,52,112,6,62,11,608,58,47,4,93,7,31,16,5,92,149,54,50,14,120,32,45,67,1,30,39,77,39,5,42,24,56,17,22,33,5,111,26,9,204,454,114,32,60,224,14,14,4,24,17,4,40,6,17,124,45,117,18,14,10,13,8,86,98,21,10,191,10,35,37,47,182,3,63,18,13,87,75,15,24,18,37,13,29,13,4,7,9,52,55,31,36,223,50,8,11,31,465,10,39,99,74,38,19,40,7,42,96,70,126,149,9,25,22,0,6,15,39,7,31,31,60,6,9,39,76,22,23,90,25,79,197,12,72,18,5,3,5,18,43,11,17,36,19,33,135,274,91,69,17,35,51,47,79,86,84,80,124,21,33,17,192,95,27,10,34,34,22,55,139,11,34,59,67,37,41,50,47,9,24,49,10,54,79,17,15,94,11,7,23,12,430,32,139,12,12,4,48,69,38,9,124,16,8,55,25,7,10,24,43,7,21,10,25,29,10,35,119,11,18,63,78,83,7,11,43,10,55,24,18,5,8,66,94,17,94,43,38,132,53,25,154,28,73,15,174,15,26,89,10,79,14,38,27,17,22,48,49,27,16,41,39,26,36,32,15,13,127,139,49,17,53,47,16,85,64,19,18,14,44,91,56,18,14,52,29,3,113,25,11,31,11,36,17,24,31,57,16,16,46,28,189,5,119,44,7,123,18,90,81,17,59,10,22,43,98,26,194,16,70,19,85,8,10,5,23,13,23,10,67,23,6,24,13,38,28,21,14,14,13,5,13,24,49,52,15,19,7,32,26,59,48,34,21,39,11,16,6,53,25,13,50,57,18,43,10,13,18,17,93,38,47,19,8,19,142,36,4,45,19,106,34,55,70,58,9,12,44,31,29,3,44,11,8,15,8,36,16,43,56,24,16,34,21,14,20,33,30,11,12,8,160,124,5,13,25,20,11,53,32,37,34,14,25,4,36,90,13,51,21,14,14,23,27,18,45,55,8,33,9,25,16,33,15,62,26,12,72,12,52,88,29,17,11,14,38,10,40,13,103,51,18,7,12,16,29,47,8,43,64,19,128,12,24,152,12,16,57,14,24,30,79,15,71,10,47,52,50,24,103,102,37,31,71,10,20,35,37,24,16,55,27,45,26,30,18,14,18,26,20,35,69,88,23,13,54,12,17,9,157,57,75,6,16,19,24,61,24,78,25,15,67,50,36,23,99,23,61,17,18,16,33,48,16,87,8,34,33,26,32,72,70,66,84,49,15,4,30,24,9,32,33,5,20,62,38,60,19,13,26,502,57,13,20,11,12,42,121,55,20,44,14,20,65,75,29,16,11,32,50,36,55,44,108,66,90,12,10,30,11,23,7,87,48,24,32,23,30,21,13,37,43,25,61,30,26,35,38,22,40,50,31,15,13,27,17,19,56,22,17,15,13,23,15,70,67,48,19,19,21,23,17,13,21,69,5,15,27,7,16,40,21,43,16,17,19,13,63,27,86,17,48,22,15,25,32,14,38,16,11,24,38,25,20,62,35,44,33,37,5,50,45,41,22,11,51,53,25,28,18,35,19,10,11,45,11,45,30,16,49,42,12,21,43,16,19,23,13,50,43,47,26,30,13,17,23,45,10,21,16,27,17,16,41,20,17,8,16,16,54,24,26,5,19,30,8,14,10,23,22,37,40,9,23,33,20,16,15,31,40,23,23,23,23,19,26,24,30,80,24,16,28,26,10,28,28,26,25,27,10,36,61,68,25,18,10,17,22,27,23,9,24,24,19,18,25,24,18,7,22,39,13,11,41,53,16,21,14,48,35,19,11,31,10,31,35,17,27,17,15,13,6,33,3,17,30,25,11,14,14,9,13,24,9,24,28,21,7,25,18,66,14,33,21,44,35,18,4,23,16,17,24,25,8,36,16,27,13,53,19,29,20,13,29,28,15,14,13,31,13,25,11,38,51,29,27,58,53,73,112,24,7,21,5,22,22,32,12,9,56,29,13,16,13,12,6,53,11,8,10,14,16,20,14,18,23,14,5,26,35,15,12,17,31,54,15,16,28,7,37,2,8,9,13,2,3,15,5,24,7,2
thing,1,17,9,100,16,23,6,37,3,5,9,6,12,88,8,9,14,18,16,6,6,58,37,52,26,30,26,29,26,31,12,190,138,29,56,117,48,14,20,10,16,8,9,9,47,22,16,8,267,60,73,10,23,65,31,11,47,15,24,23,19,14,4,22,39,14,118,12,12,9,10,0,7,5,130,28,26,13,91,42,52,6,14,19,230,21,14,8,24,1,16,17,8,37,61,18,18,5,44,22,5,19,30,1,13,28,5,13,20,6,36,7,17,26,13,38,2,8,42,133,44,40,23,52,8,14,6,2,2,0,29,6,12,39,41,98,13,2,12,8,8,50,29,4,2,77,13,18,10,9,75,13,16,5,1,30,49,5,11,47,18,3,10,0,5,30,6,20,25,22,8,127,37,8,18,9,135,8,11,67,32,20,23,34,5,37,30,27,40,55,15,11,9,5,11,10,14,9,3,18,30,3,8,8,25,10,3,27,7,19,90,19,29,23,21,35,3,8,15,2,4,20,6,12,34,82,23,25,4,3,16,22,22,16,43,21,30,8,11,15,82,39,3,17,27,5,11,50,34,8,16,23,27,1,3,32,7,3,2,18,7,44,11,2,10,20,17,30,25,3,130,7,13,11,0,4,21,6,11,1,79,9,6,18,15,1,17,18,20,6,0,9,10,5,1,7,39,1,8,21,34,23,2,0,11,7,19,5,6,1,0,14,35,15,52,19,16,34,12,6,51,7,40,14,69,5,13,70,5,22,11,14,14,10,8,12,31,4,4,8,14,22,36,12,7,12,56,55,15,32,14,17,6,36,17,7,5,3,11,34,14,10,10,16,3,8,37,14,16,60,9,55,6,24,18,9,10,8,17,6,56,6,51,10,14,23,7,16,47,6,23,8,7,3,31,24,45,3,34,1,18,16,5,7,8,7,5,1,24,15,5,4,3,14,10,19,13,17,7,25,7,5,21,16,7,7,4,11,7,18,9,2,1,12,6,7,3,24,23,5,17,22,7,12,1,3,41,14,53,15,29,7,16,5,56,14,9,7,11,25,26,23,29,47,7,10,45,22,5,6,35,16,2,9,2,13,8,8,33,7,10,17,2,14,13,6,13,17,13,1,72,34,4,11,12,10,4,6,6,13,8,3,4,7,9,20,1,13,6,2,6,11,6,5,11,11,4,6,3,13,7,14,5,18,12,11,15,10,19,22,10,21,7,10,9,9,13,13,40,14,4,1,6,11,7,7,10,20,10,6,34,7,10,44,10,11,32,5,5,8,24,1,16,7,15,6,15,11,21,32,10,5,7,2,3,3,7,6,6,13,14,9,13,21,7,3,8,7,2,12,18,33,21,7,30,7,5,8,19,21,11,3,12,2,5,22,8,15,3,4,28,8,9,4,16,12,23,6,6,4,18,12,4,22,5,3,7,7,13,22,23,17,28,30,6,2,22,4,4,11,12,7,10,20,5,15,5,1,4,110,28,9,9,5,6,15,24,21,12,12,2,1,0,13,9,1,1,7,9,10,8,6,36,24,15,5,0,3,4,6,8,24,12,6,7,9,17,4,1,6,10,36,16,5,7,7,13,4,13,11,4,1,3,2,3,12,21,11,4,2,8,1,2,26,21,10,16,8,9,5,2,5,8,19,0,6,6,3,4,11,8,11,8,4,3,2,10,6,22,12,6,6,6,6,10,5,19,11,4,5,10,2,0,2,1,10,11,11,2,3,1,13,4,0,14,23,9,3,4,14,16,3,11,12,2,15,12,3,10,7,3,7,9,3,2,6,7,12,8,15,10,2,1,6,11,26,3,6,3,1,4,2,10,5,27,8,18,5,17,2,16,2,2,5,7,5,7,15,7,8,6,2,1,5,1,11,14,3,21,3,7,4,17,7,10,10,11,23,17,8,8,10,4,4,2,19,11,4,3,17,25,17,9,4,1,7,5,2,7,3,4,4,8,3,6,11,2,2,8,7,4,4,8,20,3,4,0,8,12,1,0,5,8,5,5,1,10,3,10,8,3,9,2,3,7,4,6,4,3,17,6,10,8,10,4,2,0,20,3,15,3,9,5,6,10,4,1,4,2,1,6,9,8,13,5,8,4,10,3,3,3,5,6,4,4,4,8,4,3,12,4,16,1,2,8,19,15,2,25,5,0,2,2,2,4,0,1,2,13,8,0,2,1,1,3,11,1,2,1,4,4,5,11,11,4,9,6,10,11,4,3,16,4,14,7,7,7,14,28,8,1,4,2,8,2,2,6,1,3,14
past,4,22,7,153,10,32,10,38,3,5,30,11,33,125,11,13,11,19,11,14,14,50,35,27,29,27,20,24,7,22,12,226,166,19,49,151,73,5,26,12,19,30,5,7,42,17,29,30,240,73,47,21,24,83,24,8,45,22,13,40,23,9,8,16,33,16,130,17,8,22,56,3,6,5,165,30,36,8,114,24,87,15,20,7,244,30,13,9,38,9,46,6,32,25,53,38,30,8,61,29,18,39,39,13,1,23,10,28,33,10,31,14,30,27,16,38,5,12,58,142,53,30,23,327,21,6,9,4,12,7,101,13,23,44,28,80,15,16,8,33,4,59,37,17,12,90,13,43,19,15,70,13,19,18,24,49,58,23,11,26,17,13,13,10,21,25,10,31,35,17,26,135,42,11,9,17,150,5,17,57,44,20,29,34,3,24,64,27,56,70,5,10,4,5,13,11,24,21,66,15,42,7,4,16,33,14,12,43,17,38,77,20,34,10,7,19,12,11,16,6,5,30,4,13,46,79,37,47,14,20,12,50,35,31,48,18,50,12,19,14,55,53,15,19,22,7,16,32,67,6,9,30,31,2,7,20,10,24,4,35,12,27,13,3,15,62,10,22,16,7,130,12,19,5,5,14,31,21,9,5,74,9,3,15,14,10,12,23,14,7,2,7,11,7,14,6,23,12,4,25,43,26,4,9,15,5,30,8,18,2,5,27,52,20,39,13,29,62,14,12,39,11,39,13,53,6,29,41,9,36,6,10,14,5,10,16,29,11,9,20,13,13,22,11,17,5,40,45,21,29,10,12,11,58,34,12,8,3,19,46,25,19,32,29,3,12,26,12,9,25,3,21,11,25,19,62,19,5,29,4,63,4,28,20,12,69,16,41,30,6,28,12,14,9,22,11,42,5,35,9,19,6,14,2,6,10,7,4,24,11,17,10,9,20,16,8,4,16,2,9,15,15,26,11,6,7,10,14,17,25,3,5,4,8,9,5,4,13,24,6,11,19,10,27,8,8,36,12,42,11,27,10,16,8,63,12,3,6,7,22,18,54,43,63,11,1,33,24,10,5,39,12,5,10,5,46,10,12,20,23,11,16,5,6,7,9,13,4,5,4,90,55,1,11,19,9,4,22,16,16,16,11,6,7,11,9,22,19,4,9,7,9,8,7,18,13,7,8,4,21,7,17,3,18,4,5,36,16,29,29,9,8,2,12,6,5,8,14,38,37,9,3,5,37,14,10,8,11,16,12,20,2,6,44,8,14,27,9,10,12,12,7,17,4,24,15,27,9,33,39,24,3,13,2,10,1,3,6,13,22,7,15,19,22,9,20,5,17,4,16,24,30,16,6,32,6,21,12,30,18,16,9,11,0,13,21,3,23,6,3,34,12,8,9,42,8,13,3,4,7,8,1,5,18,7,8,6,8,13,43,17,16,18,19,6,3,31,15,5,9,25,6,8,12,10,13,13,10,16,146,20,15,8,19,5,24,29,11,4,15,9,6,10,20,2,5,5,12,13,17,19,7,35,15,31,8,5,4,5,8,6,37,15,11,7,6,16,9,1,7,7,26,13,7,6,11,8,6,17,12,9,12,3,9,16,8,20,8,1,3,2,7,1,37,21,25,10,11,7,15,13,5,3,29,10,11,11,4,10,18,10,17,12,13,8,7,17,8,16,17,18,3,5,6,11,8,17,22,14,6,10,8,7,12,11,14,16,11,11,22,22,19,6,8,21,24,18,11,34,9,14,13,12,17,14,13,7,12,11,10,8,6,8,1,8,13,2,1,6,10,11,9,2,8,12,20,3,6,10,3,7,5,13,5,11,4,11,11,17,7,10,8,1,8,5,2,8,13,8,6,3,5,9,4,6,4,6,9,5,12,13,15,14,6,4,14,10,34,13,4,5,2,4,9,10,12,8,9,3,12,14,19,6,2,7,5,12,7,7,12,2,7,8,14,6,8,12,4,7,10,3,3,14,10,8,8,5,15,6,6,3,6,5,3,6,10,4,2,7,6,4,19,2,5,9,3,3,1,20,8,8,7,4,8,8,4,10,9,7,18,6,8,8,12,6,6,4,3,7,3,3,15,7,1,2,4,6,10,5,1,5,4,5,5,4,9,10,5,6,15,3,13,20,2,12,15,9,15,21,10,2,8,6,2,6,1,7,5,8,4,6,6,5,10,15,10,2,1,3,9,10,6,13,8,4,4,6,7,8,3,4,8,5,4,7,2,7,18,11,0,5,7,2,5,7,11,4,3,5,1
call,14,83,35,507,31,22,15,82,20,5,35,23,34,169,8,18,18,48,21,10,14,112,53,92,75,54,37,53,30,91,40,472,320,51,121,191,129,23,30,18,15,45,14,22,85,38,64,36,645,126,106,17,31,119,46,10,169,102,52,31,40,18,6,38,55,27,198,21,30,38,45,27,13,8,181,39,57,17,206,53,122,11,35,29,501,53,35,8,85,7,21,28,20,63,95,45,35,32,84,36,36,68,77,28,23,1,21,11,32,13,53,14,32,47,22,69,22,14,175,333,107,71,47,171,17,13,11,9,10,8,39,13,19,132,73,145,12,13,14,23,19,84,79,9,20,178,14,43,38,38,153,7,38,21,9,58,76,25,14,64,31,7,18,17,22,37,17,39,68,23,55,230,44,4,17,26,464,11,33,138,60,24,20,59,14,57,69,66,66,96,24,27,12,8,14,4,50,18,25,23,93,13,10,28,54,26,31,83,33,52,198,24,68,40,16,29,7,14,64,5,7,51,15,35,129,285,62,53,11,16,27,42,41,42,86,47,84,29,23,17,170,73,27,17,33,25,16,76,128,16,32,31,48,24,31,40,40,11,11,55,24,103,73,19,18,140,21,21,31,13,293,41,75,16,17,12,53,40,33,17,150,19,6,39,34,9,36,25,46,9,24,14,47,32,26,20,94,41,17,36,58,77,5,14,27,7,48,29,24,11,7,53,94,20,96,44,40,81,29,15,106,25,72,51,122,17,25,104,22,52,21,31,22,16,26,33,58,15,11,31,21,47,58,38,16,14,120,129,58,32,28,32,12,96,40,14,27,15,37,84,56,25,25,39,10,12,102,22,37,43,10,77,13,49,29,109,23,10,35,20,161,7,123,38,23,95,38,53,72,14,54,25,43,35,69,22,190,17,92,11,57,15,10,17,14,13,25,7,49,25,5,22,10,41,28,27,12,19,9,26,14,24,74,30,13,12,8,29,28,31,35,14,9,39,25,8,5,23,41,14,45,58,17,22,8,12,45,22,79,29,55,6,18,17,106,16,9,28,28,71,38,42,86,90,17,17,55,23,20,2,80,14,10,13,11,48,11,58,51,20,16,37,4,13,18,26,24,17,12,14,181,85,13,9,26,18,7,38,19,37,20,12,10,7,21,81,18,26,28,7,18,16,20,22,27,34,24,26,15,21,7,39,19,56,16,21,61,12,37,88,31,35,23,32,18,15,24,19,114,50,9,6,7,28,21,19,8,42,38,31,84,16,25,100,25,31,57,9,16,28,65,15,70,11,31,58,31,28,103,76,34,28,61,12,16,21,26,17,9,43,14,42,19,45,18,10,16,18,9,22,52,84,30,16,79,15,5,8,86,34,43,5,22,10,16,81,15,72,19,20,102,58,34,10,80,11,52,14,21,11,47,21,13,81,12,18,16,32,29,91,23,284,80,41,21,7,40,23,20,31,24,9,21,71,14,93,17,17,20,338,51,13,24,13,13,39,79,59,15,32,14,19,50,42,18,8,19,21,31,32,61,26,39,76,80,19,10,39,8,18,11,68,47,31,16,33,28,15,10,19,32,33,62,22,30,30,20,7,26,38,17,10,29,15,22,18,30,32,13,11,15,19,15,63,44,82,37,15,27,23,37,26,14,94,15,27,19,13,5,37,17,46,12,16,14,10,48,14,65,26,27,13,19,26,30,11,40,19,7,19,35,22,12,35,27,31,24,27,7,53,47,42,30,17,50,20,35,29,29,18,25,8,16,43,11,25,21,14,59,48,16,23,33,15,23,18,19,21,13,28,30,23,13,15,47,28,18,32,16,15,13,13,17,33,25,11,18,12,39,14,16,21,21,24,13,16,8,26,6,21,9,15,46,36,8,11,19,29,27,12,30,18,28,12,22,23,37,68,9,30,25,40,9,18,33,36,23,22,26,42,22,70,13,8,12,10,19,18,23,7,8,13,17,7,13,23,11,18,20,64,16,14,39,29,28,18,8,16,34,7,4,23,22,9,33,3,30,9,11,14,18,24,4,4,15,24,16,54,27,24,18,13,21,25,57,18,10,18,10,51,24,19,11,42,12,21,13,10,6,11,20,13,3,24,8,22,11,22,7,29,23,15,18,24,10,10,29,7,10,18,10,26,14,11,33,35,17,29,93,11,16,12,15,20,15,14,9,9,42,11,17,17,9,15,4,32,20,18,15,15,29,8,22,13,15,13,15,18,21,5,20,18,12,16,21,14,19,23,19,8,12,17,14,4,6,11,8,13,12,16
reduction,4,2,1,143,3,10,4,9,1,3,2,0,13,31,1,5,2,9,4,5,7,12,10,10,19,10,10,7,1,13,20,201,98,6,42,25,13,14,39,11,16,3,1,12,28,10,39,12,72,5,27,7,19,31,8,0,83,34,5,7,12,4,4,9,24,4,61,5,8,10,70,3,4,3,70,8,28,1,60,16,122,11,3,0,111,28,15,20,63,17,23,8,17,33,79,65,17,8,40,22,4,52,39,5,10,21,1,27,28,8,22,5,35,13,8,37,13,4,64,155,32,15,173,137,7,2,1,2,8,7,7,0,5,52,17,24,1,3,5,6,5,16,20,4,2,42,4,13,18,29,14,5,18,3,13,37,26,3,0,3,44,4,10,19,45,5,5,22,28,5,6,60,16,0,5,1,111,1,3,31,10,4,16,16,0,19,34,6,10,29,0,2,12,1,4,9,20,12,15,10,43,13,17,18,15,5,7,33,11,27,57,5,15,15,1,10,39,45,8,5,23,10,10,6,59,52,42,33,16,41,4,28,105,12,36,115,18,6,18,5,76,24,2,1,7,15,5,16,38,3,18,43,12,25,6,21,5,29,12,30,5,22,19,2,6,63,2,4,12,4,99,12,86,2,2,3,4,98,10,10,44,0,5,7,13,5,6,4,10,2,2,3,26,29,16,8,22,6,7,6,15,66,6,23,12,7,8,3,3,1,1,9,30,3,75,24,31,52,17,8,12,9,18,1,8,0,12,25,3,12,3,11,4,7,4,11,15,5,13,22,9,7,10,4,7,3,22,25,7,17,31,10,0,27,15,3,3,2,19,59,16,11,7,18,0,2,16,5,23,5,6,19,6,7,9,48,6,4,7,14,74,0,27,2,3,33,0,17,27,3,7,6,11,8,26,7,34,3,16,4,14,3,8,3,3,3,5,1,12,9,0,4,1,9,1,3,12,6,1,3,0,1,2,2,1,0,5,3,3,18,13,9,25,25,4,2,8,6,18,7,13,6,6,4,0,1,3,5,20,9,26,4,2,2,18,1,0,0,2,61,17,8,13,24,1,0,11,4,2,0,15,4,1,2,3,5,2,1,18,7,4,6,0,0,5,5,15,3,3,6,66,49,1,4,6,3,3,18,10,5,13,9,15,5,6,26,7,15,6,2,15,5,5,2,16,17,2,6,5,6,0,8,3,9,4,5,7,11,12,33,17,4,1,6,4,4,1,7,20,10,0,3,1,12,11,4,1,8,9,3,4,1,3,42,5,3,13,4,16,7,25,7,14,10,6,10,9,7,21,29,7,4,43,0,7,2,41,5,3,24,10,9,9,13,6,4,8,11,0,12,17,16,7,4,8,1,9,20,25,15,19,0,2,0,2,16,4,17,7,10,23,9,2,7,14,5,18,8,3,6,9,17,4,22,2,4,2,9,3,14,9,15,22,7,2,7,11,6,3,4,5,0,6,11,6,53,9,7,13,46,2,4,5,1,1,13,20,2,1,7,1,2,6,6,3,8,0,5,8,4,8,11,10,1,7,5,5,12,2,2,3,20,7,9,9,8,10,8,4,3,2,9,11,2,4,2,10,3,20,10,1,8,1,5,5,4,10,3,4,5,1,16,9,31,14,23,1,2,2,12,11,0,0,22,0,1,11,1,4,7,0,10,9,8,4,4,16,7,6,8,5,0,2,1,4,1,7,5,5,10,2,43,30,59,37,15,17,11,7,76,92,7,5,18,12,11,2,8,11,6,3,1,8,6,5,6,13,2,14,3,3,1,12,4,6,9,10,4,12,17,6,1,0,7,10,19,3,7,8,1,6,4,8,6,8,1,8,8,12,4,29,0,12,4,6,7,2,17,4,9,4,5,4,5,3,2,5,13,12,12,19,13,11,3,1,6,2,19,2,4,6,4,1,5,15,8,9,8,9,0,20,6,3,9,1,1,4,8,1,8,10,2,2,4,2,9,1,2,3,26,8,3,26,14,4,4,0,3,2,1,0,6,1,7,6,1,4,5,2,10,0,2,2,3,6,2,1,0,9,2,15,6,1,6,2,6,0,11,9,24,2,5,5,27,10,8,1,1,3,10,1,5,0,19,1,3,0,7,5,8,1,5,2,11,3,19,3,9,0,9,3,11,44,32,43,34,68,78,87,4,8,0,1,7,6,12,16,2,11,1,7,2,8,3,10,14,2,9,0,1,1,0,5,0,10,2,8,3,4,2,23,0,5,5,9,40,5,6,8,0,1,2,3,5,0,33,5,4,1,0
cut,11,19,4,82,6,24,1,5,3,7,1,4,32,41,2,2,14,8,19,11,5,13,52,53,13,35,5,17,5,15,10,146,59,4,29,87,10,3,9,5,6,8,3,21,20,9,34,23,72,63,34,10,9,38,36,2,6,9,17,21,2,2,2,4,21,17,83,9,3,27,70,5,10,6,92,4,56,1,56,23,64,21,4,12,115,27,9,67,16,5,5,5,75,14,29,45,9,4,24,16,12,42,5,13,28,11,27,1,32,55,23,8,34,33,47,49,4,7,27,94,21,46,251,170,23,1,4,1,5,12,21,3,9,40,18,90,8,11,10,17,4,28,35,4,11,72,7,16,15,17,17,16,8,5,33,76,35,15,2,56,44,15,26,17,90,41,7,11,21,9,19,86,35,10,5,0,49,1,7,52,29,3,55,24,3,14,24,15,10,39,7,6,6,4,23,7,41,6,21,7,42,13,21,10,9,8,7,15,12,12,51,31,42,27,15,66,99,105,15,3,11,17,1,13,28,42,20,45,9,50,11,16,65,16,28,13,17,10,14,3,53,25,7,10,8,13,2,33,20,19,9,23,17,1,4,19,4,10,1,20,8,18,9,1,1,29,32,11,12,5,35,9,14,4,1,13,25,14,4,8,52,3,11,11,23,9,35,44,7,8,2,4,26,24,22,9,11,4,4,7,16,22,12,10,1,7,12,4,10,4,3,13,20,13,84,10,19,28,21,6,10,6,37,11,52,3,20,42,3,26,10,5,4,1,4,3,10,4,5,7,5,24,20,4,4,3,12,24,5,52,11,5,0,38,6,3,5,3,7,25,12,14,5,9,0,9,6,5,22,33,0,25,2,26,11,11,3,7,6,2,11,1,14,2,3,22,22,3,19,1,7,3,10,3,15,6,6,2,21,4,2,13,4,5,8,1,7,1,10,12,2,6,7,6,3,7,0,11,7,4,0,10,17,8,4,0,3,5,4,9,5,3,0,2,3,4,7,5,35,7,5,1,2,8,8,6,9,5,16,5,13,4,15,3,18,4,3,2,9,14,9,13,8,15,3,4,18,10,12,5,14,11,5,11,1,6,6,1,14,13,8,4,0,2,5,2,4,3,3,8,49,20,5,4,3,2,4,10,4,9,6,10,2,8,5,6,14,6,4,8,4,3,7,10,4,4,12,6,3,8,0,2,2,7,2,1,17,3,5,13,7,1,11,0,3,4,2,2,16,17,1,1,2,2,10,6,2,18,6,2,5,2,4,17,2,2,6,2,5,2,2,3,7,1,10,4,3,11,11,10,2,0,6,8,2,0,2,4,6,13,0,7,4,6,0,2,5,3,1,8,5,8,13,7,3,4,2,4,4,2,7,0,3,1,2,7,0,5,3,4,18,12,0,1,5,3,2,2,6,0,8,0,0,15,2,1,1,2,2,6,1,4,9,9,6,4,10,6,1,5,0,2,2,5,5,11,2,7,4,35,5,6,3,5,1,7,9,5,2,2,1,3,1,2,0,1,0,1,2,4,6,1,12,40,5,0,1,0,5,3,18,7,3,2,2,3,7,8,1,6,3,6,1,6,1,9,0,0,9,2,10,1,0,9,6,6,6,4,2,0,0,4,3,8,9,13,1,4,4,5,4,3,1,5,2,6,3,6,2,4,4,7,4,4,2,5,3,1,5,2,10,4,5,5,7,0,8,9,4,0,3,3,7,6,12,13,4,5,1,13,10,11,0,10,11,11,6,5,5,3,8,10,4,4,3,4,9,3,0,1,0,4,10,7,5,1,4,2,2,3,5,1,0,1,9,13,3,6,3,2,1,0,2,2,5,2,5,4,4,0,10,0,1,2,4,1,1,13,2,4,0,1,0,2,0,3,7,9,1,1,10,7,4,4,5,0,0,8,2,4,1,0,7,3,6,2,7,8,0,3,8,13,3,1,1,4,3,4,0,8,0,1,0,2,1,2,13,0,1,7,5,0,4,1,1,1,0,8,3,4,1,1,2,1,4,0,1,1,4,0,10,7,24,2,2,6,0,1,7,12,1,1,8,2,1,1,2,2,2,7,10,9,2,3,0,2,3,0,16,2,1,5,0,5,0,2,5,1,0,0,0,7,1,2,2,3,1,1,0,2,1,4,12,0,8,6,21,19,4,1,3,8,5,6,2,2,10,3,0,0,5,0,2,0,11,0,7,2,1,2,13,0,7,5,0,0,4,0,1,5,3,0,1,1,14,0,0,15,3,17,0,0,3,1,5,27,13,3,2,3
nearly,5,18,8,168,11,32,7,57,2,6,12,8,16,60,9,2,12,17,7,3,9,56,35,30,26,22,23,27,16,40,17,237,199,27,58,86,33,23,30,9,17,15,9,14,52,15,47,26,324,73,61,8,22,79,29,1,61,65,19,35,16,11,3,25,33,9,137,22,12,28,176,5,6,3,99,17,45,7,117,31,146,11,18,12,239,35,23,9,91,14,32,7,32,68,66,51,34,11,64,24,22,59,42,20,33,32,28,32,1,58,36,4,23,27,33,67,14,11,67,209,56,49,70,316,33,2,12,4,19,10,31,7,11,61,39,108,5,8,10,18,7,56,70,16,21,113,11,38,43,20,47,17,25,13,18,49,52,17,11,49,41,10,20,28,51,31,16,33,38,23,34,146,22,10,17,11,174,11,11,58,28,12,27,30,17,28,56,25,49,102,8,12,22,13,12,7,20,7,45,9,52,11,10,12,27,10,17,49,11,23,94,20,33,16,7,8,16,17,55,10,17,31,5,19,48,104,52,64,46,55,23,75,60,33,56,70,60,13,13,6,106,50,17,8,16,18,10,45,38,11,12,35,21,39,33,25,15,22,5,70,18,49,20,7,12,71,26,22,25,5,132,16,98,6,6,6,37,61,11,8,92,4,5,35,26,13,33,28,11,5,10,8,25,24,16,14,58,7,7,25,33,23,16,27,13,4,22,8,12,5,7,29,58,18,84,34,35,59,16,9,43,7,39,17,54,4,15,39,4,35,13,26,9,6,11,28,26,17,9,20,10,15,25,19,14,13,42,49,29,26,17,15,4,67,24,7,10,3,23,68,27,20,20,24,3,5,34,12,15,39,8,53,16,22,13,38,8,10,14,11,57,1,53,8,13,70,11,33,44,10,14,11,20,11,37,23,65,4,33,2,14,16,6,9,12,12,3,5,44,10,2,24,32,17,4,16,10,9,8,11,3,15,26,12,7,2,2,17,21,19,29,26,12,33,7,6,6,14,17,7,27,19,8,34,2,7,27,13,25,20,34,3,20,4,71,16,9,9,7,41,15,35,45,51,19,3,44,19,9,2,33,12,9,12,2,23,5,14,34,14,8,25,11,5,6,4,24,14,7,7,100,56,4,4,25,15,6,16,14,11,29,10,14,19,12,40,18,18,9,12,9,8,7,5,23,15,12,5,5,17,4,16,9,23,4,9,34,13,30,32,13,7,7,15,6,13,8,10,49,19,4,3,6,27,30,9,38,24,15,10,32,5,8,68,5,8,38,11,14,2,25,7,23,6,18,14,17,7,36,34,20,10,29,1,11,11,16,15,11,67,16,16,22,18,6,7,13,8,14,10,32,38,16,20,15,11,10,7,37,10,22,5,12,3,12,23,16,19,17,8,52,20,12,18,37,19,15,5,7,4,24,13,5,33,4,13,5,4,12,34,44,22,23,21,11,8,9,39,7,20,10,3,8,26,12,32,8,10,11,169,15,9,12,8,4,36,43,17,7,21,4,7,20,23,5,1,13,9,21,19,16,11,46,26,51,2,6,22,17,20,15,40,14,12,5,15,15,6,19,44,9,22,18,36,7,39,9,5,22,12,6,4,4,10,5,13,39,10,6,5,5,27,9,28,27,36,24,7,5,15,10,3,5,21,8,14,16,4,2,20,8,31,14,5,7,18,23,8,50,34,13,12,3,20,18,3,39,11,5,10,18,28,22,46,32,15,9,14,14,68,75,23,17,21,28,39,19,17,21,20,13,13,3,14,11,24,17,1,20,11,7,5,21,11,15,6,17,21,39,17,6,10,2,6,16,24,7,15,7,4,6,10,14,7,11,6,6,9,27,6,27,6,4,16,3,5,7,17,8,14,1,19,6,8,25,8,5,11,28,12,16,18,9,4,8,4,9,30,11,4,4,9,3,6,13,20,11,12,11,8,18,23,7,14,5,6,6,21,2,6,10,2,9,6,9,8,6,4,16,12,2,13,15,26,5,8,4,13,7,4,3,9,2,8,14,6,13,10,18,17,15,22,7,4,13,38,7,3,32,10,5,5,8,13,13,22,13,9,6,14,6,13,7,33,10,25,7,8,6,6,15,14,12,25,1,7,10,5,4,12,9,10,8,10,11,13,11,7,5,11,4,24,39,15,24,39,27,75,70,4,9,8,12,10,13,10,78,13,18,4,39,13,7,7,17,20,9,11,4,22,10,6,23,11,4,6,20,16,13,4,23,12,8,20,9,16,10,26,6,12,2,5,7,3,9,14,10,12,3,7
half,0,15,8,63,2,23,5,20,0,3,8,6,14,36,2,7,2,13,4,3,1,20,18,31,11,18,11,19,7,14,6,93,62,1,25,48,17,8,13,5,4,9,1,10,10,7,22,8,117,33,23,9,8,38,22,2,30,21,11,12,5,1,3,7,18,1,57,9,5,12,120,3,3,1,54,7,17,5,51,14,43,14,5,5,92,12,7,17,30,1,7,1,26,20,16,27,5,3,20,10,14,23,24,6,10,13,8,55,58,1,15,2,11,23,25,34,6,8,26,74,21,22,24,148,28,4,2,1,10,7,16,6,7,33,16,33,2,4,6,10,2,24,36,7,42,33,9,14,9,7,8,10,8,4,10,31,31,15,6,23,23,4,7,11,41,15,8,18,20,9,21,79,8,5,0,5,58,4,3,27,14,5,8,16,2,10,35,10,13,38,7,6,7,6,9,6,10,4,26,6,18,5,6,3,20,6,3,11,1,4,42,11,22,3,4,16,17,28,9,4,6,11,1,9,48,19,23,37,15,58,8,30,36,14,18,12,34,6,9,1,31,15,15,2,9,10,6,26,21,2,6,20,12,21,10,9,6,8,3,35,3,11,5,2,1,17,12,3,12,1,55,16,57,2,1,11,7,25,3,5,43,2,3,5,25,4,5,7,13,0,5,5,17,16,7,2,25,3,1,11,20,13,9,13,3,5,12,2,6,4,6,5,23,5,30,8,5,22,13,4,16,1,25,9,15,1,8,21,6,25,13,9,6,2,9,4,11,9,1,17,4,14,4,8,5,1,14,26,8,15,6,11,3,19,6,3,4,4,4,31,6,9,3,3,1,2,17,8,7,8,0,11,7,10,13,15,3,4,8,8,29,3,24,4,9,22,11,11,15,2,6,5,11,4,3,8,17,1,14,4,8,5,4,5,4,8,5,2,9,6,1,10,7,9,4,3,2,1,2,4,1,2,5,3,7,2,2,4,8,16,28,15,7,11,4,2,3,3,10,6,5,5,1,14,5,4,10,6,25,10,19,2,2,5,38,5,1,3,5,10,6,14,14,14,4,2,19,13,2,3,12,6,5,2,1,3,2,6,13,3,2,7,4,2,9,2,8,8,2,1,51,27,3,2,14,1,6,3,2,5,9,8,12,5,6,47,3,1,0,3,0,4,4,2,10,3,4,4,0,9,4,6,3,12,1,1,13,3,9,8,3,3,2,5,6,7,1,2,13,14,2,0,1,3,5,7,21,8,4,3,9,1,2,24,1,3,4,2,3,1,2,0,10,4,3,7,6,3,13,15,3,1,7,1,3,2,2,5,6,22,5,3,5,9,1,9,4,1,4,10,9,8,7,5,9,2,1,3,10,5,11,2,11,2,3,6,1,4,4,2,19,5,3,2,13,9,5,2,1,0,9,25,2,14,1,4,2,0,3,11,26,10,14,10,3,0,4,10,10,4,0,7,4,12,1,10,4,4,2,61,11,2,2,1,4,14,10,5,5,3,3,6,2,6,0,1,1,6,7,4,9,4,11,3,6,2,1,1,12,8,10,14,9,0,5,5,6,1,11,10,2,14,8,10,0,5,7,1,9,4,4,0,0,2,1,5,14,7,0,0,3,14,5,14,11,9,6,1,4,6,6,1,3,6,2,3,8,3,0,18,7,11,8,3,2,7,19,5,15,9,1,3,6,8,4,2,7,3,2,1,6,10,11,21,10,7,0,5,1,14,13,10,4,11,9,6,16,5,6,5,4,2,2,2,2,4,13,2,2,2,3,0,11,3,8,3,1,9,21,5,7,3,2,6,2,8,2,9,0,0,2,10,7,3,0,6,2,6,1,3,7,1,1,1,5,2,7,2,2,2,1,2,3,1,3,2,3,2,16,1,9,9,7,3,2,3,9,7,6,2,1,1,0,1,8,13,3,6,2,2,5,13,1,9,3,6,3,6,0,8,0,1,2,0,5,6,2,0,4,5,1,0,4,12,7,2,1,5,2,17,0,9,3,6,1,1,5,3,4,2,3,5,10,1,3,18,1,2,9,10,1,2,3,7,6,10,0,2,4,0,2,24,4,7,2,8,4,2,3,0,1,3,3,5,3,4,1,2,2,16,1,1,1,8,1,5,6,7,2,7,3,9,19,7,6,16,11,36,29,0,2,6,4,5,5,9,14,2,11,2,12,8,0,1,7,9,1,2,6,3,1,3,7,2,0,1,4,1,6,1,4,5,5,15,4,2,4,4,5,6,0,2,7,4,3,4,1,2,4,0
first,26,55,18,241,31,20,12,89,15,6,33,19,35,161,8,10,31,24,20,12,4,72,70,64,25,28,49,41,18,57,14,297,209,27,71,151,76,26,18,11,16,33,8,17,75,27,51,50,446,117,92,25,23,114,30,7,83,46,27,36,22,18,9,23,39,18,160,14,9,30,53,8,11,5,200,29,43,2,126,55,110,5,31,26,320,29,22,16,110,14,53,22,25,63,95,38,23,8,80,28,25,64,56,36,31,53,22,23,36,15,1,17,31,41,28,59,21,11,132,212,62,66,45,262,23,7,16,8,17,6,29,22,17,93,48,113,5,12,9,33,10,65,77,11,10,143,15,35,26,36,106,9,31,16,11,59,66,17,33,71,17,9,16,14,24,39,18,36,35,11,38,176,39,10,24,14,196,6,16,83,46,23,35,53,10,40,62,40,48,139,5,12,12,12,12,86,42,14,30,25,50,1,13,27,43,13,17,71,31,41,124,28,49,15,14,28,12,24,32,3,36,27,15,32,58,118,53,37,11,23,15,60,56,53,53,58,39,21,28,16,122,44,16,17,26,10,14,48,79,7,28,50,33,40,13,30,21,9,6,33,10,59,54,17,11,62,19,30,46,6,176,21,94,10,10,10,34,47,14,7,114,16,7,24,17,3,36,29,24,5,10,14,33,31,16,18,64,28,11,30,40,45,8,6,10,13,38,11,18,6,7,37,50,18,89,33,32,53,30,16,77,17,47,29,94,14,13,68,12,54,19,19,19,4,15,12,36,12,10,32,17,26,37,19,12,20,60,72,20,35,27,19,10,86,37,18,16,8,33,89,22,19,23,18,7,15,51,12,28,46,10,54,6,32,17,45,16,9,20,13,113,4,54,20,20,61,15,40,52,4,32,14,23,14,35,24,66,9,38,8,42,18,7,13,11,20,17,7,34,22,8,19,18,17,8,24,18,19,17,28,5,18,37,9,2,8,7,23,28,37,20,42,16,32,23,8,13,28,33,17,38,28,14,34,9,13,42,16,49,25,61,11,29,11,79,13,12,31,22,45,28,64,65,56,18,9,37,37,24,3,41,9,7,6,12,28,11,21,39,8,6,26,7,8,19,9,19,23,6,8,144,50,11,14,20,6,5,32,19,10,25,8,6,14,16,57,11,20,10,4,8,6,7,10,17,28,11,10,5,19,5,19,10,37,11,15,23,10,26,42,21,13,8,14,14,13,14,13,62,41,16,8,12,12,14,3,6,29,11,7,73,10,7,61,10,14,45,6,8,22,32,18,36,6,16,23,32,11,43,49,19,11,28,11,14,16,7,13,13,47,10,19,20,38,18,20,10,14,8,23,37,57,17,15,42,16,23,14,63,32,36,5,14,6,10,37,16,49,9,10,40,37,25,13,32,15,37,8,11,4,22,18,5,39,9,8,11,14,18,47,20,29,39,30,16,8,21,14,15,21,27,5,12,45,11,47,12,9,12,257,21,10,11,7,18,25,35,31,11,23,1,20,27,24,21,9,1,17,12,14,20,16,71,26,38,13,1,10,17,7,19,43,11,16,11,19,16,7,10,26,20,35,19,19,10,33,17,12,17,19,13,11,9,11,17,24,28,20,9,7,7,27,10,33,21,46,21,10,20,15,13,10,12,24,9,19,13,9,6,24,10,16,10,9,9,19,35,9,38,20,14,8,4,19,18,8,23,21,12,8,14,35,11,48,31,24,12,26,11,43,38,32,15,29,33,36,19,5,12,6,15,8,14,27,8,20,17,5,29,13,3,6,19,20,13,6,12,59,16,21,10,15,5,8,34,34,6,16,10,3,9,8,12,13,16,13,18,6,19,14,21,12,19,15,9,8,6,14,5,23,4,12,15,20,13,6,20,12,11,10,16,23,24,10,9,13,12,29,16,8,9,11,9,10,11,15,17,18,8,17,21,38,15,9,8,21,3,14,6,33,5,15,6,16,7,11,5,8,14,16,9,8,12,21,10,7,3,17,15,33,1,17,9,7,13,10,11,5,12,8,21,20,11,8,7,15,8,4,17,17,14,8,11,8,12,12,11,26,7,28,12,18,9,42,20,25,13,14,12,2,13,8,7,13,6,5,11,17,4,16,6,12,12,11,6,13,10,10,8,28,6,24,29,25,20,34,25,55,106,2,10,19,6,20,5,22,14,10,25,7,14,15,10,14,6,28,6,5,7,7,12,9,17,13,9,7,15,7,5,6,10,10,13,17,16,8,14,15,12,14,17,8,6,9,3,19,9,13,13,19
design,0,7,2,91,1,4,5,19,1,1,8,12,9,55,2,1,2,16,4,1,2,23,7,4,10,6,6,9,3,6,3,99,64,8,30,32,24,4,10,2,4,6,2,5,12,5,21,15,125,14,25,9,7,23,7,2,20,12,3,7,16,2,2,9,20,4,61,1,4,7,3,7,2,4,45,8,8,0,49,10,30,7,8,1,109,17,14,8,13,1,4,6,8,18,28,7,10,4,21,4,9,17,17,7,14,14,5,8,4,2,17,1,12,18,11,13,4,3,61,93,18,9,20,42,3,2,1,2,4,0,5,1,3,26,10,27,5,4,2,5,0,24,21,5,0,38,0,5,8,12,44,3,10,7,8,32,14,8,8,19,10,1,8,2,7,5,5,15,23,5,19,42,18,3,0,9,85,1,5,39,8,12,43,11,2,15,19,14,10,18,0,3,5,0,2,5,22,5,4,11,14,3,11,7,16,7,4,34,5,28,36,3,13,4,1,2,4,12,11,3,7,6,4,3,21,71,13,13,2,3,8,9,8,24,17,7,17,16,9,0,42,25,6,5,12,6,3,12,43,9,10,10,14,6,6,11,4,2,5,11,4,14,18,5,4,30,12,3,6,4,70,8,15,6,4,3,18,7,4,1,29,6,3,12,8,6,11,11,3,1,1,5,10,5,5,9,33,7,6,8,11,27,1,0,7,2,8,3,9,2,6,7,25,10,17,13,19,23,9,4,20,7,11,5,25,2,5,12,4,15,1,2,6,3,5,7,7,10,3,9,5,7,10,9,7,3,26,33,9,13,9,6,2,18,7,6,4,3,14,18,19,14,6,11,7,2,23,0,7,7,1,14,6,8,3,17,2,2,10,5,44,0,20,6,2,33,1,7,14,6,9,6,8,5,17,9,23,10,19,2,11,2,4,0,1,3,6,2,20,14,0,9,4,9,4,5,1,1,2,0,2,2,6,10,0,2,4,7,2,5,13,5,3,4,4,3,1,6,6,5,8,12,4,10,3,5,16,2,8,3,14,1,3,2,30,7,0,4,0,19,7,4,20,11,6,1,12,7,6,0,7,1,2,0,0,5,0,5,16,4,6,9,6,3,6,0,7,5,5,2,30,20,1,4,15,4,4,7,9,5,5,2,3,5,5,25,3,7,1,6,2,7,2,3,8,7,4,4,2,5,1,8,9,8,6,6,19,16,12,10,1,5,6,5,2,2,8,4,23,18,5,3,6,3,10,7,6,18,6,6,29,5,7,21,3,7,12,10,6,6,13,5,15,5,13,10,7,0,28,25,4,4,6,4,5,2,4,2,4,24,4,8,9,5,7,0,6,6,7,3,10,23,6,1,11,6,4,4,13,11,10,5,5,1,4,11,3,16,7,7,7,11,9,2,11,4,18,5,1,2,8,18,5,22,6,5,3,3,9,17,16,10,9,10,4,5,8,4,2,6,7,2,3,12,6,13,7,10,8,69,9,1,4,6,4,5,18,4,3,5,5,4,6,13,6,1,0,5,10,5,7,6,14,4,6,5,2,4,1,0,3,19,6,0,7,1,9,11,0,7,6,6,5,5,2,6,2,2,8,5,1,4,2,5,6,5,12,4,2,0,0,2,3,18,7,6,0,4,4,3,5,3,0,9,2,12,4,0,1,9,4,9,5,4,6,1,11,1,15,2,4,6,8,8,7,4,10,11,1,1,8,4,1,7,8,10,6,10,9,2,1,5,3,2,11,9,7,4,0,8,1,9,2,6,3,7,5,3,6,4,2,3,4,4,3,5,9,5,10,6,6,3,2,3,6,3,0,5,3,2,3,3,8,4,5,3,9,0,14,4,4,1,9,6,2,4,4,5,0,7,2,5,1,3,7,0,1,7,17,2,3,1,10,3,5,5,5,26,9,0,6,2,1,2,3,5,4,3,5,3,5,13,9,3,0,5,3,6,5,5,4,1,5,1,2,5,3,5,4,18,2,1,4,19,4,7,2,11,3,2,0,2,2,1,5,5,6,1,3,8,2,9,3,2,5,1,5,0,5,2,6,4,4,2,2,2,0,4,3,16,6,6,9,5,7,7,1,1,2,1,8,4,4,2,0,4,3,11,2,5,2,2,6,7,4,8,4,6,1,9,3,16,5,0,4,17,4,0,20,3,4,4,6,11,1,3,1,4,13,5,3,2,1,2,1,12,6,0,0,4,8,2,2,1,5,4,5,5,6,3,5,5,6,15,3,1,6,4,6,0,2,2,3,1,4,1,2,4,3,1
economy,4,19,8,133,7,41,3,20,6,4,3,11,44,82,3,6,22,13,18,10,7,40,42,27,6,18,25,41,12,15,5,237,114,13,48,105,39,7,44,21,14,24,2,15,32,19,28,32,117,108,47,14,35,102,16,4,35,35,44,24,7,4,7,12,46,25,138,19,4,8,74,6,5,5,190,15,34,9,71,37,100,41,11,6,218,51,16,28,46,7,23,8,22,28,44,43,19,4,66,36,27,33,22,17,30,32,35,34,23,11,31,12,1,58,92,34,4,16,57,121,30,62,102,198,22,6,11,20,8,12,39,4,18,67,20,135,2,14,16,16,1,56,31,6,6,88,13,111,17,22,35,16,21,21,43,37,48,33,6,94,47,9,35,9,30,35,7,35,33,14,26,85,48,10,17,6,82,9,6,89,21,14,57,37,13,31,40,14,9,38,9,5,7,13,26,16,41,12,25,13,61,22,28,11,33,20,6,52,11,31,34,35,39,25,14,44,30,59,36,13,16,14,6,11,58,57,29,31,8,42,21,23,56,32,37,29,39,28,18,8,72,47,15,5,19,20,14,95,55,33,21,37,17,6,9,17,7,6,4,30,9,25,16,2,8,83,18,64,30,10,91,21,26,4,3,7,38,83,5,7,94,4,5,15,25,12,35,30,15,6,3,7,22,24,5,16,15,9,5,11,23,40,10,10,7,13,45,8,4,9,2,20,40,35,42,19,22,51,20,14,27,15,45,10,33,1,19,49,3,27,8,10,5,8,7,8,28,4,14,12,22,7,40,4,10,10,23,29,14,37,12,10,1,43,8,7,13,4,17,46,21,22,19,20,13,13,18,10,34,46,13,43,19,18,7,52,8,5,9,8,43,6,54,16,19,12,4,28,25,7,9,18,6,4,28,13,24,4,17,3,13,13,4,12,10,4,7,0,21,29,2,5,16,17,0,6,9,3,4,13,3,19,32,3,9,5,6,16,8,12,9,9,0,12,4,3,3,5,26,3,10,11,10,10,9,3,50,8,24,18,40,4,27,5,40,5,3,3,7,21,17,39,17,28,11,1,46,21,12,13,23,4,8,13,11,14,4,3,29,24,1,6,1,3,10,4,13,7,0,3,90,43,6,6,16,1,5,10,8,4,7,14,11,11,10,37,26,10,10,9,8,4,3,3,13,9,9,13,9,9,1,3,4,18,2,2,10,3,11,23,12,5,6,3,12,4,4,5,32,17,1,9,3,13,26,10,1,20,4,10,9,5,7,29,13,12,11,4,13,5,17,4,13,8,10,20,11,2,30,41,13,7,34,8,13,2,2,2,5,26,8,26,6,17,5,2,8,1,4,13,13,16,11,6,23,5,18,28,0,15,17,6,4,0,4,8,10,22,18,5,27,16,5,4,8,2,10,18,7,4,9,9,4,19,11,2,3,14,11,11,15,15,15,10,6,8,5,3,5,17,9,6,3,16,0,44,23,9,3,57,1,5,2,5,4,11,25,8,2,9,11,3,1,0,4,0,0,5,7,4,13,5,2,6,13,4,2,9,3,1,3,28,9,8,6,12,8,12,1,11,5,35,7,7,5,16,8,0,12,6,13,6,4,4,12,18,10,4,2,2,0,8,0,28,12,28,11,6,3,61,8,2,1,16,6,1,11,10,3,12,5,7,8,6,3,14,29,13,6,8,13,1,11,3,4,3,25,22,10,4,10,15,17,8,10,11,4,9,9,23,22,15,1,6,16,24,5,10,17,2,21,2,20,10,12,13,21,21,4,1,0,3,10,7,9,12,5,1,9,11,14,10,2,3,8,9,8,5,4,0,2,3,3,5,13,12,21,7,15,4,4,0,3,2,1,5,6,11,2,12,0,3,2,9,7,1,16,15,13,3,16,4,13,4,12,4,3,18,4,3,2,3,1,6,7,7,10,6,3,9,5,21,5,2,6,7,3,5,3,6,3,2,8,9,3,3,1,2,4,22,12,2,6,10,2,6,0,0,7,8,0,5,3,3,7,2,6,4,14,7,11,10,14,1,0,1,6,3,5,5,5,2,5,6,1,4,0,4,4,11,7,25,0,13,5,0,1,6,9,6,4,6,4,4,2,5,5,1,5,10,8,3,3,4,3,6,8,4,0,22,8,10,31,10,25,18,41,27,50,3,9,5,5,2,12,0,2,3,12,2,2,4,0,7,3,13,4,6,0,4,3,0,26,15,1,2,7,4,7,3,3,5,3,8,2,11,8,54,0,3,5,4,6,6,8,29,22,3,9,6
create,3,36,17,218,7,37,5,35,5,4,27,20,33,111,4,15,19,49,20,7,8,62,68,56,26,33,22,57,14,45,5,303,166,30,91,141,54,14,27,14,29,23,6,28,57,24,56,35,317,120,52,17,34,109,26,2,66,34,44,27,22,4,11,21,40,10,184,15,9,15,70,2,13,4,203,28,40,9,116,44,105,24,16,21,367,60,29,10,42,6,20,5,25,26,74,46,26,10,62,51,22,53,33,26,27,47,13,33,27,23,41,18,58,1,139,42,11,7,124,188,40,65,58,179,25,10,6,6,7,9,44,9,10,111,40,150,8,13,24,23,13,72,53,6,12,115,22,49,28,27,142,20,30,13,18,92,62,34,6,102,27,16,24,12,25,33,13,34,42,21,40,124,49,7,18,3,195,6,25,94,41,28,33,46,4,46,62,26,28,72,14,6,17,12,18,10,43,21,20,16,104,3,30,23,35,17,36,62,15,55,118,24,56,19,5,45,25,21,32,3,7,30,15,15,81,146,31,37,11,12,23,29,49,42,54,24,39,21,25,9,87,58,17,14,40,6,12,52,96,31,28,52,39,14,17,20,11,11,4,23,11,44,27,7,6,84,32,23,30,8,184,34,41,14,7,12,41,17,11,5,109,13,8,30,21,19,23,24,17,11,6,9,45,18,7,16,52,9,16,30,35,34,0,11,22,19,37,8,30,14,8,26,53,36,55,23,33,50,28,12,55,5,38,15,87,16,27,59,12,46,13,21,11,9,9,32,42,10,10,22,20,27,47,14,16,7,56,70,21,32,22,16,3,67,29,13,17,7,21,44,48,34,33,50,11,10,43,12,32,56,5,47,7,44,12,32,16,21,21,15,65,12,57,11,16,57,8,36,38,9,26,16,22,21,28,26,70,5,39,13,25,11,7,15,14,18,16,1,53,32,5,10,24,20,8,16,5,9,6,8,8,13,28,8,9,7,5,14,13,15,21,9,6,19,20,10,7,12,26,10,16,34,17,24,8,8,60,8,63,18,59,9,18,9,57,15,9,15,17,42,15,39,45,57,8,8,67,21,58,6,37,11,5,12,7,18,4,16,45,17,11,18,5,7,16,19,18,11,9,8,88,40,9,7,27,2,8,18,8,16,20,11,6,20,23,61,17,16,17,7,17,6,5,24,22,32,14,10,12,15,4,13,15,26,11,5,27,37,21,30,19,9,5,16,12,15,2,7,53,37,10,8,9,21,32,8,5,22,18,6,67,21,21,68,28,9,28,8,18,4,20,7,31,8,19,38,21,5,69,47,24,9,16,12,10,9,9,14,10,51,14,16,14,27,15,8,11,12,7,17,34,24,23,11,34,4,12,14,31,24,27,2,7,4,17,21,8,36,22,8,25,48,18,9,32,13,20,28,6,4,11,21,5,52,17,15,8,12,9,57,31,22,33,39,25,5,29,17,12,19,22,10,17,35,9,37,11,8,23,136,9,19,11,3,11,15,83,24,6,17,14,6,13,6,9,1,12,8,13,17,22,11,18,57,40,11,10,9,9,9,14,39,9,3,27,7,21,3,11,7,16,38,10,20,14,14,16,10,17,25,9,6,4,5,6,19,18,4,4,3,10,14,7,39,18,27,7,12,5,13,6,8,4,28,8,14,3,9,3,13,7,26,21,7,14,4,29,10,21,7,14,3,7,14,9,12,31,73,13,6,13,6,3,14,12,31,9,16,6,11,7,24,7,18,27,50,20,16,12,8,15,13,9,15,5,23,31,13,3,8,0,7,10,24,13,7,15,21,24,13,13,29,16,9,13,23,9,10,3,11,7,5,16,2,25,8,33,6,22,9,15,11,10,4,8,9,2,18,8,16,3,3,3,35,2,7,13,18,21,5,14,7,36,6,12,23,7,22,17,13,1,7,8,19,9,20,15,18,9,9,28,31,6,9,10,12,10,16,9,6,3,6,9,6,11,9,7,6,18,19,16,10,16,30,6,5,0,6,4,3,7,7,5,3,15,6,9,7,9,7,13,10,7,3,2,13,2,5,23,14,22,2,2,16,4,4,1,18,5,30,29,28,29,9,17,9,1,60,19,7,7,9,19,21,2,11,3,8,7,16,3,25,9,26,5,5,10,11,8,33,2,16,6,7,18,33,37,10,67,5,6,16,3,13,3,7,0,10,19,10,40,9,4,7,9,13,10,4,2,3,8,9,15,18,7,1,6,11,12,5,7,7,2,14,9,9,20,38,7,8,8,7,5,6,17,6,21,9,14,13
job,4,17,15,80,6,40,3,4,5,8,0,3,28,50,0,0,25,8,23,2,3,30,85,61,6,46,13,48,7,21,2,168,68,12,46,103,8,3,10,2,4,10,5,29,41,6,37,15,62,174,31,10,16,52,72,1,2,1,75,14,2,2,2,12,50,21,123,20,6,5,132,0,3,4,136,21,60,2,59,30,54,20,12,15,58,22,2,14,15,1,15,3,29,10,12,25,18,0,38,37,9,23,5,13,16,22,8,47,33,25,28,11,92,139,1,51,1,11,55,38,15,142,97,164,17,5,5,13,9,17,35,14,10,66,24,201,4,10,6,15,14,66,35,0,3,68,21,54,7,4,15,45,9,5,28,30,34,27,3,163,30,11,27,13,47,106,11,15,29,9,25,105,35,12,15,1,5,1,12,114,32,7,54,53,11,31,24,9,10,31,19,4,8,18,17,6,33,10,23,6,90,9,34,5,16,24,3,32,19,12,59,68,39,17,24,112,40,24,12,10,23,20,0,11,23,26,10,19,9,18,10,26,28,7,38,7,16,26,15,7,57,49,65,11,12,6,5,58,79,29,10,12,42,0,0,18,2,9,0,19,7,17,5,1,8,8,35,18,12,4,17,15,10,1,0,13,32,5,0,1,85,2,4,19,30,6,75,62,5,13,2,12,32,17,3,5,11,4,3,10,19,7,2,4,2,6,9,5,32,8,5,2,19,27,55,5,26,8,19,5,20,4,41,30,53,0,20,66,7,16,4,3,3,0,5,5,22,2,4,4,2,18,65,3,3,4,10,22,6,67,0,6,1,27,4,15,19,1,3,23,21,14,15,4,6,17,2,8,52,71,3,47,1,51,6,25,2,9,5,4,9,13,11,5,33,7,6,18,28,3,5,9,17,13,4,5,2,2,6,0,3,7,1,17,1,4,4,0,33,9,5,7,22,18,0,8,4,5,7,6,1,8,11,0,11,1,1,5,6,3,1,0,0,6,22,7,1,5,11,7,9,7,1,21,5,1,46,7,8,6,25,0,36,6,8,5,4,1,6,2,13,32,8,18,7,1,58,21,3,12,21,16,1,2,6,6,9,1,17,12,2,5,0,10,12,4,0,10,3,2,38,3,3,10,10,0,2,1,2,0,0,2,1,42,50,10,20,6,5,5,0,0,0,0,7,1,13,1,1,18,2,1,0,2,0,2,5,9,4,7,16,7,2,0,4,4,0,1,13,4,2,0,2,10,42,5,0,14,1,0,1,0,0,11,2,2,2,3,5,0,0,5,0,3,4,0,3,1,6,8,9,0,0,4,0,0,0,1,1,20,4,13,2,13,1,0,1,1,1,15,5,4,10,7,11,0,11,17,1,1,4,1,6,0,0,0,1,10,0,1,9,7,1,3,3,0,0,3,0,0,0,0,1,7,6,0,2,0,2,9,1,0,3,6,0,7,3,2,15,5,3,10,0,3,1,3,23,3,8,35,0,2,1,0,4,18,2,10,4,10,0,6,0,1,0,0,0,3,1,2,0,0,8,0,3,0,0,0,3,1,4,5,1,0,5,1,2,6,3,3,0,49,0,1,0,9,1,0,3,0,14,0,0,0,3,14,5,7,0,0,6,0,0,9,5,1,7,0,4,2,2,0,0,3,15,7,3,22,1,9,0,6,3,3,0,0,0,0,0,3,2,0,13,11,0,1,19,12,13,0,2,0,0,0,12,4,0,1,0,5,2,16,0,14,15,9,15,0,2,0,16,0,15,1,3,1,15,3,0,1,0,0,4,5,8,3,1,2,1,4,7,1,0,0,0,5,3,0,1,0,0,2,0,2,8,3,3,4,8,3,7,1,3,1,0,0,4,15,1,0,0,2,0,0,0,0,26,5,2,4,4,1,1,7,6,2,0,7,0,7,0,0,0,4,4,1,7,6,0,3,9,5,5,0,5,1,3,7,0,9,0,4,0,4,0,1,0,0,2,1,0,0,0,0,1,2,0,0,3,6,0,0,1,0,0,0,2,0,14,0,11,0,40,0,0,0,0,4,16,7,1,0,4,0,1,0,0,2,0,6,5,12,1,2,2,1,3,0,13,2,0,1,0,0,3,0,0,0,1,3,2,18,0,0,0,0,0,0,2,1,1,8,0,2,11,11,9,4,4,0,7,16,3,1,1,0,0,1,3,0,0,0,0,3,6,0,0,1,5,0,1,1,22,11,0,0,24,0,9,0,0,2,0,0,3,0,0,44,0,16,1,5,0,6,21,25,72,0,13,8
still,26,64,24,332,25,47,12,84,10,20,72,22,48,214,13,17,21,38,19,16,16,114,75,65,53,37,69,57,19,68,31,471,327,31,133,233,111,32,50,27,28,32,20,30,119,53,67,33,694,124,138,35,43,182,45,19,148,59,32,75,50,27,6,32,78,34,229,36,35,31,97,23,20,17,227,49,93,23,184,80,171,16,37,26,526,43,41,11,106,8,29,22,33,173,130,46,44,17,172,38,25,93,111,38,38,69,37,49,67,34,59,13,34,42,51,1,16,21,185,394,132,101,71,304,45,13,16,29,19,10,56,18,29,113,55,176,24,11,14,29,15,94,89,10,15,224,35,50,50,37,170,13,41,29,23,61,107,19,34,75,40,12,26,12,54,53,24,49,86,24,51,259,56,21,28,18,375,8,18,162,70,26,39,45,19,66,98,59,106,140,8,26,17,19,13,10,38,12,30,26,79,7,9,40,65,30,12,95,32,61,208,30,84,42,21,67,21,27,37,7,14,64,15,41,116,222,85,99,21,74,38,58,82,61,104,87,140,19,23,24,196,104,29,31,39,26,21,70,112,22,30,61,60,30,27,53,29,16,23,63,11,93,48,17,21,95,23,45,72,12,312,31,117,17,12,11,66,55,29,8,164,26,23,48,48,11,50,45,32,9,16,21,23,23,25,29,98,16,20,63,82,60,12,12,29,11,65,18,24,12,8,44,83,27,118,42,36,103,28,10,129,18,112,14,159,15,39,130,16,72,22,29,27,12,33,35,51,16,4,39,24,47,61,29,27,18,123,143,50,61,51,29,14,84,59,15,17,8,48,84,53,33,20,50,11,16,84,40,35,65,10,89,26,42,27,57,26,16,40,18,144,4,86,27,33,88,20,83,95,17,52,17,30,41,73,28,164,21,58,16,43,28,9,23,20,24,18,9,59,33,6,34,21,34,44,50,21,29,17,33,12,17,42,31,9,8,8,21,23,40,45,20,17,30,13,13,12,61,36,12,42,48,17,45,7,15,45,20,76,28,65,16,37,9,143,20,17,36,22,69,41,59,75,90,21,9,77,42,41,17,74,16,10,17,11,25,19,19,53,25,35,24,17,20,25,24,28,23,13,14,236,98,14,12,45,13,18,51,23,26,31,14,19,23,15,78,18,49,20,15,22,13,26,27,33,41,20,16,2,30,21,48,15,51,21,12,69,17,38,50,37,15,15,26,21,9,24,23,80,47,13,4,10,33,34,24,16,61,29,13,67,16,16,113,5,18,99,15,13,26,62,15,36,15,47,29,31,32,88,70,36,33,41,11,22,17,25,21,20,60,32,26,33,48,13,12,16,12,13,35,55,83,39,17,51,19,16,23,116,34,54,10,26,9,40,53,18,47,11,28,80,65,22,26,82,26,43,18,21,16,27,23,11,43,7,19,32,24,34,70,34,49,55,52,9,13,18,29,21,32,24,13,16,31,37,55,15,9,22,406,61,21,32,14,20,49,75,52,20,40,10,26,75,56,22,16,13,25,32,53,60,22,168,69,87,13,9,17,6,16,7,62,38,19,23,17,37,17,12,34,30,42,38,31,14,30,40,11,57,30,32,11,23,9,19,25,46,31,14,6,17,25,25,75,47,34,36,13,22,18,14,14,16,42,12,35,24,12,3,32,17,30,17,16,20,11,38,18,97,21,46,15,9,29,37,9,36,23,14,12,35,27,23,31,20,26,25,18,15,48,47,36,19,20,50,49,28,26,32,28,25,18,15,38,13,31,28,17,35,19,8,16,43,22,32,21,10,79,25,20,20,31,9,10,28,48,25,23,15,3,13,13,43,16,22,15,18,22,42,29,24,23,40,27,18,19,15,38,13,22,18,24,16,19,15,17,34,18,17,18,34,28,31,5,29,21,24,56,29,10,26,13,14,15,21,19,19,21,9,24,77,62,26,17,8,16,16,15,12,8,25,11,11,8,12,20,40,11,29,36,6,8,32,31,11,19,8,39,26,24,10,22,11,23,24,14,11,16,14,12,15,28,16,11,26,29,10,9,12,33,16,11,15,24,10,10,23,16,11,58,10,17,8,46,26,13,5,24,23,10,21,35,16,26,9,21,11,46,17,32,13,15,18,18,12,11,9,15,12,32,8,38,32,18,30,67,49,59,78,18,5,12,16,6,17,16,21,13,36,12,36,13,16,8,10,66,11,19,9,18,23,21,42,20,12,16,16,21,24,20,7,20,16,35,28,27,26,26,99,21,10,7,15,5,9,32,15,20,8,22
december,9,44,9,158,3,2,0,18,6,0,30,8,3,25,0,1,3,6,2,1,6,21,1,23,10,13,2,6,5,30,4,127,63,8,23,13,9,7,5,3,0,2,0,3,12,11,18,3,247,6,28,1,4,9,3,2,61,33,2,5,9,2,1,8,5,4,23,1,3,9,11,1,0,5,21,4,7,2,40,15,21,2,7,2,140,10,4,1,61,7,19,2,4,21,34,16,10,1,21,7,4,10,26,2,5,22,13,4,14,6,21,4,4,11,1,16,1,5,93,70,12,16,6,69,6,0,1,3,2,2,0,0,0,13,4,19,5,4,1,1,2,13,30,1,3,44,4,5,4,5,23,1,7,2,1,15,15,2,9,4,10,1,2,15,2,1,5,3,11,4,13,41,6,0,3,5,88,0,4,11,8,5,1,8,3,4,15,6,34,45,3,1,6,0,1,2,9,6,8,3,15,1,0,9,12,5,2,2,9,11,38,1,28,3,0,0,0,0,4,0,6,10,9,2,18,48,19,7,3,5,0,15,17,5,11,20,15,1,12,14,26,7,4,2,6,3,1,9,30,5,6,17,7,7,2,5,10,14,4,14,4,24,13,14,5,29,0,1,5,6,67,3,42,2,3,1,15,3,6,5,16,0,0,9,4,0,2,3,3,0,21,12,12,8,10,4,37,36,4,2,11,37,10,18,5,3,13,4,3,0,0,0,18,1,26,17,5,22,6,1,28,1,10,0,19,8,3,19,3,25,0,1,4,1,1,9,8,2,2,18,3,10,4,5,2,1,21,25,5,3,5,8,0,7,7,5,7,2,7,29,15,1,1,6,2,0,15,2,1,3,3,4,0,3,2,16,4,0,3,6,28,1,17,7,6,22,2,28,14,6,18,1,22,25,24,2,28,3,27,1,10,0,3,1,2,3,2,1,12,3,0,0,7,6,10,2,9,0,2,1,1,10,10,14,1,0,0,8,9,20,23,25,18,41,2,7,1,11,5,2,5,7,1,5,2,0,2,3,8,6,10,2,1,4,25,6,0,16,2,21,6,11,19,6,1,0,2,14,6,0,10,1,0,1,4,0,2,21,10,1,3,8,0,1,4,9,0,1,0,8,39,15,0,3,5,8,0,27,5,9,3,4,0,0,4,3,0,14,3,1,1,1,6,1,6,11,2,4,4,4,0,10,4,11,2,5,12,1,11,21,3,1,0,3,4,1,11,3,31,8,2,7,5,1,1,10,58,5,6,7,20,3,3,21,1,1,10,1,7,4,12,4,18,1,10,3,10,3,27,18,7,1,27,3,3,1,24,1,1,20,8,8,3,5,2,4,4,5,1,4,7,13,5,4,8,0,1,0,63,7,14,1,3,5,9,7,3,19,6,10,21,28,16,2,26,7,6,3,2,6,2,3,3,25,1,1,4,5,4,21,19,11,13,9,11,1,6,4,0,6,5,0,6,25,5,30,4,14,1,174,8,1,3,2,9,10,13,9,17,9,4,0,29,14,11,8,3,3,13,9,10,1,55,26,29,3,1,6,19,1,4,8,9,4,9,7,6,1,0,5,21,2,9,9,9,6,9,8,8,14,12,7,27,4,6,2,2,1,3,9,2,48,4,13,8,26,14,7,7,3,8,7,3,7,0,29,11,0,1,12,0,12,2,1,3,0,5,0,35,2,4,0,1,4,4,1,7,3,1,3,5,10,16,42,10,10,3,6,1,18,15,4,20,30,33,0,18,3,1,6,0,2,0,8,0,6,2,0,1,7,1,1,8,1,7,2,1,68,1,8,8,11,2,4,11,8,2,8,4,4,0,4,7,8,0,3,2,2,17,2,18,2,20,8,3,2,1,9,8,7,11,9,19,8,0,2,1,12,0,11,8,5,0,6,1,1,4,13,6,6,7,5,3,8,5,9,3,6,1,3,7,13,4,3,1,5,3,13,9,3,10,4,4,2,0,7,3,1,3,20,0,2,10,3,3,7,1,9,10,5,10,18,2,2,10,2,8,7,4,1,4,13,0,2,4,40,6,3,8,1,2,5,3,5,0,31,3,15,10,8,0,8,1,28,15,18,3,7,2,1,7,8,5,11,3,4,3,31,3,10,5,5,4,5,7,3,0,5,2,0,0,1,15,3,6,27,13,15,38,5,0,1,0,2,5,38,3,2,12,3,1,2,1,3,5,26,1,5,0,0,2,3,2,0,15,3,0,0,2,11,2,4,7,8,13,1,4,1,38,0,1,0,4,0,0,0,0,9,1,0
run,2,9,2,50,0,15,15,10,2,2,7,6,8,16,2,1,2,12,7,0,7,25,8,12,8,7,5,6,5,11,1,88,46,6,20,31,9,6,13,2,4,2,0,3,16,3,19,6,118,21,12,5,3,15,6,2,19,11,1,6,3,2,1,5,9,7,48,8,4,26,7,0,1,1,50,13,19,4,42,19,39,3,9,8,87,10,13,3,16,12,10,2,12,7,45,18,8,2,18,7,10,27,9,8,12,14,4,7,11,8,11,3,16,7,11,21,5,1,20,73,19,14,15,61,9,4,1,3,6,1,5,5,4,14,10,30,5,2,5,4,0,15,19,3,3,23,4,11,8,10,14,2,5,6,2,16,18,7,6,10,12,2,7,8,10,6,1,3,2,5,9,53,12,1,5,5,61,2,2,16,7,7,1,10,4,9,20,8,12,22,8,3,5,1,5,4,14,2,4,7,23,9,4,4,6,4,1,10,5,8,32,10,8,6,3,16,5,7,10,0,3,15,0,11,24,44,10,17,2,13,4,12,4,13,19,7,15,3,9,6,36,17,4,3,8,4,5,25,9,6,6,6,7,11,8,11,4,6,3,8,3,12,13,1,7,16,1,4,7,0,64,5,22,4,2,2,7,5,2,0,34,4,1,7,7,3,0,3,4,4,4,3,13,3,6,5,23,0,1,5,11,5,5,4,2,1,6,3,2,1,1,2,16,0,51,8,4,9,6,3,10,3,11,7,17,2,6,20,4,8,1,9,6,2,5,11,8,3,3,7,5,5,7,4,5,4,17,26,6,2,4,5,3,13,9,3,2,3,4,11,4,2,4,6,0,3,20,3,3,17,1,2,2,8,4,16,3,0,5,1,28,0,19,6,9,24,2,7,10,0,9,3,6,4,8,6,26,2,20,3,5,6,5,1,3,5,1,0,15,2,4,16,9,4,8,1,3,6,0,1,2,2,15,7,3,3,0,10,4,8,10,7,4,10,6,3,3,0,3,2,3,3,9,5,1,3,3,4,6,6,5,0,3,6,25,4,1,1,4,13,6,5,16,25,3,0,11,5,14,4,10,3,0,1,3,22,2,4,5,3,0,2,4,2,1,4,4,3,0,5,31,18,2,2,3,11,1,10,5,5,7,8,0,2,8,12,3,7,5,3,3,0,6,2,7,10,3,2,3,7,1,6,2,7,1,5,4,9,7,13,9,4,2,7,5,2,6,8,13,15,1,0,0,5,5,5,18,8,8,5,3,5,7,26,2,7,7,4,3,2,6,3,7,1,9,8,6,3,17,12,6,5,8,2,3,3,0,1,3,8,5,6,3,4,3,8,6,1,3,3,5,14,6,7,11,1,7,5,23,8,7,2,1,1,4,7,4,7,3,4,11,5,10,0,15,4,6,3,0,0,13,11,1,15,1,6,1,6,3,13,8,10,10,2,2,2,5,2,4,5,9,2,5,8,1,11,1,8,1,73,4,4,2,1,0,7,8,1,2,2,1,4,3,6,6,6,0,1,10,3,4,1,20,11,5,2,0,7,5,1,11,6,6,4,0,4,4,2,0,6,3,8,5,3,3,8,2,4,2,5,2,3,1,1,2,5,8,3,2,4,2,8,5,9,13,2,11,4,0,1,1,1,0,6,1,11,3,1,2,8,2,10,8,5,0,10,1,0,15,9,4,3,2,2,5,5,6,1,1,3,8,4,2,9,3,3,0,4,6,35,37,8,3,3,4,7,10,4,2,1,4,0,4,6,1,4,5,2,2,1,0,1,5,1,10,2,7,11,4,9,2,9,5,5,6,7,8,1,1,6,1,3,4,3,5,7,7,4,10,1,12,1,6,1,0,2,3,1,6,5,1,0,0,7,2,2,2,1,8,5,4,1,2,0,4,3,1,8,2,5,3,5,2,6,4,8,5,1,6,2,7,8,1,0,0,2,3,1,5,2,4,3,5,1,1,2,1,1,3,3,1,4,20,6,1,3,8,2,3,1,2,1,3,1,25,1,2,0,4,5,6,5,5,1,1,13,1,0,2,3,3,3,1,2,4,8,2,14,2,3,8,4,3,10,2,7,2,4,0,0,6,1,1,1,2,2,0,0,2,6,1,3,2,2,2,8,5,1,2,2,3,5,5,2,9,6,20,5,25,2,1,5,3,1,0,0,8,0,9,0,2,4,2,3,2,9,3,1,1,0,4,3,5,2,1,2,3,4,4,0,3,1,1,9,2,4,4,2,5,0,2,0,0,0,1,5,0,8,0,1
act,50,223,92,1503,41,34,30,242,23,12,136,79,47,356,28,25,57,82,30,25,15,232,54,236,128,94,75,102,31,140,78,1124,560,72,248,249,187,67,57,18,38,57,22,37,154,108,140,110,2096,131,255,45,33,152,99,26,490,185,34,75,133,68,13,75,110,54,402,46,44,85,122,43,20,28,480,41,121,33,396,111,265,9,108,32,1133,81,67,7,264,34,75,27,28,184,265,108,89,36,152,63,87,170,204,42,58,175,64,27,67,26,132,61,57,124,55,185,93,20,1,813,218,125,124,477,49,20,23,34,30,35,58,25,26,301,95,259,39,19,42,40,23,156,190,26,10,453,51,60,67,65,372,9,99,37,19,156,207,50,48,75,72,14,43,61,46,57,19,98,123,63,88,423,106,17,18,44,1079,23,53,202,145,56,54,91,39,101,152,95,220,318,21,37,30,10,5,34,90,51,56,72,126,9,14,71,132,65,45,150,75,117,428,39,383,65,21,43,16,23,95,18,53,112,44,100,312,758,109,104,18,55,70,88,110,108,135,171,195,37,79,56,387,155,34,43,73,41,28,82,416,35,88,159,102,57,39,114,76,48,37,117,48,175,161,89,43,230,48,43,79,38,817,78,259,34,18,11,154,95,90,28,233,45,27,99,53,13,54,61,77,19,87,43,123,45,78,61,274,41,69,111,103,226,14,42,73,33,121,28,34,9,16,126,168,42,232,142,72,203,68,31,247,30,163,41,391,87,42,132,12,181,70,54,42,19,32,113,88,40,20,97,46,74,76,80,38,31,257,314,81,50,97,79,27,161,106,48,69,25,81,168,176,54,64,109,27,21,230,46,78,78,25,110,34,45,61,245,64,24,100,40,434,40,238,68,36,253,62,124,165,27,168,23,109,107,191,38,369,39,183,25,131,16,12,17,51,29,37,19,159,62,20,51,40,59,98,43,32,42,25,26,29,29,112,63,32,24,16,72,87,89,93,67,68,261,30,34,7,99,68,31,103,122,51,45,19,17,52,37,151,54,99,62,28,25,239,53,6,136,41,260,76,115,117,155,48,37,74,87,79,5,78,30,17,15,25,72,16,92,92,28,29,101,18,40,31,53,48,35,21,48,449,214,11,25,47,35,23,97,42,69,47,29,29,16,43,102,21,78,45,27,28,26,84,57,70,119,36,61,49,51,19,111,55,127,86,50,131,90,84,141,110,17,50,50,72,36,83,60,206,99,24,18,30,20,48,39,14,82,91,42,403,89,67,246,64,36,156,45,60,41,137,101,345,31,70,70,70,30,213,182,75,41,140,39,40,42,135,43,47,136,39,110,46,83,42,31,28,38,29,41,153,185,58,38,142,9,37,22,291,86,165,10,25,41,63,102,31,220,20,46,182,168,132,29,192,48,103,26,57,31,52,39,24,191,32,26,39,46,64,272,65,110,152,161,94,24,55,56,34,75,51,11,65,129,54,201,51,37,75,1236,118,20,33,59,49,94,191,99,51,110,37,39,148,122,54,54,15,45,46,68,89,46,233,240,220,55,22,126,34,23,90,185,93,53,57,65,65,39,30,51,169,76,91,64,62,87,74,42,120,128,40,49,34,33,65,38,96,43,80,28,25,177,32,147,100,141,58,43,74,33,62,43,56,201,17,113,30,12,23,67,23,85,24,46,30,27,126,35,275,30,53,35,21,50,45,24,83,59,19,90,45,67,42,183,83,78,52,58,52,140,130,75,45,56,226,62,49,35,46,46,33,14,12,136,28,60,41,30,78,59,37,17,77,38,55,37,26,283,43,83,48,139,49,51,65,93,36,67,28,31,38,41,123,52,25,16,26,33,56,34,108,24,213,84,28,51,37,45,24,73,41,35,36,118,81,43,24,172,30,38,50,28,48,47,42,35,68,108,73,33,54,91,39,52,28,58,57,69,50,91,169,227,92,33,13,55,33,61,65,14,81,34,58,17,48,32,17,46,73,94,25,73,55,40,34,34,23,57,76,21,41,74,20,35,83,22,35,37,21,44,29,106,14,26,25,107,23,73,50,24,48,56,27,50,76,26,26,62,49,135,38,70,53,112,124,71,23,62,16,22,44,35,36,85,30,83,16,93,43,58,39,31,35,71,42,25,23,35,32,57,18,55,78,44,36,115,70,90,248,35,39,30,25,41,52,81,26,25,234,26,71,32,28,48,32,237,34,60,44,33,31,33,57,24,36,35,11,29,47,66,51,42,43,74,31,16,35,31,166,20,16,29,23,11,15,42,14,56,13,18
would,45,291,154,1629,109,79,58,448,48,55,195,83,101,918,37,109,80,250,82,104,59,482,155,301,256,134,150,160,99,192,208,2220,1698,126,691,747,554,165,272,85,128,90,56,49,498,298,495,139,3564,258,1072,66,143,513,88,75,814,236,40,131,215,115,41,131,295,107,1275,109,103,400,189,60,78,62,1003,181,348,76,1101,299,716,27,208,109,2617,352,252,17,416,58,117,87,44,420,794,282,283,63,452,202,186,408,454,133,142,333,155,94,209,74,212,93,121,188,38,394,70,73,813,1,557,171,481,807,127,55,24,57,63,22,141,51,72,578,323,550,178,44,66,80,56,478,320,52,37,807,106,179,283,237,1035,53,187,105,69,350,448,77,169,100,209,57,179,41,82,103,88,249,300,127,231,1298,316,36,97,115,2299,41,123,448,345,144,99,257,80,302,554,336,557,669,50,128,104,18,49,55,312,77,139,179,387,63,57,193,389,145,91,514,189,388,986,136,364,170,50,96,77,60,225,40,65,302,94,271,727,1243,342,402,137,198,171,164,276,335,535,403,354,171,116,129,985,465,141,96,188,109,89,338,541,93,161,407,313,133,152,291,139,52,56,245,81,402,277,46,102,363,61,85,259,106,1536,118,499,91,43,24,317,165,127,58,656,136,46,243,208,41,96,154,284,55,53,43,281,113,56,140,569,57,130,234,312,386,35,54,202,46,274,75,59,37,23,263,325,79,597,206,277,628,181,95,465,127,470,56,1003,85,116,339,61,412,92,254,138,72,127,183,273,63,43,155,193,142,210,214,71,108,562,703,202,118,193,154,80,440,418,74,63,66,215,368,333,103,128,336,76,24,825,139,85,219,52,220,95,103,123,292,135,106,244,88,689,16,520,165,50,488,83,280,424,74,264,56,173,139,419,160,651,97,393,29,227,45,76,34,77,93,131,36,298,178,41,150,80,181,250,172,46,126,79,32,57,97,211,194,41,71,41,145,156,274,230,63,42,111,37,60,29,165,131,83,164,276,137,219,40,50,137,126,476,174,236,108,48,88,651,200,22,164,122,444,145,297,343,428,134,44,257,152,122,26,255,79,48,47,89,289,60,177,330,107,139,178,59,101,78,137,284,58,72,36,1340,552,73,87,157,94,53,218,92,222,167,136,102,43,117,408,71,232,140,77,109,110,66,93,165,268,89,168,115,142,43,350,128,408,147,52,347,147,231,410,204,80,158,187,101,97,153,142,523,250,93,25,55,144,191,99,96,350,190,100,584,58,101,550,104,121,380,129,89,111,354,94,254,80,290,242,162,140,478,510,162,82,194,39,83,135,226,102,178,214,116,195,273,220,106,92,106,97,67,163,333,454,157,49,320,117,110,95,466,252,343,36,58,76,105,444,52,372,101,85,394,201,87,81,506,172,268,88,156,66,207,153,65,370,43,146,116,219,150,398,326,246,431,310,115,55,147,109,43,165,175,34,154,267,102,281,88,66,118,1875,291,95,108,92,77,116,615,242,123,171,124,69,144,194,71,61,27,170,161,127,239,122,628,351,233,111,64,71,69,99,86,336,202,78,132,90,190,68,75,156,178,158,187,209,87,101,121,84,220,173,100,76,74,106,151,92,241,98,94,50,67,75,98,441,238,380,110,119,133,131,102,70,102,296,47,107,234,33,47,173,126,234,118,128,78,128,316,102,483,129,211,152,83,177,141,96,240,86,71,69,178,75,45,109,58,108,142,154,51,335,330,162,52,49,224,279,143,82,85,114,86,52,66,202,40,222,147,36,124,166,46,71,166,77,129,104,149,276,191,172,101,81,50,63,224,283,82,95,36,55,104,71,220,69,110,45,111,59,190,67,147,80,146,126,65,69,58,125,130,180,79,45,121,101,47,82,66,113,177,100,78,54,160,118,101,114,156,311,231,42,72,136,100,110,99,158,154,87,111,163,436,288,128,106,39,71,155,128,100,16,91,69,100,57,87,93,81,45,151,175,44,70,178,239,91,76,39,139,163,42,22,76,36,68,65,65,79,77,80,72,70,164,10,83,104,76,54,53,67,85,157,65,42,155,118,43,43,135,55,290,72,137,63,133,151,42,53,72,59,71,149,99,65,212,23,83,35,181,47,120,33,83,113,75,90,53,52,94,86,118,49,189,95,40,125,213,186,168,468,47,56,87,53,65,63,42,68,100,223,70,42,76,48,82,42,258,102,59,92,120,277,121,130,56,77,68,21,153,98,99,67,58,91,223,124,161,154,55,311,33,57,30,64,15,27,103,30,77,33,21
far,26,51,30,339,20,35,17,102,10,18,44,30,39,298,18,31,13,63,23,16,17,117,40,89,98,34,48,41,33,47,45,604,394,61,217,227,161,33,33,20,41,41,17,14,93,69,91,55,822,79,173,18,49,132,59,18,218,78,17,92,59,32,12,54,74,19,302,54,34,69,51,10,20,16,305,53,138,23,238,106,162,19,44,27,651,80,40,9,114,9,31,22,15,97,193,71,76,26,128,65,35,117,114,44,53,107,32,21,56,21,62,18,30,40,15,132,12,19,218,557,1,70,124,201,27,6,20,12,13,12,74,16,28,147,55,223,39,11,15,31,34,119,71,18,16,269,31,68,59,49,219,13,42,33,24,108,135,28,38,40,41,26,42,9,15,49,19,104,90,35,55,313,87,21,28,48,552,11,37,164,131,42,27,87,31,102,148,103,119,153,11,19,24,5,20,10,69,26,19,64,109,21,13,56,85,34,27,106,38,96,262,31,80,30,15,15,8,9,28,12,18,74,28,61,143,338,108,126,13,33,61,61,54,81,128,100,156,42,23,37,231,135,27,28,45,16,19,129,130,33,36,87,69,39,39,61,36,9,15,79,37,97,62,9,32,124,25,25,41,16,444,19,87,24,9,17,66,48,28,6,239,34,8,50,41,10,20,41,58,12,13,12,34,26,14,38,131,19,31,76,87,99,4,6,65,11,94,24,38,12,10,105,68,32,126,47,59,136,54,21,124,33,135,53,190,20,55,119,14,100,8,68,33,23,38,42,70,23,14,39,45,45,52,37,37,28,152,161,57,29,41,41,24,119,103,9,17,35,66,88,74,37,52,84,8,7,123,38,32,81,6,62,11,56,51,90,30,16,60,19,229,4,165,83,26,136,28,56,82,22,68,14,27,32,122,40,199,25,114,13,73,18,19,7,25,31,30,18,65,44,11,48,12,79,56,43,20,34,13,10,23,44,76,46,16,18,12,57,43,53,36,19,6,39,14,14,12,37,33,18,52,75,24,47,11,54,53,28,164,28,54,23,16,12,175,38,7,37,50,105,54,89,99,146,28,41,82,36,38,8,61,25,17,22,19,105,23,52,132,36,28,57,14,29,36,22,37,26,32,8,267,152,12,16,25,19,12,45,28,55,57,23,13,5,18,66,34,44,22,24,20,21,31,51,65,66,22,46,17,39,26,66,27,91,26,15,95,48,47,107,38,40,16,48,36,26,36,45,134,82,22,5,12,43,40,21,5,71,34,24,66,20,25,161,33,40,90,21,23,31,71,10,53,27,49,46,48,31,113,131,48,38,36,16,39,8,37,24,35,62,32,62,63,72,34,21,24,30,17,48,93,112,35,22,108,32,29,16,122,78,73,14,20,11,16,80,26,87,37,24,112,52,44,36,109,40,67,27,37,70,59,27,19,62,16,26,21,34,48,74,23,69,112,77,21,25,57,23,9,30,43,15,46,63,28,82,20,12,18,454,97,24,32,17,29,34,213,76,28,42,10,26,34,47,19,23,9,29,35,31,62,33,118,99,82,23,14,24,22,24,27,107,59,29,33,32,33,16,4,33,41,46,55,42,19,37,27,14,56,44,36,14,16,40,38,26,54,28,20,8,20,22,19,101,79,78,28,26,31,44,24,24,28,113,20,33,42,13,20,26,30,51,14,23,19,12,111,33,84,42,44,26,23,47,39,23,48,37,33,26,39,32,10,27,11,40,30,41,17,31,30,48,12,5,73,53,41,31,34,22,33,19,27,57,15,44,16,6,60,31,19,20,60,30,52,17,26,48,26,51,12,38,13,12,48,53,17,23,13,20,11,21,41,9,25,26,24,21,49,20,19,15,40,27,11,22,24,25,21,40,13,3,20,42,11,11,12,27,29,20,25,26,41,18,30,38,23,64,45,21,18,32,30,34,30,22,33,26,21,39,80,77,29,27,12,26,34,21,19,5,17,22,31,12,23,36,28,8,31,22,19,20,33,28,10,15,15,29,38,14,9,10,21,12,34,18,21,21,20,24,12,28,2,12,24,10,20,22,25,26,34,23,21,43,36,8,2,38,13,71,28,24,17,29,30,9,19,18,21,10,29,23,12,30,10,24,10,43,23,18,18,8,22,17,14,26,20,15,12,46,24,53,18,22,28,53,33,29,88,8,11,22,16,12,14,12,13,27,41,18,13,9,13,11,12,59,24,8,10,30,33,22,30,25,19,14,11,12,23,27,14,18,19,19,20,34,31,11,63,7,12,8,21,5,5,29,13,17,5,11
american,12,57,31,235,38,87,22,74,19,16,69,28,53,185,4,24,42,48,45,13,6,93,155,128,31,100,78,128,54,93,21,445,297,92,122,307,97,11,12,28,27,68,24,40,108,21,44,36,405,291,101,52,47,190,87,17,79,28,111,52,24,25,6,41,60,52,266,30,17,38,179,9,24,18,314,37,98,24,173,112,113,21,19,37,358,27,14,10,83,4,29,22,41,76,83,34,56,17,106,39,17,84,32,40,30,71,15,46,49,22,66,9,62,65,142,101,16,14,125,171,70,1,136,298,42,32,18,14,16,15,82,35,64,141,89,308,17,22,23,41,32,114,66,8,22,252,34,68,23,11,82,35,35,14,24,55,143,26,28,242,54,7,59,22,36,110,41,59,56,24,41,313,74,19,49,20,187,12,23,209,63,30,67,85,9,81,67,44,55,133,13,12,21,19,17,18,62,25,35,19,73,25,17,21,38,52,10,62,37,32,213,81,58,37,54,122,22,39,37,6,9,51,14,34,46,128,59,38,27,35,23,36,50,43,83,21,57,24,14,22,138,76,53,43,48,31,23,144,104,29,23,36,62,5,5,48,15,25,2,54,10,118,10,11,15,44,28,63,55,22,175,21,19,9,5,25,96,10,13,6,336,20,15,46,30,12,132,98,35,17,22,33,41,27,17,22,76,15,25,39,69,41,8,21,17,37,60,4,19,13,13,20,95,46,122,23,58,69,25,9,122,13,83,35,158,3,41,165,10,72,37,20,16,8,15,17,57,14,8,24,19,74,84,12,8,25,50,89,28,99,19,28,7,76,33,13,23,7,26,88,37,34,38,33,19,43,63,28,79,133,14,147,13,100,26,47,16,10,64,8,63,12,54,31,60,55,19,41,46,14,62,29,32,39,42,25,54,6,81,14,25,35,17,22,14,20,21,18,90,38,13,27,23,16,17,42,27,42,20,49,8,25,46,22,16,8,11,16,16,27,9,16,4,36,30,12,13,52,39,6,45,47,12,44,15,27,132,39,42,19,98,4,53,16,103,19,34,11,21,22,56,80,68,105,17,31,106,54,14,26,134,41,15,36,10,62,17,17,42,27,13,33,9,22,26,18,18,47,11,11,151,30,27,31,56,9,6,20,14,4,14,10,5,71,29,21,6,18,14,13,1,7,5,13,16,6,28,12,1,35,7,63,4,41,8,13,64,15,33,34,39,19,18,24,20,17,12,32,81,25,8,34,13,17,32,11,41,48,21,11,19,7,5,65,19,15,83,11,16,11,15,7,25,8,15,12,29,28,33,45,12,6,8,9,6,5,19,3,9,53,10,24,28,77,15,30,8,10,7,35,40,40,38,21,42,11,23,17,106,29,27,6,12,7,22,32,11,17,10,3,57,33,20,24,41,8,12,8,22,9,16,0,6,45,10,8,9,5,15,46,13,15,47,31,11,14,23,8,35,23,20,17,11,17,10,25,14,14,12,282,64,18,9,11,15,34,49,29,12,38,4,12,37,36,17,7,11,11,15,11,16,13,102,31,51,5,2,4,18,8,24,55,20,12,13,8,27,24,7,17,19,89,12,26,17,22,22,14,28,12,54,6,4,5,7,16,24,21,2,3,8,41,11,26,15,24,61,10,15,12,14,13,20,35,16,12,6,14,7,23,11,23,4,3,15,4,25,7,24,13,27,12,19,41,33,6,25,32,16,20,31,0,4,19,9,23,19,14,13,41,27,44,9,10,52,49,19,4,11,7,37,9,25,28,5,23,38,4,7,5,2,3,21,11,25,10,5,21,7,16,11,2,0,7,25,34,10,8,5,7,11,21,20,5,30,24,22,16,28,13,25,23,59,6,16,10,19,34,4,7,6,3,51,14,4,7,29,9,8,9,26,11,21,12,16,7,17,46,8,14,10,8,5,19,23,23,12,34,4,42,47,40,12,2,8,11,8,4,14,16,31,18,5,16,4,8,11,1,17,20,19,3,5,9,8,9,5,17,34,38,8,12,15,11,8,2,12,6,37,6,52,6,54,5,21,50,5,21,30,64,16,5,23,9,7,22,17,19,26,17,6,29,12,4,22,15,6,19,14,4,2,4,8,4,6,4,5,14,7,5,18,16,6,12,11,2,11,8,8,5,4,43,2,2,4,15,21,6,16,10,7,24,17,9,3,3,9,9,19,3,2,2,0,5,11,64,3,10,12,12,17,8,38,50,5,10,23,6,12,9,14,3,1,4,13,5,9,50,19,33,7,10,5,21,22,25,23,4,22,40
tax,7,16,22,233,7,32,2,14,3,4,8,20,43,69,4,14,14,24,41,6,14,62,92,75,23,69,16,44,26,25,0,435,272,8,77,115,26,16,42,12,146,13,3,32,52,12,83,29,272,86,70,20,21,57,101,0,130,14,29,12,9,3,2,29,58,36,248,78,10,17,165,3,12,13,216,18,119,0,106,64,361,38,14,12,385,89,22,53,55,21,24,13,117,23,92,215,51,13,72,95,9,79,60,23,23,47,173,251,70,24,45,20,102,58,97,71,6,15,124,481,124,136,1,306,31,1,5,2,10,39,42,9,15,138,30,145,10,15,23,17,7,60,21,6,10,108,27,61,59,55,61,22,18,18,43,166,94,40,6,153,76,14,43,44,132,85,15,33,70,18,30,240,84,7,30,7,379,7,9,123,27,33,61,69,2,43,61,30,58,65,10,4,12,10,41,20,101,23,35,75,115,37,67,25,25,13,3,150,20,50,132,50,110,126,48,100,115,132,12,13,44,51,6,61,69,225,48,74,21,104,58,21,210,26,107,263,27,61,36,16,150,33,16,54,26,93,13,68,131,39,28,83,20,50,15,40,8,22,0,30,4,17,17,2,11,19,41,20,35,21,174,33,133,5,1,9,21,82,9,17,139,12,8,15,40,10,55,60,23,12,0,8,86,56,24,23,133,21,5,39,39,68,11,18,51,29,20,8,18,11,4,96,58,24,352,25,77,70,48,12,27,16,53,36,137,2,38,67,7,23,12,80,6,4,8,17,49,16,21,13,20,14,50,17,11,13,42,58,19,132,47,10,6,66,45,6,11,3,15,76,54,29,26,91,5,7,37,8,82,72,7,71,22,37,28,12,12,50,26,19,89,3,56,4,11,19,2,22,59,7,15,5,10,4,24,6,61,8,48,6,31,8,8,2,12,18,10,1,11,30,2,0,8,69,0,3,1,3,6,6,3,6,14,16,4,12,6,4,9,12,19,7,3,10,11,5,0,8,28,7,18,37,10,6,1,0,13,16,51,15,39,1,44,2,55,27,4,71,22,39,29,55,32,64,10,1,72,17,0,20,55,19,3,43,5,112,3,7,74,25,5,16,0,7,14,28,17,4,3,8,100,51,1,14,11,1,3,19,11,5,44,36,49,28,31,33,16,24,14,23,34,8,9,11,17,23,24,13,1,19,0,59,6,39,9,5,13,36,27,30,48,17,7,40,13,5,5,7,47,12,5,1,2,22,21,6,2,53,18,3,31,1,23,80,6,10,32,15,46,6,18,13,26,8,20,42,8,10,69,26,17,6,22,1,10,5,32,7,12,53,27,6,36,16,5,17,7,15,5,20,53,25,29,14,29,2,10,22,16,10,42,6,8,1,3,20,1,14,8,50,52,10,2,4,44,10,15,7,32,13,2,23,3,37,11,69,0,17,7,26,0,17,37,34,4,26,16,90,13,13,44,5,4,11,26,31,18,4,38,88,10,4,9,13,12,20,44,60,4,4,5,1,1,26,0,2,0,1,10,11,11,14,0,84,10,6,28,6,10,5,4,21,4,3,3,3,20,12,0,1,30,45,8,2,12,10,6,1,240,9,5,16,3,4,13,8,28,2,35,2,2,17,6,47,20,5,0,2,10,31,5,5,2,16,3,2,13,21,1,12,6,12,6,9,1,3,3,9,8,5,23,0,6,8,1,1,31,17,15,14,12,32,25,24,22,19,17,10,2,131,112,51,1,37,29,64,6,7,27,2,12,2,15,14,6,13,88,6,5,37,1,12,21,14,10,16,22,0,28,28,10,10,3,9,11,37,1,27,3,0,13,7,16,5,10,3,14,15,44,1,40,0,5,13,0,3,6,18,8,30,0,5,6,11,0,4,16,16,2,27,19,8,8,0,9,10,3,22,5,8,0,6,50,6,14,17,13,4,6,4,27,6,6,26,12,4,6,5,8,19,3,5,7,5,4,5,3,8,2,29,9,5,30,11,7,7,0,23,11,0,0,2,1,5,7,1,7,1,3,1,6,1,45,7,4,8,0,3,33,4,32,3,10,8,6,7,0,1,14,25,0,15,1,39,5,4,2,6,24,10,1,14,3,46,0,5,1,0,8,14,7,55,7,5,6,30,2,15,2,11,8,130,36,19,43,32,77,56,81,1,0,58,4,8,26,15,0,1,18,2,2,2,3,0,34,4,2,10,2,8,1,1,24,15,4,0,8,16,7,4,10,1,6,0,23,232,24,42,2,23,5,2,0,9,4,242,21,5,4,1
year,48,235,85,1096,50,172,56,177,36,62,86,92,202,480,29,48,79,117,92,31,44,250,235,286,99,156,116,191,71,242,68,1373,762,126,303,585,279,80,161,61,85,108,27,140,233,70,199,183,1441,451,292,95,113,463,189,21,245,376,179,197,78,38,28,92,244,96,600,121,53,79,623,35,38,23,653,118,283,25,656,193,975,66,94,77,1072,170,117,62,666,84,174,56,222,311,423,201,170,70,373,128,125,205,224,52,327,171,137,170,316,148,262,42,198,179,164,304,69,61,477,807,201,298,306,1,470,36,60,51,142,147,144,66,93,382,162,631,24,95,52,177,39,271,338,76,50,537,71,174,131,211,254,92,128,67,69,257,375,122,71,307,216,35,148,125,276,199,93,149,196,77,205,804,169,111,65,55,745,40,51,377,188,59,196,156,39,155,292,153,119,614,38,44,83,75,94,52,176,52,370,73,228,44,34,57,192,75,73,256,89,147,499,133,238,120,66,192,167,180,224,48,188,155,38,94,305,451,392,361,163,251,108,444,335,147,234,419,195,62,109,38,367,218,94,55,71,81,71,232,432,59,66,172,184,256,70,137,63,166,46,384,59,198,123,54,42,547,121,129,127,42,625,158,820,28,27,78,124,527,58,30,452,32,36,84,158,52,175,164,80,56,45,53,119,265,116,57,208,58,42,100,177,194,108,117,55,61,134,43,83,37,29,89,277,85,513,159,123,276,89,31,229,36,238,101,242,12,108,292,32,171,51,102,34,19,62,115,128,38,56,215,45,87,162,54,75,40,233,246,104,164,102,64,21,202,113,64,56,22,103,842,140,128,86,83,24,53,170,65,130,166,38,219,51,111,44,337,55,34,68,93,280,29,228,60,76,263,69,156,258,30,80,72,91,78,103,79,234,41,179,64,79,65,46,53,59,24,62,21,127,67,18,52,179,75,52,58,37,45,21,49,19,68,114,56,38,24,44,82,69,163,116,162,138,156,59,39,25,67,149,41,85,59,40,88,35,36,220,65,204,133,175,46,111,48,319,65,23,60,51,153,101,235,144,241,68,32,183,109,53,39,189,65,29,43,43,81,45,52,120,56,34,117,23,27,47,47,92,65,23,37,575,322,17,50,72,37,38,153,59,41,100,54,117,56,55,181,110,85,31,35,45,23,24,35,92,77,56,56,11,86,23,80,33,100,29,55,103,50,99,165,93,24,34,49,66,60,42,33,247,112,31,24,44,82,113,43,85,83,67,32,120,16,40,401,36,47,126,25,38,44,99,31,141,34,76,85,88,39,180,164,99,58,191,36,40,17,56,34,32,338,46,58,42,98,49,41,43,39,40,78,111,113,104,59,112,46,42,71,167,56,129,41,44,34,51,115,40,106,47,65,205,111,68,37,118,59,78,21,39,17,64,65,22,157,33,28,23,59,51,190,88,102,95,108,64,31,69,94,57,69,75,43,38,139,36,278,45,43,71,776,93,41,37,31,25,170,150,87,48,89,30,42,114,74,38,34,12,31,33,75,84,46,199,98,132,28,38,51,91,29,100,149,64,39,60,94,60,49,41,67,116,94,111,89,33,132,68,25,65,65,57,16,41,33,67,61,125,60,26,37,33,167,51,122,124,223,67,32,34,75,41,14,32,155,48,67,84,37,31,133,50,123,62,35,34,61,271,32,111,85,50,25,45,112,78,29,185,76,47,28,49,338,182,581,539,108,40,69,48,349,348,141,68,168,165,199,98,40,100,45,52,35,40,98,37,94,105,26,67,45,19,16,77,64,81,35,37,143,94,73,61,61,30,40,88,90,26,54,61,30,35,52,70,38,47,36,53,54,78,42,125,22,43,83,19,30,35,62,20,67,13,221,42,85,39,14,42,78,36,37,127,99,56,23,52,46,43,144,35,47,17,22,22,38,54,80,42,58,45,57,85,113,32,34,46,39,25,88,27,35,30,37,26,40,26,48,44,17,40,90,53,17,92,66,29,38,8,55,53,60,22,64,37,26,75,35,32,34,42,34,59,91,99,26,29,89,19,27,207,91,20,17,42,45,77,94,23,51,80,98,25,117,31,294,57,131,61,24,46,46,22,26,32,40,29,20,22,28,23,55,25,59,25,58,32,82,50,81,27,84,48,84,281,157,155,185,209,552,585,17,43,50,68,50,68,144,130,34,105,15,131,43,30,39,90,127,23,129,24,28,34,31,113,52,33,24,55,29,52,20,134,33,48,73,36,35,41,92,66,41,24,30,74,39,46,151,42,65,35,49
ago,15,53,15,144,9,69,6,35,6,18,15,14,35,92,1,20,11,17,10,12,8,36,17,68,18,27,34,20,18,36,4,177,102,16,48,79,36,5,13,10,7,28,2,13,23,13,20,21,187,95,45,11,9,75,26,6,14,24,38,29,8,4,2,9,52,14,108,14,3,10,35,6,7,3,50,23,39,6,78,30,55,5,11,13,131,18,18,4,35,10,39,1,23,27,35,23,16,4,26,23,16,22,14,8,21,17,7,23,33,28,23,3,22,25,17,45,6,9,49,127,27,42,31,470,1,6,7,5,15,14,20,18,25,40,28,65,5,8,6,28,8,48,55,14,28,70,8,31,19,6,33,14,20,4,8,37,74,19,7,34,15,5,19,17,16,23,6,14,29,13,29,129,22,3,7,9,95,2,9,54,28,9,20,23,6,20,47,12,14,83,7,8,11,14,10,5,12,9,28,12,39,2,1,9,20,11,2,28,17,23,70,35,35,13,11,39,17,12,17,2,2,20,1,14,25,64,47,37,29,20,9,44,24,22,26,14,31,5,12,3,39,38,9,9,12,13,9,27,37,4,14,23,28,1,7,20,6,9,7,19,8,22,11,3,6,42,21,15,23,5,78,10,23,6,3,12,20,22,6,1,50,3,4,16,40,8,14,16,15,14,6,11,10,11,11,8,17,20,5,12,37,17,3,6,9,7,19,5,12,4,7,16,40,6,40,6,9,36,13,6,15,6,45,13,31,2,20,48,4,25,8,7,8,7,3,15,13,9,6,11,2,17,9,12,8,8,30,29,18,15,9,3,4,19,16,2,4,5,13,38,21,19,9,10,2,13,29,10,13,26,6,8,13,16,10,30,8,6,12,6,37,4,24,5,11,35,21,22,22,1,14,7,14,9,9,9,20,3,20,2,9,8,6,6,10,2,11,3,11,5,2,15,4,12,9,7,1,10,4,5,5,7,22,9,8,2,9,9,8,20,7,9,4,14,13,7,5,7,12,6,5,5,4,26,12,9,17,15,27,10,21,4,23,8,41,16,5,8,11,16,24,37,18,37,9,4,34,20,12,8,29,8,5,16,5,9,7,7,20,10,8,11,5,2,10,13,8,10,6,7,73,33,4,9,6,8,3,11,5,4,13,7,12,8,10,11,10,9,6,4,4,8,5,7,10,10,10,9,3,8,9,13,6,22,2,6,18,7,16,9,6,5,7,8,6,6,4,2,35,13,2,1,8,14,8,7,23,8,9,4,22,3,6,32,1,4,21,1,3,7,8,3,7,8,10,15,11,6,13,11,9,6,18,3,5,0,2,3,4,18,0,5,7,11,3,12,3,9,1,8,19,12,4,3,20,7,6,4,8,16,12,7,6,2,2,10,7,16,9,2,24,14,5,2,30,7,5,2,8,1,11,4,4,8,1,5,4,4,9,14,9,12,10,8,5,2,11,4,9,10,6,8,9,10,12,8,7,7,12,96,25,4,3,6,9,9,15,7,7,11,0,15,6,5,5,0,3,6,1,7,12,6,3,26,10,5,3,5,10,3,11,23,2,6,5,2,4,4,9,6,12,16,5,14,4,14,6,4,8,7,24,5,8,6,9,13,9,9,2,3,9,10,8,11,12,10,7,3,9,10,5,4,6,10,4,10,9,1,3,13,4,8,3,5,2,1,19,5,19,7,16,4,6,12,15,2,15,15,4,4,5,7,10,15,7,10,7,9,7,4,5,19,5,7,9,7,21,3,14,6,7,5,7,10,7,7,10,1,2,3,0,1,12,2,5,5,5,3,7,7,11,9,3,4,9,8,10,5,5,3,5,5,3,4,8,10,6,5,11,2,9,8,3,7,3,2,5,7,2,10,4,3,1,8,4,5,8,4,2,2,8,13,8,0,8,4,2,19,8,4,2,2,8,5,6,8,5,4,2,5,13,16,3,2,6,3,2,4,1,1,5,9,0,5,4,6,15,0,7,14,12,3,4,5,4,4,2,6,7,29,1,3,3,3,5,4,5,4,4,4,19,8,15,2,1,11,3,8,25,9,4,0,7,3,12,10,1,1,5,6,2,12,3,3,7,8,4,3,9,4,2,2,3,3,6,2,1,1,1,0,2,8,2,6,5,1,6,4,2,6,5,11,10,4,11,8,13,19,21,5,8,4,12,3,4,1,8,4,9,0,2,9,3,1,9,4,2,6,1,2,10,4,19,8,3,3,3,5,0,2,3,4,1,12,7,4,6,11,9,8,4,5,6,3,4,8,9,1,7,11
faith,8,11,4,37,12,6,8,25,6,3,13,4,8,65,6,9,3,8,9,5,5,21,33,35,8,6,17,18,11,19,3,76,47,14,20,101,33,1,0,10,4,25,3,2,40,9,8,5,75,58,30,5,11,70,17,6,23,2,11,16,4,3,3,13,13,15,72,3,9,1,4,3,2,7,49,5,14,3,43,17,9,0,4,6,74,4,2,0,12,0,3,3,2,20,18,1,6,0,10,3,0,12,14,14,6,13,2,1,2,4,7,2,6,10,5,13,0,4,20,55,6,32,1,36,6,1,3,3,3,1,25,6,7,19,26,27,13,2,4,13,9,18,7,9,5,33,5,16,3,2,40,1,5,7,6,5,36,2,3,22,2,2,6,0,4,6,4,8,9,5,13,44,8,2,9,8,84,1,10,21,16,7,9,15,1,14,9,10,8,15,1,4,0,4,3,3,5,4,2,7,8,0,4,6,18,8,3,12,3,5,34,11,12,4,9,6,1,1,6,0,0,6,2,9,16,29,5,12,2,3,0,1,6,7,16,6,10,1,0,4,26,29,9,3,17,2,11,25,8,7,4,2,21,5,3,14,0,1,0,2,2,34,3,1,5,5,4,20,14,3,47,3,4,3,2,3,11,4,1,0,44,1,1,10,6,1,2,6,8,3,1,9,4,1,1,1,13,3,5,8,10,9,0,1,4,0,12,1,1,2,3,1,15,9,13,3,3,6,2,5,23,4,9,3,43,1,7,29,1,11,5,1,1,2,4,4,6,3,2,7,1,6,13,3,0,4,10,26,7,18,5,9,2,11,5,0,0,1,5,21,5,2,2,6,1,4,21,15,8,16,4,23,5,13,3,6,6,1,15,3,23,0,10,4,9,18,5,9,6,5,18,12,8,9,11,8,18,2,10,1,11,3,0,5,2,0,3,3,4,4,3,4,3,4,1,9,4,5,4,10,5,2,10,11,3,4,4,4,4,6,4,2,2,3,3,1,2,3,7,0,5,6,3,3,1,0,14,5,3,2,12,8,5,11,16,2,14,4,1,10,9,14,11,27,8,2,12,4,2,1,29,2,1,7,5,15,2,2,4,7,3,3,3,5,3,2,1,6,2,1,44,16,8,8,6,1,4,7,13,3,4,0,0,1,3,5,0,1,1,1,4,0,2,1,6,7,1,6,1,12,4,2,1,10,2,1,1,4,5,8,3,9,3,3,2,7,5,6,6,9,3,0,3,1,0,2,4,4,4,1,18,1,1,11,1,5,9,1,5,1,3,1,5,1,7,11,8,0,23,10,2,1,1,1,2,0,1,4,7,10,3,3,3,13,2,1,1,1,2,7,7,9,4,2,5,1,3,0,25,2,7,1,1,5,1,6,1,6,3,1,9,0,1,3,3,2,8,1,7,0,5,1,1,11,1,0,0,2,4,11,5,4,11,12,5,1,3,1,9,5,8,12,0,6,2,6,3,0,3,41,5,3,1,2,1,3,9,1,5,6,1,4,7,0,1,4,0,2,5,1,5,2,8,0,7,4,0,2,2,3,3,18,7,0,0,5,6,4,0,2,6,16,2,2,1,2,3,3,5,6,0,1,3,0,1,4,5,4,4,1,0,2,6,15,2,4,8,0,5,0,5,1,2,4,0,1,2,3,1,11,2,5,1,2,2,0,4,1,11,0,3,0,3,0,10,1,5,5,5,1,4,4,1,2,0,0,5,3,2,2,0,6,1,2,4,16,5,0,2,3,6,1,2,7,5,5,1,0,4,3,1,1,2,0,7,0,0,1,3,0,9,0,0,2,1,3,0,3,2,2,1,1,2,2,13,5,18,0,11,2,3,1,0,2,2,1,4,2,0,4,1,0,2,0,0,2,12,4,2,1,2,1,12,5,4,11,4,12,4,3,0,3,1,3,0,3,2,9,0,4,5,4,2,0,5,1,0,0,3,3,7,3,2,1,2,3,2,0,4,4,0,0,5,6,6,13,1,2,14,0,0,0,0,3,0,2,1,0,1,1,6,0,1,6,3,1,0,1,1,6,1,2,3,16,0,1,1,6,1,4,2,2,3,4,3,0,1,4,2,4,2,3,0,2,5,8,2,8,2,1,0,0,7,4,0,0,0,6,4,1,2,5,1,1,3,10,8,5,12,2,0,6,3,1,1,0,0,0,4,2,3,0,2,0,0,6,1,0,1,0,4,6,1,10,1,2,7,2,1,2,0,1,2,4,2,1,5,4,7,2,1,4,0,2,0,2,0,2,1,9
steadily,1,6,3,39,2,4,4,9,4,1,4,2,13,45,4,6,3,2,5,2,0,18,6,15,5,4,13,7,4,13,3,59,42,12,29,40,21,3,7,11,7,4,3,3,10,1,1,6,71,17,7,6,11,25,5,4,15,10,4,13,10,6,3,5,11,7,35,5,1,1,7,1,2,2,58,5,15,4,34,11,61,3,1,5,74,4,4,3,8,0,5,5,7,14,22,6,10,5,35,11,6,18,4,6,9,11,1,4,12,2,16,1,11,6,5,16,1,1,23,24,20,18,5,60,7,3,1,8,3,3,10,3,5,11,13,36,0,2,4,4,2,7,18,7,2,32,2,14,5,4,33,3,7,5,2,8,27,3,7,9,5,0,4,1,2,10,3,8,9,2,4,41,10,5,6,0,36,3,0,25,9,0,9,9,3,19,9,6,8,17,0,1,9,2,3,2,6,5,5,11,11,2,2,6,23,6,1,6,6,23,39,4,11,11,2,2,2,6,5,3,1,3,1,5,12,28,13,14,7,8,3,6,14,8,14,8,6,3,7,5,18,13,10,4,6,0,2,19,20,4,1,7,5,2,0,4,1,3,1,6,3,25,6,1,3,14,2,6,7,3,41,4,8,1,1,7,10,7,1,0,31,1,3,8,3,3,3,4,2,1,2,3,3,0,2,4,13,1,2,9,11,6,1,1,2,1,34,0,3,2,0,6,11,8,15,7,8,18,5,6,7,4,17,3,16,2,2,14,1,11,4,7,4,1,4,5,5,7,1,7,3,4,3,5,13,4,15,24,6,6,3,3,1,9,6,3,3,3,4,10,7,6,6,2,4,3,5,4,3,12,2,15,3,11,5,9,1,2,8,5,14,0,13,4,4,5,0,11,11,2,14,5,2,0,8,5,10,3,6,2,8,5,2,4,1,2,1,3,10,5,1,2,6,3,1,23,3,6,2,5,3,10,16,2,0,2,4,8,9,7,3,2,0,5,1,1,4,5,4,0,9,7,4,10,3,4,19,5,13,4,9,4,20,1,16,3,3,1,4,8,7,12,19,17,4,19,10,4,4,0,12,6,0,4,3,11,1,1,7,8,4,17,2,1,4,3,4,6,1,2,31,11,0,4,9,2,2,4,1,0,4,4,1,2,3,6,10,1,0,3,0,0,5,0,8,2,4,11,1,3,4,2,2,10,2,2,4,4,5,4,5,6,3,3,5,3,2,2,15,4,3,1,2,2,5,1,4,13,3,2,6,2,1,17,3,5,25,0,5,2,3,1,10,0,4,6,2,4,14,11,2,3,2,0,3,1,3,1,6,7,7,3,5,11,6,2,2,2,1,5,7,11,3,1,14,5,2,6,8,10,10,1,1,0,0,6,5,3,5,2,12,9,2,5,4,0,5,1,8,3,5,0,2,4,0,3,2,4,2,15,12,9,12,4,4,2,2,0,2,5,4,4,3,14,1,8,6,1,4,45,18,0,2,0,5,6,12,6,1,2,5,0,1,4,0,0,0,4,3,2,5,5,2,4,5,1,0,4,1,1,1,9,5,6,4,2,16,3,1,3,3,8,2,4,2,6,3,2,3,1,0,2,2,3,2,3,7,4,1,0,1,4,1,13,6,17,5,3,2,3,4,3,2,10,5,5,2,3,1,6,3,4,1,0,3,0,16,5,13,10,3,4,2,4,8,3,6,3,3,0,3,4,1,3,1,6,3,2,8,5,5,9,1,2,12,4,7,4,10,1,4,1,2,2,5,6,1,1,21,2,8,3,4,1,5,3,2,1,3,1,3,4,0,4,9,5,3,0,5,2,2,2,5,0,5,1,5,2,2,1,2,2,1,1,3,1,3,3,0,3,0,0,0,4,5,3,2,2,2,2,3,1,0,1,4,3,2,9,3,6,1,6,3,0,2,3,2,4,0,1,3,8,6,0,4,3,4,3,1,1,4,1,0,4,1,2,2,2,6,3,6,3,4,2,0,1,1,4,4,0,0,2,2,1,3,3,4,4,0,3,3,1,1,0,1,1,2,1,1,3,3,0,4,4,0,1,0,2,2,6,3,1,3,1,7,0,1,5,4,3,3,3,3,1,0,5,0,1,0,3,1,0,1,4,3,0,3,2,1,7,7,5,2,1,2,4,3,2,8,1,2,3,1,1,1,0,2,1,2,3,0,7,6,2,2,3,4,0,0,1,3,2,7,9,2,4,4,2,1,0,2,2,1,4,0,2,2,6,2,1,1,2,0,2,4,2,1,1,1,3
decline,4,3,5,46,4,6,2,11,2,0,5,3,14,28,0,0,0,4,1,1,6,22,6,11,7,7,4,0,0,5,9,82,45,0,14,26,24,3,23,3,3,3,4,7,11,8,15,7,141,20,22,5,5,19,4,1,18,2,2,7,11,3,2,2,14,6,30,6,2,3,11,6,0,1,38,6,9,1,34,12,30,1,9,5,105,3,6,5,21,2,7,2,8,21,24,5,13,2,24,5,4,11,24,2,4,9,2,1,4,1,8,2,20,6,13,29,3,3,34,57,12,14,2,51,5,3,8,1,1,3,11,2,5,16,10,19,2,5,2,6,3,16,12,0,2,43,4,13,12,2,32,2,8,1,8,12,15,5,4,17,7,1,6,3,9,6,4,5,8,7,5,32,8,1,1,6,46,2,4,19,7,1,6,12,3,7,16,12,23,30,0,4,5,3,5,5,7,1,8,4,6,6,3,6,6,7,6,13,13,7,20,5,13,2,5,12,11,13,10,1,4,9,1,6,15,27,10,7,4,10,11,13,6,10,13,6,26,4,9,2,41,10,4,1,5,3,1,7,20,3,3,11,11,1,2,10,9,1,1,5,0,8,12,0,6,8,7,3,8,2,38,2,9,0,1,0,8,3,9,1,25,2,7,7,8,3,8,5,2,1,4,3,2,7,1,7,28,3,4,12,16,7,4,2,8,0,7,1,4,1,1,3,12,1,11,0,10,23,1,6,15,6,22,10,27,1,4,21,5,14,1,7,4,1,3,6,12,4,0,5,8,8,6,8,1,3,14,28,7,3,4,6,4,17,5,2,6,0,5,13,9,3,2,7,0,3,13,4,1,5,1,12,5,6,6,10,2,1,6,1,23,1,8,7,5,8,6,15,12,0,5,1,4,3,16,3,30,2,21,2,10,2,0,3,4,0,2,2,12,2,3,3,8,6,11,4,1,7,4,2,1,5,8,2,1,1,0,10,8,13,5,1,1,4,3,2,2,10,5,3,4,4,2,5,0,0,8,0,13,1,4,2,3,3,33,5,0,2,4,11,5,9,14,8,0,0,10,6,3,3,13,2,1,0,4,10,3,5,4,5,2,8,2,2,1,3,1,2,2,1,51,10,1,3,2,1,3,4,5,4,8,4,4,3,3,8,9,6,5,3,2,0,3,5,5,9,3,3,0,6,0,5,1,4,4,1,9,1,9,8,7,0,2,4,5,2,3,5,17,5,2,0,0,7,10,5,1,12,6,0,11,4,1,15,4,1,13,0,3,3,10,4,5,2,4,9,7,1,9,14,4,1,0,2,1,12,0,2,4,6,4,3,5,6,3,0,1,2,6,4,5,17,6,1,13,0,0,3,14,11,9,0,4,6,5,15,4,5,5,1,12,6,6,0,9,1,3,2,5,2,7,2,2,8,2,2,9,4,5,12,4,5,13,13,4,0,1,3,1,4,4,3,1,3,3,8,8,3,0,94,14,5,2,2,2,4,24,7,10,4,2,7,10,19,3,2,8,6,3,8,6,2,14,17,10,3,0,4,3,2,2,15,15,3,10,1,8,4,4,6,9,7,9,5,5,3,11,5,4,3,4,5,1,1,3,6,11,3,2,1,0,5,2,15,3,4,2,3,12,3,7,1,2,7,4,3,2,1,1,4,0,2,0,5,5,2,1,3,7,3,3,5,1,7,5,5,5,3,1,3,2,2,2,2,4,5,3,4,2,5,2,4,0,1,4,12,8,4,4,6,2,1,4,7,0,2,1,2,2,4,0,0,9,3,4,3,1,5,4,5,5,4,1,1,2,2,2,2,2,5,0,4,8,0,1,0,4,2,9,4,3,0,9,4,0,5,1,9,1,1,5,3,1,6,1,2,1,6,0,1,1,2,1,0,3,6,5,6,6,1,4,2,2,7,3,2,2,6,3,3,22,15,6,1,1,3,2,1,4,1,11,2,5,1,3,1,2,2,3,1,1,4,11,0,1,1,8,5,8,0,3,0,0,3,6,5,5,2,2,4,5,2,1,4,5,3,1,4,2,2,3,1,3,6,5,1,0,2,1,12,7,2,3,2,4,4,0,5,3,5,5,2,1,11,2,0,6,12,4,3,1,8,2,1,2,1,1,1,4,4,0,0,6,2,2,6,7,3,6,4,6,1,2,0,2,0,0,4,2,7,3,1,0,10,2,7,0,2,4,2,3,6,10,3,6,6,2,3,1,3,2,0,6,5,4,0,4,2,19,3,2,2,5,2,8,9,9,2,0,0
six,6,17,7,47,0,7,6,12,0,4,3,4,4,21,2,5,4,8,4,1,3,18,4,12,5,13,7,8,1,24,4,91,36,11,16,25,10,6,9,2,6,7,2,4,9,4,15,8,106,16,13,4,2,21,3,0,33,8,10,3,7,2,2,4,11,10,28,8,1,8,38,3,7,0,32,9,17,2,48,10,47,4,5,2,85,7,14,4,34,7,74,1,6,20,37,15,10,3,23,3,19,14,17,2,12,10,8,5,19,10,17,4,8,7,9,19,2,6,30,63,13,16,10,142,15,3,3,1,1,5,5,4,3,28,4,31,1,7,1,10,0,12,13,1,1,32,2,9,9,13,12,4,9,0,2,16,21,0,2,9,6,1,6,6,23,6,6,3,11,5,15,73,7,2,0,2,64,2,0,16,11,3,1,12,2,3,14,5,9,52,0,2,2,4,3,5,12,0,33,4,17,2,5,7,7,2,3,13,2,5,25,5,6,5,4,2,4,4,13,5,2,9,2,3,16,39,12,17,20,23,7,36,18,9,10,19,11,0,12,3,19,14,3,1,3,2,2,13,38,4,5,6,3,9,9,7,3,5,1,20,4,27,6,4,4,25,3,3,10,2,44,11,36,2,5,0,8,20,2,0,17,0,2,4,8,3,8,8,3,6,4,4,17,14,10,4,20,1,0,6,6,13,0,9,3,1,3,5,4,0,2,10,6,1,38,16,8,17,6,2,15,3,13,4,15,0,1,3,1,23,3,11,5,3,6,4,4,5,2,24,4,5,3,3,7,1,15,20,9,3,7,11,1,14,17,2,4,6,3,23,11,7,1,5,0,2,14,2,7,7,2,9,6,4,7,21,2,2,1,2,36,1,25,5,4,5,7,11,9,1,11,2,2,2,18,5,21,6,12,1,4,2,6,0,1,0,5,1,9,3,0,4,4,6,6,2,0,4,0,0,2,2,10,5,4,4,0,5,3,12,10,11,5,3,2,7,0,8,6,1,6,9,3,7,1,1,12,2,15,7,10,1,0,3,22,3,0,3,3,15,2,11,6,13,3,1,13,3,5,2,5,6,0,1,0,2,4,5,5,4,3,4,3,1,2,1,4,3,1,0,30,34,0,2,4,2,3,10,1,5,4,3,4,1,6,23,1,3,6,1,8,2,6,1,10,1,6,2,1,1,0,4,3,11,2,5,4,5,6,5,10,1,4,5,8,1,4,2,14,7,4,4,3,1,4,2,1,7,8,8,8,3,5,37,2,1,13,5,3,2,10,7,12,2,10,2,2,2,14,10,6,3,14,2,4,3,9,1,3,13,1,5,5,2,1,1,4,4,3,4,5,13,4,4,7,2,2,2,16,5,4,2,0,1,2,5,2,5,4,5,14,18,4,4,25,3,6,0,7,1,5,15,0,19,3,2,1,3,4,8,18,5,9,1,3,4,4,8,2,6,8,3,4,7,4,25,2,0,1,67,12,1,3,5,1,4,13,3,1,10,2,7,16,13,8,7,7,1,1,1,4,4,9,21,6,1,0,3,2,1,6,14,4,2,2,3,7,1,2,13,10,1,9,8,2,15,4,2,6,4,5,1,2,1,2,2,6,6,0,1,2,17,2,6,12,4,3,1,1,6,4,3,0,14,2,2,6,1,1,5,4,4,4,1,3,2,24,4,4,1,2,1,9,20,11,2,10,1,3,3,2,10,5,21,19,5,2,0,6,41,46,7,2,7,22,8,1,2,2,2,2,1,0,4,3,4,8,3,17,0,4,1,6,5,11,5,5,5,10,11,4,4,1,2,11,6,4,2,1,4,4,6,6,4,2,1,3,6,4,0,10,5,4,6,0,5,0,11,1,2,0,11,10,12,1,0,3,0,6,1,9,7,1,1,2,2,1,9,3,0,0,2,7,4,1,10,3,7,4,4,16,15,5,1,2,3,2,5,1,2,10,7,2,1,2,1,3,1,0,6,3,1,16,10,1,4,0,18,3,0,1,8,5,5,9,0,6,1,4,1,4,6,2,0,1,5,2,1,20,2,1,3,4,3,4,3,1,17,3,6,2,1,2,30,5,14,11,3,3,0,2,0,2,5,3,1,0,1,0,11,2,2,5,0,3,4,2,2,6,7,8,5,15,8,4,14,6,21,28,1,1,1,2,1,1,8,2,5,15,2,1,4,5,1,8,24,3,1,3,2,2,2,4,1,2,2,0,2,3,2,0,0,6,14,1,6,3,2,7,1,0,0,6,1,4,6,0,4,1,2
10,0,7,1,48,2,11,1,5,1,1,1,6,14,17,0,3,6,2,3,1,0,12,11,16,3,5,1,5,1,13,0,50,20,4,13,28,8,2,8,1,0,3,1,4,5,4,18,7,62,22,9,6,0,9,19,0,31,5,11,4,1,1,0,6,5,5,12,7,4,11,56,1,4,1,24,6,12,1,35,10,53,3,2,2,43,14,5,2,17,15,13,2,62,2,18,20,6,1,13,2,4,10,4,0,7,8,7,12,10,7,6,0,12,9,17,10,2,1,35,22,12,15,39,147,14,1,3,3,5,1,7,5,6,16,4,22,0,2,0,3,3,12,17,0,0,26,2,9,3,2,4,4,7,1,4,23,14,12,2,22,14,2,8,14,57,6,2,5,4,0,13,28,7,4,0,5,27,3,4,24,6,2,19,7,3,7,11,5,8,14,0,0,1,5,7,1,22,4,6,3,11,1,5,0,4,0,6,21,3,4,18,6,14,10,2,7,4,18,5,7,2,9,0,9,16,21,8,13,2,20,1,6,15,1,7,26,8,3,10,1,13,8,1,3,7,8,3,9,22,5,5,18,5,4,1,6,1,18,1,11,5,7,6,6,1,16,6,2,4,1,23,14,20,0,0,10,7,16,3,2,18,1,1,6,18,5,6,7,0,3,2,6,8,39,8,1,13,4,2,6,6,16,2,13,2,5,3,3,0,1,1,3,13,2,25,7,8,10,8,4,5,1,14,6,7,0,6,10,0,5,1,7,0,0,1,3,0,4,1,5,4,7,4,2,3,1,9,6,5,18,4,2,0,14,2,3,5,1,2,14,9,5,7,3,2,1,4,2,7,6,2,15,3,6,2,7,2,5,2,0,10,3,7,3,3,6,0,4,12,0,2,3,3,3,12,2,5,0,9,2,4,1,0,0,5,1,1,0,5,1,0,2,2,4,0,5,0,2,2,2,0,2,5,1,1,0,1,0,6,9,3,6,1,4,4,5,0,1,12,1,3,9,2,3,2,3,13,3,2,3,8,1,6,1,11,6,1,2,1,3,2,1,2,7,2,0,11,4,5,3,6,3,0,1,1,3,0,1,4,1,2,5,2,2,1,0,0,1,0,1,22,10,1,0,4,1,4,1,1,1,1,2,3,3,4,9,3,3,3,0,5,1,2,2,6,1,1,0,0,4,1,6,1,3,2,1,4,1,2,4,1,3,3,3,6,2,0,1,5,3,3,2,0,14,3,2,0,7,1,3,0,0,0,14,1,0,5,4,2,0,5,2,10,2,0,5,4,1,4,7,7,0,11,0,2,0,5,2,0,12,2,2,3,1,2,3,4,1,1,3,4,4,2,2,2,1,4,5,6,0,8,0,0,1,1,3,0,3,5,3,9,10,1,1,4,1,1,1,1,1,0,0,1,8,2,1,2,1,1,12,0,6,2,4,4,2,0,3,0,1,1,0,2,0,3,5,7,1,4,36,4,3,1,3,2,1,7,1,0,2,6,2,0,4,3,0,3,2,2,1,2,1,3,1,8,0,0,4,0,0,0,5,2,0,3,1,1,1,2,6,4,1,0,3,1,4,0,0,7,1,2,2,1,0,0,2,4,0,4,0,1,1,3,8,4,5,3,2,3,4,0,2,0,2,1,9,2,3,1,3,4,3,3,0,1,0,6,0,2,5,1,2,4,2,0,0,9,4,1,3,2,3,3,6,10,3,0,2,1,37,43,5,4,12,10,5,7,3,1,5,2,0,3,3,1,5,4,1,2,2,3,4,1,1,4,0,2,1,0,1,3,2,0,2,0,4,4,2,1,1,3,0,1,0,2,0,2,1,3,1,6,0,2,1,3,0,1,2,0,3,0,2,2,6,1,1,0,14,0,2,2,1,0,0,1,0,0,5,0,1,0,0,0,1,7,3,1,7,0,1,1,4,2,2,4,0,3,6,1,3,0,1,0,4,0,3,2,1,1,6,0,2,2,4,3,0,0,0,5,2,5,1,1,0,5,1,0,0,0,1,3,9,7,1,3,3,0,0,4,4,1,0,2,0,2,6,0,1,3,2,4,4,2,6,0,6,7,3,1,4,1,2,0,9,1,2,1,0,0,5,3,1,1,5,0,2,3,3,0,10,2,3,4,3,5,5,6,18,7,0,0,2,1,1,2,1,9,1,5,0,8,1,0,6,9,10,0,0,0,0,0,0,5,2,2,0,1,1,0,1,1,0,2,0,1,2,3,3,0,5,0,0,1,4,3,9,1,1,3,1
future,6,24,12,135,20,50,6,57,7,9,19,15,36,182,22,16,20,23,34,14,12,47,104,62,31,45,51,55,39,45,19,244,210,33,67,253,98,5,27,24,17,47,5,23,57,25,38,11,270,192,74,34,45,149,83,7,43,20,53,46,15,7,9,22,55,35,186,13,12,17,28,4,11,8,242,72,65,9,113,75,75,6,29,39,184,48,20,5,33,3,19,13,11,52,44,28,46,6,83,21,12,49,40,29,101,39,7,21,31,16,29,5,39,44,35,56,0,5,58,141,74,82,42,144,20,25,10,11,5,7,1,16,22,60,53,139,10,11,17,18,9,46,26,19,7,141,22,50,17,22,76,13,13,25,30,37,90,27,15,80,18,32,21,9,12,65,5,30,24,17,27,158,45,30,31,7,135,13,12,102,30,25,25,37,9,39,41,37,31,63,10,27,4,13,13,9,37,18,19,23,26,3,22,14,31,34,18,45,16,32,123,55,38,17,20,54,17,29,19,13,7,37,8,16,48,62,35,25,9,12,12,35,33,28,69,11,71,14,13,18,85,69,19,20,28,7,11,59,54,27,17,24,50,9,7,30,7,1,6,16,1,55,16,0,15,37,30,57,34,4,137,24,16,11,6,17,29,14,6,3,133,5,7,18,8,7,21,44,15,7,2,11,13,16,6,7,34,5,12,31,40,25,1,9,13,5,36,7,25,10,4,43,66,21,28,8,20,37,15,16,52,19,56,30,82,5,24,102,10,41,15,15,7,4,10,8,47,9,7,9,21,27,40,19,19,12,35,67,25,33,10,31,16,98,30,4,16,6,27,50,26,17,28,33,12,25,37,19,32,91,7,70,11,53,16,14,11,0,35,10,86,8,48,15,24,62,13,49,44,5,33,27,8,8,35,17,47,5,32,9,29,24,3,13,2,12,14,2,30,26,8,12,9,18,17,29,15,16,14,28,9,11,24,13,3,6,8,9,22,17,10,7,1,14,19,11,13,21,35,6,18,28,13,33,10,16,79,24,50,18,73,7,38,5,71,7,21,6,16,26,25,39,52,53,11,14,47,23,12,6,54,26,3,27,3,35,14,10,31,30,16,32,3,10,14,11,8,25,13,1,91,72,12,18,22,12,6,7,15,8,16,11,4,12,5,24,34,9,5,16,4,7,10,4,12,12,9,15,1,20,3,18,2,24,4,5,45,8,21,29,28,17,8,13,25,8,4,16,54,39,7,8,7,36,10,14,9,28,15,7,17,3,4,44,6,5,37,3,7,6,23,10,9,8,21,18,14,13,30,35,24,7,9,3,7,1,4,11,10,46,6,14,17,33,14,9,12,17,5,35,30,48,15,9,21,14,20,5,30,14,24,2,8,1,11,26,8,12,8,5,46,11,9,11,22,10,15,6,4,7,17,1,8,16,6,3,10,5,16,28,15,18,29,26,1,8,21,13,16,11,19,14,8,11,18,21,16,7,12,166,26,10,25,1,7,13,30,19,3,7,7,11,5,12,7,3,1,6,7,13,15,7,31,10,26,8,4,5,4,14,15,37,13,13,11,8,18,14,0,8,20,59,11,14,4,27,12,6,15,9,15,6,5,9,5,15,26,14,2,5,6,4,5,25,18,15,20,9,10,10,6,3,3,14,7,11,12,5,4,12,12,15,11,8,7,5,19,11,25,24,28,7,6,7,10,9,10,33,13,6,20,7,1,4,4,11,22,10,4,10,12,14,2,8,26,24,21,10,23,6,21,24,12,26,8,12,9,5,7,6,2,4,14,0,9,5,13,5,6,11,11,3,2,5,6,34,6,11,5,3,8,12,6,2,30,12,28,6,22,3,0,8,5,6,5,1,10,20,5,5,1,2,5,2,7,7,21,10,8,6,10,4,20,14,18,12,14,30,10,7,3,4,3,16,10,4,18,29,3,20,11,18,4,6,5,12,8,5,4,4,1,8,5,8,8,12,14,0,9,16,5,2,9,4,12,12,1,15,11,3,3,5,6,3,5,3,5,3,5,8,13,13,9,8,6,5,7,12,2,29,5,5,11,2,11,4,7,3,0,17,4,11,6,11,3,5,1,7,4,1,3,6,8,4,2,4,1,11,4,7,6,10,6,12,2,7,6,5,7,10,8,11,6,5,7,18,21,11,18,3,5,15,9,5,4,2,1,4,13,8,1,6,7,5,3,8,5,2,3,17,12,8,25,19,2,2,11,9,5,2,4,5,4,5,9,4,4,31,11,16,7,13,5,13,4,11,10,2,14,26
learn,2,11,5,46,7,12,12,7,7,6,8,6,19,45,0,5,4,6,2,2,1,16,25,25,9,11,23,21,6,16,9,79,63,17,31,73,24,4,5,6,1,8,4,4,15,9,9,0,90,34,21,15,7,43,43,7,14,7,8,12,2,3,3,8,13,1,73,2,3,9,13,2,7,2,93,8,23,0,39,19,15,3,13,10,79,1,3,1,17,0,2,9,1,10,16,0,18,1,18,4,3,12,6,6,13,13,0,3,7,6,22,1,4,9,14,18,0,5,25,51,16,35,9,66,18,6,3,2,4,5,16,1,10,29,19,38,5,3,4,11,4,22,11,1,4,45,6,10,5,8,10,13,9,4,14,5,27,2,5,23,3,1,6,1,7,17,2,11,7,5,13,50,22,1,11,5,58,6,9,36,16,5,6,10,2,29,29,12,9,31,4,3,3,1,1,2,2,10,5,5,7,0,0,1,6,12,7,10,5,10,36,19,15,6,6,16,0,5,4,0,3,14,3,10,12,29,23,12,8,6,7,12,3,8,31,1,20,7,2,5,23,17,9,15,13,2,1,28,21,3,7,10,11,0,2,6,4,3,0,8,1,18,2,2,4,23,12,10,6,2,42,3,1,2,0,5,9,1,2,0,62,3,0,15,11,1,3,4,17,6,2,2,5,2,1,6,12,4,1,4,15,3,0,0,3,0,18,6,7,0,3,9,14,4,10,5,7,25,4,6,20,1,18,37,30,2,5,31,0,8,7,5,1,0,5,5,10,5,1,2,3,11,13,8,1,4,6,26,10,14,1,4,0,15,7,1,2,8,10,11,7,6,7,8,4,4,14,4,6,14,2,23,0,13,1,9,5,7,4,5,20,2,10,0,4,16,4,9,13,3,16,2,6,5,11,9,13,0,13,3,8,5,6,3,1,2,9,6,9,7,0,5,1,9,0,10,3,3,5,8,8,4,8,5,9,1,0,3,6,8,4,1,0,7,8,0,1,10,6,4,6,3,6,13,2,1,25,6,14,6,10,2,8,3,23,2,5,5,9,7,11,13,17,28,4,6,14,12,5,1,25,10,0,3,9,7,2,9,16,4,3,10,2,4,8,3,2,14,3,0,45,9,3,5,3,1,2,4,1,0,6,1,5,1,7,4,8,0,2,1,3,1,1,1,8,2,9,12,0,5,8,3,4,4,1,13,5,1,8,12,8,1,6,9,2,4,2,5,20,1,2,4,2,21,2,2,5,10,4,1,5,3,3,20,2,7,11,2,1,4,6,2,6,4,6,6,3,4,11,5,7,3,5,1,2,0,0,0,0,9,5,4,6,10,7,16,3,2,0,9,8,14,4,2,8,2,3,0,4,8,1,2,3,2,1,6,4,6,5,2,10,4,2,5,8,0,3,1,3,0,4,0,0,8,1,0,6,4,7,16,1,5,6,5,2,1,15,0,9,2,20,6,3,5,3,4,1,2,2,61,9,3,2,1,4,3,3,10,2,1,0,1,4,2,1,1,0,0,2,0,7,0,13,8,8,5,1,3,1,3,6,8,1,6,5,2,3,2,6,4,3,15,2,6,3,3,1,2,4,2,1,2,2,3,1,4,11,8,0,0,7,1,1,3,13,19,9,4,4,7,10,5,9,20,7,6,0,1,4,10,3,2,2,5,3,3,15,3,5,1,5,6,2,15,10,0,6,5,3,0,1,2,0,1,1,5,8,5,4,0,0,20,0,1,9,2,8,2,13,3,8,0,2,7,3,7,7,3,4,2,1,1,4,0,1,1,4,4,4,3,5,6,3,0,1,7,1,4,4,2,7,5,2,3,7,2,5,1,6,1,0,0,7,4,0,3,4,6,2,1,1,1,9,6,1,1,11,0,3,2,3,4,10,2,1,3,4,8,5,2,2,2,0,1,6,2,0,3,2,7,4,14,2,1,7,3,9,0,2,5,2,3,1,3,2,6,1,0,3,2,2,1,1,0,8,1,4,9,4,40,0,4,0,0,0,3,1,7,0,2,7,4,15,4,0,1,6,4,7,11,1,0,7,5,3,1,2,1,0,8,1,1,5,0,2,3,1,0,4,1,1,1,0,0,1,1,2,7,2,0,4,2,1,3,0,0,1,4,6,4,0,5,0,1,1,2,3,1,2,1,2,4,8,7,1,1,0,3,2,4,2,3,1,0,2,3,1,1,3,7,3,0,6,5,0,1,3,0,0,2,0,0,2,0,1,0,7,6,3,6,7,4,1,3,0,3,12,3,8,5
live,0,14,11,53,11,26,2,28,10,8,5,16,13,97,3,18,12,16,10,12,5,31,47,35,31,23,11,22,18,28,7,106,78,14,53,117,65,4,12,8,6,49,4,7,25,16,8,3,138,72,32,11,14,104,50,8,30,5,23,28,5,3,9,7,27,13,170,12,16,19,43,1,9,1,131,15,34,8,84,40,28,9,7,12,113,7,5,5,14,1,5,12,11,18,19,5,13,3,28,13,4,18,17,12,23,19,5,9,11,7,17,3,18,10,10,29,0,4,26,72,28,64,15,93,25,7,5,5,3,6,22,10,1,49,33,80,14,1,10,20,6,49,16,8,4,46,15,27,4,9,23,9,14,5,7,16,45,3,10,57,17,5,21,3,6,21,10,17,50,7,19,93,34,5,9,13,78,2,8,41,23,16,12,26,3,21,35,16,21,30,4,7,10,11,2,4,12,9,18,15,16,6,1,5,13,11,1,12,9,17,67,22,23,22,5,29,9,13,4,0,5,30,7,18,22,64,28,19,8,7,6,13,11,16,54,8,43,12,2,14,49,39,7,17,19,3,11,23,27,10,9,16,26,3,4,13,12,3,0,24,2,24,3,1,5,10,29,15,26,4,77,8,6,6,4,4,21,2,2,1,87,6,6,19,16,4,17,15,14,5,2,0,9,11,6,3,22,4,5,35,16,12,0,1,16,9,30,4,7,3,5,9,17,8,25,4,24,17,10,8,34,8,33,24,56,4,14,57,3,25,12,8,7,1,6,5,21,2,6,3,9,16,28,3,1,4,22,32,15,49,6,5,5,25,11,2,8,6,6,25,6,8,12,19,5,8,21,22,16,23,5,23,3,36,7,15,7,3,30,3,52,4,20,18,25,35,8,15,20,11,13,10,25,3,14,11,21,1,11,7,12,11,12,9,8,18,9,4,9,12,23,8,9,13,4,3,0,17,5,9,8,9,8,8,5,4,2,14,6,10,7,1,0,2,9,7,6,1,6,8,7,13,2,11,2,6,19,7,35,8,31,0,11,7,43,9,8,8,11,11,16,38,46,61,6,5,39,7,10,4,63,11,1,11,4,50,12,15,8,6,9,16,1,4,5,3,5,1,2,1,46,14,5,12,10,4,3,4,5,5,13,3,5,0,5,6,13,9,8,3,1,1,4,5,7,10,4,4,2,13,11,19,4,8,2,7,15,2,6,18,7,5,4,6,11,7,3,8,42,9,3,1,0,17,5,1,3,8,6,4,15,0,0,44,1,6,15,1,4,3,8,4,10,3,7,10,16,7,12,21,21,6,1,2,9,2,2,1,2,10,6,8,3,18,6,17,6,7,2,16,19,21,12,5,30,7,17,13,2,17,8,2,19,0,2,4,4,11,4,2,22,7,6,16,17,5,10,8,2,2,4,0,1,6,2,7,2,1,9,14,1,11,17,21,1,2,11,8,3,3,20,15,4,7,9,11,3,1,2,65,11,10,7,1,3,13,23,18,4,8,0,10,0,1,0,0,0,5,1,2,16,4,16,4,5,11,0,1,3,7,4,12,4,5,6,6,7,7,7,1,8,20,2,6,0,3,5,0,5,4,7,4,0,8,0,4,9,3,0,1,7,2,6,13,5,10,11,8,7,2,7,9,5,10,4,14,5,7,7,12,3,14,4,13,1,4,3,2,18,17,9,3,3,0,7,0,14,10,9,5,11,0,0,3,1,9,6,6,1,9,7,11,2,3,16,22,33,3,9,2,10,7,18,14,3,10,5,3,22,10,15,3,7,2,3,9,5,11,3,3,4,9,4,7,2,7,2,5,3,0,2,9,9,2,19,9,8,8,11,4,3,4,0,0,0,0,5,9,1,2,4,0,6,3,1,0,3,2,0,2,1,5,18,10,10,14,2,21,10,5,1,2,6,4,3,5,5,5,3,8,7,5,5,2,5,2,3,3,0,4,2,8,6,1,2,4,9,2,4,2,2,0,0,2,4,16,0,0,9,0,0,3,2,2,5,1,1,2,12,1,7,3,6,3,2,4,3,7,10,19,4,2,2,8,28,0,1,1,3,3,5,1,10,0,6,0,5,1,4,0,2,4,2,4,4,0,0,2,0,0,4,1,2,5,3,2,4,4,4,10,0,16,0,1,7,6,5,1,5,1,2,9,19,1,0,0,1,4,4,2,1,3,6,3,7,0,2,8,3,5,7,5,15,12,2,0,8,1,6,4,0,6,1,1,3,2,5,10,3,7,7,5,6,6,9,18,16,0,8,21
also,31,102,41,654,37,44,27,151,16,14,97,44,59,315,21,37,33,79,34,25,25,143,85,121,101,116,80,66,48,94,52,797,473,62,225,271,166,47,64,31,39,64,23,34,121,59,155,94,1083,171,169,38,37,216,82,26,255,149,42,79,81,30,24,61,91,45,362,34,26,87,124,29,22,23,483,64,128,18,320,93,299,20,66,38,757,79,79,16,144,16,39,32,42,108,200,90,75,28,164,57,84,142,124,39,44,132,52,40,61,33,93,26,67,111,66,113,13,14,301,578,147,141,138,382,40,19,11,16,28,16,60,29,49,1,82,304,33,23,43,46,29,160,120,18,17,289,29,67,71,58,249,24,58,42,39,160,156,45,32,163,76,16,50,27,40,52,38,102,123,33,121,400,113,15,29,28,571,25,49,261,121,58,73,94,28,111,145,79,131,202,16,14,33,12,15,19,91,43,46,57,126,21,42,51,116,41,31,155,56,121,346,35,127,61,26,52,16,49,75,17,22,97,34,75,219,397,120,122,42,57,101,67,102,92,145,118,119,55,48,38,246,144,47,33,79,36,39,131,265,21,57,109,85,61,32,81,33,26,18,104,36,119,107,19,21,193,41,50,70,33,529,67,154,30,18,21,143,84,52,32,257,25,19,67,48,34,67,82,52,15,15,30,83,42,22,45,175,34,41,90,82,210,11,26,48,28,98,19,44,24,19,56,150,71,156,67,111,147,83,41,195,38,102,53,216,41,35,145,20,107,27,56,29,25,31,76,78,34,32,63,34,61,87,35,39,42,155,220,91,68,58,65,30,159,71,30,25,20,50,116,144,82,57,91,38,25,142,42,54,66,25,152,28,67,40,179,41,28,45,40,285,17,195,53,38,150,51,71,98,33,79,37,70,48,112,39,211,25,142,20,116,21,23,24,24,26,34,19,130,67,9,58,31,76,23,37,28,47,20,34,19,41,82,40,15,22,18,49,31,49,44,28,22,52,31,21,22,61,66,29,83,114,28,69,21,29,64,31,126,42,109,26,46,22,227,38,9,41,36,102,53,85,127,152,53,32,100,71,57,13,101,31,13,21,23,103,13,40,89,35,33,57,21,18,39,34,45,15,22,19,297,144,15,16,69,26,24,53,32,52,51,21,28,40,65,96,39,63,36,17,20,27,25,45,59,57,30,33,20,44,22,78,33,76,27,34,83,52,56,109,46,31,30,40,55,34,51,27,149,96,16,32,24,46,54,36,11,94,53,41,117,19,29,219,39,51,124,20,28,41,118,27,109,31,48,69,61,22,168,140,50,42,76,27,33,39,39,21,24,126,46,69,51,60,23,33,24,27,24,40,86,121,50,31,118,17,37,26,146,70,89,6,22,29,37,89,26,86,34,33,80,107,59,26,151,24,64,33,25,21,53,16,23,91,21,44,36,50,32,129,46,106,99,68,62,18,37,41,33,50,36,16,58,91,21,140,32,46,43,629,96,33,18,21,36,46,144,66,31,70,28,34,71,82,38,38,10,30,34,33,80,30,126,133,105,20,28,35,12,24,18,109,45,50,49,41,49,43,23,88,71,82,59,77,25,70,34,16,63,68,42,19,20,23,48,36,71,30,24,28,14,37,31,95,82,116,48,24,45,41,38,18,18,141,29,47,29,12,24,39,40,65,27,18,32,30,100,35,128,41,46,28,36,74,56,23,53,71,37,38,46,43,46,49,26,64,25,68,21,73,76,76,18,32,91,90,70,35,48,51,32,27,22,85,18,51,52,30,90,36,31,17,47,22,45,41,38,76,28,71,29,71,33,25,57,45,25,42,19,20,20,26,39,29,16,16,27,40,73,31,23,19,64,39,24,19,29,50,15,40,20,25,23,60,41,23,24,48,31,19,48,32,44,30,30,40,40,86,39,27,28,37,24,30,32,50,38,58,25,52,71,115,26,30,20,19,36,34,23,16,38,23,37,22,15,39,18,18,30,81,33,30,50,36,19,13,17,47,53,45,20,35,14,19,50,12,23,23,39,22,31,58,24,21,19,32,22,27,39,57,41,26,39,28,31,9,20,42,18,93,25,43,22,54,43,17,31,51,24,16,28,24,19,45,20,28,20,64,22,18,37,37,27,31,17,17,31,44,19,73,17,70,45,19,31,63,43,75,107,23,49,26,24,24,22,19,40,40,85,20,14,32,19,29,19,85,27,15,14,30,49,18,30,39,27,17,31,18,49,21,42,33,25,20,26,33,42,48,51,27,37,30,18,21,25,28,26,26,21,19
never,6,48,19,220,41,37,7,101,10,12,28,20,31,223,10,22,26,40,38,15,11,88,66,101,49,48,59,76,38,85,23,325,255,61,103,235,143,18,30,21,17,64,14,19,83,43,24,33,471,165,151,28,42,171,36,9,124,28,45,34,49,28,6,25,44,33,250,30,25,27,34,15,20,6,281,31,66,9,209,64,48,3,15,35,360,40,35,4,54,4,17,18,18,84,89,19,32,4,72,40,21,41,45,41,28,73,17,18,39,16,48,10,20,40,24,55,4,10,95,323,55,89,30,162,28,26,13,10,4,4,53,19,33,82,1,116,33,14,21,41,27,80,48,5,20,166,34,46,39,16,168,13,30,18,15,35,98,14,28,85,49,3,30,7,10,51,13,40,42,25,25,256,49,14,38,57,273,14,28,102,42,23,32,62,11,77,78,47,68,91,22,19,8,9,21,7,29,12,16,24,53,8,1,15,70,28,25,56,30,56,157,41,50,28,28,38,6,15,33,3,19,50,6,34,56,149,52,74,19,18,29,29,29,25,88,30,79,6,20,26,154,66,32,26,64,10,14,77,60,16,18,31,44,12,13,37,20,2,4,35,8,88,26,4,10,42,19,75,53,5,234,9,28,11,10,12,49,15,8,4,144,19,6,40,26,1,33,43,34,12,5,16,28,7,2,12,61,10,28,52,57,28,3,4,18,4,58,11,33,5,7,16,62,17,71,30,40,60,32,15,74,31,94,20,145,6,24,145,10,57,29,32,29,11,30,24,39,10,5,42,20,34,55,16,9,11,78,93,34,47,18,21,14,80,39,2,12,14,20,75,37,10,10,31,3,19,73,43,29,88,11,91,8,50,26,29,18,8,56,23,117,4,76,24,25,52,14,50,70,8,58,16,26,21,46,39,80,9,40,2,48,25,8,17,16,24,14,11,42,26,14,24,6,40,7,43,25,18,18,34,14,28,34,39,8,9,4,17,17,33,9,10,0,30,13,12,12,27,58,16,33,47,13,48,5,9,64,20,73,21,52,7,36,14,100,19,27,13,20,39,30,105,63,107,15,13,66,23,14,5,84,25,7,17,13,67,17,16,41,12,22,36,34,25,20,23,12,26,12,9,196,73,9,30,33,18,10,20,34,42,44,24,10,11,11,33,10,21,14,7,8,9,13,12,24,25,16,23,10,31,16,37,12,48,13,8,42,16,37,60,36,23,15,28,26,23,16,20,86,39,12,4,16,19,17,7,22,27,29,6,92,13,10,80,7,35,41,4,11,13,21,9,20,19,28,28,33,19,53,55,22,14,24,3,6,5,21,18,14,26,18,20,21,95,19,19,20,19,16,23,69,60,28,11,44,11,21,11,48,41,30,4,2,1,10,30,16,50,9,10,54,8,15,23,74,10,27,6,13,5,16,7,14,43,6,5,9,8,20,45,33,19,45,35,7,4,20,12,12,15,31,22,12,36,6,22,8,6,9,246,14,16,10,5,13,33,46,29,15,29,13,23,17,25,10,10,0,13,10,16,31,8,56,52,54,9,6,6,6,12,12,36,25,10,17,17,26,16,7,15,21,53,13,15,5,18,19,18,33,18,10,9,13,15,19,14,34,30,10,5,15,9,19,24,29,72,31,12,15,22,9,16,12,46,10,17,17,8,12,23,17,17,13,19,9,8,48,12,58,14,24,4,6,18,21,12,18,6,13,9,36,10,1,7,7,18,16,21,4,9,7,35,5,5,39,50,22,14,13,14,28,7,8,25,11,43,14,10,13,32,4,5,31,4,10,5,17,24,19,18,7,15,9,11,14,46,6,12,6,13,7,16,23,5,34,11,12,16,24,6,29,17,18,8,7,2,7,25,4,22,8,9,2,10,5,10,25,12,13,11,16,17,26,27,18,19,20,62,23,12,10,11,14,14,8,15,9,15,4,18,34,30,17,15,7,8,15,7,13,2,1,14,17,15,10,7,10,2,27,2,8,7,10,14,9,13,2,13,23,5,3,9,6,6,7,4,12,6,8,12,14,9,7,3,13,7,5,13,8,51,5,9,15,11,13,2,7,17,18,36,8,14,12,10,33,5,11,5,9,2,16,18,12,17,8,10,6,16,5,5,6,4,12,8,9,7,5,15,4,10,13,29,2,5,8,26,27,9,45,8,4,16,13,8,7,5,2,10,18,5,4,4,11,3,2,13,5,1,14,9,21,12,14,23,7,10,11,17,11,8,4,11,8,12,12,8,23,27,16,12,9,13,2,10,4,14,5,5,4,28
work,30,128,82,706,37,117,42,131,30,37,39,87,164,409,21,39,77,129,83,46,27,157,253,214,113,142,125,310,59,163,31,1151,536,104,310,496,175,22,50,33,55,82,27,97,246,61,135,135,841,380,191,110,74,350,284,23,138,199,132,150,34,43,19,96,167,80,613,46,39,102,198,74,38,36,749,93,271,24,409,177,308,27,45,70,780,105,71,18,129,12,58,39,40,147,158,85,115,40,270,98,246,203,117,98,80,145,24,90,108,33,113,27,135,150,201,176,19,30,259,550,223,308,145,631,65,27,36,19,31,22,139,38,80,304,116,1,42,44,43,59,55,214,112,31,18,433,70,112,72,68,250,48,68,66,56,153,218,61,31,364,123,45,84,30,60,254,46,134,150,63,113,555,181,58,86,18,554,26,40,468,248,31,128,206,57,189,171,100,101,231,18,28,49,35,27,31,188,52,68,49,189,25,39,44,78,89,33,222,84,146,458,124,130,76,54,233,36,91,88,54,29,99,34,86,197,311,164,150,46,59,100,88,134,116,170,42,157,91,64,53,285,185,78,85,96,53,49,226,311,57,48,104,126,25,29,77,15,17,7,98,90,177,67,9,47,277,101,104,85,41,384,75,120,35,21,45,132,70,28,25,381,35,31,90,68,30,160,200,66,39,17,41,88,63,23,33,126,21,44,89,113,125,29,20,49,51,129,39,199,29,23,146,197,93,160,71,103,216,100,24,133,31,222,151,316,20,132,247,18,112,40,54,41,42,35,85,114,26,17,37,38,68,204,38,34,62,107,212,122,256,42,47,11,222,86,29,30,46,99,199,123,80,123,59,31,69,84,59,155,188,30,227,28,184,91,191,39,16,89,20,211,34,194,59,142,161,61,88,142,41,66,76,96,29,114,56,144,20,127,48,52,67,29,51,24,38,53,6,94,111,17,41,29,95,28,76,40,50,55,69,27,77,114,32,40,30,36,71,26,51,17,16,5,47,67,15,19,59,94,39,98,57,84,55,12,31,195,54,184,53,173,13,97,32,217,54,38,11,88,102,88,112,114,209,66,50,177,72,104,99,173,64,31,32,25,172,40,64,132,58,43,84,24,34,60,48,58,60,33,30,253,154,13,29,74,18,39,45,22,36,58,38,17,56,80,61,64,49,57,42,23,23,52,42,76,56,37,55,26,64,29,41,34,83,17,25,93,75,50,84,66,51,30,56,69,39,27,46,167,123,21,29,25,87,67,57,14,61,26,39,95,16,21,171,56,35,115,21,36,27,53,29,72,29,69,53,44,31,121,185,59,25,126,29,45,19,46,29,26,131,34,74,78,87,29,24,33,35,13,92,88,99,64,27,285,35,17,90,64,51,56,36,31,9,27,78,42,96,59,30,130,217,65,24,77,29,54,25,28,30,57,2,29,75,27,32,27,24,70,91,22,82,104,77,46,37,70,54,49,53,67,44,50,76,19,127,74,31,51,382,72,37,14,27,25,66,86,60,23,47,18,31,23,14,19,8,5,17,33,24,80,39,43,74,67,22,17,48,35,22,106,141,36,41,34,29,32,32,15,68,47,149,40,42,26,175,33,10,38,36,37,32,15,34,49,76,68,49,11,14,18,40,15,84,53,102,52,16,13,66,14,27,7,100,38,43,32,68,20,38,21,84,15,39,15,13,107,41,87,38,74,25,50,59,33,25,57,100,49,20,56,8,22,51,47,73,25,28,25,58,50,83,13,41,90,91,97,26,78,28,61,38,30,57,24,51,41,26,74,17,15,11,52,44,39,27,14,10,22,47,32,53,37,17,59,111,42,31,15,21,36,23,25,26,57,55,28,31,57,26,12,22,28,32,21,15,27,83,17,38,6,5,44,96,75,24,77,29,15,11,49,21,35,20,45,43,20,72,23,32,3,46,5,36,34,79,37,55,32,55,69,78,30,27,52,40,35,17,8,16,23,31,28,58,14,12,28,23,36,51,72,37,41,21,22,12,4,8,44,13,8,26,16,10,74,16,34,11,29,39,60,112,64,19,10,22,20,37,46,67,25,14,56,22,23,9,33,10,21,68,50,28,21,28,36,14,29,35,30,24,28,14,8,17,6,24,17,10,19,13,32,33,17,20,20,24,28,21,15,100,23,37,29,7,17,32,32,76,72,15,48,33,29,25,41,13,27,38,54,10,33,55,11,26,27,41,37,43,17,36,26,18,47,62,13,4,39,8,49,12,14,21,8,6,15,16,28,101,15,69,26,41,21,34,33,42,81,50,28,52
wrong,4,18,3,73,12,5,10,14,1,0,38,6,0,131,2,7,5,19,6,9,4,23,22,29,32,18,24,12,7,12,15,126,87,12,46,66,52,2,0,5,3,10,2,2,36,14,12,7,199,19,32,14,9,36,15,6,50,12,2,7,18,9,2,4,8,11,106,1,21,11,11,1,4,10,114,6,21,2,46,25,14,0,12,8,165,6,4,0,24,0,5,6,6,19,33,3,13,2,25,6,3,14,18,13,15,12,1,8,5,2,5,5,2,8,4,24,5,5,39,178,39,17,10,24,5,13,0,2,1,0,10,5,14,33,33,42,1,1,4,7,21,35,16,3,4,70,9,14,16,5,78,1,7,5,3,11,30,2,14,15,2,1,9,0,4,10,2,29,22,9,10,88,24,3,8,35,137,3,11,23,24,16,0,23,0,17,25,20,32,40,2,7,1,0,2,1,3,9,4,47,28,0,2,10,22,6,1,10,4,21,55,6,19,6,9,14,4,3,11,0,1,55,3,9,15,97,26,12,1,3,8,7,5,14,40,1,28,7,4,7,64,19,4,19,18,5,4,32,21,6,10,15,27,1,5,25,11,2,3,6,8,18,15,1,6,4,3,17,11,2,76,0,15,6,2,3,23,2,10,5,63,14,1,18,10,2,3,6,32,2,4,3,11,1,1,6,28,6,4,29,21,11,1,0,7,4,38,7,4,0,1,10,11,1,21,3,16,36,12,2,86,19,33,1,145,6,12,24,3,19,9,5,14,6,14,4,13,6,0,7,15,8,5,8,0,4,34,47,17,9,11,5,6,21,26,1,7,4,20,18,8,3,12,27,3,1,25,6,2,11,2,12,0,9,10,7,5,3,26,3,70,4,29,6,6,14,6,38,35,0,53,3,12,5,23,5,35,1,30,2,23,0,4,4,1,20,6,5,11,4,5,7,2,13,5,3,1,12,6,3,5,10,40,13,3,9,3,14,7,16,4,4,10,5,4,6,0,13,5,9,12,28,3,9,2,3,7,8,30,8,7,4,1,2,47,6,0,14,10,15,12,20,29,54,2,9,5,5,3,5,16,8,0,6,5,37,6,16,12,1,9,19,2,15,9,18,6,4,12,5,54,29,2,4,2,8,5,21,11,25,6,2,2,3,10,5,0,15,0,8,3,23,3,4,8,11,8,9,2,6,1,40,3,20,5,6,21,15,25,31,14,8,5,13,4,5,6,14,37,20,1,1,5,1,2,11,7,10,16,9,25,3,5,34,4,5,13,4,3,13,9,4,14,8,8,11,16,4,33,40,4,1,1,3,8,2,3,12,7,14,4,10,7,16,8,20,3,7,3,6,14,30,4,2,26,6,5,6,53,26,14,3,2,4,10,14,1,24,9,0,29,12,7,3,41,8,11,1,6,3,4,0,7,7,0,1,2,3,23,21,0,15,36,21,5,2,7,4,9,7,12,9,24,19,3,1,4,8,7,114,33,1,2,3,1,7,31,18,13,16,0,1,13,14,9,4,4,11,14,9,21,8,100,43,50,7,1,2,1,3,0,11,22,1,9,5,14,7,0,5,12,4,6,3,5,2,7,12,7,15,6,3,4,10,3,4,8,4,1,0,7,3,4,13,11,14,2,7,6,0,5,6,3,12,0,4,7,5,5,10,8,6,0,9,4,0,6,5,21,0,6,4,1,1,7,1,13,9,5,10,9,1,0,1,1,10,10,1,1,2,3,16,7,0,12,8,7,10,0,18,5,3,3,19,2,12,0,4,9,3,0,0,21,0,11,5,2,20,5,5,9,7,3,8,8,17,7,4,1,1,2,4,9,2,7,3,7,10,9,1,2,0,6,6,7,4,2,9,7,9,12,1,0,9,0,4,2,4,2,7,7,4,5,10,4,3,6,54,6,3,6,3,4,7,7,9,6,1,1,46,9,24,22,0,0,2,23,0,9,0,0,18,5,2,7,2,4,2,6,3,2,8,0,1,9,4,2,19,6,5,6,3,0,3,3,1,6,0,2,1,0,4,0,3,26,17,6,3,2,4,6,5,3,5,6,1,3,1,2,10,1,1,11,8,5,5,1,2,13,1,4,11,4,0,6,3,3,33,7,2,2,1,5,1,2,1,1,11,7,2,0,13,0,0,1,13,1,1,2,5,0,4,0,1,1,0,3,1,10,8,0,1,4,0,2,9,2,5,7,3,3,11,5,6,2,6,0,13,6,1,1,1,3,0,7,3,7,1,9,7,2,1,1,1,0,2,0,1,1,0
record,11,5,6,56,1,13,1,14,2,1,7,8,7,23,4,8,6,5,5,6,1,24,21,11,11,8,3,12,0,9,2,83,47,8,31,39,16,5,14,0,4,17,2,9,19,8,6,12,92,42,16,11,9,26,13,0,11,16,13,17,1,2,2,4,13,12,42,18,3,3,24,0,7,0,42,14,16,1,31,6,19,10,6,8,91,12,6,3,20,0,3,0,14,12,13,19,17,2,22,15,7,8,14,2,16,13,3,11,8,4,12,4,14,13,10,11,4,2,19,44,11,22,15,95,8,2,2,5,7,2,11,3,1,23,14,44,1,1,3,23,6,22,16,6,5,40,3,10,6,6,14,6,7,7,3,10,20,7,5,24,9,0,6,2,22,4,9,13,12,4,8,47,11,2,0,2,67,3,2,19,11,8,10,12,2,11,13,9,6,25,0,1,2,4,1,5,8,4,14,6,11,3,6,7,13,3,2,13,8,5,22,8,15,2,3,18,5,11,17,1,2,10,3,3,15,58,28,13,3,5,7,8,7,5,9,3,7,8,12,4,14,20,4,7,7,4,5,14,29,4,3,12,16,4,3,14,8,2,2,27,5,11,2,3,3,29,13,7,11,2,45,6,15,5,5,4,14,2,2,0,22,1,7,6,6,4,10,9,4,2,5,2,9,7,4,5,13,3,3,11,6,20,6,4,1,2,6,12,14,8,3,4,16,6,10,0,4,32,4,2,24,2,16,8,20,4,5,11,4,15,6,1,2,5,4,7,8,2,5,5,6,4,12,2,2,0,14,19,4,12,2,3,2,21,13,2,3,0,9,17,13,6,4,13,0,4,6,5,8,6,1,12,0,15,3,23,4,3,6,4,13,1,23,4,5,18,10,17,14,1,9,10,2,7,9,7,16,0,9,8,6,3,0,2,2,1,0,0,15,2,2,5,11,7,0,2,1,2,1,1,1,2,9,0,5,4,7,10,3,6,4,2,1,10,1,2,0,1,6,3,4,19,1,2,3,0,4,4,10,10,6,3,5,1,16,8,1,6,0,6,5,23,12,9,6,1,13,5,2,1,9,1,0,5,3,5,2,8,6,11,1,7,1,1,1,4,0,4,0,9,36,11,1,2,11,1,1,18,2,8,3,2,2,2,1,8,8,5,2,2,2,0,7,4,5,6,2,4,1,2,0,11,7,7,3,5,9,2,24,8,1,2,1,4,7,2,4,2,26,13,0,1,6,6,9,3,7,7,5,6,8,5,4,20,5,4,7,2,1,6,3,2,8,1,4,9,9,5,12,16,4,3,2,1,6,0,0,3,1,11,3,6,0,10,6,0,2,3,3,2,4,8,6,3,10,1,1,8,11,3,8,2,2,0,0,5,4,3,4,0,16,22,2,1,23,7,1,3,1,2,3,5,1,15,3,2,1,5,4,15,3,8,10,4,3,3,2,1,3,3,7,5,3,5,2,3,6,7,7,57,1,2,2,1,3,2,14,5,2,4,2,4,4,1,1,1,0,9,7,2,11,0,17,20,17,0,3,1,4,0,5,6,5,2,5,1,1,0,2,3,4,7,12,3,1,6,6,0,1,3,2,0,0,5,3,3,8,2,1,0,2,4,1,8,5,15,2,1,5,4,3,1,2,7,1,0,3,3,5,6,4,5,5,1,1,2,9,1,9,6,5,0,7,0,2,2,5,12,2,6,1,1,1,9,5,7,2,8,0,10,4,6,0,8,10,12,11,5,7,4,5,4,1,19,1,6,8,5,2,5,0,2,6,2,5,3,2,10,1,12,6,8,1,0,4,9,1,4,4,6,7,2,3,1,0,1,2,9,11,1,4,2,2,3,2,4,3,4,1,4,0,3,0,1,0,3,4,0,10,1,8,7,2,4,4,2,0,12,5,2,1,0,1,1,4,4,3,5,1,6,4,7,3,0,0,5,0,8,1,3,0,2,7,5,5,3,8,3,0,6,6,2,1,5,3,1,0,3,2,2,1,3,3,1,7,1,4,1,6,0,9,2,2,3,5,6,1,2,5,5,1,2,0,0,17,4,6,0,1,6,3,4,4,6,12,6,0,1,3,2,1,4,1,1,2,1,1,0,0,3,4,5,2,1,2,0,3,5,1,2,1,16,6,1,8,8,4,5,7,1,8,5,3,0,0,2,1,0,8,2,7,1,6,1,4,2,3,7,0,1,0,0,13,3,1,1,3,1,1,2,1,2,3,3,2,4,1,4,1,2,2,2,0,4,9,5,4,2,4,3
clear,5,15,4,93,4,6,2,19,6,1,9,3,18,53,3,3,6,11,6,3,6,16,37,25,14,19,23,14,7,17,4,140,52,20,27,70,33,7,12,6,10,27,2,6,20,4,16,9,122,38,29,8,8,51,4,2,26,7,12,14,5,2,1,10,14,8,61,5,5,11,6,7,7,7,99,8,24,3,31,16,43,12,7,7,102,21,5,10,16,1,18,3,1,22,31,11,10,3,27,10,21,15,10,12,8,14,5,10,10,6,9,2,16,24,6,14,1,5,42,66,15,23,23,52,6,4,4,2,1,0,17,4,10,43,21,43,4,3,1,12,5,24,9,4,1,46,13,10,16,5,50,3,16,3,4,23,29,5,4,26,9,1,3,2,2,12,1,9,7,4,4,53,24,0,7,3,87,2,5,40,13,6,8,23,8,21,20,9,21,24,7,3,6,2,7,4,20,4,8,6,32,4,1,5,15,8,1,15,3,28,39,17,15,9,3,12,11,9,11,3,3,13,2,10,17,53,12,24,5,5,15,6,14,12,27,16,14,7,9,11,32,10,8,4,21,6,3,19,14,6,6,10,14,4,7,17,5,0,3,1,2,43,17,0,5,13,4,13,16,1,62,7,17,3,2,3,17,16,7,3,35,4,7,10,1,4,9,9,13,2,2,6,13,3,2,3,15,7,13,3,19,5,1,0,8,2,17,3,0,1,2,8,15,6,11,7,12,21,10,5,17,5,18,3,38,2,9,23,3,14,8,7,6,4,5,18,20,4,2,7,6,11,17,3,3,9,15,39,8,8,10,3,3,32,13,3,3,0,7,20,13,7,8,21,4,1,22,6,10,24,5,36,4,13,3,11,10,5,10,0,38,5,29,5,7,26,7,4,19,1,16,6,11,10,11,9,25,3,14,1,14,7,4,5,3,2,6,3,20,9,4,9,6,14,1,14,5,9,5,16,2,6,17,10,4,5,1,10,4,15,1,3,1,4,2,3,4,11,12,4,6,13,3,7,3,10,21,8,12,14,25,3,11,3,28,8,3,5,9,11,14,16,17,15,7,8,14,7,11,1,18,12,6,3,3,8,1,6,14,11,5,5,2,3,6,2,4,5,5,0,38,14,0,8,13,1,3,4,4,8,4,1,1,8,7,6,4,4,5,8,2,3,2,6,7,15,4,8,7,9,2,10,8,12,7,2,11,10,10,10,4,9,4,9,10,6,6,8,26,8,7,6,1,3,5,2,3,4,9,2,32,3,12,23,4,5,17,3,3,3,7,1,10,5,20,8,7,2,18,21,7,4,11,1,4,1,5,4,3,12,2,9,6,14,2,4,2,1,1,8,13,21,12,1,13,1,2,1,12,7,10,2,4,3,4,28,4,9,5,7,16,13,4,0,15,2,10,6,7,1,4,2,1,17,7,3,3,4,7,15,12,7,11,10,5,3,14,3,2,2,6,3,3,17,3,11,6,3,4,65,5,5,2,2,7,11,13,7,2,6,2,7,4,9,3,2,0,2,5,5,7,5,7,23,9,0,0,8,12,3,18,19,3,5,5,5,8,2,2,6,10,9,8,5,5,8,2,9,14,12,2,4,3,1,3,4,14,6,4,2,3,5,3,10,8,7,11,6,6,2,7,0,0,5,2,6,3,0,1,7,1,5,1,8,1,0,8,3,9,5,5,2,7,8,8,3,9,10,2,2,14,4,1,4,4,4,6,2,2,10,7,7,5,4,6,11,6,3,5,3,4,8,2,3,7,9,1,3,3,2,0,0,6,1,2,4,2,0,2,5,5,2,0,4,13,8,2,1,0,4,9,4,5,3,14,1,8,5,5,1,3,0,7,8,0,7,9,6,3,6,1,2,7,4,1,4,8,3,3,4,6,1,6,6,6,6,4,12,1,1,1,1,3,3,2,4,2,13,3,6,10,14,5,8,5,1,0,3,7,0,2,2,5,1,4,1,4,4,8,8,2,2,13,5,4,2,0,2,6,2,0,7,2,0,2,1,5,2,4,4,5,11,0,2,1,0,1,1,2,13,6,2,6,6,6,0,0,3,1,10,5,0,3,0,4,5,1,15,5,4,6,2,2,2,2,3,2,3,2,3,4,5,1,0,2,8,1,4,6,7,1,7,0,1,3,9,7,4,11,1,0,5,3,6,3,0,7,5,10,1,6,6,4,1,2,10,3,0,3,10,7,6,6,6,1,0,3,6,2,0,0,6,4,6,4,7,7,6,0,1,2,1,0,6,1,1,2,2,0,6
history,8,37,6,117,16,32,16,44,2,9,21,14,21,174,4,19,11,10,16,12,7,45,32,29,16,14,37,31,8,20,10,132,143,13,57,143,62,9,17,8,5,51,2,18,45,10,18,28,167,95,32,25,20,133,14,8,34,26,19,32,9,7,10,14,36,20,159,21,10,2,38,3,4,3,85,30,29,5,98,35,56,11,8,16,118,5,8,3,29,4,14,13,15,15,26,9,25,5,27,16,10,21,13,8,33,23,6,17,18,10,33,5,16,23,15,29,1,4,40,80,31,41,17,177,28,13,4,6,10,3,18,11,20,46,41,59,7,23,12,1,11,34,35,7,14,63,4,18,28,9,50,11,7,9,13,24,48,19,21,26,16,2,22,12,25,12,1,18,21,12,21,110,29,6,6,16,81,6,10,19,26,13,13,14,2,33,33,17,11,25,11,24,11,8,8,2,9,9,12,19,21,8,5,3,21,7,4,33,9,22,64,26,23,7,13,19,11,8,15,9,7,17,4,13,11,45,49,26,7,12,9,13,17,15,32,9,39,8,13,5,55,31,12,20,12,8,4,12,36,4,7,21,24,20,7,24,7,10,2,26,3,24,8,1,10,17,12,19,35,13,81,6,36,3,5,3,13,5,10,3,83,7,3,19,17,2,17,14,20,9,0,4,12,11,2,12,10,12,4,15,30,12,3,9,5,3,27,6,6,6,4,13,37,9,21,9,11,35,8,7,48,4,38,3,48,2,6,47,5,17,3,6,7,1,9,8,26,6,3,29,4,8,16,7,6,8,26,40,13,10,3,16,7,22,10,1,9,6,11,35,12,7,12,10,4,14,12,13,10,17,1,14,5,14,7,12,2,7,20,6,27,5,19,12,21,28,9,11,38,5,10,12,12,6,20,11,21,4,14,8,18,7,6,3,4,7,4,4,15,11,3,15,33,8,4,5,1,12,6,7,5,3,13,5,7,6,8,10,17,22,5,5,0,8,8,3,1,5,16,5,10,12,4,25,9,8,24,12,26,8,18,5,5,6,81,2,8,11,4,15,14,61,29,26,11,6,28,14,9,3,36,8,5,14,3,16,13,13,11,3,3,14,10,13,8,13,4,8,3,5,71,20,9,12,16,6,8,7,7,13,8,9,9,3,4,21,17,9,2,4,8,5,4,2,13,9,11,7,1,12,10,16,4,6,7,5,15,2,8,15,6,8,10,6,12,10,7,9,32,15,3,2,3,11,12,5,25,11,13,1,35,2,2,21,4,10,24,2,8,7,12,4,6,4,9,10,10,3,22,25,10,4,2,2,2,2,10,5,4,18,7,6,6,29,9,11,4,6,3,18,21,26,8,6,18,4,5,10,11,8,14,4,5,1,3,23,1,9,1,4,22,5,5,11,21,10,10,3,8,1,7,2,3,16,6,2,3,4,12,22,4,5,18,14,4,2,5,8,10,10,2,2,12,9,4,14,3,3,10,86,8,6,9,3,4,14,16,10,3,16,3,14,9,11,4,4,0,4,9,5,10,6,23,2,18,5,1,3,2,3,3,23,16,5,15,2,7,3,4,4,9,16,6,14,3,6,4,1,4,4,6,1,3,10,5,10,10,11,0,3,9,1,4,21,8,18,2,8,10,10,7,6,6,5,5,1,3,4,2,24,4,10,2,7,3,2,19,8,17,13,5,5,4,3,12,4,8,11,11,5,12,2,9,5,17,17,2,6,3,24,20,8,0,7,21,51,14,2,5,7,6,1,9,11,5,8,13,3,3,4,1,5,6,6,13,5,2,12,4,6,6,5,0,6,7,8,1,3,3,2,6,3,4,16,9,7,19,7,13,3,25,3,2,4,3,2,7,6,1,7,1,12,5,2,3,7,7,6,6,5,4,6,18,5,4,6,11,28,9,7,3,4,1,4,1,5,6,4,1,8,15,7,3,3,5,0,2,4,5,2,1,4,0,9,4,5,0,0,9,4,3,2,1,15,9,6,2,6,4,28,1,2,2,2,3,2,7,3,3,1,9,4,10,2,4,6,3,1,5,14,4,0,8,3,4,2,0,2,3,14,2,6,7,0,9,9,2,2,7,2,6,7,4,5,6,3,2,2,5,3,2,0,5,5,6,5,1,8,1,10,3,13,2,1,1,6,7,12,7,5,1,4,10,4,5,0,2,3,5,1,4,2,1,2,5,8,1,8,8,1,11,4,21,10,3,3,9,2,5,1,0,1,2,4,4,3,6,7,2,0,7,2,4,0,1,6,5,4,11,7
remember,0,14,5,44,11,7,6,27,4,3,9,4,16,73,1,6,7,10,6,1,0,10,58,33,14,16,26,18,9,26,6,59,48,15,38,88,30,3,8,6,5,16,3,7,19,8,5,15,68,39,25,8,8,48,14,2,19,2,13,7,4,3,1,5,15,8,65,2,10,5,8,2,3,1,115,5,20,4,41,13,11,3,3,11,53,3,3,3,10,4,7,7,6,13,24,5,18,1,19,5,2,6,8,8,4,19,5,4,7,2,10,0,1,13,14,15,2,0,23,56,34,32,7,39,8,9,2,3,0,3,9,4,6,29,27,55,21,6,5,11,1,19,6,3,4,41,6,13,7,1,30,2,4,5,2,8,46,0,2,24,5,0,10,3,6,15,4,14,19,5,3,66,21,2,10,4,75,2,16,39,26,5,6,20,1,34,27,13,12,9,2,4,2,4,5,0,7,8,2,19,23,1,2,2,7,9,1,3,4,8,49,10,14,2,8,11,7,3,9,0,1,25,1,6,7,30,17,16,8,4,5,6,7,1,20,4,23,3,3,4,30,12,8,15,16,3,5,33,14,1,4,7,11,1,1,12,1,1,0,6,7,21,4,0,3,8,7,17,13,2,34,3,2,0,3,4,10,1,1,0,49,8,2,14,8,2,10,7,20,3,1,3,4,1,1,3,5,3,3,18,16,2,1,1,4,3,16,6,8,4,2,12,11,7,10,1,5,22,15,1,8,5,27,9,48,0,15,26,4,17,4,1,8,2,7,6,9,3,0,3,6,9,10,3,3,6,10,17,12,13,3,4,0,14,11,2,7,3,9,23,13,1,9,4,1,6,6,11,7,21,3,24,2,17,12,4,5,3,15,1,27,6,12,4,9,10,10,13,7,3,14,4,5,3,3,9,11,1,12,0,15,6,1,7,3,5,2,1,9,7,11,5,1,11,3,7,4,3,4,6,13,2,6,4,3,1,1,16,2,9,2,1,0,4,6,2,2,8,9,2,6,5,3,12,4,3,15,5,10,6,10,1,12,1,21,1,7,5,23,2,19,14,14,45,11,11,21,4,2,5,22,10,2,7,5,40,11,12,12,3,4,10,5,4,7,3,4,5,7,1,43,10,7,6,6,2,4,6,1,13,5,2,2,3,2,6,4,5,3,5,1,4,4,3,3,3,7,5,5,8,0,9,0,10,1,2,5,18,4,13,8,7,7,11,2,6,3,7,15,7,0,2,2,5,3,0,6,5,2,1,13,1,0,17,4,3,3,1,1,3,3,1,3,3,3,3,7,3,13,16,2,2,2,1,3,0,3,0,2,6,1,4,6,29,6,9,2,4,0,6,10,7,4,4,32,4,3,5,0,6,2,0,2,1,0,3,2,4,4,3,14,1,2,5,6,0,2,3,0,0,6,0,2,5,2,0,1,2,6,12,2,1,26,9,8,8,12,4,4,5,11,6,12,7,1,4,2,1,3,30,19,2,0,0,7,3,9,4,5,7,2,4,3,2,0,0,1,3,3,3,4,2,2,9,5,4,2,0,0,2,1,9,4,1,1,4,5,3,0,3,0,14,0,1,0,3,1,4,3,0,3,1,0,1,3,4,4,5,1,1,9,3,3,6,3,5,7,2,4,3,1,7,1,7,4,1,1,2,0,4,2,2,0,0,0,2,11,1,1,3,9,4,0,6,4,0,2,8,1,6,6,3,2,2,1,1,1,2,1,5,6,9,1,2,5,1,6,1,2,2,9,0,3,0,0,3,1,1,0,2,0,0,7,1,5,1,3,1,0,4,2,0,0,0,10,6,3,3,1,0,3,2,3,2,7,2,3,6,5,1,0,1,4,1,2,2,5,6,0,1,1,1,0,1,1,0,7,1,2,3,2,0,4,7,3,2,5,13,0,0,0,7,2,0,3,2,5,12,1,7,4,4,5,1,4,1,7,0,3,1,0,3,1,1,0,2,3,0,3,1,0,0,1,3,7,1,0,3,2,4,0,2,1,2,1,0,5,3,2,1,7,3,1,4,2,0,2,2,0,13,0,0,3,2,3,1,0,1,2,9,0,3,3,0,3,0,0,1,5,2,0,1,1,0,7,2,2,0,0,3,2,1,1,1,1,2,0,2,2,3,0,11,0,0,3,2,2,5,5,0,0,1,4,0,1,1,2,1,0,0,0,0,2,2,1,0,0,0,1,1,2,5,9,8,0,0,3,2,1,1,0,1,1,2,0,3,5,4,5,10,3,2,1,4,1,6,5,0,2,7
bring,16,53,29,337,29,39,15,96,12,17,78,30,49,266,10,20,30,51,30,9,16,114,66,109,68,67,42,104,39,77,39,543,427,44,183,266,179,25,58,23,27,42,12,25,97,57,58,61,822,156,159,36,61,201,47,29,168,78,44,65,68,34,10,53,124,38,318,24,28,71,57,12,15,17,337,54,73,12,236,92,163,23,52,32,570,58,36,9,113,1,56,30,14,90,178,61,63,19,129,70,19,88,86,50,59,84,16,28,56,24,65,24,56,72,66,94,13,15,156,478,119,114,60,271,48,18,7,16,12,12,46,22,49,160,80,214,35,22,24,34,19,1,89,8,19,244,47,75,50,46,174,18,62,33,29,76,145,41,42,123,69,12,36,10,30,47,21,95,101,41,73,338,77,8,25,42,461,13,40,162,88,49,45,78,12,67,135,75,111,157,22,25,33,11,9,17,63,35,24,55,149,23,21,41,75,43,14,110,45,89,207,67,64,30,10,35,38,34,53,8,21,68,12,50,108,300,102,69,20,26,49,41,90,76,133,46,90,40,47,38,178,114,33,31,64,19,27,94,120,27,32,89,93,16,24,67,29,11,10,74,13,105,48,11,20,127,36,44,55,28,361,15,76,22,14,13,75,35,38,7,206,22,20,46,57,14,51,51,37,14,20,25,10,24,11,21,103,29,27,74,84,73,4,10,42,10,84,25,27,20,15,45,72,33,89,54,52,154,62,23,133,31,106,34,179,23,53,103,21,82,17,27,22,11,31,35,76,38,8,39,33,56,77,32,14,29,129,185,50,38,27,34,29,88,73,38,23,18,48,108,80,31,43,70,19,8,102,24,51,82,13,84,14,71,32,74,29,20,56,18,193,9,121,37,31,158,41,68,82,14,115,19,38,34,77,40,171,15,99,17,39,26,22,19,20,29,35,13,92,44,33,40,26,51,39,43,24,36,18,17,33,36,60,32,13,22,12,43,33,47,19,14,4,35,28,15,9,61,32,15,43,52,18,53,14,26,59,34,134,24,69,21,23,14,158,37,18,16,35,80,58,97,116,167,34,10,112,42,39,5,87,25,23,16,16,86,23,39,91,15,30,37,13,26,27,20,38,28,32,13,270,113,14,30,42,18,18,49,32,42,47,17,12,26,37,65,33,52,24,22,14,23,21,31,36,55,35,23,17,37,19,65,22,60,23,20,58,49,57,64,44,32,18,20,22,29,26,39,128,61,11,17,21,43,59,16,28,47,57,20,76,15,26,172,25,29,95,10,20,23,50,9,69,23,30,45,60,32,90,107,36,29,24,15,22,15,22,16,22,55,31,36,51,51,38,39,30,20,22,34,68,96,27,30,113,28,39,25,121,58,61,24,21,13,32,67,24,75,32,25,100,57,34,19,146,25,38,28,21,16,36,7,10,41,15,20,26,40,42,91,24,102,64,70,36,12,53,27,19,25,46,26,17,67,34,62,21,16,25,508,51,22,22,13,17,72,103,63,33,38,11,23,26,61,19,18,15,40,46,26,51,16,110,120,89,18,6,23,11,14,18,96,47,17,34,13,39,21,16,49,40,49,47,36,27,15,51,11,36,32,61,28,12,20,21,23,52,22,10,6,12,26,25,84,45,76,32,26,31,25,34,16,29,72,12,31,32,8,13,49,17,63,34,35,26,19,64,19,107,31,37,19,13,30,29,19,47,46,24,22,32,9,10,25,17,39,25,41,16,65,64,39,15,17,61,66,43,27,37,37,23,32,24,55,17,47,24,14,59,37,29,19,34,15,33,28,26,50,16,40,32,32,11,13,37,58,16,20,11,6,20,22,35,16,30,18,39,20,45,14,30,28,55,25,13,16,17,25,9,21,12,21,30,29,20,19,29,20,16,9,19,15,28,16,18,38,18,74,27,24,25,15,17,34,20,30,22,25,21,36,75,62,25,10,16,13,45,22,19,11,23,10,26,17,14,28,50,12,23,30,24,9,12,24,18,19,13,27,32,31,18,25,16,14,33,22,33,25,28,5,20,38,5,8,25,26,23,21,13,28,12,20,14,31,20,16,16,17,19,50,20,19,19,16,35,25,10,26,15,7,24,27,10,41,15,17,22,37,19,9,17,14,21,17,14,6,25,20,23,32,12,39,27,3,26,36,28,35,53,13,8,24,19,20,10,16,13,17,21,7,36,21,11,8,4,65,14,7,14,17,28,11,36,17,16,17,21,18,19,21,21,32,12,31,13,16,18,30,47,13,21,16,15,10,17,21,12,12,23,18
since,17,64,17,380,24,21,18,99,15,23,78,26,45,182,12,18,29,31,20,15,14,115,31,59,51,39,36,41,21,68,32,437,332,24,105,126,124,36,44,12,13,9,16,29,61,36,52,60,809,90,93,22,30,137,22,21,140,81,21,50,59,27,7,28,62,20,205,17,29,34,102,9,9,9,125,27,57,9,309,66,179,13,37,17,534,67,38,4,180,19,51,16,58,88,126,32,44,13,106,26,56,75,98,29,37,79,20,35,70,36,77,21,31,53,35,89,30,19,190,320,71,66,21,338,55,7,18,12,13,17,26,11,16,120,48,112,16,16,9,35,6,89,1,34,20,188,16,47,47,41,108,14,53,23,10,60,55,22,63,33,31,9,27,18,43,18,22,44,77,22,61,209,38,4,12,22,342,14,23,59,74,34,26,56,14,37,86,46,97,217,17,29,20,8,9,17,36,15,24,24,61,8,6,32,81,11,26,80,28,88,151,15,75,26,7,33,27,20,62,14,28,45,13,39,89,212,89,88,21,38,21,62,68,50,47,52,81,16,34,27,136,71,40,10,35,18,23,50,91,16,27,59,59,26,18,48,45,17,9,73,10,68,65,26,13,103,12,18,41,19,302,41,155,12,14,5,46,39,28,8,149,14,16,25,61,7,30,28,50,19,26,12,23,23,27,28,101,24,14,56,90,66,14,28,37,10,59,15,13,8,6,29,65,18,130,42,40,111,18,13,114,13,57,13,108,11,14,76,29,76,9,21,17,9,18,48,38,29,15,59,14,35,46,23,19,16,141,147,42,35,27,25,8,58,49,4,16,16,46,90,35,18,20,40,14,12,75,13,16,24,12,32,10,17,23,93,19,7,34,19,108,8,85,27,10,104,18,53,100,7,58,12,41,45,80,30,153,20,61,12,51,14,15,5,25,14,16,11,90,22,9,16,29,39,36,23,23,17,3,13,13,21,53,39,8,4,8,30,46,48,60,41,21,73,12,31,10,52,25,22,46,31,15,42,10,7,18,29,83,38,42,15,15,9,152,12,4,38,16,85,40,105,51,41,13,14,44,41,16,3,35,12,6,8,9,21,26,36,36,10,9,42,11,9,19,20,34,13,13,14,268,87,7,9,21,34,10,47,30,16,30,9,12,5,21,55,15,36,14,13,12,10,17,15,38,53,14,20,15,22,12,42,11,33,8,17,57,13,36,66,19,11,17,17,21,16,23,16,102,40,18,10,12,10,24,22,40,50,51,12,61,14,17,95,26,17,80,15,13,11,68,23,66,10,41,37,34,15,74,64,27,23,40,6,18,16,14,12,11,60,12,39,17,29,19,24,15,30,21,17,59,69,16,13,47,8,9,18,181,45,41,8,17,28,30,56,15,78,10,11,78,49,26,24,69,25,39,6,23,15,34,34,14,67,12,13,19,13,30,74,41,58,43,53,21,6,8,36,20,34,13,7,21,41,23,90,17,28,21,547,58,10,23,13,15,76,78,55,15,39,15,17,64,82,50,32,6,25,37,26,46,14,181,71,100,16,9,39,13,19,17,73,37,18,25,19,28,24,13,32,35,21,40,40,24,33,16,15,29,37,15,9,40,20,20,9,47,14,10,14,12,59,28,56,46,37,21,26,16,20,23,10,33,54,6,31,22,5,7,38,14,41,22,6,21,13,50,18,94,40,24,23,12,21,32,9,46,20,8,15,24,20,29,57,27,33,12,35,14,74,71,35,23,44,52,44,19,10,18,39,7,3,6,35,7,40,36,12,38,32,12,10,30,14,32,20,20,103,20,30,23,30,5,16,19,34,18,20,22,19,14,15,25,18,6,2,15,17,43,34,30,19,38,25,11,10,14,14,16,26,25,21,12,36,14,9,8,21,25,15,37,24,23,9,16,19,27,79,20,14,31,27,11,27,18,21,14,16,10,30,48,47,15,22,5,19,12,30,26,7,27,17,19,7,7,28,12,8,23,23,11,9,46,23,13,21,18,48,35,52,20,46,15,27,18,17,18,13,22,17,14,24,11,20,25,40,10,12,25,19,13,15,14,22,18,27,28,34,17,44,17,32,20,65,34,31,14,27,10,11,35,32,23,15,11,21,18,50,17,22,16,11,21,24,10,23,13,18,12,22,6,32,41,37,22,55,34,58,137,11,14,19,12,5,13,38,16,10,47,12,28,21,18,11,14,64,7,28,16,7,23,17,29,12,17,21,11,22,17,20,6,16,17,30,17,3,16,19,63,10,9,7,15,3,7,5,21,16,10,3
beginning,3,9,3,39,2,8,13,10,2,1,8,6,12,34,4,1,2,6,0,5,5,14,14,8,8,9,4,10,3,11,7,87,47,8,16,38,16,8,11,1,3,4,2,0,8,7,4,21,91,18,22,5,11,23,6,0,12,9,3,13,3,3,2,5,16,4,33,3,3,5,39,2,0,3,39,12,16,4,35,9,23,4,7,5,64,11,13,2,28,1,8,2,0,6,13,6,11,1,14,6,7,17,21,4,17,9,4,4,16,7,11,5,6,6,0,10,1,3,26,52,18,8,6,76,14,9,7,0,1,0,19,1,8,18,5,31,3,6,4,7,3,8,34,1,6,42,4,10,9,17,17,3,2,7,7,10,21,1,2,9,8,9,3,3,3,6,2,10,11,5,6,22,5,11,1,3,48,1,1,17,16,3,4,7,2,6,15,11,9,23,1,7,3,1,3,3,7,9,5,2,12,3,2,3,5,6,5,16,3,13,34,11,11,4,0,4,2,4,2,2,6,10,4,8,13,32,23,8,9,4,2,27,17,10,10,9,20,4,7,1,36,21,5,4,9,3,7,7,15,2,3,5,10,5,2,8,6,2,3,13,1,8,6,2,4,28,4,5,5,3,36,2,18,2,4,4,6,17,0,1,28,0,2,6,5,2,4,16,5,1,3,2,2,9,6,2,11,3,0,8,7,10,1,4,3,2,12,3,2,2,1,18,15,2,22,7,2,16,1,4,10,2,13,5,7,3,5,11,0,11,2,3,9,1,2,3,5,2,1,8,3,2,5,3,8,5,9,12,10,7,4,3,3,28,9,0,2,1,8,26,8,10,15,11,3,2,8,3,8,11,0,7,5,3,4,24,2,1,6,0,10,4,11,3,5,20,0,8,12,1,6,4,3,7,8,1,11,1,13,3,6,1,0,1,3,1,1,0,8,6,2,2,0,6,0,4,0,6,2,2,2,3,12,4,0,4,6,3,9,11,5,1,2,7,2,0,1,0,1,3,9,9,2,3,1,1,12,4,17,3,9,1,5,0,25,3,0,4,3,18,7,8,11,17,3,8,15,9,4,0,9,3,1,8,3,4,1,5,8,6,6,4,2,2,5,3,12,0,6,1,34,11,0,2,8,2,2,4,3,0,7,4,8,1,1,8,11,4,4,5,3,2,4,4,9,4,5,5,1,4,4,1,2,8,1,2,11,3,3,9,1,4,0,1,1,1,2,4,15,7,0,3,2,5,1,6,5,2,5,1,16,1,4,14,5,1,7,0,1,3,2,3,11,0,5,12,4,8,14,11,1,1,7,0,5,1,0,9,4,20,2,3,4,4,1,1,2,7,3,4,9,13,0,4,10,3,1,0,10,1,9,3,4,2,1,11,1,7,4,1,17,6,8,4,2,4,0,0,4,3,7,4,2,5,5,3,0,0,2,8,3,9,7,7,0,2,5,0,0,6,4,1,2,6,4,13,1,2,5,42,8,5,10,2,2,6,13,7,2,5,0,0,7,5,3,1,0,3,1,6,4,7,6,15,3,1,3,2,1,9,0,19,1,5,1,1,3,1,0,10,2,6,3,9,3,7,2,1,1,9,1,4,2,4,4,0,11,1,3,5,6,4,1,3,10,4,2,3,1,4,1,2,0,10,0,10,6,5,3,7,0,11,0,1,0,1,4,3,4,6,11,2,2,1,10,2,9,11,3,1,4,14,5,17,14,6,1,5,10,12,12,13,5,7,3,1,6,2,7,4,5,6,1,7,2,7,3,2,7,1,3,1,6,1,3,0,4,2,1,5,1,1,2,1,1,10,1,2,3,1,3,4,7,0,6,2,2,0,5,7,5,1,2,6,1,0,3,6,0,3,2,5,2,4,2,1,5,5,10,1,4,2,8,1,0,1,1,7,3,2,0,4,4,1,5,7,6,6,1,3,5,7,3,2,3,3,0,2,1,1,1,1,1,2,1,1,3,2,3,8,3,2,4,4,2,2,1,4,2,1,0,2,2,1,5,4,4,3,2,2,4,6,0,0,3,2,2,0,7,0,4,0,1,4,5,5,1,0,4,4,4,2,1,14,2,6,1,3,5,3,0,4,3,2,2,3,2,5,1,1,3,2,3,2,2,5,3,2,2,5,1,6,14,6,10,6,5,14,24,0,3,2,1,2,2,2,1,6,4,1,0,10,4,0,3,3,3,3,2,3,2,1,8,3,1,0,1,4,2,0,2,1,7,5,3,1,0,6,4,1,1,3,1,0,1,2,1,2,2,3
century,2,11,3,28,4,13,5,22,4,7,6,3,6,53,4,16,4,4,10,2,1,10,16,20,11,4,14,8,3,9,3,56,36,5,16,49,21,2,2,3,3,15,1,3,14,9,10,3,103,38,11,2,7,38,9,5,5,5,10,12,3,4,1,7,12,3,57,4,5,3,4,0,7,0,37,10,15,0,41,11,14,5,0,2,60,3,5,2,17,0,2,3,4,14,13,9,9,1,8,9,7,8,10,2,12,20,2,11,21,42,10,0,6,12,3,15,3,3,10,37,16,22,10,50,28,5,2,2,1,0,7,4,4,17,20,18,4,5,1,14,4,19,20,6,1,22,9,11,8,1,22,2,3,4,9,7,25,5,11,12,3,4,9,2,2,4,3,1,6,6,12,33,7,5,1,6,42,1,3,19,12,8,3,12,3,8,15,7,23,37,1,4,3,2,2,1,6,3,7,3,13,1,1,1,14,6,1,15,2,5,33,8,12,4,3,15,1,1,6,0,3,15,0,5,17,14,18,21,4,0,5,8,4,8,5,6,16,5,1,1,18,7,2,4,7,1,5,11,9,1,3,11,12,0,3,10,2,2,1,5,1,14,3,2,4,5,2,6,7,1,45,0,4,1,1,4,10,3,0,0,30,0,1,14,8,0,5,6,8,2,4,4,3,2,2,5,7,4,0,6,15,4,0,3,3,5,11,4,3,1,1,1,16,4,13,3,5,12,5,1,6,2,15,6,17,4,9,21,4,5,0,3,4,1,3,6,21,4,1,15,1,3,12,1,4,5,16,17,4,3,5,2,4,10,7,0,2,1,3,15,4,1,4,3,2,6,6,9,4,6,0,6,3,9,13,5,0,3,11,0,15,2,10,5,2,23,6,7,15,4,9,7,5,1,8,7,17,0,8,2,5,3,2,0,3,6,4,1,4,0,3,9,2,7,1,4,2,5,1,2,4,4,10,12,3,2,1,6,7,13,3,4,1,9,2,3,4,1,4,1,2,4,1,11,7,5,1,2,14,5,9,2,3,2,30,4,2,2,5,3,4,14,14,12,5,0,8,10,4,3,14,1,5,7,2,13,9,5,5,6,5,7,5,2,5,5,4,1,4,3,29,11,6,5,1,2,3,6,4,10,5,3,2,4,5,6,2,9,5,4,3,9,4,3,10,5,2,2,1,8,5,11,6,11,2,0,13,2,6,6,2,5,0,6,5,2,2,1,16,7,0,2,0,2,2,5,19,3,3,1,11,1,1,10,2,1,9,0,1,1,4,2,5,5,6,3,7,1,10,9,9,2,1,1,0,2,0,1,2,5,1,5,3,7,0,6,5,2,4,5,5,9,2,3,10,3,1,1,19,5,6,2,9,1,4,8,5,5,5,1,11,1,2,6,6,4,4,0,1,0,5,1,1,0,0,5,5,1,4,12,2,4,8,7,1,0,6,2,3,2,2,7,4,11,0,1,0,4,1,58,8,4,4,0,4,4,6,7,11,5,1,8,3,10,2,0,2,0,3,4,9,3,4,5,8,4,0,5,7,5,3,6,5,1,3,0,3,0,3,4,4,12,3,6,0,3,2,2,3,5,5,0,1,3,2,1,5,1,0,1,1,6,0,6,6,1,3,3,3,4,3,4,2,1,1,3,2,2,0,12,0,4,0,2,0,0,3,0,7,6,3,3,1,2,3,2,1,4,5,4,7,4,3,9,3,2,2,6,0,0,0,4,3,1,9,6,7,4,4,3,3,4,1,2,2,4,3,1,0,3,0,0,8,1,4,2,2,9,2,1,2,4,0,3,4,2,2,1,1,1,3,5,4,0,1,5,3,6,1,0,2,2,1,2,4,1,3,0,1,0,0,1,0,1,1,4,1,2,2,1,2,29,7,4,1,5,7,11,4,0,0,1,1,4,0,1,4,2,3,4,10,10,3,3,2,1,4,2,1,5,0,2,0,2,2,4,7,0,5,1,1,2,1,4,1,0,1,9,3,16,2,1,2,2,2,3,4,0,4,4,7,6,2,2,1,13,0,0,3,4,1,1,2,3,1,8,0,0,1,5,0,0,1,1,5,3,0,4,4,1,3,2,0,1,3,2,5,1,2,0,0,1,1,1,4,5,0,4,2,5,1,8,0,0,1,4,5,5,2,2,0,7,5,1,1,1,3,0,2,1,3,5,1,2,3,3,0,0,1,2,1,5,3,6,0,2,1,3,3,2,0,4,1,1,3,0,9,0,3,3,3,1,1,3,1,1,2,3,4,2
take,64,165,57,802,66,69,36,144,47,16,142,63,100,484,19,63,56,101,52,25,26,426,173,215,151,117,128,146,65,176,106,1110,780,101,280,460,263,51,74,34,56,84,44,71,198,114,145,107,1589,306,301,74,89,333,115,45,277,156,91,125,91,50,20,89,178,86,619,56,65,90,114,41,34,30,662,76,167,35,506,207,280,24,93,69,1142,147,65,24,220,18,85,50,53,180,272,87,128,27,250,85,74,191,191,77,90,178,42,72,113,33,143,38,88,115,68,224,44,23,453,807,269,252,108,537,70,33,32,43,32,26,141,45,46,289,166,433,70,40,46,63,41,244,188,42,22,1,81,128,91,58,347,34,116,46,51,170,272,61,51,198,98,40,79,26,63,117,39,134,140,73,105,585,178,42,65,49,794,31,60,311,181,64,79,162,53,164,219,170,204,314,23,64,50,29,45,34,123,33,75,57,161,13,29,84,145,83,38,170,76,156,507,86,175,60,50,101,64,58,168,37,26,118,32,85,203,613,179,145,60,62,81,99,121,125,191,129,177,65,61,65,384,232,62,90,80,37,29,196,280,38,70,108,132,41,45,100,64,30,20,115,30,259,91,38,34,196,64,86,88,35,699,80,126,20,27,41,166,72,60,21,401,43,23,109,60,24,69,164,94,38,42,46,107,51,42,47,215,53,50,141,155,163,7,26,60,25,191,29,44,24,12,106,191,83,201,82,99,230,94,40,298,32,199,81,402,44,83,264,25,182,53,79,50,28,36,106,137,46,18,74,65,101,116,96,44,47,177,337,94,115,47,61,33,233,133,49,43,54,78,189,126,50,77,118,33,42,214,61,91,186,39,194,34,138,47,125,43,26,98,31,351,30,242,83,62,194,64,122,186,12,136,45,89,69,202,70,309,18,256,21,117,45,34,42,28,31,45,19,138,70,30,73,52,91,86,86,54,70,40,64,31,85,214,80,17,33,19,94,66,116,60,51,10,103,46,45,22,96,96,35,107,120,54,81,30,45,144,64,191,56,144,42,74,35,256,51,26,72,70,192,98,133,189,229,43,44,119,82,72,20,139,66,24,29,36,128,30,100,135,60,52,96,28,47,55,70,65,49,51,24,455,205,16,41,77,29,38,74,49,63,91,42,18,43,52,106,59,56,37,48,27,32,73,36,59,86,147,44,16,50,23,113,35,127,32,42,201,56,100,136,79,41,49,59,59,39,59,78,192,111,21,45,36,51,74,64,41,97,81,42,195,47,49,247,60,39,167,26,22,62,107,37,124,28,72,76,62,61,185,205,61,43,81,47,55,28,82,41,41,127,46,101,102,109,40,37,35,40,29,79,121,195,90,43,138,31,40,24,236,98,114,23,39,25,54,112,37,116,35,34,185,136,87,34,195,39,72,28,59,26,81,36,18,139,17,42,45,55,79,169,66,111,153,155,45,19,69,36,29,49,74,23,41,155,47,174,25,47,46,970,174,43,55,37,71,66,187,105,50,79,29,45,102,86,42,32,17,54,53,56,90,49,235,165,145,37,18,40,48,32,36,165,85,50,65,27,76,48,17,82,83,126,78,74,51,88,64,31,67,73,52,33,30,49,53,61,87,69,23,27,16,60,26,214,87,146,113,45,55,48,66,38,42,171,36,56,48,23,28,66,38,94,29,33,41,34,120,33,196,41,79,50,37,75,69,37,78,77,32,46,74,29,24,84,32,76,58,51,26,85,85,85,35,46,114,108,77,37,64,47,59,39,27,114,27,71,57,11,83,42,33,23,82,35,63,36,37,120,25,89,57,62,24,28,65,89,38,49,28,39,30,38,70,35,62,31,42,34,107,31,47,34,90,70,26,34,34,74,29,67,31,21,70,105,35,26,44,47,53,20,76,25,55,30,56,46,71,166,51,42,42,57,28,59,43,43,57,67,33,78,102,154,63,18,22,40,30,34,59,15,55,52,44,20,32,38,55,29,52,79,27,28,38,50,38,32,31,55,70,36,15,52,29,34,63,25,53,37,54,35,57,94,29,23,45,50,26,49,52,60,31,42,53,47,78,25,41,47,49,110,28,40,34,42,67,46,20,54,41,21,35,43,34,46,12,35,23,97,27,28,28,24,35,26,23,24,23,38,41,56,26,67,50,21,43,74,46,53,144,27,19,31,28,26,30,29,35,47,115,23,42,46,26,45,22,158,35,24,44,36,43,22,44,52,34,23,22,29,44,37,31,24,43,41,31,22,40,58,96,29,23,27,29,33,26,34,25,36,15,50
away,0,14,9,70,6,10,4,33,4,7,17,13,8,43,4,9,5,21,8,7,5,24,44,33,19,15,18,20,11,29,4,98,95,11,41,71,30,5,6,3,14,16,4,9,20,19,22,5,150,28,32,15,14,51,24,5,16,8,17,14,5,3,1,9,35,9,94,3,3,8,16,3,5,5,85,9,43,2,57,28,21,9,8,34,122,26,7,2,28,1,5,6,7,18,28,8,13,3,16,20,5,13,10,13,13,14,4,7,11,9,15,0,13,22,21,35,4,4,51,106,31,34,27,71,8,5,2,4,2,2,22,6,15,29,34,70,9,3,13,4,6,47,16,4,9,81,1,32,10,10,45,8,14,8,5,8,52,11,3,30,15,4,15,2,7,25,7,23,23,6,18,76,32,4,11,8,98,6,8,37,26,8,11,35,0,27,19,17,19,32,5,7,1,4,2,10,7,3,13,9,26,2,1,5,12,9,1,29,8,19,54,19,41,9,8,30,7,5,10,1,1,16,3,10,22,49,33,22,5,3,9,13,13,18,19,10,25,8,5,5,61,29,17,9,17,4,7,24,17,7,7,10,16,1,3,12,2,2,3,9,1,23,3,5,3,13,7,9,9,2,54,4,9,3,4,4,17,3,6,1,47,12,2,19,10,3,19,21,17,5,3,9,7,4,0,5,16,5,4,14,17,14,1,1,11,4,20,5,14,11,1,7,13,9,28,5,7,29,14,2,35,5,51,13,58,7,11,55,4,20,9,8,8,5,9,10,15,4,1,6,5,24,16,2,2,9,27,34,13,21,4,12,3,31,19,2,5,1,10,26,16,5,11,22,4,2,21,6,13,31,2,28,5,21,13,19,8,10,16,3,51,5,13,4,14,33,11,8,22,2,17,3,11,11,22,13,28,3,32,5,12,9,4,10,10,23,16,5,15,10,4,17,1,12,1,8,3,14,4,11,5,10,16,6,4,6,0,6,4,9,7,1,3,3,8,0,6,5,6,3,9,11,2,12,4,6,19,12,16,8,15,8,14,5,20,6,5,5,7,18,16,26,10,33,2,2,22,7,17,6,21,11,2,4,2,20,5,12,19,13,21,6,1,5,12,3,7,11,4,1,41,12,4,8,10,6,5,7,6,24,8,2,2,9,12,10,4,11,4,6,5,5,3,9,15,10,9,13,7,13,7,33,4,22,6,8,31,25,15,13,12,7,9,8,6,9,12,8,40,19,3,3,12,12,4,6,7,13,2,8,25,5,6,31,4,3,14,4,7,6,5,1,12,3,6,6,8,12,21,23,7,5,6,5,6,4,17,5,5,14,7,5,7,19,2,2,7,6,4,8,8,17,13,11,25,21,3,4,20,13,9,0,8,3,3,12,1,12,11,10,26,6,3,4,14,2,8,6,2,1,3,0,2,9,3,2,3,1,5,12,1,5,30,19,2,2,19,9,7,6,8,3,12,16,5,6,5,3,6,70,4,11,1,2,8,15,20,15,12,13,3,16,2,5,1,4,1,7,6,6,17,4,29,23,10,8,3,1,5,5,1,19,5,8,3,4,5,1,2,0,2,20,3,2,5,3,20,1,7,6,14,1,2,2,2,4,11,10,5,1,5,1,8,13,10,7,12,5,6,5,5,7,2,17,3,7,6,4,1,14,3,2,5,9,5,3,2,4,20,16,8,0,0,7,3,1,10,7,0,2,12,2,1,4,4,9,3,2,5,8,10,10,1,0,14,9,13,1,4,4,9,16,4,14,3,7,1,4,7,7,2,3,4,3,7,1,2,5,2,9,9,11,5,3,6,16,6,4,2,1,2,5,4,3,12,3,4,1,7,6,2,5,4,9,4,5,4,6,3,6,2,0,10,5,0,1,7,7,2,1,7,4,8,4,8,3,5,18,5,4,4,3,3,11,4,7,4,6,1,25,13,17,6,5,2,2,7,2,2,1,3,9,4,0,5,10,30,0,8,5,4,4,2,8,8,9,0,3,8,2,0,3,0,2,4,2,2,6,1,1,8,14,2,2,5,2,1,1,6,10,6,2,7,6,7,4,0,5,5,12,1,3,4,7,4,3,5,8,1,2,3,6,6,1,4,7,6,11,2,2,8,2,0,2,2,3,3,5,3,5,1,8,2,1,2,5,6,2,13,2,4,13,5,0,3,3,7,3,5,2,8,3,5,6,2,7,0,1,5,7,2,2,11,7,2,2,4,5,4,1,4,6,3,0,6,1,7,9,2,4,3,7,3,2,1,3,6,3,4,6
grow,8,32,18,151,12,41,9,40,6,12,43,29,24,178,12,18,15,26,9,12,8,42,44,50,48,38,25,32,15,34,13,248,202,22,76,127,73,9,19,18,18,33,7,20,45,16,31,31,336,99,73,17,41,128,68,11,54,39,32,39,37,12,2,19,40,20,183,23,13,18,63,5,13,8,204,29,32,14,116,43,111,13,19,19,264,39,21,10,53,2,10,18,23,31,86,47,33,9,73,25,13,36,35,18,43,43,13,16,38,14,35,5,111,49,54,50,5,11,60,179,68,68,61,174,31,16,14,13,9,9,50,10,27,67,46,112,14,10,10,18,13,75,47,10,11,128,32,1,29,26,77,18,13,14,27,57,64,14,8,79,27,13,23,1,30,37,17,33,52,20,25,121,49,9,13,8,187,9,18,104,34,14,28,40,9,48,54,32,69,73,5,8,16,17,19,15,20,11,17,25,64,7,13,22,36,20,10,33,13,36,89,30,34,18,15,35,16,22,39,6,4,26,10,30,51,115,58,40,12,26,33,28,27,34,46,46,60,18,21,15,87,61,26,14,28,18,15,60,60,20,9,33,27,19,12,22,15,12,7,52,9,42,27,3,9,57,13,52,35,7,119,15,28,11,6,10,30,37,8,7,111,23,10,22,33,17,28,26,26,8,0,15,13,20,11,9,49,8,13,35,29,37,5,8,26,15,55,5,14,15,2,39,54,18,58,10,26,60,24,16,58,14,59,25,97,8,28,55,8,30,9,19,13,10,10,13,34,13,8,23,7,25,40,12,20,14,53,65,25,29,15,14,7,65,45,7,5,6,16,49,32,15,30,30,7,10,30,17,20,46,10,37,9,42,25,34,8,8,37,9,73,6,35,30,23,63,11,41,27,7,36,11,22,18,30,23,64,4,47,13,27,13,11,12,8,25,16,5,32,19,12,22,27,28,21,19,6,23,9,18,15,11,34,14,6,8,11,18,10,17,1,5,5,14,10,7,8,20,19,10,9,23,6,29,10,8,39,18,59,20,38,8,19,8,93,11,8,10,20,31,24,40,54,50,11,3,41,22,25,11,45,10,8,15,1,50,10,17,32,20,15,22,10,11,17,5,14,9,11,6,82,39,3,8,27,7,5,15,19,21,24,15,9,3,9,13,20,11,10,18,7,6,3,9,13,13,11,17,5,16,7,24,3,33,7,6,30,28,20,34,14,16,10,20,21,9,7,25,94,16,9,9,5,31,34,11,12,25,13,8,21,1,8,43,9,22,37,4,12,12,23,5,22,9,23,16,20,17,28,54,21,9,22,9,4,5,16,14,13,36,10,13,20,30,11,19,12,13,3,18,35,47,10,14,51,30,20,14,62,26,20,7,13,7,10,32,5,27,12,12,46,26,16,11,37,13,14,5,12,8,15,2,6,10,4,9,4,13,17,23,20,40,27,34,18,7,34,16,10,10,24,17,24,27,17,32,10,2,7,212,27,8,13,6,15,15,34,28,12,15,3,11,7,26,5,3,9,20,19,17,22,4,32,55,39,10,9,7,9,13,12,36,14,15,11,16,20,10,2,15,8,37,13,18,8,13,21,6,16,10,22,8,8,8,10,14,21,9,10,3,12,7,9,25,24,11,10,10,12,11,7,12,11,21,6,12,8,11,7,24,7,14,10,7,2,12,18,19,41,43,27,4,10,11,15,8,21,15,13,8,19,5,1,7,7,17,11,20,8,24,25,25,3,11,26,32,36,9,27,19,11,22,9,24,7,18,10,5,19,12,6,9,26,9,17,7,10,29,9,24,13,24,12,17,18,16,5,7,11,5,10,3,9,4,13,11,15,9,23,5,18,10,11,10,3,5,8,14,8,11,5,6,7,9,4,5,12,8,3,6,18,5,17,6,8,15,5,40,3,9,2,7,7,7,13,5,9,17,7,9,26,21,10,0,14,9,8,8,11,8,10,6,10,13,7,8,24,6,8,18,8,7,11,10,8,7,8,10,14,16,4,5,2,2,12,6,15,11,6,8,18,32,7,3,6,3,4,7,14,10,9,2,10,17,6,2,7,5,12,20,5,5,13,11,13,2,4,9,14,4,2,14,7,7,9,4,10,18,6,3,15,8,5,6,8,9,13,6,9,13,5,24,18,7,13,15,10,11,20,4,3,6,8,4,7,2,7,9,12,7,5,7,9,7,8,10,15,0,2,10,12,4,31,16,5,11,7,3,6,2,15,10,3,11,2,14,6,31,15,9,7,5,10,6,9,15,17,2,11,12
large,3,14,3,158,10,7,2,41,2,9,9,7,9,94,5,11,9,20,8,8,5,44,12,34,38,11,20,18,8,14,7,241,235,14,84,63,45,17,29,2,15,14,15,11,26,16,36,17,299,19,63,8,17,70,6,11,61,56,6,25,17,11,3,18,27,6,159,25,6,43,27,13,5,9,129,22,39,8,124,26,126,3,18,14,221,46,29,2,59,5,37,12,7,36,109,53,21,25,42,36,23,65,37,10,19,38,18,15,43,9,26,8,17,28,7,50,4,8,67,283,59,23,59,131,19,3,5,12,9,3,17,5,4,71,39,72,16,6,16,28,7,50,47,9,8,91,10,29,1,35,50,7,21,22,11,42,59,14,10,16,25,12,19,7,13,16,9,28,36,7,48,134,42,4,13,18,229,8,17,72,41,9,16,35,8,36,73,35,34,57,4,11,27,3,5,7,24,6,11,14,76,16,9,9,49,13,9,60,18,44,79,7,29,14,4,4,11,11,19,9,11,20,7,25,64,133,47,60,11,17,25,29,38,29,42,58,54,25,24,15,93,62,11,7,20,14,11,41,59,11,20,46,17,31,27,20,12,2,12,40,19,47,17,3,12,68,8,10,19,10,134,27,115,9,3,2,27,41,17,7,64,7,9,27,13,9,7,22,15,8,1,3,12,9,4,16,52,3,4,29,28,29,6,3,22,6,30,9,11,5,8,34,47,12,55,34,49,63,35,12,47,11,46,3,75,3,18,34,8,39,1,25,14,11,6,26,26,10,4,25,18,10,30,11,20,11,48,66,22,12,21,21,4,78,34,11,6,6,19,62,35,11,11,35,4,2,43,12,7,29,5,15,9,21,15,51,13,14,15,19,73,3,60,21,6,99,14,29,43,3,22,8,12,15,37,10,59,6,33,4,18,8,6,2,9,16,17,6,44,15,6,13,35,41,18,14,7,12,7,5,11,14,19,10,1,9,4,22,14,18,20,14,3,14,3,8,1,7,14,5,28,31,9,38,4,11,20,4,68,18,24,4,11,2,95,4,1,10,19,38,21,62,48,66,23,12,42,23,24,3,18,16,6,8,3,32,3,18,44,33,14,20,13,7,16,11,31,6,15,11,126,55,4,2,28,10,14,22,20,18,38,39,14,6,26,58,23,24,11,17,12,3,9,9,8,29,2,16,21,20,9,19,6,24,10,3,41,21,28,37,27,4,10,17,10,12,8,14,56,47,10,2,6,26,27,12,3,24,21,15,20,4,4,62,20,13,51,9,13,6,22,10,25,6,20,28,15,11,55,62,14,7,21,1,3,7,20,12,15,38,12,15,36,17,10,14,9,11,12,16,18,35,13,5,36,8,9,13,24,27,26,3,9,3,8,22,3,16,12,33,50,32,6,12,59,16,29,10,10,8,15,17,11,19,16,3,11,14,13,45,26,23,40,32,17,3,12,27,6,17,15,4,19,24,7,40,8,12,12,169,32,9,8,3,7,11,44,17,8,23,10,4,3,12,4,5,2,10,21,11,32,14,38,29,18,9,10,9,3,16,8,50,19,7,6,8,12,6,15,27,13,19,13,27,18,22,4,2,24,10,9,7,6,11,21,11,36,15,7,0,2,15,4,37,21,47,12,7,9,20,16,8,4,34,9,17,23,3,2,17,14,19,15,10,5,8,33,14,57,32,26,12,14,19,16,6,26,12,12,9,11,16,13,23,27,18,6,8,5,46,49,28,6,13,27,37,19,17,23,16,11,11,4,18,16,15,19,9,27,17,7,6,24,17,18,13,16,16,19,26,7,20,10,4,38,27,13,14,8,10,8,7,13,7,11,4,10,3,19,10,40,2,9,13,9,6,8,10,12,15,6,18,5,8,9,5,7,11,8,17,13,6,12,10,6,12,4,23,18,4,2,9,7,15,14,10,10,10,10,15,14,30,9,21,4,5,11,19,8,4,4,8,10,10,6,13,10,1,8,17,11,8,19,18,9,10,5,12,12,1,3,14,9,6,17,3,10,12,13,4,6,18,2,9,6,6,8,5,8,2,17,5,8,9,9,7,4,15,10,26,7,15,12,31,11,10,21,7,7,5,10,10,8,19,5,7,7,3,5,8,7,4,5,7,4,9,10,9,8,5,9,14,20,8,22,33,30,42,72,1,12,10,7,10,2,12,32,11,15,5,19,9,9,4,6,6,23,14,3,19,27,3,8,17,7,6,10,15,15,8,7,15,7,10,5,20,9,10,12,0,6,3,5,1,3,11,3,9,3,1
expense,3,25,16,198,8,4,10,25,1,9,15,6,13,70,3,2,5,14,3,8,4,42,10,25,22,11,7,20,11,21,9,296,138,7,51,39,31,24,17,7,14,6,4,5,40,11,28,18,244,10,43,3,13,31,5,9,62,60,3,15,18,3,6,15,25,5,92,13,4,31,52,25,7,2,111,20,15,5,101,28,119,5,17,6,320,45,39,3,76,3,13,7,2,32,74,32,20,14,46,14,16,39,47,9,15,38,29,17,20,7,36,12,22,27,4,37,5,10,65,237,49,11,55,211,6,2,4,2,13,2,22,8,9,58,16,68,5,6,5,9,1,46,41,17,1,58,10,26,35,1,52,0,19,7,7,43,33,14,4,5,47,11,14,1,19,8,7,22,34,8,19,101,34,6,4,5,220,7,2,31,25,6,4,21,11,19,55,27,18,62,4,6,6,0,12,5,27,4,12,19,38,10,7,9,37,11,27,60,6,36,68,8,24,17,1,10,23,13,33,4,20,22,8,17,77,137,46,54,18,44,23,28,62,23,42,101,33,21,5,8,93,31,13,9,13,8,10,28,64,11,13,35,18,39,20,18,11,7,7,46,6,25,27,14,12,150,4,2,5,15,180,22,124,9,4,0,15,94,17,3,47,8,2,18,11,0,2,14,21,4,9,2,28,17,5,7,50,2,8,19,17,45,10,5,13,1,26,16,7,4,1,11,63,5,123,41,37,51,23,3,41,13,19,6,32,4,4,22,4,43,5,14,7,6,9,19,19,7,16,22,27,13,16,8,9,6,54,52,17,6,32,12,5,49,30,16,4,3,17,109,27,9,6,29,2,0,39,8,11,21,4,23,5,12,12,60,12,11,6,16,61,0,79,7,4,78,1,20,32,8,24,3,12,17,35,8,58,8,45,6,11,5,4,3,11,20,10,3,19,14,5,12,6,17,2,13,3,5,7,1,4,6,15,6,1,5,2,12,11,11,37,10,17,12,2,3,2,8,16,4,14,26,7,5,1,2,11,8,31,17,17,5,3,8,52,11,0,4,4,58,8,12,37,24,10,1,25,12,14,0,13,5,9,2,3,18,3,12,28,14,6,10,5,1,8,5,27,4,6,7,134,61,5,2,7,10,7,26,17,22,15,26,16,7,14,26,15,19,16,11,19,12,11,7,16,25,7,19,21,6,2,21,7,24,10,8,32,15,21,35,12,8,13,6,16,9,15,16,44,39,6,4,1,15,12,16,0,22,20,18,23,7,10,82,6,16,28,13,9,14,30,5,30,3,26,24,9,7,71,53,19,9,70,3,8,2,7,9,9,68,11,24,26,19,5,4,9,9,13,16,17,26,19,17,36,2,4,5,38,24,24,5,1,11,9,31,14,34,20,20,31,38,17,11,28,13,31,7,14,14,16,20,8,40,6,7,9,15,16,41,39,32,32,26,14,4,13,14,5,17,17,1,13,25,4,60,5,6,4,138,13,6,7,5,5,14,50,6,7,19,9,2,7,10,6,5,5,7,12,6,23,22,40,52,25,8,5,19,5,14,9,37,14,11,14,17,22,7,7,8,11,4,27,7,5,17,14,8,25,22,17,5,11,4,26,12,24,6,8,2,4,31,11,18,32,39,8,4,10,19,3,3,4,32,2,7,19,1,6,5,7,19,20,14,8,25,42,11,27,15,16,7,6,5,10,7,34,13,5,15,10,42,22,91,77,19,18,20,11,59,50,23,6,21,27,21,21,10,14,7,12,5,8,16,19,16,8,12,36,23,7,8,14,17,9,5,15,2,9,34,1,26,6,2,5,28,9,14,12,7,2,12,11,14,8,11,9,5,19,8,11,3,15,12,8,3,1,9,15,13,3,20,4,24,8,4,7,16,17,12,35,15,14,8,7,11,10,32,3,4,5,14,12,8,5,19,11,5,10,7,9,25,9,10,2,8,10,23,8,5,5,2,10,6,10,19,6,5,3,16,18,11,28,14,7,5,1,5,9,2,2,11,3,5,24,8,4,9,4,8,2,9,1,2,9,5,12,5,13,0,11,6,8,4,5,9,1,23,7,29,7,13,8,59,15,13,6,15,9,7,7,5,9,15,3,12,5,3,3,13,4,2,4,13,12,16,14,24,2,39,5,27,59,31,23,47,28,80,112,3,4,5,4,6,20,21,13,6,40,7,14,5,13,19,4,15,19,24,3,3,25,4,23,5,10,3,4,7,5,5,29,10,13,12,11,12,12,2,3,3,7,3,14,1,0,19,2,8,4,0
power,24,235,67,845,48,37,23,227,18,24,96,49,56,412,44,75,38,118,25,22,20,219,94,138,135,67,95,69,46,92,75,930,607,60,278,392,276,80,52,59,38,90,12,18,223,105,139,104,1871,158,305,45,85,245,24,38,301,76,17,89,130,38,21,67,101,23,622,50,62,72,53,36,28,17,538,72,97,28,345,106,234,8,83,45,1358,128,62,2,140,13,26,40,11,158,251,99,86,22,172,71,107,164,182,75,70,153,14,17,47,8,106,44,35,142,15,170,23,14,372,1035,219,82,61,254,33,40,33,32,12,4,76,10,23,249,168,250,78,14,50,50,30,174,108,17,22,347,45,77,50,52,1,14,77,59,22,220,147,43,86,64,45,9,35,21,12,39,23,101,84,72,67,537,110,5,22,70,962,25,75,171,132,113,31,115,62,133,177,112,207,224,22,31,18,6,6,23,83,35,32,114,144,11,7,84,169,60,55,170,51,152,520,44,150,64,18,19,1,9,96,30,32,111,31,58,211,597,114,151,12,56,84,69,73,243,174,68,169,47,48,23,368,161,33,51,109,21,36,113,249,74,67,109,100,22,69,105,61,8,30,79,42,168,102,33,37,116,24,69,102,28,785,27,69,45,17,15,148,54,90,17,322,55,10,135,49,11,17,28,103,12,23,29,103,20,16,58,168,30,57,127,128,121,2,8,82,5,108,17,40,15,7,141,108,48,97,69,72,189,70,40,210,68,166,24,488,64,32,138,25,178,53,96,64,54,72,196,112,40,17,64,60,37,85,78,35,44,274,303,89,32,96,92,74,226,131,33,34,51,87,121,145,46,42,106,41,25,216,63,59,82,18,136,23,57,58,75,43,32,102,36,453,22,248,77,16,120,47,119,165,24,151,32,81,77,165,75,332,34,208,12,177,28,34,29,33,70,37,22,110,93,22,46,13,91,67,60,32,36,21,21,40,48,113,108,17,55,20,87,74,103,62,26,7,48,33,37,15,74,64,34,77,148,42,119,14,16,69,36,184,53,104,30,30,37,286,76,15,85,47,179,69,143,195,145,32,26,70,40,109,5,92,41,26,24,27,115,63,99,110,34,49,79,34,29,38,65,46,34,47,25,420,165,24,34,38,42,27,70,45,82,65,28,16,25,44,177,25,87,51,38,12,53,34,80,71,129,33,71,61,70,23,131,131,428,171,46,164,117,90,179,68,46,40,69,41,41,91,65,198,145,39,23,38,46,31,38,65,94,84,48,536,53,37,328,38,65,251,30,45,53,130,18,108,43,107,80,101,48,225,196,86,61,67,15,42,49,36,43,49,86,29,96,54,92,60,49,19,52,30,52,162,206,70,27,131,27,39,43,223,113,117,17,23,22,34,98,58,226,40,54,146,169,74,36,262,54,151,24,81,22,72,39,22,133,29,39,32,49,78,194,79,81,172,145,53,27,90,45,20,76,86,15,83,141,47,88,29,21,43,924,140,45,49,46,41,51,243,134,61,70,25,53,79,106,35,28,23,42,60,66,115,44,233,321,135,61,10,29,27,31,40,167,79,33,46,50,87,47,18,38,80,62,88,57,29,46,48,40,90,105,88,30,26,42,37,37,85,40,36,17,43,28,32,152,107,77,42,44,45,33,49,39,44,98,19,10,41,12,22,73,68,62,22,35,59,24,96,15,201,56,56,39,13,63,69,40,69,92,35,49,83,16,16,27,8,67,66,60,29,38,32,64,16,19,128,98,40,49,47,52,57,12,15,68,38,78,48,12,47,57,9,30,76,36,73,26,34,87,48,57,53,105,31,29,127,102,46,28,16,46,27,16,67,17,36,10,48,26,86,33,35,24,45,43,20,32,32,59,38,101,22,13,53,42,13,48,30,57,54,31,64,34,99,29,71,114,45,148,114,26,32,60,53,74,16,53,45,57,19,83,104,274,72,70,15,22,39,29,35,13,23,57,46,33,47,43,21,26,47,40,17,20,37,69,17,30,19,66,73,32,18,21,18,32,30,23,31,19,38,27,26,60,0,29,32,43,16,37,23,34,32,27,28,52,67,20,16,69,19,92,30,29,43,25,71,20,14,85,28,17,63,45,43,40,26,55,37,74,25,45,29,30,39,39,36,15,28,27,32,66,18,49,9,10,14,75,54,23,110,28,7,26,15,20,36,11,30,25,122,41,17,17,45,14,7,63,22,4,38,61,79,67,37,29,22,43,9,49,41,25,17,46,27,52,24,22,74,24,98,10,20,17,17,4,8,13,12,32,25,36
start,9,6,3,42,1,19,5,3,2,4,1,8,22,22,1,1,6,5,9,2,1,12,38,29,10,22,8,10,4,12,0,84,32,11,21,43,13,1,3,3,5,17,2,6,9,2,17,7,41,36,18,7,9,35,46,2,11,2,20,6,0,3,1,6,10,9,51,7,2,7,31,2,2,2,49,10,29,1,48,9,31,9,7,7,33,13,3,12,14,2,4,2,28,4,16,16,13,2,14,13,4,16,3,13,13,7,5,16,17,10,9,3,16,20,45,13,1,2,9,53,13,35,22,92,14,1,3,2,4,4,13,13,9,24,13,48,1,6,3,11,2,18,14,3,2,34,8,18,7,0,14,1,8,10,8,19,24,2,2,31,11,3,23,5,16,35,11,10,10,7,16,42,20,2,3,0,29,4,6,36,12,7,35,10,1,17,13,6,6,26,1,6,5,3,5,2,13,2,4,3,36,5,9,2,2,6,2,10,3,10,28,25,19,9,8,25,17,12,6,11,7,10,0,10,12,25,14,7,4,19,10,11,20,8,15,1,7,11,3,2,8,15,11,8,5,0,3,20,18,10,5,10,11,0,2,11,0,2,0,4,4,7,1,1,4,5,13,9,4,1,20,7,4,3,0,5,8,2,0,0,41,3,1,3,9,6,7,9,5,6,2,8,11,15,7,1,11,4,8,8,12,5,0,3,2,9,19,20,5,1,3,4,14,8,19,1,7,11,2,1,4,1,13,30,21,2,3,32,4,10,1,9,1,3,3,5,4,2,1,1,0,9,13,4,2,4,9,9,4,21,1,3,0,8,3,1,8,6,3,16,12,8,10,6,2,2,4,2,6,19,2,3,2,14,2,7,1,3,5,3,15,3,6,2,9,8,1,6,9,0,7,8,6,2,3,4,5,0,10,2,3,6,1,5,1,0,5,1,3,3,3,3,2,8,10,3,2,0,2,2,1,2,7,0,5,0,4,1,4,2,0,1,0,1,6,3,2,0,3,2,2,1,1,1,0,0,16,3,12,8,11,2,14,4,10,1,1,1,0,4,9,11,6,11,6,8,20,6,7,5,10,20,0,5,3,6,3,3,8,4,3,4,2,2,7,4,3,2,2,0,24,4,3,3,3,0,2,1,3,0,1,1,1,6,11,5,3,3,4,2,1,0,3,2,2,2,8,0,0,6,2,2,0,1,0,0,4,0,1,5,5,5,2,1,6,0,1,6,15,4,2,2,2,2,13,6,2,3,1,0,1,0,1,9,1,5,4,2,2,5,2,0,0,3,2,3,3,2,3,7,4,0,4,0,3,1,3,1,2,7,1,3,3,2,5,2,1,0,2,7,4,5,4,3,12,5,6,5,9,3,4,1,3,1,0,2,1,1,1,0,5,0,1,2,5,0,3,3,3,0,0,0,1,8,3,2,2,1,1,2,3,4,5,7,3,2,5,4,2,3,6,6,2,3,0,3,3,2,5,27,20,1,2,0,1,4,6,5,2,2,1,3,1,1,1,0,0,2,0,2,1,0,2,2,3,0,2,0,5,0,2,8,0,1,8,1,2,2,2,4,1,12,0,5,1,3,0,0,1,0,10,0,0,0,0,6,7,7,2,1,1,1,1,1,7,1,1,1,0,1,2,0,0,3,4,0,0,2,0,5,1,5,1,3,1,0,3,1,1,2,2,3,5,4,3,0,8,12,2,0,0,0,0,3,1,2,1,1,2,7,6,13,2,13,9,12,2,3,3,2,1,1,5,1,0,4,9,2,2,1,1,1,2,3,3,4,1,1,1,1,4,0,0,1,4,3,0,1,0,0,2,1,2,2,3,3,5,1,1,2,7,0,1,2,0,1,2,8,0,3,0,0,4,0,0,1,14,6,0,0,3,2,3,1,5,0,1,3,1,2,0,3,0,2,0,3,0,3,0,4,4,2,2,0,2,1,3,3,0,2,0,0,1,1,0,0,2,0,1,3,1,0,4,6,1,1,0,0,1,5,0,1,0,0,1,0,4,0,2,2,9,2,20,0,0,1,0,3,5,3,3,0,0,0,2,0,0,3,0,1,4,6,1,0,3,2,1,0,6,0,1,1,3,1,0,0,4,1,0,0,2,6,0,0,0,1,0,1,1,1,0,3,1,0,3,3,14,0,2,0,3,6,5,5,1,2,0,2,4,0,1,1,1,1,5,0,0,1,1,3,2,1,8,4,0,0,7,0,5,0,4,0,0,1,0,0,1,10,2,5,0,3,1,5,13,6,10,2,4,3
return,14,39,16,206,18,11,8,40,7,3,20,18,21,87,4,12,13,36,8,11,9,51,25,44,21,24,25,20,8,44,22,253,205,15,55,100,79,16,26,8,21,12,8,4,55,16,19,10,420,41,70,10,33,60,16,4,107,38,16,18,18,8,5,23,33,12,133,8,13,8,27,2,12,6,120,10,29,11,121,49,86,4,21,14,308,54,7,3,70,6,33,13,9,74,68,16,32,10,68,49,17,42,63,16,19,38,18,8,25,8,31,10,21,30,9,41,7,5,99,187,42,35,18,128,20,5,7,8,9,7,13,9,14,58,30,68,7,7,16,7,4,62,53,2,3,116,14,13,21,19,77,8,1,8,7,38,66,8,14,34,9,7,21,8,12,25,8,24,41,21,27,130,48,3,19,12,222,7,23,55,26,23,10,32,8,27,57,18,34,80,12,13,26,5,9,6,19,12,12,23,43,0,6,16,31,10,10,32,27,30,102,21,47,12,11,13,3,3,15,5,10,27,7,17,82,158,51,48,10,24,17,26,26,16,46,25,42,12,23,10,88,53,13,4,35,9,4,34,59,10,9,49,34,9,16,24,10,1,11,40,7,42,21,12,16,45,4,17,24,12,191,23,71,12,4,1,19,15,12,3,78,7,3,24,14,6,11,16,32,4,12,10,49,10,10,15,70,4,15,35,49,29,6,10,13,13,26,8,5,4,6,20,32,8,79,19,33,43,28,3,72,8,40,7,81,5,14,55,9,54,11,25,9,7,6,20,23,25,5,15,13,31,33,6,9,3,61,77,39,19,14,22,17,63,26,8,11,9,27,52,41,19,12,29,6,6,59,13,14,24,9,34,6,17,9,39,11,8,26,8,110,5,68,14,12,49,17,33,36,4,25,7,37,17,46,14,73,3,34,7,24,7,4,2,3,8,12,7,39,10,4,10,20,9,13,16,11,15,8,8,8,14,23,19,3,5,4,15,13,25,38,8,4,15,7,7,4,16,9,12,23,25,7,23,7,10,25,13,46,22,45,10,8,28,63,8,7,19,10,37,20,23,31,68,10,6,53,15,8,4,21,10,9,4,3,18,8,32,35,15,8,10,2,8,7,11,11,7,9,3,120,56,2,8,27,2,9,25,7,15,10,8,9,3,8,69,6,26,16,9,12,7,13,9,26,34,9,16,3,15,8,51,4,22,11,9,28,6,35,29,18,2,7,10,10,12,12,14,72,19,8,3,2,14,15,20,9,21,26,5,63,12,8,55,1,9,34,7,15,14,30,10,39,10,25,25,18,15,42,47,14,23,19,4,3,11,14,4,13,26,16,31,23,22,13,13,7,6,10,17,35,39,37,2,56,11,5,14,56,30,31,6,7,7,14,38,8,29,11,7,38,16,15,7,38,6,21,3,13,9,16,43,4,64,6,9,11,11,12,27,73,23,23,26,15,8,16,7,10,15,19,5,9,33,8,57,9,7,12,250,26,16,8,10,9,25,62,31,16,18,7,12,17,21,11,10,2,8,16,16,23,12,73,30,61,14,4,15,7,5,4,40,24,12,20,18,21,7,8,18,23,19,22,7,14,19,13,9,19,21,17,7,10,5,9,15,26,6,9,12,10,6,13,25,20,29,17,10,15,8,20,12,12,48,2,7,16,6,1,19,8,21,13,8,16,5,22,11,21,13,17,12,6,21,16,10,26,13,7,10,14,18,8,11,11,15,8,8,6,44,50,25,11,3,28,59,14,8,9,7,7,2,5,48,6,29,29,2,14,15,2,8,12,5,18,7,7,11,21,30,17,15,6,9,15,16,7,7,9,5,13,12,15,17,11,2,20,10,29,8,12,3,24,17,4,8,14,18,11,25,9,9,2,13,8,6,7,15,29,10,13,11,11,4,13,6,14,45,16,7,12,7,12,13,6,28,8,4,12,14,30,23,7,5,3,8,10,17,10,5,12,4,7,3,10,9,4,14,7,17,3,8,34,51,13,13,3,17,14,21,16,13,5,9,19,5,17,8,9,9,4,12,5,9,7,8,7,8,7,13,7,14,5,10,30,10,6,33,4,24,5,12,10,17,20,9,4,11,9,6,15,8,9,17,7,5,6,28,5,22,7,3,10,3,4,11,5,13,3,7,3,18,12,7,16,40,47,13,73,13,5,5,4,5,3,12,2,5,25,11,8,0,6,8,8,43,13,1,5,3,8,8,10,10,13,8,10,9,8,6,3,5,8,27,7,9,16,10,10,3,6,7,12,3,1,5,10,23,3,5
resource,0,10,1,81,7,10,2,30,1,3,7,6,13,81,12,8,3,21,6,1,4,31,15,12,16,8,6,14,4,17,11,127,134,14,32,68,44,7,11,14,1,8,1,6,17,19,25,29,189,25,28,13,17,54,21,8,22,21,7,21,10,10,7,15,16,9,97,3,3,14,22,7,5,6,120,22,20,9,50,20,54,7,14,6,154,17,21,2,18,3,2,6,6,23,49,9,13,2,43,35,21,27,18,5,18,21,3,5,13,4,16,7,21,13,5,29,2,6,37,105,33,14,18,67,4,7,5,1,0,1,25,4,5,42,18,66,5,7,3,9,5,33,23,7,4,46,8,14,22,7,59,10,8,1,7,39,28,29,5,25,9,16,9,3,14,12,4,17,26,6,22,58,19,14,5,2,81,6,14,75,19,9,25,17,5,13,27,17,13,29,6,8,5,3,3,7,17,10,14,8,19,4,11,10,25,7,10,23,7,39,64,18,10,16,2,5,5,11,8,22,10,14,5,11,32,49,18,21,5,26,14,22,20,17,54,25,32,21,10,6,61,26,5,5,14,2,13,20,43,5,6,17,13,9,9,16,10,4,5,9,1,22,17,1,7,31,24,8,10,11,117,11,21,12,4,3,20,21,2,1,52,3,1,12,6,9,7,13,12,4,1,3,4,5,2,6,10,5,1,14,15,37,6,4,8,6,16,2,12,4,6,22,42,16,15,8,18,28,13,8,19,4,17,11,20,2,17,23,1,18,0,8,6,6,3,11,13,2,11,11,11,1,14,1,10,8,24,29,12,7,9,9,3,101,10,11,0,5,13,27,16,22,57,19,18,3,12,7,3,12,4,23,10,25,4,22,6,5,9,4,47,3,44,9,9,53,1,13,20,4,15,8,4,5,17,9,24,2,14,1,11,3,3,1,5,16,9,2,24,19,4,6,8,15,7,5,3,5,3,4,0,7,17,7,1,5,1,8,7,9,14,5,1,5,9,0,4,8,34,6,4,18,6,14,5,5,21,9,22,11,22,1,7,11,40,4,1,1,11,21,7,11,22,24,8,3,15,19,52,2,17,6,2,10,4,9,2,5,13,11,13,11,10,1,10,2,17,3,3,2,60,31,1,3,10,3,12,17,6,4,18,7,5,1,6,26,13,10,1,7,2,0,7,11,16,10,4,11,0,7,7,9,3,8,1,3,9,4,7,16,8,5,1,5,9,8,4,10,30,26,4,6,2,6,10,11,1,15,7,13,9,2,1,26,7,6,39,1,5,4,11,2,8,4,17,12,11,2,27,25,13,5,15,0,8,1,6,5,4,18,11,11,14,9,3,8,4,6,0,8,21,20,6,5,17,7,8,4,12,11,14,4,6,2,3,14,4,13,4,7,16,8,3,3,7,6,23,1,4,5,10,1,9,18,13,7,3,10,9,27,4,18,15,9,6,3,10,9,3,9,2,3,2,10,5,16,8,4,4,81,16,8,7,3,3,13,23,9,2,6,1,3,2,4,1,6,1,4,8,10,16,2,20,0,7,3,4,2,1,5,9,24,10,16,8,11,8,7,5,12,3,11,6,13,3,15,4,1,7,3,1,3,5,4,6,11,10,23,2,0,1,4,4,28,19,4,4,4,2,7,10,1,2,4,3,7,9,8,1,6,2,13,1,7,1,2,18,4,14,30,6,4,9,8,12,4,17,57,8,3,5,3,12,4,2,18,6,10,6,6,5,16,6,8,13,9,11,4,15,8,12,5,6,11,3,8,15,9,4,7,5,1,2,1,3,15,5,12,3,7,5,3,10,3,6,21,13,5,6,1,6,2,6,3,5,17,10,7,7,4,5,4,11,8,3,0,7,1,2,8,5,1,9,7,8,3,6,2,1,1,7,4,5,7,8,14,2,10,11,1,2,2,0,5,1,9,9,8,4,17,5,21,1,5,10,4,2,7,0,6,4,1,1,10,5,2,3,2,10,8,6,3,1,8,4,6,0,3,6,1,0,2,3,3,2,1,5,3,3,3,3,28,3,2,2,0,3,1,1,4,4,1,7,5,0,1,1,9,1,12,7,15,1,11,4,3,1,12,4,1,5,5,2,0,3,3,2,2,1,7,1,4,4,1,6,3,14,2,4,15,2,6,8,7,9,12,20,12,41,2,4,0,4,7,3,8,3,7,16,4,3,10,1,4,3,9,5,0,0,11,4,6,5,6,0,3,3,11,4,3,2,6,2,3,5,3,8,11,16,3,6,4,10,4,4,4,0,4,9,2
growth,1,10,4,50,3,8,4,14,3,9,12,8,22,67,7,4,8,5,4,0,2,24,27,13,8,14,10,14,4,11,1,82,102,3,22,63,20,4,21,5,2,10,1,11,14,6,10,14,84,36,27,11,27,34,9,4,18,12,5,20,5,6,2,3,20,6,77,9,3,8,14,1,4,3,153,8,24,0,35,14,74,15,5,7,129,14,8,31,7,1,6,5,23,14,16,21,10,5,38,11,6,24,13,1,24,9,13,33,18,10,11,8,43,18,28,23,1,2,19,69,24,24,43,69,8,6,2,8,2,4,30,14,7,39,15,56,3,3,4,13,2,29,10,7,9,51,5,27,11,7,22,8,7,7,1,63,18,7,9,35,22,5,7,4,24,18,3,13,25,5,25,59,17,7,8,3,55,3,2,40,24,11,23,20,5,30,22,9,15,19,1,5,7,5,4,3,20,9,3,13,31,6,15,5,17,9,8,27,7,8,35,5,16,5,3,11,15,36,4,4,4,16,6,11,18,30,19,16,4,10,9,12,28,26,35,7,29,15,12,10,29,19,12,8,10,4,3,20,20,3,3,24,6,1,2,5,5,3,1,20,2,15,7,0,12,61,19,10,8,2,37,7,6,1,2,1,13,14,1,5,36,4,3,7,17,3,21,25,5,3,1,5,7,12,3,6,4,5,2,8,15,14,2,1,5,2,29,2,22,5,4,26,29,10,17,1,16,24,12,13,11,6,20,21,25,2,26,18,4,16,2,4,8,3,6,2,10,8,2,3,7,4,10,8,4,4,12,17,11,6,2,4,10,27,13,8,2,8,12,19,17,12,21,15,4,3,5,8,11,13,1,10,4,15,8,8,5,2,13,3,31,1,20,15,3,30,12,14,6,4,10,8,4,3,14,9,11,1,10,8,8,3,6,3,4,25,2,2,25,15,10,6,11,15,1,1,2,13,5,0,10,12,12,7,4,5,3,5,3,6,3,4,0,1,9,1,1,3,8,3,2,12,1,7,1,2,14,5,25,8,10,2,11,2,39,5,1,0,8,13,11,17,27,25,10,1,9,17,10,5,26,11,2,3,4,35,1,3,16,7,4,6,3,2,3,0,5,3,5,0,19,16,1,1,7,3,7,5,9,15,12,6,10,4,7,6,29,10,5,12,5,4,3,7,6,2,2,4,2,10,4,2,5,12,2,0,16,2,5,14,14,1,0,12,3,1,4,8,22,21,5,8,1,71,7,4,3,13,8,3,7,0,1,14,3,4,25,5,1,1,5,2,1,1,4,3,11,2,6,18,7,5,3,1,1,2,4,2,1,10,20,3,12,6,4,20,6,5,2,11,15,7,1,2,22,10,20,2,4,1,11,3,4,0,1,5,6,8,1,2,16,2,1,4,3,2,3,6,2,1,4,1,2,4,2,2,3,4,13,20,4,6,14,8,5,6,30,5,6,2,23,3,7,4,5,8,6,2,3,42,2,5,4,0,2,6,11,7,1,3,2,2,0,2,6,0,0,5,6,3,11,6,4,0,4,13,1,0,0,5,4,17,0,9,4,3,0,4,1,0,4,17,0,3,1,11,2,0,7,4,2,4,2,5,5,8,7,5,0,3,3,1,0,8,15,3,1,4,5,7,1,2,2,2,1,0,6,3,4,7,2,3,5,5,1,0,1,11,20,22,5,3,4,4,2,3,7,18,3,4,4,3,3,2,3,4,16,1,2,6,5,5,0,1,10,8,23,3,39,4,7,4,5,3,4,3,11,1,5,3,1,0,4,1,3,5,5,0,3,8,3,4,2,4,2,7,4,2,2,4,5,1,3,2,7,4,2,2,5,5,3,3,2,0,0,0,4,4,1,3,1,0,3,3,1,1,4,2,0,8,5,5,4,1,4,8,4,11,4,2,0,0,0,1,7,2,4,4,0,3,4,6,4,1,3,2,14,4,1,2,2,3,1,3,0,0,2,1,1,8,1,3,1,1,5,2,0,2,3,12,0,1,1,2,1,0,2,1,2,2,5,3,3,0,0,0,3,1,1,2,1,2,1,6,1,0,0,0,0,3,5,4,1,5,7,0,1,2,6,3,1,2,3,5,0,1,0,0,2,0,1,2,0,1,1,2,6,1,1,15,1,3,6,1,1,4,8,5,11,3,1,3,1,1,5,3,1,2,2,3,3,0,4,3,3,5,3,0,0,4,4,0,17,5,0,2,1,0,3,1,4,2,0,2,3,1,2,12,0,0,8,2,5,4,0,14,3,0,3,2
federal,9,81,57,440,12,19,8,130,7,4,20,23,42,120,13,32,13,30,26,8,10,69,56,78,55,50,18,30,13,46,8,494,174,29,139,127,30,11,20,25,29,17,1,35,71,28,90,127,976,50,79,35,19,24,34,10,89,62,21,35,27,5,10,13,60,32,208,27,12,44,106,17,12,13,275,26,62,16,158,49,171,18,16,17,807,61,32,73,46,18,11,27,54,45,80,61,38,19,110,43,67,86,87,30,49,58,37,76,49,31,59,32,37,92,30,61,15,16,156,350,108,55,166,257,37,5,8,12,16,23,37,5,16,160,35,153,11,10,23,24,8,76,60,10,7,170,8,57,42,43,220,19,38,39,63,1,61,26,18,84,51,14,30,11,111,27,13,59,87,26,48,223,82,17,6,8,326,11,12,170,86,38,162,48,17,41,91,51,88,65,5,25,9,6,41,23,78,21,37,39,128,19,26,20,46,57,61,161,26,80,184,18,69,26,8,22,54,134,34,55,28,38,15,39,113,403,51,73,17,101,44,40,84,107,70,43,78,31,32,26,133,55,13,17,52,41,11,64,203,23,48,32,44,18,22,19,22,20,14,40,37,38,55,9,11,124,81,16,20,17,255,60,51,24,9,18,67,69,19,35,119,10,7,36,42,25,53,23,22,10,5,12,56,40,16,23,69,32,23,32,56,123,20,16,35,11,34,8,41,28,40,96,86,45,82,34,51,83,34,32,97,11,67,50,180,60,58,55,10,64,17,45,15,15,13,83,30,11,40,29,41,16,24,32,20,16,110,95,65,49,51,47,19,84,52,34,8,5,42,37,148,61,39,39,6,10,64,10,43,30,14,72,19,40,45,74,24,12,27,17,173,12,97,47,25,85,51,27,35,9,82,19,38,27,60,19,138,14,94,7,70,4,5,7,15,7,12,0,14,39,3,18,3,52,2,16,0,16,4,6,4,20,115,43,11,25,17,42,16,47,15,13,2,20,15,4,1,4,36,24,48,59,22,10,4,2,19,14,86,28,44,11,13,10,87,33,4,31,20,42,23,40,70,47,18,1,40,19,47,2,54,13,11,13,6,28,5,23,57,20,12,29,3,11,14,18,29,7,14,43,84,82,8,11,6,10,5,42,14,43,32,7,25,60,27,92,50,32,16,17,4,27,10,43,35,35,9,23,30,32,11,54,31,102,33,14,48,90,20,56,42,13,6,16,27,11,12,14,68,94,7,3,12,27,13,37,7,27,38,12,188,9,68,137,56,20,53,22,38,19,50,14,60,27,44,30,38,55,74,82,23,14,29,67,24,12,12,29,23,103,9,45,15,31,13,19,26,28,2,17,46,63,19,14,85,15,18,21,53,22,48,28,11,7,20,47,12,79,40,14,62,103,32,16,93,42,44,10,33,6,29,11,11,38,27,26,6,30,35,86,11,51,70,58,26,11,45,34,13,10,22,13,48,47,8,27,41,28,52,209,8,16,11,34,7,24,90,44,17,15,19,6,13,13,6,13,3,4,22,26,33,11,23,439,19,10,16,14,4,4,7,67,29,15,13,23,37,29,5,6,21,36,16,14,19,29,8,11,64,20,2,5,20,6,21,18,36,7,10,9,19,15,10,45,69,19,11,14,10,22,4,8,2,53,5,8,18,4,5,32,16,40,8,24,19,9,7,16,82,17,31,7,14,4,3,18,35,68,15,13,15,11,29,20,23,40,22,31,28,31,28,28,4,26,59,22,36,27,45,6,8,8,6,25,11,41,44,22,24,21,1,5,44,14,19,15,13,30,13,38,22,51,28,3,54,40,16,14,6,24,10,7,24,18,9,9,21,13,31,13,6,1,1,14,3,4,19,4,5,15,4,8,23,43,15,5,10,20,6,8,16,12,40,9,12,24,12,42,20,7,2,27,85,22,9,17,19,24,18,30,21,102,36,7,15,17,8,21,29,25,2,10,21,22,10,12,4,12,15,66,51,10,13,13,11,10,0,4,17,0,4,6,7,5,19,8,11,11,13,16,12,27,10,5,7,8,0,21,13,17,35,2,4,19,44,3,1,3,2,60,65,55,15,12,23,9,3,23,12,9,9,7,19,12,0,23,1,1,10,20,29,36,9,7,27,4,16,13,14,41,8,20,21,7,22,23,41,36,51,6,0,14,8,25,19,10,7,6,34,16,9,6,14,17,19,1,8,7,13,2,4,11,21,17,6,10,35,12,19,10,6,18,6,9,13,36,25,28,1,6,6,29,17,4,34,29,9,3,8,2
come,19,86,43,339,33,66,22,75,13,25,35,34,59,311,15,50,32,51,41,30,28,108,118,130,104,79,83,132,55,85,30,553,414,62,178,362,177,10,46,19,32,62,32,25,121,50,47,45,583,234,157,43,48,246,69,22,160,70,82,55,21,16,14,41,95,62,377,33,30,39,42,9,16,17,429,51,134,19,315,118,140,14,30,30,458,66,35,9,95,11,44,25,30,91,124,43,62,17,110,65,21,82,75,49,58,76,26,35,52,31,66,14,48,62,34,107,15,18,207,448,135,143,94,375,74,36,27,15,21,14,90,27,45,156,98,218,30,20,29,48,46,145,55,21,25,272,52,64,59,33,147,24,66,28,18,61,1,33,32,119,38,14,54,12,29,89,23,86,101,33,41,342,129,31,44,27,385,21,53,186,108,34,42,75,15,109,96,67,106,140,12,30,23,30,29,23,40,23,25,50,137,5,15,22,51,37,13,71,48,72,237,82,89,23,42,70,29,39,51,13,19,78,11,31,81,303,108,119,31,36,38,50,65,78,100,48,104,29,29,31,175,114,33,36,49,22,22,129,132,14,27,87,76,13,13,55,20,8,13,84,16,110,27,3,24,81,28,78,74,12,292,25,61,9,13,17,54,25,17,8,251,21,11,52,49,9,43,59,49,31,10,23,56,28,14,25,85,21,26,77,82,59,12,11,24,20,77,26,30,13,9,78,114,34,96,29,111,104,35,19,92,24,157,29,183,14,52,183,16,80,35,44,30,26,32,41,79,16,7,25,24,60,66,17,17,25,101,123,35,52,28,40,14,100,65,12,24,32,37,135,73,33,28,71,7,35,78,52,56,101,7,105,23,80,38,75,22,26,60,24,158,11,110,35,53,107,28,60,82,13,75,47,44,24,55,33,107,15,86,12,42,40,13,30,23,31,19,9,69,38,29,39,24,47,46,37,21,38,21,37,33,33,66,21,20,16,9,36,27,58,11,8,8,26,24,11,8,34,42,16,57,56,13,50,19,17,108,32,96,30,85,20,65,19,159,24,29,24,43,64,54,74,104,195,35,44,125,40,33,18,117,31,8,38,19,143,29,39,92,49,31,38,8,16,29,19,26,36,23,7,223,84,19,16,50,7,11,20,9,29,44,22,11,11,39,30,17,32,16,20,13,22,25,28,25,33,26,31,21,40,14,34,15,81,12,12,70,50,44,72,36,26,22,50,29,31,10,41,129,73,13,4,36,23,33,17,9,48,27,16,87,10,19,121,15,26,60,8,25,29,39,14,54,16,22,50,36,16,70,120,43,11,33,17,21,23,30,14,19,73,26,26,46,68,24,35,24,16,14,43,56,55,50,23,85,24,24,17,58,51,40,15,13,1,13,57,11,37,28,7,89,52,22,22,95,11,37,17,21,7,20,17,7,46,10,27,6,13,25,35,25,42,99,58,31,14,57,19,28,14,47,19,16,53,15,42,24,13,29,346,95,31,22,12,22,36,71,55,18,41,15,20,16,34,8,3,7,20,18,12,30,15,36,52,26,9,5,11,12,11,17,94,37,19,25,11,34,15,12,22,32,60,21,17,15,26,29,17,44,25,48,11,4,23,24,36,44,25,7,6,16,23,20,42,49,61,52,12,29,33,20,18,10,54,12,17,29,19,8,30,27,39,15,17,11,5,64,17,51,15,39,13,14,30,33,24,31,35,26,28,37,6,11,27,23,35,14,18,17,68,67,80,4,10,40,57,37,21,27,16,28,22,29,40,13,26,17,13,11,16,3,15,45,23,41,13,14,7,11,32,17,22,15,12,41,34,15,11,4,13,15,16,32,16,32,21,30,20,43,5,37,7,60,35,12,17,11,32,9,29,6,9,29,29,8,8,28,10,16,18,20,13,26,20,33,21,15,51,20,18,2,10,12,24,11,23,24,47,6,28,43,49,37,9,14,13,19,11,10,8,26,17,36,16,19,12,40,5,27,14,10,20,23,15,19,15,7,18,26,28,7,7,18,6,22,9,18,8,20,6,30,39,12,20,11,10,15,13,11,39,18,4,23,23,19,3,1,12,6,40,5,16,23,13,28,12,14,14,13,6,9,14,12,23,19,10,11,13,6,13,10,22,11,21,12,8,7,18,11,24,13,40,36,5,14,22,30,32,50,12,4,19,30,15,8,7,8,10,30,6,5,13,11,5,12,70,5,7,10,8,22,13,27,48,7,11,23,14,9,10,10,19,4,16,17,13,14,24,27,23,16,17,10,17,11,16,11,7,17,41
energy,1,8,4,81,8,14,7,13,4,2,9,7,13,117,7,7,8,13,11,6,7,24,34,15,12,20,10,22,9,17,6,147,102,10,36,105,34,3,26,8,7,11,1,10,15,7,27,35,112,79,32,29,10,43,11,7,14,14,22,21,5,9,7,13,34,10,58,12,6,20,33,0,9,3,96,13,17,2,55,21,79,8,10,9,92,8,39,4,20,1,2,6,27,11,19,4,20,6,33,30,12,16,15,5,23,25,3,15,17,15,17,8,33,34,27,19,2,7,50,77,28,26,40,122,19,2,3,5,0,12,27,2,3,45,14,61,2,7,5,19,0,41,22,1,5,61,11,14,14,14,43,2,8,29,7,26,33,1,30,54,15,15,9,8,34,11,7,22,17,7,32,46,31,6,8,4,65,5,5,64,14,4,41,33,4,33,29,12,3,24,7,2,1,10,7,3,43,4,17,18,41,7,16,6,9,2,5,24,2,41,47,12,21,5,13,26,14,11,11,5,4,8,1,10,27,42,8,16,8,12,10,13,44,21,21,17,16,24,55,8,41,21,8,5,20,5,5,24,56,18,11,53,16,4,2,13,5,9,0,12,2,20,12,1,7,22,20,15,10,12,56,17,25,9,1,12,21,5,5,1,35,4,8,11,7,14,9,11,13,0,1,8,12,10,2,10,11,8,0,10,20,16,1,2,8,7,23,8,6,8,16,17,45,9,10,8,10,24,10,9,28,2,31,6,21,0,11,30,1,16,1,7,5,2,10,8,17,7,1,7,7,18,18,7,5,5,16,22,9,11,5,9,4,37,6,8,9,2,10,42,36,16,46,10,15,8,10,7,9,22,1,22,1,12,10,29,7,9,10,17,35,3,28,7,2,22,1,22,19,5,13,8,5,2,12,10,17,6,21,1,9,3,2,5,6,13,2,3,22,30,3,5,5,7,3,12,0,2,3,10,3,4,19,7,5,2,5,10,12,4,6,5,5,2,8,12,2,5,19,5,8,14,5,12,2,5,26,7,12,12,30,2,16,7,30,2,0,9,1,21,24,23,17,19,7,0,33,8,8,7,15,7,1,3,3,9,11,5,11,15,3,14,1,5,20,2,6,7,5,1,63,23,4,11,8,1,6,11,3,5,8,5,1,0,9,18,3,8,3,8,3,3,7,8,7,8,3,4,9,4,4,4,2,10,3,2,14,24,8,17,8,5,11,6,6,8,2,6,15,12,5,18,1,4,14,2,1,9,5,4,9,2,0,24,6,8,13,1,11,1,11,1,4,5,5,10,8,4,14,22,5,0,5,0,2,2,6,1,4,22,7,28,8,10,5,4,3,3,2,4,8,8,9,5,11,3,4,1,13,6,16,13,3,6,1,5,2,8,3,2,21,10,2,4,2,2,3,5,2,0,5,2,2,20,10,1,3,5,4,30,3,7,14,8,6,5,10,7,5,7,2,3,3,12,3,19,4,3,12,63,0,8,2,1,2,9,16,15,2,4,2,9,1,6,6,0,0,5,8,2,10,3,39,4,3,2,2,0,1,1,3,12,1,6,1,6,5,6,7,2,4,10,7,9,5,9,6,2,9,2,9,2,2,4,10,9,9,11,0,4,2,3,5,20,9,27,3,2,4,26,10,0,5,19,1,8,6,4,2,9,5,16,2,9,0,4,18,6,20,9,6,3,6,3,4,4,8,51,10,1,6,4,0,8,6,6,2,9,2,11,2,13,0,2,10,2,9,5,4,3,8,4,0,4,2,6,5,2,7,6,3,4,4,5,12,5,4,8,3,2,2,3,1,3,7,10,3,1,2,1,1,2,1,2,2,9,9,0,16,1,15,2,3,6,0,1,4,4,2,3,3,2,5,8,0,2,7,6,2,3,0,5,11,9,5,2,10,14,4,3,2,1,0,3,2,4,2,11,1,7,6,12,7,6,2,2,3,4,0,7,3,2,3,9,4,5,4,3,4,2,2,1,1,2,10,1,0,4,8,4,0,0,5,2,7,1,1,2,6,1,6,0,0,1,2,0,6,1,5,5,2,7,8,6,2,1,4,4,0,10,17,11,2,2,4,7,1,0,2,2,4,0,2,1,3,3,6,5,1,3,0,16,2,3,3,1,12,5,4,8,1,8,7,1,3,9,11,9,12,3,0,11,8,5,3,2,5,1,15,1,8,2,0,0,4,3,5,2,3,5,14,5,10,6,2,3,1,1,5,4,2,3,1,3,3,4,2,16,0,2,3,9,5,8,3,6,6,5,6,5
independence,7,26,8,89,12,8,5,18,3,7,47,4,9,117,9,30,15,11,9,9,4,40,14,21,21,9,21,12,17,10,17,137,123,6,44,80,62,2,6,8,6,41,1,0,16,25,16,9,404,58,47,29,19,66,6,15,35,8,1,15,24,23,3,5,18,9,152,12,14,7,4,7,1,5,107,21,21,4,79,39,25,0,8,7,229,6,12,3,32,1,4,17,1,25,49,1,9,5,53,10,2,23,24,11,11,14,0,2,11,6,33,8,6,6,3,34,9,6,48,169,38,28,6,71,7,3,7,4,2,2,15,5,10,32,28,31,14,5,4,21,2,42,63,2,11,51,3,8,10,4,86,2,14,5,9,18,32,30,1,30,4,7,9,7,3,9,3,24,19,7,18,96,17,2,2,12,134,6,16,24,15,29,9,12,0,14,25,29,43,70,5,7,2,5,3,2,9,6,5,16,12,0,2,10,59,10,2,24,21,32,75,8,24,3,4,2,3,2,5,3,0,19,4,5,18,51,23,29,4,4,11,8,18,26,25,2,32,9,5,10,63,16,13,7,23,4,5,23,29,8,5,16,28,1,3,20,13,4,1,10,0,37,25,10,14,17,9,13,28,15,129,2,10,5,4,6,25,2,3,0,58,1,0,26,11,2,3,6,14,2,9,5,7,4,3,7,23,7,7,20,40,14,1,10,15,4,43,4,13,1,12,13,17,10,5,4,10,34,7,3,44,11,31,9,77,9,9,28,7,21,4,3,19,3,7,24,15,12,3,24,11,18,23,23,3,11,56,85,17,9,3,20,9,20,22,3,13,13,13,30,15,7,11,24,5,4,32,14,5,15,4,10,6,7,3,5,4,2,35,3,57,3,19,17,0,31,5,24,25,2,28,3,13,15,31,14,48,2,41,5,21,5,10,1,4,5,4,10,17,16,14,21,1,15,28,11,6,4,2,6,11,12,21,32,3,4,6,7,25,25,5,11,0,26,15,8,2,15,14,3,19,13,8,38,11,6,2,12,40,1,20,4,13,6,39,9,2,45,5,21,25,33,32,18,5,23,13,18,10,4,20,1,4,3,2,10,19,13,17,5,2,14,5,13,9,19,8,13,2,3,133,25,5,21,6,8,2,12,15,6,12,1,4,0,4,10,6,16,4,6,4,8,6,2,11,21,9,13,3,6,8,19,8,21,7,2,16,1,15,45,12,8,1,7,11,8,7,11,50,7,6,4,4,12,2,3,46,14,10,7,54,5,3,29,2,9,43,2,4,12,30,1,13,3,8,5,13,8,30,33,8,4,2,0,4,4,2,3,5,11,5,4,10,16,12,11,10,12,3,8,23,49,3,0,10,7,5,2,59,22,24,3,7,6,11,19,2,48,2,3,38,10,9,16,10,9,10,1,5,2,5,0,2,16,2,1,4,7,17,33,1,11,32,20,8,2,9,3,2,4,4,3,17,12,8,10,1,10,6,284,61,8,9,11,7,17,34,68,23,14,8,8,12,16,18,9,1,9,5,5,13,5,200,32,19,11,3,2,24,8,8,17,8,6,15,5,18,6,0,12,15,11,15,13,4,3,5,8,10,17,1,5,2,6,6,7,23,4,1,3,9,15,8,16,12,24,11,17,15,3,2,7,20,9,2,10,6,2,1,12,3,11,1,7,6,0,7,8,51,9,6,7,4,13,17,2,8,7,10,4,15,0,0,13,1,3,9,10,2,2,4,15,14,0,25,5,10,3,9,9,5,4,2,19,6,15,2,0,5,16,5,4,12,0,7,13,8,159,3,8,10,4,0,2,8,12,5,2,1,5,11,7,11,1,6,6,10,4,10,13,3,6,5,10,4,5,6,12,2,14,9,4,2,3,1,1,3,5,2,5,12,6,13,15,13,9,7,23,16,2,7,6,6,9,6,3,3,10,5,11,29,30,18,2,2,2,3,0,9,1,1,4,6,5,4,13,4,3,11,1,1,0,1,0,3,10,2,26,14,4,2,8,2,12,2,3,12,6,10,5,4,1,0,5,15,28,6,2,0,13,3,4,8,9,5,14,0,3,2,20,2,0,6,3,9,12,1,10,2,4,8,12,5,7,3,3,8,17,4,1,4,5,5,7,6,0,3,4,7,5,4,19,1,3,2,6,7,0,1,2,1,7,7,1,1,4,3,4,5,4,1,2,1,1,1,15,0,2,2,4,9,9,8,7,3,10,2,4,6,13,0,5,4,2,8,4,13,1,55,6,4,8,2,4,0,3,0,7,2,0
help,8,44,18,243,14,71,7,33,13,16,13,10,54,196,9,11,36,41,36,28,10,50,167,99,30,132,78,120,36,81,13,416,228,66,94,374,103,8,40,23,30,70,19,49,79,10,95,53,243,333,91,79,40,226,179,9,14,11,117,59,12,35,12,27,61,38,275,23,13,23,154,1,21,9,373,20,113,12,114,87,112,11,9,49,221,42,24,15,33,3,19,25,38,63,33,31,53,2,114,38,20,61,18,47,26,64,3,56,49,23,71,19,94,102,163,75,4,10,75,100,40,242,153,307,34,22,9,17,9,22,80,23,57,163,85,364,15,24,26,26,24,123,33,9,12,198,30,79,16,5,64,31,34,25,35,84,119,54,30,1,52,13,63,19,57,172,38,71,84,25,74,243,86,27,52,9,70,22,11,277,38,28,161,87,13,64,47,32,23,77,11,9,9,16,28,23,79,27,32,15,93,23,24,16,40,66,6,54,31,43,185,72,62,55,46,134,20,56,30,7,17,51,1,30,38,73,50,58,29,40,26,19,77,45,80,10,35,57,37,24,97,74,31,36,48,18,19,128,143,36,22,38,83,1,4,41,3,17,1,35,8,90,8,1,16,29,81,85,67,15,99,38,8,14,5,47,86,6,4,2,171,15,26,15,25,36,137,121,31,18,1,22,34,35,16,7,55,12,16,38,33,37,4,8,11,17,49,7,58,17,31,32,106,76,82,9,69,45,26,14,41,9,77,121,112,0,50,166,18,40,29,31,7,3,11,31,75,8,4,10,12,55,116,9,8,26,32,70,61,126,10,25,3,103,13,17,28,6,10,93,51,58,63,22,12,31,24,25,99,143,17,190,16,139,19,44,11,15,40,9,50,18,40,14,72,43,34,39,37,32,21,29,24,7,8,23,9,2,28,9,21,38,5,42,13,14,31,7,58,49,23,13,34,26,11,41,27,28,32,61,9,16,34,6,24,2,13,5,6,11,2,1,0,22,44,9,16,28,42,13,19,23,11,48,26,30,138,29,50,18,103,5,74,20,48,6,32,6,21,11,42,49,46,71,19,25,127,41,17,31,101,44,3,13,12,52,8,5,41,28,9,27,5,15,21,8,7,36,6,1,87,13,12,34,39,6,10,9,14,4,28,10,3,55,45,37,23,2,11,14,1,3,0,11,13,3,26,14,1,16,8,9,0,8,5,4,46,6,23,20,27,15,23,8,13,18,4,21,64,11,8,20,22,46,38,5,3,28,3,6,8,1,2,51,19,7,20,14,16,4,2,6,10,19,4,12,10,8,19,35,9,0,2,6,6,0,2,5,7,62,7,18,23,49,7,10,4,4,0,23,25,21,36,15,39,13,14,13,11,21,19,3,9,4,1,10,7,10,12,2,27,12,8,3,30,2,1,5,2,0,6,5,2,28,17,3,5,2,13,37,13,8,29,21,15,12,26,19,28,1,22,32,7,7,13,22,20,14,20,110,33,13,4,8,13,32,12,31,17,7,4,19,2,2,2,4,1,5,9,5,5,2,7,12,10,3,3,1,4,6,13,27,6,9,10,3,13,19,5,13,9,80,8,6,4,13,11,0,19,6,18,0,0,7,11,18,14,22,2,1,12,3,8,26,9,22,44,2,5,14,1,4,3,16,33,10,1,22,3,17,6,22,13,4,1,1,3,2,17,13,7,5,13,3,3,4,17,53,14,2,25,0,2,3,6,15,1,6,7,16,6,74,3,12,47,31,31,7,27,2,32,20,11,13,7,12,33,12,12,8,4,4,15,7,21,9,11,4,5,7,13,9,5,4,10,20,4,13,4,0,7,14,3,11,33,18,15,14,18,4,18,17,0,9,0,0,9,26,0,12,2,0,8,2,3,4,32,14,10,4,19,5,8,31,14,5,6,29,4,12,0,3,3,13,4,3,6,28,1,21,15,10,5,2,15,10,1,6,0,19,3,6,1,27,1,2,8,1,15,10,0,2,3,4,5,4,0,2,16,10,1,5,3,1,1,0,10,2,17,0,34,7,61,1,0,2,3,16,17,67,6,0,24,4,6,3,6,3,3,22,11,21,2,1,1,5,3,0,16,1,1,8,2,1,0,0,9,5,6,1,10,27,1,2,0,1,16,2,3,11,4,30,2,0,7,11,23,7,7,1,16,30,11,13,8,2,0,5,6,2,11,8,1,3,7,0,6,9,8,5,11,6,31,48,2,1,40,1,12,1,2,4,0,3,10,7,7,82,3,63,9,32,2,24,40,31,41,0,13,49
cost,3,24,11,178,6,11,5,16,9,7,7,10,25,49,2,2,12,16,26,5,3,30,25,37,42,32,11,20,8,54,9,291,143,14,63,70,29,52,114,7,25,19,3,27,26,17,46,45,162,34,70,10,21,49,28,5,73,63,13,12,10,3,2,23,47,20,118,36,34,36,59,11,0,6,168,22,44,7,129,39,219,50,17,14,229,47,28,11,60,12,19,8,36,24,54,73,28,19,38,24,64,44,37,18,17,31,44,44,41,23,17,10,47,27,30,40,10,12,72,209,41,54,76,216,15,2,5,7,6,14,18,3,17,76,49,123,2,9,9,16,5,69,31,8,3,98,15,27,25,47,45,11,9,9,22,51,38,15,4,52,1,10,22,10,59,38,13,24,36,15,20,132,49,8,15,16,161,7,15,76,36,13,59,34,6,34,75,33,32,57,5,3,26,17,20,5,72,19,26,13,71,22,21,17,37,25,5,86,12,33,91,15,37,22,8,39,35,34,26,18,11,20,8,19,72,126,80,72,24,86,23,49,98,48,55,62,34,20,66,4,89,46,18,18,11,10,11,53,81,9,23,54,16,9,14,23,7,12,6,59,20,19,16,2,13,100,16,17,30,17,120,13,101,11,6,12,25,61,7,12,85,21,25,21,24,8,170,134,15,12,7,3,24,24,9,11,41,9,9,19,28,62,14,15,14,9,23,10,8,8,4,24,52,9,168,35,45,86,32,16,31,7,52,15,35,4,18,52,2,33,8,27,3,9,4,15,10,7,4,22,13,22,19,6,6,8,38,51,22,43,20,11,1,54,16,41,6,6,19,73,35,27,8,16,5,4,40,8,52,31,2,20,8,24,17,56,10,18,7,4,54,11,56,6,7,57,7,14,24,10,7,9,23,7,36,6,49,10,27,9,21,2,8,2,5,6,14,0,26,15,0,10,11,16,3,7,3,13,5,1,2,4,27,11,1,4,5,7,7,15,7,16,7,16,2,4,0,2,19,9,20,25,14,11,2,3,32,7,35,13,29,4,10,3,59,6,1,5,14,34,18,23,17,30,7,1,47,12,18,8,34,16,7,6,3,13,2,7,22,18,6,13,6,3,4,9,26,5,5,5,115,39,2,9,33,9,15,21,18,11,16,17,19,41,21,6,13,8,23,6,11,9,8,15,20,18,9,19,23,13,3,20,10,13,5,7,32,14,19,35,10,8,4,12,35,4,4,12,46,25,9,1,6,35,29,19,4,27,13,10,7,2,10,44,5,19,32,12,9,6,21,8,25,10,13,16,18,17,36,49,12,6,32,0,7,5,74,17,4,51,26,18,21,22,8,8,19,5,8,22,28,20,22,28,47,5,14,28,9,11,30,6,4,0,7,37,7,15,22,21,45,32,13,10,17,6,22,20,11,9,19,13,16,26,8,6,7,10,12,36,7,26,25,17,7,9,12,19,4,7,12,3,10,31,11,38,15,12,15,85,9,6,7,2,2,21,54,8,4,17,6,2,3,11,4,1,1,2,11,6,20,7,9,36,18,7,4,10,12,4,44,86,10,14,11,3,5,12,5,11,12,14,14,15,8,35,5,2,21,11,4,3,9,3,10,7,32,4,14,8,3,26,10,40,16,28,8,6,6,22,7,3,1,21,7,5,10,4,4,18,4,31,25,11,6,25,19,6,19,19,19,2,11,23,11,12,28,15,7,16,8,17,24,45,43,16,10,19,9,69,85,20,21,35,22,36,22,8,25,13,10,4,61,12,14,38,23,11,10,4,3,0,9,4,20,17,11,2,14,38,4,14,0,5,15,22,49,11,4,2,19,6,23,3,7,2,6,8,18,5,12,1,8,8,10,2,6,9,6,7,2,17,4,33,12,1,9,7,2,11,35,8,3,3,7,6,3,27,5,12,3,4,9,5,21,23,13,5,14,6,10,25,3,9,7,10,3,19,5,5,1,5,2,8,10,12,1,3,3,32,18,9,22,0,12,7,1,6,9,0,4,15,8,2,12,5,9,7,0,13,5,20,29,6,4,2,1,4,13,16,8,2,4,3,10,0,8,5,13,33,12,12,11,24,10,5,4,10,4,2,5,4,11,34,6,5,0,3,4,9,3,12,14,7,5,18,12,8,0,31,3,39,44,4,19,28,25,59,47,4,4,5,6,4,5,38,9,6,20,1,6,3,4,25,12,25,2,18,2,6,4,4,46,14,3,0,12,4,10,4,81,8,8,31,4,12,5,17,5,5,7,5,7,2,8,29,5,6,0,2
waste,1,6,4,36,3,13,3,12,2,2,4,6,12,52,14,3,6,7,7,3,2,15,5,11,11,9,3,8,6,5,1,67,60,11,19,25,8,4,16,3,6,3,0,4,3,4,11,7,71,12,21,3,14,9,8,3,10,13,5,11,6,4,4,11,8,2,58,3,0,6,12,0,2,0,60,18,19,2,38,10,19,1,10,7,78,28,13,1,9,1,1,3,2,4,18,10,20,2,22,11,5,12,13,3,13,7,4,15,10,4,9,1,9,16,11,12,1,2,14,57,26,7,14,35,5,2,0,1,1,2,32,1,5,16,3,45,1,0,1,2,0,12,9,9,4,40,4,13,12,11,9,3,7,16,5,14,14,15,7,13,10,1,9,2,14,19,2,6,15,5,3,39,16,17,2,6,35,2,8,27,8,6,18,12,1,9,22,19,8,28,3,11,3,2,12,7,14,1,5,5,13,0,1,3,6,3,9,24,4,18,28,7,20,2,1,15,8,10,2,2,4,14,1,2,10,21,15,11,8,12,9,18,13,11,30,8,26,4,5,2,27,18,2,0,6,1,2,11,19,4,2,8,10,1,2,8,3,1,0,2,0,7,7,2,2,18,8,2,6,2,46,5,5,4,2,2,9,6,2,5,48,9,3,4,9,2,3,26,4,1,1,1,10,0,1,3,10,0,3,5,11,7,0,2,3,1,12,0,10,3,2,23,14,4,15,4,5,10,3,4,10,6,11,1,19,1,11,11,2,10,1,5,6,4,3,4,6,2,1,4,9,4,7,1,12,6,12,26,5,11,3,2,3,71,9,2,0,1,12,11,8,8,12,30,2,1,8,5,7,18,1,5,2,4,6,3,1,2,2,2,18,0,17,2,8,61,1,8,13,0,6,4,7,1,7,4,16,2,10,0,3,0,2,0,3,3,3,0,5,6,1,2,0,6,4,2,1,0,7,0,3,2,13,6,6,2,0,1,5,3,1,0,0,3,2,0,0,0,6,2,4,1,5,5,1,2,7,1,16,0,6,1,9,2,23,2,2,2,4,10,4,4,12,16,3,0,7,11,13,1,4,9,2,11,1,14,4,5,11,16,14,4,0,5,2,0,3,1,7,1,28,14,1,3,2,7,3,0,7,0,11,6,0,0,0,1,19,1,3,11,2,4,10,2,11,5,1,3,1,1,2,3,0,2,1,1,24,4,1,15,4,1,3,5,2,4,2,6,16,24,4,1,0,9,4,7,0,10,2,1,7,1,1,11,5,7,12,2,3,0,14,1,2,4,3,4,3,5,12,18,7,0,5,0,6,0,1,7,5,8,3,4,11,3,4,1,4,10,0,9,8,14,2,4,5,10,2,3,2,8,11,5,3,0,0,11,3,7,5,0,19,9,4,3,4,1,6,2,1,3,7,0,1,2,4,4,2,3,0,8,0,8,10,11,0,1,8,1,1,3,0,4,1,7,6,10,1,1,3,43,3,9,13,4,3,5,17,7,3,2,1,1,1,1,0,0,0,8,1,2,9,1,15,2,4,3,1,1,0,11,0,14,7,3,2,3,1,1,0,1,3,4,5,1,0,7,1,1,3,3,0,2,0,8,4,5,10,5,2,1,2,1,1,9,7,0,0,3,0,8,0,0,4,5,0,7,9,2,1,3,3,9,6,1,3,0,15,4,7,3,15,2,6,9,8,0,4,9,2,2,4,0,1,1,0,7,2,1,3,4,8,8,1,2,4,3,2,5,14,6,6,10,1,11,1,2,2,1,4,3,2,1,4,2,6,4,8,7,2,6,2,1,1,1,1,19,1,3,2,0,0,3,0,4,1,1,1,1,2,2,1,0,1,1,0,2,0,0,0,1,0,1,11,8,0,0,2,3,1,1,1,3,4,0,4,0,3,4,3,1,1,1,0,0,6,1,14,2,1,2,6,7,2,0,1,0,1,0,0,3,3,0,0,3,2,4,11,4,5,3,2,2,0,2,0,0,0,4,4,0,0,0,0,0,1,0,1,1,2,1,1,7,0,2,0,0,1,4,2,0,4,1,1,0,0,0,0,0,0,9,1,0,0,2,1,0,1,5,4,1,0,3,3,2,2,0,0,0,0,1,4,5,1,1,0,4,1,2,0,5,1,6,1,2,4,9,4,5,4,1,0,4,2,2,4,0,0,1,3,1,8,5,3,3,0,6,10,0,0,4,1,1,4,1,1,2,3,2,1,1,0,0,0,0,5,3,2,0,2,3,1,2,6,4,0,6,3,0,0,0
save,3,30,13,93,16,28,6,39,1,11,13,3,12,79,3,15,7,23,16,5,2,27,32,50,27,20,16,26,8,27,6,176,110,15,52,70,27,5,13,2,15,30,3,19,33,15,51,11,134,62,60,6,10,52,38,9,32,16,17,12,4,8,3,17,27,13,111,8,7,11,45,2,8,4,116,12,35,11,69,28,49,3,10,4,161,54,9,5,26,6,5,4,9,17,62,16,21,7,28,18,7,39,29,10,13,18,10,26,20,7,16,8,35,24,27,26,2,7,43,179,42,59,43,148,19,6,4,6,6,8,21,6,21,50,30,84,9,6,3,22,10,36,27,3,9,79,15,23,19,14,35,23,21,9,7,30,54,9,9,63,22,9,1,6,27,25,17,26,43,8,19,113,50,4,10,9,105,9,16,73,34,24,15,24,3,33,43,29,22,38,3,8,9,7,11,8,32,4,7,19,31,21,1,10,25,13,9,38,19,23,97,14,33,10,7,34,7,14,14,5,5,32,2,12,40,70,36,33,15,47,14,15,32,22,38,8,24,15,17,8,33,28,37,9,20,15,6,51,49,20,10,21,24,8,6,16,8,8,2,37,9,23,8,3,9,24,12,10,18,1,106,14,27,15,5,5,30,13,3,2,94,4,1,7,17,4,21,20,23,8,2,1,23,20,8,7,23,6,2,18,23,22,4,8,11,40,20,13,8,5,2,26,21,10,52,18,31,36,10,2,31,7,43,13,42,6,14,47,4,38,6,17,4,6,11,10,15,6,4,7,12,23,21,10,4,5,20,29,20,30,9,16,7,47,20,6,15,4,10,33,24,16,13,26,5,6,26,14,17,38,1,22,7,22,14,33,9,9,12,5,43,9,47,10,7,33,8,12,29,6,15,3,12,4,22,10,15,5,24,2,10,5,0,3,19,7,14,2,15,11,4,13,7,17,7,10,3,3,4,2,6,10,27,3,11,5,4,18,4,19,7,4,2,6,10,5,2,2,14,9,14,11,9,13,3,3,20,11,21,4,47,4,12,4,44,12,7,4,19,23,15,28,35,33,5,7,27,9,23,11,90,10,5,5,3,43,8,5,24,17,13,9,1,6,7,2,9,8,3,2,72,28,5,7,11,4,3,7,6,10,17,16,4,9,11,24,10,11,9,6,3,8,3,7,9,8,13,14,4,9,12,38,6,28,3,9,17,10,7,30,8,8,13,16,5,4,6,16,47,18,4,1,6,10,12,9,1,21,7,5,22,2,3,37,3,14,19,5,5,10,13,2,10,7,15,21,16,10,29,28,7,3,10,2,7,5,14,7,14,11,16,13,12,10,7,6,8,5,1,11,11,27,19,6,24,9,8,14,7,19,22,6,2,1,3,14,2,15,7,2,24,23,1,11,20,5,8,2,8,2,10,10,5,10,2,8,5,3,8,24,13,6,27,20,9,5,12,11,7,10,9,6,16,14,3,16,7,3,8,63,17,8,5,3,11,13,31,16,12,19,8,7,2,0,1,2,2,5,3,4,12,3,10,20,6,6,3,1,1,2,1,16,15,2,11,9,10,6,5,5,10,19,7,1,4,2,6,2,13,4,4,2,0,8,7,16,11,2,6,0,5,7,4,33,18,20,16,3,5,14,6,7,4,19,8,3,6,6,2,6,4,18,6,6,3,3,32,11,6,6,13,4,10,17,11,7,13,5,2,6,20,2,1,7,7,8,2,5,5,18,13,22,2,6,22,35,10,5,14,3,10,5,5,25,6,18,17,4,6,8,2,2,15,7,8,6,7,2,4,8,8,10,2,3,13,16,3,2,5,2,4,2,14,5,12,6,5,11,14,4,6,1,9,4,3,0,4,14,2,8,2,3,9,17,3,3,7,8,13,5,18,4,9,7,10,2,8,21,15,3,2,10,4,1,12,15,9,7,2,9,8,12,10,9,7,3,6,6,2,2,6,5,7,1,9,3,15,0,4,5,6,2,15,21,5,2,2,1,9,2,0,2,5,1,7,1,8,2,4,1,13,10,15,5,3,1,4,5,8,17,8,2,2,4,5,2,0,9,1,13,3,15,4,14,2,2,5,10,8,4,3,3,4,3,2,3,4,4,0,4,5,7,2,1,2,1,2,4,7,9,3,18,8,7,16,14,23,15,19,7,1,9,7,7,3,3,3,3,9,5,1,5,4,7,0,27,2,4,8,5,8,5,3,6,3,3,4,3,7,3,2,1,1,7,4,7,9,12,0,4,4,14,2,4,5,2,11,4,2,5
2,3,22,5,68,2,10,2,10,0,1,5,4,4,16,2,1,0,6,4,3,3,16,7,18,1,10,2,13,2,20,7,80,29,5,11,30,7,6,11,4,1,3,2,9,8,3,22,3,100,21,9,5,3,21,14,0,15,15,8,10,6,0,6,3,11,2,25,8,5,10,83,3,3,3,47,2,17,0,22,12,51,5,2,4,56,10,9,0,39,19,19,2,43,18,50,28,4,2,26,5,7,14,13,0,10,17,19,17,28,11,14,2,9,12,13,12,15,8,61,41,9,22,44,125,17,0,1,3,6,14,9,1,3,27,7,30,0,2,2,12,3,10,18,3,2,26,2,1,7,1,21,5,8,3,4,11,12,8,7,19,10,2,6,1,47,6,4,11,10,5,25,42,12,2,2,6,38,2,1,26,10,5,11,8,0,7,10,6,13,22,3,1,4,4,5,3,24,5,11,3,19,5,6,10,7,1,5,13,9,6,30,7,11,3,0,9,11,12,8,6,5,13,1,3,22,33,14,22,5,20,6,16,26,0,14,21,9,5,13,0,18,16,2,1,7,4,1,8,27,1,5,5,9,9,2,4,3,29,0,14,1,21,6,16,3,27,7,4,5,2,38,6,27,2,0,4,14,15,6,0,14,0,2,2,3,3,4,7,3,0,15,7,8,21,40,3,15,6,4,1,9,20,7,49,3,4,6,0,6,2,3,4,28,6,39,9,9,15,8,5,12,3,12,10,17,5,7,10,0,14,3,9,1,3,0,6,3,3,5,11,4,7,14,7,0,2,13,11,11,3,12,0,1,22,4,3,3,1,5,28,3,6,6,9,4,1,8,2,8,5,1,6,2,8,1,10,4,3,2,4,24,2,12,6,5,16,8,13,12,1,8,5,4,7,7,6,11,3,11,6,6,1,0,2,3,0,2,1,14,5,1,6,1,5,2,0,4,1,2,2,0,2,13,7,3,1,2,4,5,12,8,16,5,44,5,1,5,7,9,4,4,5,2,5,5,6,12,1,8,5,13,1,4,2,10,8,0,4,3,2,5,8,4,17,1,4,9,6,4,1,13,4,0,1,4,2,0,4,11,2,1,10,2,6,2,1,1,4,0,5,33,13,0,0,11,3,0,8,3,1,2,2,1,2,0,6,2,2,2,1,1,3,1,2,4,0,4,1,0,2,0,6,1,4,5,4,11,2,12,12,1,0,4,2,7,4,2,1,9,4,0,6,4,5,7,1,35,3,5,6,8,1,4,15,3,0,11,0,3,1,8,4,18,1,4,2,5,0,11,13,3,0,14,1,0,2,19,1,3,20,5,5,3,1,0,1,5,2,4,7,4,4,3,1,4,0,2,5,10,3,7,5,4,0,2,4,3,3,1,2,9,16,11,2,9,3,3,4,3,2,3,8,2,17,6,1,0,3,0,13,4,9,4,6,2,2,5,6,2,5,3,2,1,8,4,16,4,9,6,64,4,0,2,2,1,4,11,1,3,6,3,4,7,6,4,6,1,0,7,5,6,1,3,9,1,0,1,2,10,1,6,8,3,4,2,4,5,5,1,0,5,4,5,4,2,11,5,1,2,4,1,2,4,11,1,3,2,3,7,4,1,23,0,9,2,8,6,0,3,1,1,3,1,10,2,5,1,1,0,3,5,12,1,1,1,3,7,1,5,4,3,2,0,9,7,2,4,2,3,3,3,13,9,21,9,8,1,6,1,81,77,1,13,47,12,8,9,3,2,4,3,2,1,4,1,4,7,2,5,4,1,2,3,5,7,2,2,1,2,7,1,1,1,0,3,2,1,0,2,8,0,5,6,1,1,2,4,2,4,2,7,1,4,3,4,2,2,7,1,2,2,7,11,7,1,2,5,9,2,5,6,4,1,0,3,1,3,8,1,1,3,0,0,1,5,10,3,12,1,5,4,11,1,2,1,4,4,1,0,1,3,3,1,4,1,1,1,1,4,7,1,20,16,11,0,1,0,5,2,2,2,12,8,1,1,2,0,1,0,0,3,2,1,1,1,29,1,1,1,5,3,0,1,2,0,16,4,9,1,5,0,5,2,12,2,18,12,1,1,3,1,2,2,2,4,0,1,0,5,3,5,6,4,2,3,3,2,2,2,3,2,3,5,6,9,13,12,15,34,2,5,5,1,5,3,4,4,1,11,0,1,0,0,2,19,21,1,0,3,1,4,0,4,3,1,1,3,0,0,0,2,0,3,1,3,3,1,3,2,2,0,3,0,1,2,8,8,0,2,1
billion,3,12,7,125,6,28,5,1,2,0,4,0,20,64,4,2,9,3,15,7,0,19,29,24,5,38,4,22,1,25,1,145,48,4,31,73,7,2,19,9,5,1,1,45,13,5,61,46,85,49,24,16,6,28,19,0,0,6,21,17,4,4,6,1,23,10,55,15,5,16,121,2,5,1,84,6,35,2,59,11,139,17,5,8,179,25,22,48,18,49,52,12,106,32,39,38,24,2,51,15,12,22,4,5,21,22,45,90,51,41,24,7,30,25,47,54,2,10,46,82,15,36,132,276,16,4,2,9,23,57,12,7,6,40,10,60,4,22,2,25,6,30,43,3,2,63,7,30,13,19,12,16,12,14,24,111,29,34,3,57,59,14,27,47,1,26,9,30,21,9,24,60,17,6,1,8,13,7,2,67,7,8,98,21,5,9,26,12,5,24,6,6,5,5,65,19,30,13,23,10,34,25,33,6,16,2,9,12,1,7,37,8,36,29,8,28,88,140,31,29,21,16,2,9,28,37,18,38,25,449,5,26,107,18,20,48,11,12,28,3,25,8,8,14,3,20,6,27,80,33,16,22,6,7,3,6,5,52,2,15,2,12,6,3,7,31,31,6,6,3,14,46,56,3,1,8,12,128,0,8,37,6,12,4,45,8,22,24,1,7,1,5,35,67,54,8,8,6,5,5,13,40,66,35,7,17,8,8,11,19,9,8,20,10,47,8,14,42,6,13,6,2,29,20,10,0,8,11,2,18,3,17,0,3,4,11,5,2,14,17,1,8,14,3,4,3,22,14,31,19,5,10,1,39,2,10,9,4,2,52,18,26,9,9,2,4,1,2,22,12,3,38,6,19,2,14,1,15,1,3,16,8,16,1,7,9,0,9,17,1,1,5,5,2,2,5,1,1,10,4,2,6,2,6,3,2,1,1,21,9,2,2,18,3,3,0,1,0,0,3,0,8,9,1,2,7,4,0,2,11,5,6,0,3,5,8,4,0,42,5,11,2,5,5,3,0,14,3,5,9,26,2,12,4,11,3,0,9,7,5,18,12,7,13,4,0,18,9,10,3,10,7,4,7,0,1,1,0,18,6,3,6,1,3,4,0,3,0,0,0,166,25,4,2,12,0,1,4,2,1,7,3,9,4,4,13,20,0,0,0,5,1,1,3,2,1,4,0,1,30,0,22,0,0,4,1,6,22,4,12,1,0,2,1,4,0,0,0,22,14,3,0,0,15,6,1,0,13,5,1,0,0,1,21,1,3,6,3,5,1,3,1,6,3,6,4,3,1,7,2,6,0,34,5,4,0,0,6,0,57,4,8,1,7,0,9,1,4,8,5,5,1,14,1,3,1,9,3,0,2,5,18,2,0,1,2,0,5,2,4,7,10,1,0,1,0,0,2,1,0,0,0,0,0,8,0,0,4,2,8,4,3,2,2,5,1,8,20,3,5,0,0,0,5,2,17,4,18,24,29,0,0,1,1,0,6,11,6,1,2,2,1,0,0,0,0,0,9,1,6,1,1,4,0,2,1,1,2,0,3,0,10,1,1,5,0,14,4,0,1,2,7,1,5,2,6,1,0,2,0,1,0,1,0,4,3,37,3,10,4,1,17,0,17,6,1,2,0,0,11,1,0,0,0,2,0,2,2,0,1,1,2,2,2,7,2,9,1,1,9,3,0,12,5,3,4,21,22,3,0,1,33,75,50,60,11,1,0,0,18,9,9,7,74,8,14,11,3,7,9,4,0,8,1,8,11,18,3,0,3,0,1,7,4,23,5,3,1,4,8,7,1,0,1,6,6,4,4,1,0,4,4,4,2,3,2,6,4,4,8,12,0,0,8,2,0,0,9,0,4,0,3,0,2,0,0,6,15,0,10,12,1,0,0,1,0,0,5,0,3,0,0,0,3,8,48,1,7,0,4,3,13,1,0,1,4,0,12,0,10,3,0,1,7,0,0,1,1,1,12,3,0,11,0,0,0,0,0,2,6,2,0,0,9,0,0,0,0,1,0,6,3,3,0,0,4,0,4,17,14,0,0,17,1,3,1,3,1,1,1,12,18,0,5,0,2,0,1,4,21,0,1,1,0,0,2,0,0,5,0,2,11,1,0,3,10,3,5,0,9,2,4,69,8,59,36,35,137,38,0,3,6,2,6,2,0,2,0,15,0,2,1,0,2,59,1,1,0,4,2,3,1,23,10,2,0,13,0,1,0,1,0,0,0,5,8,1,15,0,4,0,6,0,27,6,19,8,0,5,3
get,4,38,21,122,7,48,2,23,9,16,10,15,33,68,5,6,28,21,34,6,2,32,141,79,39,56,50,74,21,56,6,256,157,48,75,151,19,9,15,9,10,17,5,27,53,16,28,20,124,149,66,27,14,93,87,4,18,7,64,17,4,7,3,13,53,22,187,16,14,22,60,2,9,16,164,29,121,4,105,57,41,3,14,30,180,42,13,8,28,3,11,10,29,29,27,10,30,3,52,23,12,46,7,30,25,37,5,41,31,15,39,5,35,33,106,53,1,6,57,103,49,110,85,199,23,6,10,6,6,6,65,17,21,52,51,254,10,4,12,12,15,47,18,6,4,117,25,37,16,8,39,35,25,12,18,27,89,11,9,172,38,19,25,6,26,1,8,26,25,10,16,169,55,32,34,6,64,9,13,172,66,6,50,74,8,61,49,37,21,51,13,12,14,15,25,7,48,9,18,6,73,9,11,7,13,37,5,39,28,14,125,82,50,31,44,178,26,32,19,2,4,29,8,19,30,75,31,25,16,21,11,21,26,27,57,12,39,15,17,15,79,50,30,49,8,9,9,80,70,21,6,19,22,2,5,32,3,7,1,26,16,42,9,0,6,17,35,39,19,11,57,13,7,6,1,19,32,7,3,3,128,7,7,12,13,5,115,102,14,26,0,9,37,22,5,9,23,7,9,23,28,14,2,4,8,21,15,13,38,7,4,39,36,21,94,10,43,20,15,2,31,16,56,50,87,3,41,118,4,29,25,22,6,4,8,10,30,6,10,5,11,29,80,6,7,17,20,39,9,79,9,11,8,81,26,7,39,6,6,41,20,20,19,14,4,18,19,14,53,91,5,60,7,69,16,37,6,7,20,4,36,8,30,12,31,38,27,23,27,6,13,11,16,10,12,17,9,9,22,1,4,22,9,19,6,6,18,2,18,17,10,3,5,17,3,16,10,12,9,19,6,15,29,3,10,4,1,9,4,19,11,10,0,11,18,6,5,9,20,9,19,9,5,7,0,9,69,12,20,9,58,2,35,5,37,15,10,5,25,6,27,32,21,68,18,10,61,13,19,28,46,31,5,18,6,48,7,7,28,27,11,8,3,14,12,4,2,23,13,2,63,23,4,12,13,5,5,6,9,9,17,10,5,48,23,19,17,12,13,13,7,4,6,15,11,4,13,8,3,15,4,6,2,25,4,5,29,20,15,10,16,12,10,12,7,15,2,11,42,18,1,2,6,15,23,9,1,16,2,4,7,1,4,33,5,20,16,6,6,6,3,3,11,1,6,1,14,9,14,25,14,0,3,4,2,1,3,3,8,29,5,3,14,21,5,10,7,9,1,24,14,17,22,17,29,10,8,13,15,4,8,2,8,2,3,13,3,8,13,2,35,12,8,1,13,1,2,1,4,1,4,4,3,22,8,3,0,2,6,10,33,11,23,16,12,7,17,3,25,5,19,11,12,11,5,14,7,1,12,65,19,6,10,10,6,15,8,19,5,10,0,2,1,1,1,2,0,9,3,3,9,2,1,23,13,3,1,1,1,5,8,16,2,6,5,1,10,5,3,8,1,40,1,8,5,11,3,2,6,1,10,4,0,5,10,6,12,13,3,1,3,1,0,6,7,28,19,4,6,9,6,5,1,27,14,12,7,13,9,5,1,16,11,8,0,3,25,5,5,2,17,4,7,21,8,3,16,14,13,4,6,3,0,1,5,4,1,2,3,11,5,27,0,5,27,22,7,3,8,4,20,11,3,12,1,9,14,5,1,4,3,1,8,6,10,3,7,2,5,4,16,1,2,1,21,22,2,6,1,3,1,6,2,3,17,7,1,8,13,1,7,4,6,3,6,1,6,21,6,6,1,1,0,5,2,3,25,9,6,6,9,2,1,6,15,7,1,12,6,7,0,9,2,3,5,0,3,8,2,14,30,15,8,3,7,7,9,0,4,7,1,7,6,1,1,0,3,1,4,4,2,0,14,5,2,2,0,0,6,3,0,5,8,1,1,1,10,1,6,3,17,6,62,0,3,0,0,11,9,31,2,4,13,2,4,3,1,6,11,6,3,17,1,0,5,4,0,2,5,5,1,0,3,4,0,1,1,0,1,8,0,19,2,1,1,2,2,2,2,4,2,10,0,0,5,7,7,10,11,0,5,16,9,5,0,4,4,3,4,0,6,7,0,2,7,1,2,0,5,7,13,1,19,25,1,0,28,1,6,0,0,1,0,3,7,1,4,25,3,23,1,5,0,4,12,22,38,0,4,17
thousand,3,10,2,47,7,11,2,14,2,3,9,3,17,41,2,6,6,9,6,1,0,21,10,25,8,13,10,22,12,30,4,116,81,14,19,34,23,8,9,11,4,13,2,5,13,8,14,9,90,31,14,3,7,23,31,4,25,9,11,7,2,3,2,7,16,5,61,13,3,15,48,1,1,2,56,7,32,4,56,12,44,0,8,9,59,12,9,1,41,4,11,9,7,19,18,11,18,4,23,12,3,18,9,6,10,17,5,7,16,8,18,5,7,13,11,24,5,1,19,88,19,41,15,93,6,4,3,4,6,2,5,2,10,38,13,46,2,9,1,1,4,21,22,2,3,39,7,17,9,7,23,11,8,4,3,13,23,7,3,38,13,2,17,4,9,8,1,22,27,10,22,88,20,4,1,6,68,0,3,25,22,4,14,19,1,11,15,13,9,39,3,3,8,3,1,3,8,5,25,7,16,3,2,8,8,5,2,19,10,16,39,9,11,7,8,7,2,4,13,2,5,17,4,9,23,54,39,10,90,25,16,29,16,9,15,6,21,8,7,7,32,16,10,6,10,5,6,25,34,7,9,15,13,7,3,8,5,1,2,26,5,35,7,2,4,13,10,4,8,1,47,3,22,1,1,3,9,3,3,0,42,4,5,9,11,4,9,11,5,3,6,0,7,7,1,7,19,3,1,11,8,13,7,3,5,4,12,6,6,3,6,13,14,4,18,9,7,26,12,4,21,4,23,19,15,1,8,21,9,21,9,10,2,3,6,6,10,5,2,11,4,21,15,2,1,8,18,25,9,14,1,5,6,23,6,3,7,3,8,31,1,7,9,5,4,4,9,8,7,22,0,22,1,12,7,30,11,1,5,11,15,1,24,4,9,32,0,8,19,2,12,1,9,7,15,2,14,2,13,9,3,8,2,7,2,5,6,2,14,3,3,3,2,15,6,6,1,10,0,5,2,6,9,8,4,0,5,8,6,9,0,4,7,4,4,5,2,0,4,8,9,4,1,5,1,4,14,4,11,5,7,1,5,3,18,3,2,6,6,11,11,17,26,46,18,18,24,8,7,0,31,5,2,5,8,13,2,4,11,6,6,2,1,1,4,3,4,7,5,5,79,14,2,4,9,5,6,6,8,7,12,7,2,1,8,13,9,6,7,1,2,2,1,1,7,5,6,3,3,3,4,9,2,2,1,7,9,4,8,6,5,3,10,7,1,6,5,3,27,8,5,1,1,6,9,2,4,6,3,10,12,0,1,19,6,4,11,4,3,4,6,3,9,3,8,11,10,13,14,10,7,3,9,3,13,0,4,2,4,12,6,3,8,7,4,0,7,4,1,9,3,8,3,4,9,4,9,4,6,7,5,2,4,0,1,6,2,5,8,2,12,6,4,9,20,1,6,5,4,3,7,2,6,12,7,4,3,1,2,16,4,7,9,10,3,0,2,14,3,7,11,4,0,13,8,12,10,1,3,46,17,4,3,1,6,4,26,2,3,6,0,2,1,2,2,1,0,1,1,11,16,7,20,9,12,5,0,5,1,6,1,15,1,5,4,1,0,0,3,9,2,7,3,3,8,7,10,1,14,3,10,6,3,5,3,10,4,7,0,0,2,10,12,13,6,39,18,6,2,7,4,6,6,17,9,8,5,5,3,17,11,9,2,4,4,1,5,5,15,11,4,1,6,7,5,4,10,10,4,3,5,2,7,12,11,5,8,2,8,14,7,11,3,9,17,12,11,3,7,2,3,5,1,11,0,8,8,1,19,4,8,1,6,2,4,3,5,0,6,5,2,5,3,2,10,12,2,6,2,0,0,6,6,1,1,3,4,2,12,10,7,2,1,1,1,1,3,6,0,3,0,2,8,3,1,2,4,2,1,3,0,8,5,1,3,4,6,9,3,2,5,0,2,3,10,2,5,1,1,2,5,7,8,2,5,3,0,9,3,1,6,2,3,2,4,2,8,1,1,7,1,3,0,7,5,3,1,0,4,1,0,5,0,1,5,2,4,2,16,7,15,5,9,5,2,3,1,4,16,9,5,1,2,6,5,0,1,5,2,8,5,6,1,13,3,14,6,3,4,4,0,0,1,2,1,2,4,2,2,4,12,2,2,7,1,4,3,2,1,5,1,3,6,0,6,6,2,11,10,1,14,6,5,5,6,3,12,1,6,3,6,8,4,6,4,6,3,8,0,3,11,6,5,1,1,2,8,1,2,3,3,3,3,1,2,4,1,3,5,3,0,1,3,0,2,0,6,1,1,1
effort,9,27,18,226,18,20,11,58,11,5,55,13,29,170,7,20,28,21,16,6,18,53,35,52,57,39,35,32,15,31,21,416,253,33,112,162,103,10,16,11,17,41,9,15,68,48,50,56,397,89,85,53,35,134,18,24,101,42,20,49,18,26,6,20,55,11,192,14,14,26,24,7,9,7,232,27,49,15,120,59,114,6,21,22,400,31,29,2,59,4,19,18,17,56,120,11,53,12,150,30,10,61,52,20,31,39,22,11,33,18,36,15,35,34,15,49,3,3,98,249,104,59,33,149,14,8,8,5,3,5,30,11,17,102,40,134,29,13,9,18,14,95,44,10,1,134,23,33,28,22,101,10,24,17,13,59,86,22,24,71,24,6,26,11,30,26,22,1,42,20,29,193,84,16,12,23,268,11,15,93,66,36,41,58,3,73,74,56,66,97,5,13,21,4,9,17,24,11,20,52,92,9,13,32,71,17,4,64,30,55,151,23,52,25,13,10,9,20,30,15,10,31,11,33,64,187,51,41,15,19,32,27,55,72,88,36,57,37,25,23,122,51,12,26,41,20,16,55,92,15,35,40,55,6,9,19,20,8,7,40,21,69,30,9,10,80,26,27,30,12,174,18,24,13,7,7,51,28,23,7,166,27,10,27,24,11,17,23,29,5,7,16,13,16,8,19,43,14,14,44,63,42,4,12,19,8,59,10,17,8,13,40,60,32,32,28,27,108,30,10,86,15,41,20,112,10,34,73,7,52,12,23,10,8,15,21,60,17,7,9,10,24,27,28,7,23,66,103,43,15,20,28,12,72,34,11,12,16,37,83,47,30,48,32,6,18,58,22,29,50,12,73,13,31,35,54,11,13,39,12,114,8,75,35,26,63,18,30,36,10,54,20,18,18,42,26,68,6,71,16,33,15,6,16,10,48,17,5,74,42,8,31,18,49,29,27,23,17,14,21,12,21,60,27,6,11,17,30,20,38,11,4,0,20,26,11,13,34,29,18,39,40,17,31,12,14,38,19,66,10,43,15,10,8,99,11,5,19,21,57,30,44,66,87,20,22,46,26,10,5,47,29,7,7,8,66,8,33,64,9,18,34,11,14,48,9,22,23,23,6,124,50,8,20,25,10,11,24,17,34,34,7,3,4,6,33,15,25,12,24,8,22,17,21,23,24,24,34,38,22,16,47,14,59,13,10,84,46,49,41,25,21,13,35,17,18,18,36,61,41,18,17,10,15,24,16,15,26,19,13,46,7,9,59,15,17,52,12,17,18,23,10,31,18,19,21,31,10,70,107,20,13,15,26,23,17,21,10,16,39,16,41,30,29,19,23,8,13,5,19,41,47,22,10,42,7,18,13,81,41,36,13,13,8,14,38,4,45,19,7,52,24,29,23,58,8,31,15,15,11,16,12,7,30,13,10,4,18,21,52,20,29,64,21,17,11,47,14,12,24,19,11,23,39,19,46,9,10,18,231,61,21,13,12,18,18,60,38,9,27,5,12,15,26,15,16,8,18,25,22,36,13,57,51,41,10,10,8,16,5,11,59,22,12,18,7,17,29,4,9,21,38,27,25,12,14,12,9,34,7,22,9,8,17,15,23,39,15,7,8,7,11,15,42,34,40,33,18,13,17,24,15,22,42,11,17,16,17,9,31,19,31,2,21,5,1,26,15,59,17,25,15,10,21,15,11,23,30,23,14,22,4,0,11,9,25,15,15,5,21,17,34,2,9,40,26,14,12,21,18,21,18,12,23,7,27,9,7,39,20,16,16,24,11,35,17,12,19,9,20,26,22,11,6,45,37,19,11,10,2,10,9,16,8,16,15,14,17,24,12,2,18,15,19,7,6,12,22,5,17,17,6,31,7,2,5,13,13,12,11,13,13,9,17,10,15,8,49,12,13,7,13,11,22,10,9,13,34,6,18,25,31,25,6,9,7,18,7,12,6,7,10,21,25,10,18,10,12,10,23,7,6,12,4,13,13,4,15,17,9,9,3,11,9,21,4,5,9,13,7,14,24,3,6,6,7,17,9,13,25,18,11,14,17,12,7,9,16,8,37,15,11,9,9,20,6,2,7,7,11,11,19,6,19,8,10,7,27,8,7,8,19,20,14,6,2,9,10,17,23,12,15,9,4,7,22,12,20,27,4,7,23,8,7,10,0,1,7,17,5,7,10,9,1,4,21,9,9,11,15,12,7,23,23,16,4,4,16,5,10,2,14,6,8,11,7,14,27,39,4,8,21,5,7,9,12,11,7,2,13
many,8,41,22,255,21,32,10,58,14,19,29,11,39,162,8,18,19,32,16,17,26,73,44,64,56,47,30,46,26,48,23,386,275,35,117,155,82,19,45,15,24,21,13,10,57,47,49,42,446,90,91,13,41,105,63,13,111,71,30,41,32,15,7,20,56,24,226,21,20,34,28,16,14,13,216,31,72,18,152,65,122,7,27,16,393,49,28,11,65,10,24,28,3,61,94,40,57,23,64,43,18,69,55,25,35,68,28,21,38,20,35,23,33,42,29,86,11,2,123,300,90,56,70,196,29,9,9,8,11,4,24,7,50,123,42,150,22,12,7,21,19,101,77,11,6,140,23,52,36,34,84,10,41,26,25,87,101,17,19,84,36,15,43,10,21,25,27,42,1,14,45,210,76,10,24,32,303,6,33,125,64,20,37,42,6,43,91,43,77,79,14,13,17,6,9,15,50,25,38,46,86,11,17,25,47,25,5,80,18,57,161,21,75,17,16,24,9,20,28,6,9,55,11,30,93,194,58,72,14,26,35,29,48,59,98,49,85,17,31,29,117,78,36,15,44,22,13,54,87,13,38,48,53,22,18,35,30,8,11,59,18,49,31,5,24,86,19,24,25,16,225,14,47,15,12,5,38,22,25,14,137,19,12,42,42,22,36,39,31,15,9,9,39,17,14,24,63,18,12,56,71,69,6,7,34,9,48,6,31,13,13,36,69,21,66,35,64,94,41,15,107,20,84,34,109,12,44,74,21,43,16,32,14,10,21,28,39,26,10,18,20,28,40,15,13,23,84,97,49,37,22,27,10,68,37,10,13,7,29,67,42,31,35,32,10,11,65,16,43,32,6,51,9,43,34,68,23,13,35,17,113,5,85,17,16,89,17,38,57,18,59,13,39,20,47,36,102,15,40,12,43,11,7,7,15,22,27,10,53,28,11,22,18,43,20,11,4,22,10,14,14,14,49,18,13,16,9,27,19,23,19,7,1,14,24,3,1,19,22,19,41,40,14,47,12,11,35,25,96,24,46,5,18,7,115,27,4,15,23,49,31,41,86,77,19,7,61,38,14,10,71,12,5,10,8,28,15,23,45,14,25,27,14,12,26,13,32,17,16,13,143,84,6,16,33,19,15,24,22,33,29,26,5,7,16,70,29,32,18,8,15,16,11,19,43,19,10,21,9,16,21,36,9,45,7,7,40,22,43,44,13,19,14,24,22,16,25,19,99,45,20,2,15,33,45,21,11,52,29,21,51,10,14,100,23,15,55,9,12,12,53,11,53,10,32,36,25,32,56,69,27,25,27,10,19,6,36,19,18,59,30,34,35,30,20,13,14,17,7,25,50,52,25,20,77,23,16,15,38,31,36,8,17,2,9,53,10,42,14,12,68,31,11,19,66,16,42,13,17,14,22,22,6,49,11,8,10,19,25,66,12,63,58,45,17,11,39,20,20,20,35,12,36,41,17,42,17,8,21,222,35,12,15,11,11,26,64,24,9,29,13,15,10,25,8,2,6,20,27,20,38,21,57,71,55,11,13,12,2,13,2,47,9,27,21,27,18,13,8,25,25,36,17,21,11,16,25,7,28,15,12,4,7,13,24,17,30,17,12,3,11,9,25,50,31,21,8,12,15,15,19,10,8,46,8,15,26,11,12,38,18,24,18,12,18,19,15,21,55,24,28,6,16,31,23,9,35,23,22,21,22,3,4,16,11,40,17,23,19,64,57,41,6,12,39,61,25,18,28,16,19,20,18,38,9,40,40,12,29,18,22,7,23,16,44,24,13,17,19,28,13,34,9,6,21,31,18,21,6,7,11,8,22,10,16,13,9,15,36,20,27,5,13,9,10,12,13,26,6,18,9,10,12,19,13,14,28,18,15,12,16,8,35,4,21,28,14,55,9,7,6,8,17,14,16,20,28,26,15,23,23,31,17,17,10,11,26,16,11,6,9,18,11,14,10,12,24,6,8,17,18,7,22,33,21,16,2,7,20,13,2,15,14,4,15,7,11,11,19,9,11,14,10,4,20,8,12,13,14,19,11,13,15,25,2,4,2,11,8,44,14,21,12,21,16,12,6,12,12,8,3,13,20,33,7,12,6,21,11,9,13,18,15,19,12,6,8,6,7,29,9,28,10,5,13,30,22,14,42,10,7,15,17,18,7,17,8,10,22,17,11,13,9,7,9,22,18,22,19,7,20,11,21,19,9,6,9,20,13,9,18,9,10,9,13,18,14,21,16,8,3,16,16,5,14,17,16,10,10,8
restore,2,36,16,125,12,9,3,38,3,3,28,10,15,59,4,10,15,12,6,8,5,36,21,24,15,25,11,20,3,18,13,126,127,5,19,65,82,12,24,10,3,16,5,8,30,14,30,8,270,39,47,9,22,53,14,10,29,10,8,19,22,8,6,8,20,7,106,8,8,9,15,2,3,4,94,9,23,10,51,25,30,6,19,6,197,16,15,7,30,3,9,10,7,28,27,17,10,6,33,13,13,21,31,22,17,23,5,9,23,9,11,5,14,21,9,24,4,5,63,127,35,24,18,77,13,5,2,7,5,0,17,5,7,33,25,63,9,4,4,12,5,41,22,5,6,73,6,20,7,8,72,7,21,6,5,26,33,7,7,25,15,5,8,5,9,10,10,20,14,1,20,74,15,3,3,11,109,2,6,26,28,22,15,22,5,19,23,17,33,38,2,9,4,2,3,5,35,6,13,13,26,8,5,8,32,14,5,22,12,23,47,7,35,4,2,12,6,7,11,4,10,24,2,10,45,73,17,21,5,18,11,7,30,18,17,20,34,9,8,5,65,30,7,5,29,8,11,22,42,0,8,25,34,3,2,12,14,2,5,15,2,25,19,1,8,24,5,9,9,10,92,4,21,7,0,4,22,10,7,2,48,10,4,26,10,3,5,9,11,4,2,2,10,5,4,10,32,5,8,18,37,18,1,3,8,2,24,4,12,2,4,13,22,10,28,16,10,33,21,9,49,5,26,5,42,5,12,27,6,27,8,6,9,5,9,15,18,8,14,16,8,19,21,8,7,12,50,46,22,14,13,15,10,19,14,3,12,0,12,30,11,10,3,17,9,5,28,5,13,7,4,26,4,20,9,11,10,1,11,6,64,4,38,6,4,27,8,11,31,3,13,4,10,9,23,16,31,2,66,5,19,3,5,3,11,7,5,6,26,11,4,8,1,14,22,10,6,6,11,2,4,13,22,12,3,5,6,11,3,17,14,3,4,14,10,5,0,5,16,4,10,17,3,9,2,2,9,6,30,8,16,7,8,11,23,15,2,14,7,28,17,14,28,27,7,4,21,9,3,4,18,3,1,7,1,15,9,10,19,4,7,17,4,10,8,4,15,13,5,1,76,36,2,11,9,10,2,14,7,11,8,2,2,3,11,24,4,14,0,7,9,8,10,2,9,12,8,10,8,13,5,18,4,12,9,10,28,11,9,20,11,5,4,12,4,5,8,7,31,12,8,1,4,4,7,8,12,15,21,4,51,4,4,44,9,8,34,2,2,10,18,4,9,7,19,7,14,6,36,23,11,5,10,5,3,2,3,2,4,11,10,13,7,17,12,4,1,8,4,10,14,23,9,7,32,10,5,5,27,14,17,7,6,5,6,18,4,24,3,5,16,9,7,6,22,4,16,6,3,6,13,5,7,24,3,6,5,5,9,39,11,7,10,14,7,2,5,5,6,16,3,2,2,24,7,11,4,6,6,139,29,5,3,5,12,14,35,15,14,11,4,7,12,12,3,4,1,11,10,16,15,7,59,12,22,6,2,6,4,4,5,23,20,5,10,5,14,8,4,11,14,13,13,4,6,5,7,6,8,11,15,2,5,5,4,2,14,4,10,4,5,6,6,22,13,16,9,9,8,6,5,6,8,19,6,8,4,6,5,17,3,9,3,6,6,5,10,2,34,9,7,5,2,7,9,3,6,3,3,4,14,6,1,5,2,20,6,2,4,6,6,11,6,2,14,19,16,5,8,11,3,3,4,12,2,11,21,0,13,11,10,3,12,10,5,6,9,25,7,12,14,4,3,2,3,14,5,1,5,4,3,7,13,2,5,1,30,5,22,6,4,4,4,12,3,4,7,7,11,7,8,5,1,3,1,4,5,6,8,2,4,11,13,3,9,5,14,26,8,8,10,11,3,5,6,9,6,11,3,19,15,24,9,8,0,3,6,11,9,6,3,7,3,6,8,8,5,6,5,4,0,10,8,11,7,6,0,20,3,3,4,3,8,9,0,3,8,3,12,6,5,3,1,7,6,6,6,18,1,4,7,9,3,6,15,3,10,12,3,12,9,6,8,7,9,4,2,3,3,2,8,10,5,6,6,5,5,23,9,8,2,8,10,8,4,6,11,4,4,9,1,11,4,5,8,16,5,7,29,8,0,9,6,5,2,5,5,3,13,6,2,7,2,5,5,6,3,4,3,6,6,10,8,7,6,7,2,5,5,4,7,3,3,7,1,6,7,6,11,2,2,7,1,2,3,2,2,6,2,7
new,13,45,14,202,15,19,8,60,8,33,55,27,51,119,6,7,10,18,14,6,1,73,53,43,22,42,25,30,6,39,10,300,227,20,87,135,63,19,20,16,8,26,14,11,57,20,54,25,623,105,73,10,22,96,27,3,81,61,21,44,17,15,5,28,35,17,157,18,12,56,39,28,13,11,200,18,48,9,133,44,144,11,35,27,311,30,37,8,80,12,19,10,16,38,75,29,26,14,71,12,30,50,36,8,26,55,6,19,34,21,38,19,26,40,25,51,13,9,88,231,55,41,30,205,29,13,4,5,15,13,27,13,19,121,25,113,10,8,4,21,3,73,61,6,12,105,18,25,48,19,67,16,27,22,25,48,41,32,18,74,20,3,19,25,24,16,22,29,45,20,1,149,49,4,18,8,211,6,10,100,42,30,44,35,11,38,63,41,65,77,10,15,21,6,9,3,46,17,41,9,59,4,21,24,61,11,14,66,9,44,118,25,50,14,6,26,6,19,34,19,7,42,15,37,87,134,83,64,16,15,26,42,39,33,50,36,59,25,34,10,81,56,12,8,7,16,14,50,92,9,14,42,29,13,24,21,22,7,6,53,3,54,37,12,6,52,15,10,20,15,180,23,47,12,12,8,48,29,14,4,79,12,9,17,21,18,8,13,17,14,23,9,11,15,8,15,67,12,11,26,38,59,4,21,12,5,26,5,13,13,17,18,59,22,77,21,27,48,43,12,70,10,42,27,97,8,17,62,8,49,18,16,6,7,6,22,33,27,7,26,14,20,23,13,21,15,67,81,29,18,27,12,9,59,31,17,6,9,15,50,45,21,34,21,18,11,50,23,17,28,9,43,12,32,11,63,14,8,15,15,90,21,54,17,5,78,16,45,40,5,33,17,17,27,47,13,81,2,34,13,21,10,14,9,6,11,18,8,49,24,7,56,15,50,16,17,5,5,4,7,3,23,28,13,8,13,8,20,26,36,14,16,9,32,23,10,1,11,38,8,23,36,16,48,13,32,42,4,57,15,37,7,23,8,104,10,2,9,10,49,14,35,43,67,19,13,34,44,20,2,28,26,8,8,8,23,8,13,33,5,11,20,9,9,14,13,28,14,2,6,145,62,8,10,24,13,21,19,20,7,17,15,16,2,53,46,24,17,7,9,6,3,12,8,29,17,9,11,7,15,4,48,9,35,9,11,43,13,46,35,10,8,10,8,15,18,13,14,67,29,13,13,5,28,30,13,41,27,30,13,36,3,7,75,13,19,70,13,5,7,31,9,45,7,14,18,22,5,60,41,16,13,29,6,11,9,9,5,19,53,18,21,12,24,10,6,11,20,11,21,30,38,17,11,31,9,10,6,124,19,37,3,4,14,15,29,10,19,10,20,37,30,17,12,50,16,26,9,10,9,20,11,9,18,9,8,24,16,14,86,22,37,32,38,30,2,25,30,9,30,10,10,14,51,10,64,9,15,11,369,37,11,11,6,11,27,44,16,8,32,14,25,23,29,16,10,3,7,25,28,33,11,167,35,35,18,5,22,72,19,30,64,19,26,17,14,23,6,84,60,19,22,17,44,12,37,14,8,24,19,18,7,13,3,20,16,28,14,4,20,21,26,16,40,31,36,20,5,11,6,30,18,7,43,8,45,26,6,7,24,26,18,13,3,13,7,57,11,108,37,8,19,14,41,30,12,46,40,8,9,16,6,10,33,19,29,12,29,10,61,46,23,9,13,49,31,97,16,14,22,16,18,5,30,11,22,16,4,21,17,14,15,15,7,12,9,8,34,21,24,15,22,11,2,30,19,7,23,8,5,5,12,22,12,11,11,17,7,25,23,19,25,44,19,14,5,13,17,9,16,12,16,8,24,33,13,8,18,8,11,9,7,18,6,13,8,18,44,28,9,9,5,6,13,16,39,19,13,5,21,22,38,7,12,5,11,11,14,9,5,11,6,19,14,16,13,4,7,9,23,3,2,7,19,10,4,12,23,16,14,1,14,3,6,35,10,16,8,18,9,45,48,11,8,5,35,13,16,18,17,15,3,18,11,20,37,7,24,8,27,10,9,14,33,19,21,199,24,10,8,6,13,11,9,12,18,4,34,20,4,7,10,5,24,5,6,19,4,3,14,7,15,12,2,15,24,10,43,29,3,10,14,12,16,4,5,58,16,28,6,14,30,7,5,6,46,12,5,2,27,15,22,13,14,10,6,4,5,20,22,57,6,12,13,7,3,7,20,14,8,3,2,9,1,4,2,11,13,9,2
one,52,220,97,956,69,108,41,373,37,55,176,66,87,689,48,94,76,194,88,50,38,307,202,284,188,137,175,223,127,224,106,1381,997,157,406,720,360,52,90,69,95,116,40,72,296,136,196,106,2218,453,395,90,120,452,156,55,382,150,143,133,124,74,22,124,173,75,889,73,64,163,203,45,41,53,793,132,246,30,620,236,364,23,93,94,1472,155,90,18,242,17,103,83,55,262,383,155,161,37,270,151,160,256,223,127,135,230,60,86,146,79,176,42,85,124,105,259,41,53,423,1298,313,313,240,804,129,44,41,32,73,28,158,50,93,400,256,555,88,47,53,110,66,338,209,22,33,585,76,121,134,101,537,42,130,58,59,223,342,46,96,243,132,39,113,42,60,169,88,193,210,74,149,1,251,37,90,67,1010,49,107,367,212,90,98,199,33,198,294,188,320,743,39,76,56,30,41,49,115,58,171,190,241,19,24,83,184,104,47,245,91,186,676,129,214,90,87,117,47,82,142,31,68,451,36,113,267,668,208,252,162,109,143,216,162,200,284,142,266,88,66,95,498,251,84,94,149,60,47,319,319,62,69,161,148,53,87,130,67,17,20,167,55,261,92,30,56,264,99,116,149,51,818,47,187,51,29,35,152,78,68,32,604,53,22,168,114,28,110,125,134,46,33,58,125,80,39,56,266,61,70,194,219,178,19,33,84,40,190,46,88,22,19,178,209,59,289,85,166,297,182,42,296,64,264,116,540,51,141,334,49,256,72,128,82,43,99,122,166,53,26,92,77,115,156,106,44,68,282,418,106,145,88,94,65,287,183,60,60,46,110,271,151,66,80,149,27,64,249,77,115,224,34,238,60,178,98,177,71,34,129,47,485,32,273,112,92,291,114,154,229,32,175,71,116,91,218,91,349,37,204,28,184,55,47,45,67,71,67,31,167,88,53,120,40,137,64,105,62,109,42,67,60,80,146,102,40,45,28,89,99,147,113,40,11,85,64,44,23,87,110,51,147,142,52,148,26,56,194,97,260,59,184,45,83,40,436,96,63,83,96,166,138,251,275,344,77,56,184,94,81,25,235,73,25,74,27,308,71,129,162,63,62,100,63,65,71,76,86,88,60,31,618,277,39,54,94,45,31,92,52,108,136,43,47,39,128,258,46,101,62,46,38,52,58,65,100,128,46,82,54,75,46,131,58,209,56,54,213,81,134,232,108,65,73,104,57,51,59,87,292,172,44,22,54,77,60,45,53,115,96,64,341,39,50,327,56,82,214,42,59,58,142,23,116,27,96,98,98,79,221,264,91,52,83,33,50,60,74,56,67,135,54,107,118,172,73,83,61,58,39,100,170,234,112,68,219,55,73,52,242,123,141,19,40,20,60,140,47,148,71,26,228,135,116,59,243,81,123,48,71,21,80,102,39,135,27,50,52,67,88,219,129,146,220,185,56,43,104,80,49,72,133,66,62,157,58,126,46,28,63,1077,145,67,50,42,44,116,243,146,66,133,42,65,81,146,47,39,34,70,89,79,124,51,236,265,144,56,28,51,56,41,55,194,98,50,68,56,92,34,35,115,106,129,75,97,36,93,71,40,141,78,58,35,29,74,69,64,120,73,18,20,37,63,49,153,114,193,88,50,60,72,55,52,51,168,41,107,71,33,35,99,80,91,38,51,42,39,177,56,208,84,102,42,47,255,80,45,99,73,55,58,104,30,15,52,32,83,62,74,25,100,92,99,28,38,129,126,103,57,66,45,80,46,49,126,30,115,88,36,73,94,19,30,94,48,133,37,43,121,100,90,60,125,46,46,117,143,50,62,18,44,41,49,78,37,93,34,54,71,134,41,57,34,76,67,35,34,52,102,40,89,37,24,46,81,39,34,80,48,80,35,61,59,70,53,84,72,70,195,80,38,42,71,63,58,45,60,55,65,31,98,196,163,70,43,25,49,70,42,30,44,54,48,53,37,49,52,60,38,67,106,43,71,56,90,49,48,23,81,74,41,11,38,26,32,63,17,47,24,47,48,67,94,45,27,42,38,24,55,111,92,45,32,50,63,57,31,31,69,19,140,36,47,46,54,96,28,40,58,40,23,39,45,46,82,23,52,25,84,25,76,43,36,47,53,44,29,20,47,40,69,33,117,36,20,34,107,91,92,150,30,33,56,50,21,28,23,26,54,104,32,25,45,35,43,19,154,44,19,64,51,122,58,77,72,44,30,37,46,54,42,31,41,42,82,41,82,82,64,101,51,19,28,39,25,14,52,26,41,25,50
way,5,30,17,200,19,31,16,58,12,9,34,33,32,137,12,34,23,39,23,21,14,73,77,78,69,45,54,49,24,36,16,386,274,36,125,219,104,30,30,15,25,39,11,22,63,30,50,38,428,124,109,41,28,133,43,10,78,29,21,31,22,17,7,28,75,35,272,17,13,51,52,12,14,17,289,38,81,12,166,80,95,6,35,30,434,67,32,12,51,6,13,23,14,44,96,38,46,16,84,36,27,82,50,37,42,44,16,35,22,8,39,18,48,49,35,56,6,12,106,316,87,74,84,169,22,8,10,8,7,7,45,22,34,113,49,181,24,11,24,29,21,77,38,5,7,178,32,49,42,34,110,20,48,19,17,82,129,31,17,86,49,16,50,12,17,55,20,84,76,15,49,251,1,13,20,13,284,15,35,149,69,25,34,59,15,98,65,68,81,77,13,14,28,3,22,8,48,19,20,30,96,9,23,18,37,29,12,81,32,65,192,37,66,25,25,52,16,19,18,15,16,51,13,50,75,209,70,52,23,17,36,31,43,67,89,39,58,41,25,22,126,119,28,33,47,16,19,80,89,21,37,54,44,8,10,43,14,6,4,46,14,47,27,5,10,45,23,29,31,13,230,22,36,15,13,17,47,19,11,15,181,16,14,42,25,10,55,48,37,15,4,11,32,27,8,8,76,20,23,52,64,44,5,4,30,16,72,9,38,9,12,49,55,20,76,29,62,75,39,20,73,16,77,18,148,15,40,101,11,76,18,31,11,14,21,38,69,12,9,16,17,31,39,23,11,27,76,87,33,45,20,29,12,101,46,33,19,14,42,72,51,34,46,55,9,18,65,32,37,50,12,61,16,50,38,57,20,19,40,8,106,10,76,33,8,55,15,40,61,19,65,19,19,17,42,21,62,11,63,7,31,18,13,14,13,28,18,3,42,27,11,30,20,49,19,22,12,31,14,14,10,22,52,26,15,17,11,30,13,37,17,7,0,17,16,6,12,23,22,13,26,36,30,34,13,16,47,22,64,14,41,6,27,5,105,23,11,21,30,48,38,43,65,77,28,44,48,56,29,13,64,28,15,18,12,65,12,18,66,28,21,31,12,11,27,19,26,20,21,5,142,60,15,16,30,6,11,15,15,22,34,24,9,15,31,29,14,29,20,15,14,14,20,25,30,18,28,37,43,27,12,40,15,50,17,16,78,42,42,47,31,19,26,32,31,24,14,39,73,55,18,12,13,27,36,18,14,37,17,15,42,8,13,65,19,19,49,18,14,20,31,6,27,8,24,36,20,13,64,96,26,14,15,13,19,3,26,15,11,29,18,27,34,39,24,30,27,13,10,33,36,57,29,14,80,9,19,19,50,57,43,9,12,8,14,51,8,30,23,7,62,35,14,13,65,8,27,29,12,12,29,23,6,36,11,17,14,22,11,51,44,31,70,32,24,13,39,18,10,8,27,16,21,36,20,40,15,9,20,224,84,27,10,9,15,15,72,38,20,31,1,16,19,29,15,4,12,20,32,10,29,7,47,52,31,14,6,11,9,14,9,39,22,20,18,7,32,18,8,18,21,48,18,27,17,23,15,3,30,16,17,9,3,18,12,33,31,20,6,8,14,6,6,38,29,42,17,14,8,25,16,13,11,31,8,19,19,9,8,22,9,19,14,30,16,11,39,22,55,10,23,17,21,30,17,18,30,42,12,18,23,3,0,10,4,27,15,18,10,17,23,35,5,6,23,30,32,18,14,18,19,15,7,20,5,26,17,5,26,15,6,11,23,9,25,13,16,11,13,27,9,30,12,6,29,41,27,12,5,5,12,9,17,5,21,25,13,16,24,10,21,16,18,15,5,8,20,33,11,22,9,6,24,11,15,5,24,6,26,14,20,5,11,12,10,16,10,46,15,9,6,8,13,17,6,15,15,33,6,16,38,46,17,11,12,6,20,11,11,3,14,10,7,8,4,10,9,5,11,19,11,4,8,20,14,7,2,23,23,15,3,12,11,6,12,5,10,7,16,10,25,26,15,8,11,8,8,13,20,29,17,13,6,29,10,5,15,17,9,23,11,10,16,14,16,5,8,13,16,8,6,15,7,17,13,9,14,24,3,8,7,13,13,12,4,9,6,5,7,30,9,43,2,2,11,30,16,12,38,2,1,18,14,6,9,10,0,8,23,10,12,8,8,8,4,21,14,4,6,11,21,13,14,21,6,8,4,14,18,6,15,11,5,17,14,30,15,24,27,13,5,20,4,5,13,12,17,3,5,20
ahead,1,6,11,37,3,17,0,7,3,3,2,1,16,49,7,4,4,7,8,3,4,15,15,12,10,17,9,18,6,17,2,71,36,7,13,51,20,1,10,8,7,8,1,8,14,1,6,8,36,43,13,6,16,36,20,1,1,7,17,11,1,1,6,6,15,9,40,4,3,8,8,0,4,4,98,48,30,0,33,22,14,2,9,7,42,10,10,4,6,0,16,1,6,10,3,3,11,2,30,4,1,23,8,8,11,4,0,10,10,5,10,3,10,7,12,21,0,1,17,36,21,19,7,111,3,2,5,1,2,4,30,1,5,15,14,58,3,2,0,6,2,8,4,11,5,42,4,9,4,6,5,2,3,14,7,17,31,6,2,27,8,17,4,2,6,32,4,16,10,3,4,37,13,1,6,6,14,2,2,38,6,1,8,22,5,12,14,12,1,22,3,7,4,7,7,6,14,3,6,2,8,0,1,1,10,6,10,11,4,7,23,9,10,6,2,12,8,16,7,4,6,16,1,4,8,11,12,1,4,4,6,12,8,8,18,0,19,5,7,0,15,13,7,5,7,1,1,12,15,1,5,5,18,3,0,8,0,3,0,5,4,12,2,0,1,1,7,5,8,3,10,2,4,2,1,13,7,2,0,0,34,6,4,0,8,4,2,15,0,1,0,1,6,9,1,1,5,3,1,3,10,3,0,1,0,3,12,2,8,1,1,23,17,7,14,5,4,5,1,3,10,3,16,4,13,0,14,14,0,4,0,5,2,0,2,1,16,2,1,11,3,7,12,1,8,11,5,13,5,10,4,2,0,40,6,0,3,1,5,13,6,9,21,12,1,14,3,3,11,19,3,10,7,4,4,8,3,1,3,2,9,2,10,3,10,26,1,9,11,2,2,7,2,3,1,8,3,3,12,3,3,1,4,2,1,1,3,0,3,3,2,4,1,3,0,2,0,1,7,3,1,4,8,3,3,1,1,2,4,3,0,0,0,2,5,0,0,2,9,5,5,2,3,7,1,10,19,1,9,1,12,0,21,1,26,2,6,2,4,8,13,7,6,14,3,2,9,5,7,12,14,4,2,8,2,8,1,1,7,14,10,5,0,2,6,1,1,4,8,2,21,9,1,3,3,0,0,1,5,1,13,6,0,0,1,2,13,0,2,7,0,0,3,1,3,0,3,1,1,4,7,0,0,1,0,0,11,3,0,4,1,4,2,2,5,2,0,4,17,11,0,0,1,7,5,4,0,3,1,1,0,0,0,7,3,5,1,1,2,0,0,0,4,1,3,2,1,1,1,1,3,0,2,4,0,0,0,4,6,11,0,1,3,5,2,0,4,7,1,4,5,4,5,2,3,4,1,3,1,2,4,1,1,1,0,4,0,5,1,0,15,9,3,5,9,3,0,0,0,0,4,0,5,2,1,0,0,0,1,11,0,0,6,5,0,0,9,1,2,0,2,1,0,0,3,1,2,0,2,25,1,19,10,1,1,1,5,4,0,2,0,3,3,0,0,0,0,0,0,3,1,0,1,0,0,0,0,1,2,6,1,12,1,6,0,0,3,2,0,3,2,6,0,4,0,5,0,0,3,0,3,4,0,4,5,4,8,3,0,3,0,4,0,6,3,4,8,0,0,4,0,1,0,1,4,3,3,6,0,3,0,5,1,2,0,0,0,2,3,2,12,0,3,0,2,2,1,9,2,3,4,0,0,2,1,7,1,0,4,4,3,7,0,1,3,5,1,3,4,0,3,11,3,6,2,3,3,1,2,1,0,0,2,1,5,2,10,0,2,0,1,5,7,0,3,11,0,1,0,0,0,1,0,2,2,12,4,1,2,1,1,0,0,7,0,0,3,4,0,1,0,1,0,0,1,0,6,0,0,0,3,0,1,0,2,0,0,10,0,2,1,0,0,4,6,1,3,2,0,2,4,3,0,0,3,0,0,0,0,1,0,1,0,3,1,0,4,0,3,1,0,0,0,1,1,1,0,2,0,2,0,0,0,0,0,0,0,0,1,0,7,6,3,1,0,0,3,2,4,8,3,0,2,1,1,0,0,0,1,6,4,3,1,1,0,0,0,3,4,3,0,0,0,0,1,0,2,0,0,0,0,6,0,0,0,3,1,1,0,4,2,6,1,0,1,1,2,0,2,1,2,1,0,1,0,0,1,5,2,0,0,15,0,2,0,0,0,0,2,3,4,1,9,5,1,0,0,0,0,0,0,0,0,0,4,3,1,6,0,2,2,2,0,1,3,2,4,0,2,5
easy,0,11,1,47,10,15,1,19,4,5,6,10,12,46,1,2,13,23,11,6,5,25,47,33,12,15,37,30,22,40,0,119,94,30,22,96,17,3,8,8,22,11,7,16,44,3,15,6,95,65,41,12,18,61,19,0,20,3,23,20,1,6,0,11,24,15,64,8,5,13,7,3,12,6,98,7,29,2,55,40,44,1,10,6,64,27,3,0,14,3,9,8,1,36,32,7,17,5,35,12,4,25,11,18,9,17,5,5,17,0,24,0,17,18,15,28,3,5,18,97,28,49,30,65,7,9,6,1,0,0,31,11,9,29,38,86,8,0,7,6,10,25,12,1,1,65,11,13,13,4,22,3,19,5,8,6,44,8,2,52,15,2,10,2,1,34,1,12,24,3,18,90,20,6,1,4,62,7,6,53,21,6,18,28,4,21,26,7,7,29,2,2,10,7,2,0,23,6,6,7,29,5,4,3,10,17,1,18,12,10,50,25,15,5,11,25,4,10,22,0,5,11,2,14,26,43,12,19,7,4,3,7,17,5,36,8,12,9,9,21,50,22,8,15,6,2,2,60,17,12,1,9,12,1,3,6,2,1,0,7,5,38,3,0,6,14,5,34,22,4,54,1,9,1,1,8,13,4,1,1,59,5,3,6,5,1,21,14,16,11,1,12,4,10,0,3,18,0,7,14,14,4,1,1,6,2,12,2,3,0,3,8,23,13,49,9,17,11,6,4,14,3,27,11,45,0,20,54,1,30,18,3,2,0,2,3,16,7,4,10,0,15,26,0,3,13,10,33,11,19,4,8,6,28,11,4,1,2,11,42,13,8,4,8,2,11,14,7,33,54,5,59,4,39,7,8,2,3,11,3,20,3,28,7,20,4,0,20,3,1,15,9,6,1,7,9,8,3,4,1,9,17,2,11,2,6,8,0,11,12,2,3,11,7,0,24,16,13,5,25,1,7,7,1,1,1,1,3,1,7,10,2,0,10,8,1,5,15,18,2,12,2,1,26,3,2,43,10,24,11,34,1,28,7,12,6,17,2,9,6,16,20,14,32,3,5,30,9,3,9,26,9,6,7,4,16,2,0,17,4,6,10,1,7,5,3,6,16,2,0,55,19,0,9,20,1,1,3,3,3,3,2,3,10,3,13,8,2,5,1,2,9,0,5,5,3,3,8,3,17,1,4,0,13,3,0,11,6,9,16,10,10,5,4,4,12,0,13,17,3,1,4,5,14,8,2,1,10,1,1,8,0,1,22,3,7,11,2,3,1,7,7,3,4,4,5,6,6,3,14,6,4,5,4,3,2,4,1,11,12,5,5,11,21,3,3,7,1,1,11,9,13,16,5,16,2,3,2,9,3,6,1,2,0,0,5,6,4,5,0,13,1,9,0,12,0,7,1,3,2,6,2,1,20,0,1,2,4,5,7,22,13,12,8,0,3,8,0,10,2,15,8,9,1,1,2,1,0,2,46,3,2,1,0,2,24,8,4,0,6,4,2,0,1,1,0,0,2,6,6,10,3,6,15,2,3,0,0,1,0,8,17,1,1,4,1,11,2,2,2,9,24,6,7,4,6,8,1,6,1,5,0,0,0,3,4,9,9,0,0,0,2,7,9,2,11,23,2,8,3,5,3,1,13,1,5,11,4,2,9,5,8,3,1,0,2,1,1,7,16,6,2,3,3,2,1,3,3,4,2,6,2,0,2,0,3,4,2,1,12,9,9,0,2,13,15,11,3,8,0,16,0,3,12,1,6,8,1,1,4,1,2,2,6,9,2,1,2,8,3,2,5,5,1,6,11,2,0,0,1,4,1,5,2,19,7,3,6,5,5,7,0,5,3,1,1,3,15,1,10,1,0,2,2,0,2,5,2,8,7,8,0,6,1,13,4,0,8,2,2,0,4,1,10,3,6,7,6,0,0,5,6,7,0,2,5,5,2,0,0,0,2,0,1,4,1,0,0,7,1,1,12,11,7,1,1,0,1,7,1,0,0,1,1,1,3,1,1,2,3,5,7,5,2,2,0,0,3,4,15,2,0,12,3,2,0,0,3,1,14,2,6,2,12,5,0,8,2,6,1,2,2,2,3,1,0,3,0,0,0,4,5,1,0,0,0,3,1,1,6,0,12,2,0,2,9,20,2,13,0,0,2,1,5,1,4,6,5,3,0,0,2,2,0,0,2,0,3,0,4,5,5,11,17,0,8,14,1,0,0,0,0,5,2,4,13,2,21,1,12,3,6,0,5,2,2,3,2,0,19
suffer,5,19,4,100,10,6,3,21,4,2,20,5,8,81,5,5,5,11,2,3,7,31,5,21,20,9,6,7,6,21,7,134,105,7,39,50,47,10,19,3,7,7,2,4,18,25,13,12,260,12,41,5,14,29,8,9,40,6,2,5,22,13,2,5,9,5,80,3,9,15,17,7,3,7,66,15,13,8,74,12,32,0,11,7,168,16,11,1,41,0,17,11,1,21,42,3,17,3,29,12,2,21,31,9,17,26,1,0,11,5,14,9,6,3,1,18,5,5,44,115,48,20,7,55,9,8,0,6,2,5,7,5,13,28,57,18,35,2,3,16,4,42,22,3,6,49,8,8,18,5,70,0,12,2,3,8,27,4,12,9,16,6,9,6,8,6,6,23,32,11,8,67,13,6,4,1,143,5,15,33,17,14,2,23,2,15,25,25,40,56,5,2,4,1,5,5,8,3,5,14,23,2,2,6,23,11,6,12,6,13,58,12,30,9,1,0,2,2,13,2,4,18,3,8,20,51,15,26,2,9,10,22,21,18,29,5,34,3,5,7,85,26,3,9,18,18,6,11,39,2,14,15,21,3,6,14,25,1,9,11,6,26,16,4,8,16,6,7,15,5,99,9,21,3,4,1,16,6,6,5,46,3,2,15,19,2,12,9,14,0,7,6,20,3,3,6,45,4,5,18,44,17,2,2,10,1,20,6,4,1,6,5,15,5,33,9,8,49,19,6,73,18,39,6,47,3,7,29,7,13,3,11,10,4,5,6,19,8,1,30,11,9,14,9,4,3,34,41,18,8,10,8,7,12,19,4,1,5,8,21,12,3,3,20,4,0,36,13,2,18,4,7,1,8,12,23,8,6,21,1,51,2,26,16,7,16,14,31,19,2,26,1,12,7,18,11,51,6,17,1,16,4,6,3,8,2,9,7,17,4,7,11,8,16,11,7,3,5,3,0,6,5,16,14,0,2,0,14,11,23,6,7,0,11,4,7,0,11,9,4,16,20,9,12,3,4,5,10,22,8,7,13,2,0,44,10,0,7,6,28,12,17,30,42,2,1,18,5,4,1,15,9,1,2,1,21,2,9,23,2,6,14,1,11,7,1,7,6,7,5,102,31,4,7,8,3,2,14,18,18,14,15,3,2,1,30,4,6,4,4,5,12,2,3,23,19,8,9,4,13,1,29,8,16,11,8,23,7,21,20,14,3,4,7,5,2,14,2,30,14,3,2,10,11,3,8,7,27,11,2,33,4,7,33,7,20,24,1,7,2,18,1,17,5,15,10,20,9,23,18,7,8,13,2,6,11,4,12,6,13,5,11,5,18,4,11,3,9,5,10,22,34,9,0,14,6,7,4,50,15,15,1,5,8,11,15,3,19,3,1,27,5,7,13,26,6,21,1,5,4,16,3,5,9,8,5,6,7,10,21,13,20,14,23,8,0,2,9,6,19,11,9,5,13,3,15,10,1,1,147,18,6,13,1,6,10,25,18,9,15,6,5,5,16,5,8,4,11,5,9,9,7,86,15,24,5,1,4,1,2,3,18,15,7,8,10,15,12,2,8,10,4,7,11,4,5,13,5,7,11,10,9,7,7,6,7,14,2,4,2,4,8,9,26,8,30,8,5,10,8,17,7,13,28,5,7,10,3,6,14,6,12,8,8,6,8,13,10,33,6,14,6,0,13,14,5,10,1,7,8,11,6,3,4,2,9,7,6,3,10,8,7,9,7,16,16,7,6,17,16,6,2,2,22,6,23,15,2,11,15,5,3,13,2,5,4,6,21,4,11,8,8,5,5,4,13,1,4,4,1,6,5,14,9,8,2,9,10,14,8,4,0,15,6,3,13,2,1,3,5,9,14,2,2,5,4,6,16,6,6,11,5,10,2,1,5,14,36,10,4,7,4,0,11,30,6,9,2,3,25,19,24,11,5,3,3,6,3,10,3,4,3,6,2,6,10,7,3,10,8,3,3,5,15,12,9,3,10,14,3,2,3,0,4,10,4,15,1,12,4,1,9,0,4,38,4,9,9,4,4,3,8,3,10,3,6,0,8,5,13,6,7,10,4,4,5,3,8,2,6,6,10,8,5,1,6,3,28,6,3,2,1,6,3,4,6,5,7,2,4,4,12,5,2,6,15,9,8,15,5,6,10,2,4,5,5,1,4,14,6,0,9,2,5,5,15,2,7,2,2,6,8,7,9,4,5,2,10,5,8,0,3,6,7,9,1,10,0,19,3,3,3,6,2,0,6,2,4,1,5
upon,100,386,121,2068,144,77,88,500,66,67,294,116,117,910,105,148,87,276,64,79,98,581,97,351,325,123,152,160,106,223,159,2286,1679,148,748,750,589,136,188,85,179,100,62,40,402,279,317,177,4008,171,579,49,184,431,100,98,1023,398,10,205,269,118,44,179,245,96,1291,99,136,235,120,67,58,53,1132,197,218,76,1067,286,594,10,199,95,3127,224,196,3,434,54,159,62,3,341,757,221,249,100,394,203,191,361,465,135,150,464,111,49,174,58,196,85,82,195,5,375,88,61,1079,2299,552,187,379,745,95,84,36,46,64,27,135,58,78,571,273,554,137,67,87,81,75,461,342,48,42,794,98,187,229,220,962,29,222,81,55,326,385,65,134,70,161,35,105,38,13,64,68,268,303,109,211,1010,284,14,62,143,1,49,162,398,325,179,22,276,72,337,435,296,626,619,37,78,142,2,26,57,159,159,108,222,399,38,53,191,311,161,93,479,184,404,1036,67,399,130,41,4,19,13,233,56,59,248,91,252,575,1458,357,328,83,114,185,176,233,337,452,380,439,122,120,99,989,464,94,104,200,97,71,267,546,93,223,337,277,110,155,214,148,32,67,251,112,302,301,79,116,521,77,84,225,77,1832,114,436,88,66,4,250,207,196,51,691,122,35,256,147,24,50,113,231,28,90,60,211,91,65,127,555,102,86,276,338,432,15,64,182,29,280,76,88,18,30,253,310,72,477,248,196,593,232,94,682,133,381,76,916,109,110,333,62,404,80,162,127,84,102,205,276,114,50,169,156,136,140,191,67,64,651,706,205,77,196,167,76,435,346,89,67,77,224,348,397,89,129,289,53,15,465,117,101,182,67,213,63,139,143,411,93,72,233,122,955,42,606,164,35,574,84,340,390,76,399,42,223,199,462,228,1056,84,416,69,291,26,61,20,96,106,120,64,297,167,53,152,83,240,211,125,78,93,55,12,77,94,285,211,26,68,48,196,174,240,224,86,66,181,37,73,1,196,93,70,227,301,133,178,25,45,126,104,528,146,200,103,22,83,736,119,25,181,139,458,165,278,315,378,90,102,240,166,186,9,243,51,62,64,64,266,74,255,260,84,106,202,70,118,125,194,175,68,108,87,1012,556,41,89,128,107,75,217,148,148,147,81,82,19,162,290,87,234,117,110,75,81,97,118,192,326,92,179,142,129,61,308,142,353,247,108,292,141,254,377,140,118,91,150,211,101,140,128,544,326,86,44,48,139,191,139,72,220,231,101,558,79,114,556,108,150,406,83,97,130,354,84,334,60,237,249,206,107,462,511,130,168,222,47,96,93,215,94,103,189,147,232,166,202,134,78,96,103,75,128,432,462,124,46,381,70,47,51,624,266,300,30,87,82,119,315,110,391,154,91,412,391,169,106,535,127,249,77,161,77,193,100,68,303,52,116,108,147,207,376,200,369,323,366,142,61,135,134,47,144,198,37,153,305,126,402,83,74,96,2264,310,84,113,73,122,154,523,243,110,325,107,86,249,308,87,88,72,151,147,148,281,131,619,437,512,106,58,145,58,84,113,355,169,145,162,169,203,74,56,119,279,150,181,155,118,139,117,81,362,223,88,73,94,103,131,96,228,91,82,69,83,152,115,390,224,304,113,132,144,114,122,108,108,377,58,115,100,41,61,154,121,179,84,87,99,58,295,80,442,132,169,94,52,150,167,59,197,108,94,116,169,113,44,162,87,148,135,162,80,295,288,162,52,67,239,248,139,122,108,165,218,46,43,261,90,214,109,58,257,163,85,101,161,69,155,89,115,313,132,213,120,173,59,98,202,236,103,145,55,108,98,80,174,90,68,45,104,68,258,82,160,70,185,158,84,112,84,187,90,191,90,52,163,164,87,88,69,132,99,90,94,78,204,91,103,166,164,379,127,100,99,126,95,154,105,158,108,129,91,162,348,384,114,98,56,56,128,130,115,27,96,88,104,56,85,110,70,70,138,220,67,94,178,181,72,91,62,156,175,43,64,96,58,87,198,74,100,80,112,78,51,167,7,88,140,107,87,71,97,77,112,85,47,140,140,48,83,133,98,288,57,90,109,160,202,59,51,128,60,51,124,123,90,200,60,114,43,211,94,112,98,54,79,97,72,66,64,86,80,151,53,222,90,84,109,244,177,165,525,78,28,77,42,78,63,93,56,57,255,90,56,63,93,52,49,299,91,105,81,99,103,102,87,49,112,85,31,106,125,80,98,111,93,163,116,134,123,29,230,22,62,38,65,3,5,74,12,75,20,17
capacity,0,7,1,45,6,7,4,11,3,1,5,2,9,36,3,3,2,6,2,8,2,14,9,14,6,2,17,9,8,11,6,73,41,12,29,31,9,3,4,6,5,5,1,4,24,3,5,7,77,17,20,4,8,29,4,1,24,6,6,10,2,3,3,6,7,7,66,3,0,5,15,2,5,1,47,4,13,1,22,12,42,0,6,10,61,6,13,0,16,2,7,7,10,10,21,4,9,6,22,8,10,11,10,8,5,11,1,1,11,4,6,1,9,6,1,8,0,2,23,41,11,12,7,40,2,1,3,2,2,3,13,6,2,25,14,26,3,3,2,6,2,13,14,1,1,31,6,9,8,7,25,4,7,6,3,11,21,5,6,22,7,2,9,2,7,9,0,11,6,2,6,49,15,2,7,5,49,1,11,36,7,6,14,14,2,10,9,8,7,22,1,4,4,1,0,1,8,8,3,12,5,0,1,1,7,9,1,21,4,10,40,4,3,2,3,1,2,6,10,12,3,10,5,5,19,37,12,9,4,6,7,6,4,12,19,1,10,3,6,8,27,16,3,2,6,1,4,20,27,1,4,14,18,4,3,7,1,0,3,13,0,13,7,1,3,19,7,9,8,1,44,5,5,3,3,2,4,4,1,0,27,4,2,8,4,1,2,6,5,1,0,2,4,3,1,5,8,0,3,14,7,8,1,0,3,2,11,0,5,4,3,3,11,9,16,3,8,12,6,5,12,1,24,4,16,1,3,15,2,10,4,9,1,3,5,10,8,2,5,5,0,5,7,2,4,4,6,15,2,5,9,11,4,21,7,7,7,5,7,13,6,8,12,11,2,1,13,5,3,10,1,16,5,9,4,27,10,2,8,5,19,3,15,6,6,13,1,13,6,3,6,1,4,2,5,7,20,5,11,4,3,4,1,4,1,1,4,1,3,11,0,1,0,6,6,6,4,5,4,6,2,10,4,4,2,3,5,9,3,5,12,1,0,8,1,1,2,5,6,3,5,5,1,6,1,1,21,7,16,2,11,1,5,2,13,5,5,2,3,6,11,11,10,23,5,14,18,9,11,0,14,2,0,2,5,11,2,6,5,4,6,6,0,5,10,3,2,5,0,2,33,18,0,3,5,4,1,5,4,2,9,4,2,2,2,19,4,1,3,4,0,2,3,3,6,4,11,11,3,9,4,5,1,8,3,3,6,2,7,5,6,3,2,4,9,1,0,8,12,4,2,0,4,2,6,3,1,5,1,3,22,2,7,18,2,9,12,5,4,5,5,3,4,2,6,6,6,2,17,10,7,2,3,0,3,4,0,4,2,10,0,3,5,11,4,2,2,2,1,9,4,14,4,2,10,2,5,1,2,4,7,1,2,0,2,7,1,10,4,1,4,10,5,1,5,1,8,0,1,2,7,4,2,13,3,1,1,2,13,8,3,10,7,2,2,1,3,5,5,1,5,2,11,3,1,10,2,3,8,39,25,1,1,2,5,6,9,6,1,4,4,0,0,2,1,0,1,4,3,1,13,0,6,9,1,5,4,1,1,2,3,10,4,6,1,5,5,6,1,9,6,10,4,7,3,9,8,1,5,3,0,1,5,1,6,5,5,4,2,1,10,3,1,7,4,22,12,1,3,4,4,4,0,12,1,3,1,6,8,5,2,6,1,4,3,4,24,3,4,2,2,2,4,12,4,3,4,6,3,2,4,0,0,0,0,3,4,2,0,6,2,10,0,2,8,12,3,6,5,3,7,0,2,3,6,5,5,3,13,3,0,4,4,4,5,4,0,0,1,3,2,0,2,3,2,6,4,4,1,5,5,2,11,1,5,4,5,3,5,5,1,1,1,2,0,2,1,5,3,10,0,0,1,6,1,1,3,1,7,1,3,0,8,4,4,11,3,6,5,0,1,3,2,7,2,4,0,5,1,5,6,17,2,0,1,5,1,5,3,3,1,4,1,4,1,3,4,0,5,7,2,1,2,4,2,4,1,1,7,2,2,5,1,3,2,2,2,3,0,7,1,9,0,2,1,0,0,1,3,7,5,1,5,9,0,1,1,4,1,8,2,1,4,1,7,1,1,0,1,0,2,1,4,1,1,2,0,1,2,4,0,5,5,1,2,0,3,0,2,4,5,6,0,0,2,0,9,2,8,1,3,4,2,2,3,1,2,3,12,3,0,3,4,3,1,3,2,1,5,2,3,1,4,2,1,1,2,1,3,2,1,4,1,1,2,2,4,9,4,1,1,2,2,1,0,0,0,3,2,5
whatever,2,13,17,134,10,3,5,48,3,4,10,10,3,81,7,12,6,20,11,6,5,34,26,33,30,21,22,9,9,9,7,164,138,16,46,87,49,9,16,8,6,11,6,6,30,25,19,11,262,24,44,5,14,32,7,10,46,17,8,21,10,6,4,14,18,8,139,9,18,10,12,7,4,8,122,19,23,10,80,21,42,4,14,6,181,18,10,5,17,2,4,9,2,28,51,14,12,4,19,18,9,21,39,11,17,33,3,7,11,3,16,5,6,25,12,18,4,2,53,123,37,23,9,51,9,10,0,4,0,4,12,9,8,49,28,40,11,2,5,10,16,40,23,1,3,60,8,18,17,2,75,6,23,14,2,12,53,5,16,11,15,8,16,1,2,13,3,15,33,6,10,107,35,2,6,15,162,11,1,41,24,10,10,22,1,35,60,36,48,61,5,12,12,6,4,3,16,7,2,29,14,1,3,8,26,15,8,26,11,33,72,6,36,9,5,9,1,3,18,2,6,21,5,11,52,100,25,15,3,8,17,12,20,28,43,11,32,9,7,6,65,44,13,15,18,4,3,38,39,7,11,19,17,4,11,28,10,4,4,18,5,20,21,0,1,19,13,12,18,12,219,8,15,9,6,4,19,9,9,5,86,10,1,23,9,0,6,12,23,6,2,1,12,3,0,13,16,4,2,27,27,23,1,1,16,9,40,6,5,1,3,12,25,6,32,12,15,30,13,8,53,9,33,10,76,8,10,45,1,36,11,17,13,3,8,18,14,10,4,7,13,6,12,10,4,5,48,63,21,7,20,15,10,46,22,5,6,4,18,36,20,6,5,28,8,3,46,12,5,18,1,17,10,6,8,20,8,4,25,12,84,6,55,13,3,46,25,22,23,6,35,7,9,5,38,21,69,2,23,2,25,3,6,1,6,6,2,2,36,10,9,13,9,26,15,21,2,8,1,1,19,6,23,22,3,3,6,16,13,21,6,3,1,6,7,1,3,14,14,10,9,22,2,13,3,5,18,13,36,7,24,6,4,12,54,9,2,13,16,31,17,19,27,34,23,4,16,17,20,2,26,9,6,7,3,33,8,8,16,4,10,12,5,5,4,12,12,2,7,6,71,28,7,9,11,9,5,19,9,14,15,3,4,0,9,20,0,11,6,9,5,7,9,9,11,24,12,13,3,13,2,20,9,24,3,5,27,15,14,30,7,5,7,11,11,9,11,10,46,26,6,2,0,3,13,16,4,21,15,7,39,5,6,52,4,16,29,9,16,11,20,0,15,5,16,17,14,5,37,38,10,7,13,5,8,4,8,5,9,12,6,17,11,19,24,9,7,4,4,15,17,33,17,3,29,4,3,2,27,22,26,4,2,0,8,24,5,32,8,4,21,21,10,6,20,4,22,2,14,2,7,5,4,25,8,6,6,10,9,28,8,21,33,26,8,5,24,4,6,9,16,14,11,21,4,13,9,4,11,149,22,10,9,4,7,7,47,21,7,15,4,6,9,18,3,3,1,6,11,8,11,5,43,23,21,6,2,8,0,1,2,30,18,10,6,11,21,5,1,15,15,8,14,9,9,8,6,2,14,12,9,6,4,9,11,6,22,12,2,2,7,5,5,24,20,13,4,7,8,3,10,5,8,37,5,8,11,5,6,6,6,12,7,2,10,4,20,4,23,12,13,9,6,11,14,8,7,10,4,8,10,2,1,3,2,14,5,6,2,6,8,8,1,1,13,21,5,3,7,13,13,2,1,18,6,22,15,4,4,17,4,5,10,5,3,6,9,19,2,10,9,4,2,2,3,12,3,5,3,7,5,4,13,7,7,4,13,7,17,2,4,2,15,10,7,0,5,10,3,14,5,2,5,4,6,6,8,4,6,8,5,7,11,8,7,5,7,33,11,2,7,8,7,17,3,16,12,6,4,18,18,28,8,5,5,1,8,11,6,0,8,11,9,5,5,14,3,2,9,4,2,8,9,21,7,5,7,9,11,5,0,1,6,3,4,1,2,0,7,7,6,6,3,5,1,3,3,6,5,6,5,8,2,14,8,1,3,8,3,22,2,8,14,8,9,1,2,14,4,4,10,9,10,8,3,7,3,8,1,1,6,4,11,1,6,5,8,1,2,14,3,12,3,2,9,16,20,6,15,1,0,4,8,9,7,3,0,5,11,5,4,4,4,2,2,25,4,0,5,8,6,13,2,6,5,1,2,6,5,5,0,3,6,3,5,4,10,8,9,11,1,2,4,0,0,2,5,6,0,3
need,6,55,37,531,16,90,15,58,28,22,50,31,92,316,22,34,37,71,49,19,35,143,150,149,92,130,80,111,54,82,23,817,440,90,243,361,148,32,53,35,44,80,23,55,103,35,125,93,517,284,172,52,45,232,160,14,142,97,96,90,33,33,11,56,153,41,383,43,29,73,123,18,31,20,664,55,154,17,290,113,257,22,39,65,608,108,100,26,111,8,39,35,34,102,168,95,59,23,164,93,81,127,99,67,57,138,31,52,58,27,83,39,89,94,114,162,11,16,202,448,164,209,123,377,54,21,25,19,16,24,102,36,41,261,102,468,23,19,40,19,39,162,59,17,19,311,37,104,72,31,171,36,55,75,40,170,186,64,24,277,76,27,73,26,67,172,25,93,125,26,100,367,149,38,53,33,398,36,41,1,117,45,158,148,36,172,147,111,90,146,13,33,35,23,36,21,142,45,38,38,191,16,40,30,86,74,52,193,34,118,363,86,101,70,45,148,46,85,45,26,27,59,14,84,136,346,148,117,31,74,58,67,88,83,139,91,124,65,76,40,202,135,37,39,53,34,25,225,320,39,82,79,81,14,19,64,27,21,15,105,48,119,53,14,32,187,101,85,64,16,330,64,67,24,17,44,108,57,27,29,288,27,34,57,46,31,122,123,54,25,8,19,66,36,21,32,94,31,25,62,97,107,20,25,40,38,108,30,57,30,29,84,264,61,165,47,101,104,74,51,96,29,156,82,179,12,75,198,14,75,34,43,24,33,31,58,71,18,16,25,36,80,115,24,34,35,109,149,96,112,49,31,17,171,64,55,35,32,70,140,150,97,103,54,23,40,76,42,90,141,24,199,29,122,50,153,30,38,57,29,183,17,182,61,74,125,52,77,83,23,67,35,45,21,76,43,101,22,106,17,47,36,17,25,18,14,31,13,83,65,20,32,26,101,27,42,20,31,30,50,19,31,95,36,29,33,19,46,32,37,31,15,1,39,36,17,17,30,108,33,65,86,37,31,12,23,158,42,142,34,128,12,58,18,124,37,19,12,75,56,71,83,106,215,42,49,117,62,47,23,120,60,11,17,15,97,15,34,138,59,46,40,16,18,29,36,37,35,19,14,315,108,14,24,44,12,30,24,22,24,63,33,19,50,44,67,52,42,29,24,14,22,29,43,49,33,47,40,29,39,10,48,33,83,16,15,106,52,60,76,70,21,39,43,50,33,33,43,105,87,14,12,20,61,47,39,9,63,28,31,53,7,20,117,42,43,118,17,33,31,41,21,71,32,44,58,36,24,117,159,54,16,57,19,30,10,27,18,20,91,22,45,30,78,21,34,22,13,8,56,62,85,63,31,143,19,34,28,40,75,50,21,24,6,19,68,28,49,49,16,84,113,31,10,103,16,30,28,30,10,47,27,30,70,42,33,15,42,52,84,39,91,99,51,34,24,78,61,31,22,40,31,38,54,17,82,32,26,53,252,115,44,20,37,24,45,61,75,22,44,21,18,11,9,13,9,3,13,31,23,40,27,18,79,25,15,13,21,26,12,38,81,32,31,37,8,37,49,8,40,28,93,29,34,27,57,16,7,38,21,21,11,15,29,24,33,40,30,5,11,10,7,15,79,42,117,43,19,22,43,23,20,19,97,37,40,34,16,14,37,26,39,18,33,13,10,177,33,65,36,44,14,51,90,50,37,46,87,25,19,35,15,19,19,25,47,21,24,23,64,54,65,7,30,61,49,64,40,59,15,36,16,13,50,18,38,51,35,53,14,6,12,41,21,25,24,13,5,15,40,30,45,21,13,68,81,47,15,4,21,13,20,21,31,43,32,23,21,62,18,14,4,29,43,20,14,32,48,8,20,6,9,30,37,14,12,74,18,19,10,36,14,23,27,33,25,17,58,23,22,7,13,11,30,19,45,24,29,24,31,34,76,22,13,36,16,21,14,3,14,14,13,15,20,12,13,12,14,19,67,30,18,35,57,20,12,1,6,28,11,3,19,11,6,21,8,32,11,34,22,31,22,39,14,13,6,6,39,32,68,21,3,41,19,23,4,5,14,11,66,28,26,10,15,27,5,25,15,26,9,8,9,12,24,11,8,17,10,14,16,19,35,12,10,8,14,31,18,15,51,18,31,28,9,39,28,37,37,99,10,43,33,20,45,13,5,13,14,51,5,8,6,17,15,6,35,9,6,3,13,32,15,45,32,8,5,32,10,19,8,9,11,12,21,18,14,15,71,22,41,24,38,11,33,29,30,58,9,18,23
do,21,77,28,277,35,17,10,57,9,14,29,27,33,157,9,14,18,35,22,12,6,69,75,89,65,45,34,44,15,36,28,496,236,16,151,156,73,23,27,13,17,20,13,16,87,30,37,39,493,66,140,38,25,72,46,14,95,50,30,51,31,11,4,20,46,28,212,22,12,49,37,16,8,10,273,31,63,20,183,69,119,5,32,30,416,62,32,11,70,7,22,12,10,75,130,38,48,18,59,35,42,76,74,32,44,60,10,29,28,14,46,8,21,41,32,70,8,7,145,345,131,63,27,188,28,16,9,7,11,6,30,16,23,121,42,248,24,11,13,26,26,88,74,16,12,181,26,34,41,25,132,12,26,19,24,86,108,14,15,38,36,8,34,10,7,66,22,66,64,28,42,212,69,6,21,17,325,7,24,117,1,26,18,70,11,85,142,56,83,105,2,18,22,7,6,7,55,11,13,42,103,4,10,31,62,25,16,60,41,61,192,17,56,25,12,25,10,22,36,15,12,43,11,39,97,230,70,74,18,18,38,27,37,62,69,40,93,16,16,26,175,82,28,24,41,8,11,60,99,9,25,38,52,13,18,37,17,5,5,39,30,61,50,4,6,126,13,17,33,6,255,12,72,8,11,5,59,26,18,11,145,23,7,35,27,8,28,33,64,23,11,5,32,18,2,23,71,13,12,46,55,77,4,10,26,5,55,15,19,6,1,61,37,11,98,30,47,69,34,14,77,14,77,19,152,22,27,76,14,58,8,44,22,21,15,28,41,20,13,18,27,33,36,28,11,21,73,90,33,34,22,33,21,93,58,21,7,27,57,66,65,24,46,22,9,10,65,32,21,42,2,32,7,30,19,81,18,10,47,15,156,7,78,26,17,95,27,48,69,12,70,7,28,22,45,21,69,16,81,11,29,9,9,14,18,23,27,4,32,18,8,30,10,43,22,17,8,23,9,4,20,21,38,25,7,16,5,48,16,31,18,11,4,16,11,9,1,32,25,11,41,36,29,23,9,7,44,28,94,14,38,21,11,12,101,19,2,25,30,65,37,60,58,96,16,29,35,28,43,3,40,25,7,12,9,69,8,22,51,22,21,34,6,15,24,14,25,6,16,13,166,68,12,4,21,12,22,26,12,26,30,11,8,8,20,30,4,30,20,13,15,12,24,17,19,33,22,22,28,22,10,43,8,45,30,10,75,35,30,65,21,8,19,44,19,20,31,48,79,61,4,6,25,21,20,22,5,40,43,13,70,10,14,93,27,21,42,7,16,29,36,8,44,17,31,38,21,24,64,81,20,22,39,11,23,31,12,16,27,46,16,22,33,54,15,21,11,25,11,42,42,61,29,15,90,19,22,21,77,48,52,10,10,9,19,63,3,54,21,14,67,40,22,19,72,19,26,14,26,13,27,11,12,38,15,12,12,14,26,57,39,46,67,38,17,13,44,18,14,27,24,13,24,24,16,69,18,18,19,270,75,23,12,21,20,20,63,49,19,15,4,18,21,30,6,10,10,16,26,18,48,21,50,77,48,11,8,16,11,16,27,58,27,15,15,15,20,12,11,23,16,34,28,14,27,38,21,1,22,24,15,5,9,23,28,28,33,26,12,7,12,18,12,56,48,41,27,20,14,30,19,17,16,71,9,16,28,7,11,25,19,35,26,9,14,8,67,9,69,22,26,16,21,28,22,10,31,20,19,16,21,15,9,28,15,24,19,17,10,34,35,52,6,9,40,21,35,16,29,20,17,11,6,30,9,23,8,5,36,15,22,12,29,10,28,12,7,36,22,34,19,18,19,5,59,52,11,18,6,11,11,14,21,18,8,19,14,21,34,10,13,7,37,15,7,7,21,22,12,35,8,13,12,26,14,9,23,22,12,11,22,8,16,11,10,16,17,55,19,13,11,22,10,15,8,12,22,16,15,21,45,70,24,10,17,13,17,14,27,8,3,13,17,5,15,14,37,4,14,27,29,7,34,16,8,10,8,10,20,3,2,7,10,8,19,10,9,10,18,10,17,54,5,12,22,11,10,20,16,13,15,15,9,16,4,2,5,16,10,40,11,14,7,24,31,3,11,9,6,13,15,17,12,15,2,13,0,18,9,6,10,8,15,17,10,2,6,9,9,36,9,24,14,9,17,41,11,22,71,17,15,12,10,8,11,6,9,5,34,12,6,11,9,8,6,29,16,32,6,7,12,9,13,19,6,14,14,6,16,13,11,12,13,10,19,9,20,5,24,8,4,9,9,2,5,8,9,16,3,5
preserve,8,27,11,145,14,14,12,98,6,5,23,14,7,120,18,36,5,32,14,4,9,40,31,23,30,14,9,18,13,24,8,188,134,14,65,137,148,4,4,12,13,30,3,4,40,20,29,12,368,34,41,7,26,58,18,12,48,20,3,27,26,10,8,16,26,9,138,9,8,14,21,1,7,4,118,13,19,16,89,26,42,1,14,6,245,22,17,2,55,2,5,11,1,34,61,13,15,2,57,22,10,28,38,20,20,24,4,3,12,5,23,12,14,28,7,26,5,7,56,144,42,30,33,59,9,7,0,1,3,2,25,5,16,58,23,31,16,8,6,13,5,49,34,3,8,64,8,14,9,6,113,7,23,9,11,38,34,4,29,28,13,6,24,5,8,6,4,36,20,22,30,90,25,1,6,14,179,6,10,45,26,1,14,13,9,23,42,27,49,61,6,2,2,2,0,6,27,7,13,20,23,4,1,13,62,22,13,42,13,23,84,5,27,11,2,3,1,7,7,3,6,22,9,14,45,93,21,26,4,12,18,12,16,36,55,8,42,13,10,3,88,48,13,8,17,4,10,41,60,12,15,18,30,3,6,14,20,3,3,14,2,39,20,4,4,23,7,20,22,7,187,5,21,20,6,1,62,4,10,3,97,6,6,18,10,9,23,20,28,8,8,9,12,7,2,17,34,8,13,26,42,38,0,6,13,11,28,3,10,3,1,32,34,9,17,12,21,36,13,10,69,9,31,5,104,8,7,29,7,31,7,10,15,5,12,13,18,13,3,15,20,10,22,21,8,14,55,57,27,15,16,12,4,34,22,2,4,10,19,33,28,19,12,33,9,6,39,13,16,10,5,23,11,20,12,21,14,5,22,12,92,8,72,11,2,51,1,25,33,5,34,7,15,7,32,10,63,5,55,5,28,4,3,1,6,7,10,15,23,32,3,12,4,23,12,15,4,7,5,9,4,5,24,16,10,2,5,21,11,21,13,7,2,12,9,7,4,8,13,4,10,28,6,23,8,13,15,15,35,9,39,8,4,6,76,11,6,13,11,24,9,33,46,26,12,0,32,17,23,4,37,3,5,12,3,22,19,28,27,7,18,19,12,8,11,5,9,10,10,6,109,39,7,5,15,11,3,9,9,9,8,6,7,13,5,29,8,12,4,16,3,12,5,6,16,17,8,7,4,14,14,33,9,41,18,0,29,4,13,39,11,8,1,7,18,11,17,19,38,19,5,1,1,5,11,12,22,25,8,9,88,4,9,58,3,18,38,2,7,13,25,2,16,7,16,18,18,5,46,46,13,12,8,0,9,7,7,6,7,18,4,26,12,22,12,2,5,5,5,25,36,34,8,7,16,14,10,7,45,21,23,4,9,4,7,21,4,36,8,4,18,14,11,12,36,11,28,4,5,3,12,16,4,17,6,7,11,11,15,50,20,25,32,31,7,1,7,9,4,19,14,7,4,22,5,21,5,11,5,166,18,10,14,9,14,17,43,14,3,15,3,12,6,24,7,7,4,11,15,9,28,10,69,24,27,12,1,9,14,12,2,29,24,12,12,14,14,11,23,10,16,20,13,22,6,4,8,3,29,26,2,1,6,8,7,12,12,5,3,9,3,17,10,36,27,20,12,4,8,3,6,10,9,10,0,10,5,6,5,18,14,20,8,6,10,2,11,5,38,9,8,7,10,3,12,7,16,14,7,5,12,2,1,8,1,11,3,12,4,3,3,17,5,6,32,16,14,9,7,11,13,5,4,10,10,14,10,6,17,12,17,5,11,4,14,8,3,15,13,13,9,7,3,7,4,18,3,9,8,3,4,8,10,6,7,1,18,10,33,13,1,7,5,2,1,3,4,5,7,16,8,3,7,1,4,3,1,5,16,4,1,7,30,15,23,23,7,38,27,6,13,8,13,21,3,5,9,6,2,13,19,22,12,5,5,8,13,3,5,5,4,3,7,3,7,10,6,7,9,10,2,3,9,14,6,14,4,6,18,3,4,5,4,10,1,3,7,5,18,5,5,8,0,11,12,11,14,6,10,15,4,7,5,6,26,9,1,9,0,21,1,4,8,6,13,8,6,19,6,4,9,14,7,1,3,9,5,14,6,15,7,1,16,5,7,3,4,5,6,15,4,20,1,2,2,21,11,5,11,7,0,9,6,8,9,1,3,6,11,10,3,4,7,0,1,26,6,1,2,6,6,9,8,7,7,12,0,12,9,14,2,11,5,12,8,8,12,14,11,2,8,6,6,2,1,4,3,7,2,3
program,0,19,6,238,4,38,7,10,3,8,5,5,45,106,1,0,17,9,19,8,2,42,51,45,6,34,23,37,14,34,7,172,91,32,69,120,40,11,32,12,8,26,5,42,42,9,93,94,134,97,50,29,15,78,54,2,5,11,34,40,5,10,7,10,21,17,98,11,0,5,102,2,7,6,189,12,50,10,65,37,120,16,8,25,152,19,13,26,16,8,8,17,32,31,24,19,20,4,113,15,25,36,19,23,29,20,16,55,27,8,35,43,57,33,54,39,1,1,54,99,27,67,61,196,20,9,9,6,1,19,25,6,12,73,32,128,0,10,8,13,6,45,26,4,3,79,11,28,16,4,31,35,10,25,23,162,42,41,9,161,59,18,15,11,98,50,14,41,37,15,44,98,34,8,18,2,22,14,10,158,18,14,1,35,6,28,25,10,5,33,5,3,4,8,21,10,48,18,15,18,33,12,25,13,32,30,9,46,9,37,64,28,29,12,9,39,18,74,21,12,13,14,3,13,39,32,16,17,9,83,28,35,58,43,39,12,14,40,42,13,41,22,16,13,13,5,8,53,134,14,32,12,24,0,1,18,1,19,2,20,3,38,24,1,13,26,49,30,16,13,30,43,15,9,3,26,33,44,2,10,75,10,29,11,17,21,63,32,9,4,3,15,18,31,21,11,24,26,9,19,10,85,17,8,14,16,18,10,39,23,37,23,68,49,45,10,35,20,11,25,20,2,29,42,27,0,34,54,6,31,14,8,5,2,1,27,15,8,17,21,6,14,34,5,8,11,35,44,53,42,8,14,2,38,9,14,8,5,13,53,55,60,26,16,1,14,6,5,37,45,8,84,8,43,9,26,1,3,11,6,47,11,34,15,26,20,4,18,8,4,8,30,22,5,16,6,5,8,27,0,8,16,6,19,5,2,7,1,12,34,2,3,8,12,1,19,11,4,7,27,0,6,44,3,4,6,9,3,6,8,1,21,0,8,9,1,12,9,57,10,6,17,5,11,9,7,57,13,16,7,56,0,31,6,10,6,12,3,4,7,19,16,25,18,13,3,41,7,14,2,36,13,6,10,7,7,4,4,28,7,3,14,2,11,22,2,7,15,1,3,91,26,7,9,17,0,7,4,3,1,13,4,6,25,2,8,32,2,2,0,5,2,4,19,9,2,7,2,1,9,2,6,1,4,0,1,16,14,4,17,7,6,9,1,11,4,2,8,33,12,1,5,7,33,17,7,0,15,0,4,0,7,0,36,5,6,10,3,14,0,9,5,10,18,1,12,6,4,11,7,10,0,18,1,6,0,0,0,1,78,0,14,5,14,3,2,1,2,6,12,9,11,12,13,8,6,8,13,6,4,17,9,8,0,3,1,5,13,2,1,16,13,5,3,7,6,0,5,2,0,2,0,7,4,15,2,2,2,4,37,3,6,2,4,3,8,20,18,7,0,3,9,5,16,1,7,25,19,42,40,1,1,2,2,1,13,9,16,1,5,1,3,0,0,2,1,0,0,5,4,1,3,5,1,4,0,3,4,1,1,4,31,0,2,0,0,8,45,1,0,4,43,2,2,3,21,4,1,7,0,3,3,0,1,2,21,13,9,6,8,0,1,1,28,14,7,14,0,2,11,2,0,0,6,4,2,0,4,2,15,3,15,0,8,1,1,15,2,4,13,7,0,19,5,4,5,6,66,16,0,5,5,29,4,11,13,3,2,10,12,13,12,0,15,29,9,31,9,20,2,11,2,8,4,5,10,13,15,2,2,0,0,1,1,5,21,6,0,2,3,10,7,4,0,5,5,0,4,0,1,10,2,3,7,14,6,5,0,9,13,2,2,0,3,1,0,8,10,0,6,0,0,15,2,2,1,9,16,3,3,8,4,5,7,11,4,5,11,0,6,2,0,0,1,3,10,8,6,0,5,6,13,3,2,3,6,0,4,0,9,2,2,2,16,1,1,3,2,4,23,5,6,2,0,6,2,0,0,9,1,1,2,3,4,0,0,4,2,1,5,11,5,14,5,1,0,1,7,14,16,2,0,11,3,2,1,0,0,1,32,30,20,1,2,1,9,2,2,5,4,0,7,3,0,0,1,0,0,3,0,12,16,0,3,1,4,16,1,0,13,3,10,28,3,16,19,6,31,2,1,5,10,10,15,7,3,2,2,24,0,2,1,0,3,9,0,0,4,1,1,2,1,26,18,2,0,30,1,3,0,0,7,0,0,1,3,2,50,0,15,4,24,0,11,36,11,19,1,13,13
put,2,40,21,220,18,25,4,40,15,10,17,19,37,136,6,7,35,49,20,11,13,71,85,78,50,43,50,66,32,55,29,350,216,43,97,179,62,10,24,17,19,27,10,24,69,27,43,36,324,92,116,20,33,92,36,12,68,41,34,37,21,14,6,29,36,20,195,20,15,31,31,6,14,13,226,28,70,11,119,69,91,12,33,24,327,45,32,13,51,5,38,16,14,46,82,48,42,16,62,46,34,66,40,34,34,59,16,24,30,16,53,11,37,46,53,45,8,10,91,257,87,85,69,156,23,15,9,12,12,7,37,10,26,94,62,206,23,12,23,14,20,78,56,7,12,162,35,40,35,21,115,10,32,17,20,48,75,33,12,87,34,12,24,8,21,74,19,58,42,22,35,199,59,22,28,23,276,14,22,148,70,13,35,1,11,77,80,56,45,68,7,18,14,8,15,9,46,15,18,40,111,10,13,28,41,23,21,50,22,48,138,44,53,17,26,54,19,28,34,8,6,32,8,24,49,187,58,47,16,15,39,27,39,55,78,22,56,30,23,23,134,50,19,20,20,13,15,93,95,18,14,32,32,7,6,31,15,6,8,45,14,85,15,6,15,72,23,32,32,10,155,17,28,11,4,6,38,14,10,12,126,16,17,32,29,7,50,39,22,8,12,22,40,18,8,18,58,29,14,22,55,30,5,7,14,12,33,9,15,10,7,40,49,22,69,46,25,74,35,9,57,24,69,35,101,10,39,100,13,50,16,23,12,27,19,28,43,19,8,13,16,32,34,7,10,16,71,90,33,31,15,19,11,85,27,15,12,15,24,104,43,15,35,28,7,11,47,17,38,75,8,62,9,54,34,79,17,5,31,9,101,7,73,33,20,64,34,31,61,4,30,24,29,15,34,30,79,6,84,8,25,15,6,14,12,14,23,2,26,27,7,19,14,34,33,25,13,15,18,28,16,31,39,28,17,12,4,21,22,22,24,11,1,20,13,6,5,25,25,15,42,24,19,25,6,10,57,22,53,16,59,3,26,10,74,18,12,18,24,79,41,43,48,106,23,17,52,20,29,6,48,45,10,9,16,73,8,20,54,32,14,19,2,10,21,12,14,18,32,9,133,52,7,16,25,10,12,13,8,35,33,17,4,16,18,31,20,20,21,16,5,13,11,26,23,21,16,17,50,20,4,21,8,42,18,11,65,33,28,38,19,22,13,22,11,11,15,22,49,48,10,1,10,29,20,11,10,25,11,15,23,7,17,56,10,15,38,11,13,22,28,12,29,11,18,21,30,13,43,65,15,7,14,7,7,6,18,9,18,45,8,35,26,41,15,16,17,11,6,27,46,54,30,5,55,10,21,14,60,41,23,3,7,3,14,36,9,37,17,7,55,60,19,7,52,5,26,14,31,7,20,18,13,42,13,13,16,10,24,45,28,32,47,35,7,4,14,21,17,10,31,6,13,28,9,41,8,9,18,197,41,15,13,11,11,19,40,41,14,11,7,12,12,24,6,3,2,9,11,6,34,14,48,70,26,11,7,13,9,5,17,50,12,11,13,8,13,12,5,18,17,39,11,6,17,20,15,4,24,14,22,7,4,23,15,17,35,24,5,6,6,9,6,26,20,47,33,9,16,27,30,20,9,49,15,10,13,9,8,18,14,25,10,15,9,9,69,14,25,8,23,11,16,36,21,8,20,18,15,11,22,3,5,17,11,18,15,8,6,34,27,22,5,8,21,22,19,10,22,20,21,8,9,31,11,10,17,4,17,13,2,5,27,16,16,6,10,23,12,21,14,10,4,4,52,37,23,15,2,13,8,17,14,3,22,9,13,11,35,7,7,2,24,15,4,7,10,18,7,11,5,11,17,21,3,5,24,6,10,1,24,10,9,3,15,9,13,30,9,11,5,6,15,21,12,11,10,31,11,33,35,43,21,5,16,7,16,4,13,4,6,7,9,10,9,10,5,2,10,23,7,9,9,13,17,10,3,14,18,6,2,10,8,5,5,5,11,11,16,7,16,7,10,7,9,4,5,9,15,25,9,9,19,8,17,9,0,6,7,17,4,6,8,8,7,7,11,3,10,5,9,8,4,9,7,11,5,17,2,3,10,7,9,2,6,8,4,11,14,8,9,23,7,2,15,11,8,10,21,3,15,22,11,6,5,6,4,6,14,11,6,12,4,8,4,25,3,12,5,8,18,7,28,17,5,4,8,5,6,5,11,5,6,17,10,10,12,28,24,9,5,10,3,6,8,6,17,4,4,16
road,4,3,0,101,6,7,4,21,3,1,5,3,10,28,9,5,4,7,1,1,2,15,10,13,12,5,5,7,1,8,3,102,59,3,15,28,15,5,1,4,3,6,1,11,13,6,19,11,145,30,21,7,8,14,3,0,7,22,3,19,10,0,2,11,10,4,33,3,1,10,9,15,7,1,29,10,17,3,36,10,27,5,6,6,116,25,10,4,24,0,7,1,4,2,26,12,8,3,19,1,66,24,7,5,3,14,0,3,17,2,10,2,13,4,11,19,3,4,39,80,31,9,2,39,6,1,3,3,2,3,9,2,3,28,11,57,0,2,8,2,1,12,14,2,3,53,0,9,8,11,62,1,8,5,5,17,15,4,0,13,6,1,3,0,5,8,1,3,6,5,11,33,15,5,4,2,72,2,1,36,11,9,6,11,1,14,16,9,11,23,4,4,6,1,9,1,14,1,2,3,11,0,0,3,3,5,4,19,5,14,40,7,13,5,2,5,0,0,11,7,5,4,8,5,31,23,16,11,4,3,15,11,6,7,16,8,19,5,1,7,22,13,8,2,11,4,2,12,35,4,3,11,11,7,7,12,0,1,1,9,7,11,11,0,10,22,4,3,12,7,64,5,24,4,2,0,16,8,9,10,25,2,2,8,4,1,0,3,9,2,1,0,15,4,4,4,21,0,5,6,14,14,0,2,0,7,5,1,3,3,2,3,12,0,24,6,8,8,11,1,8,3,30,4,29,6,5,9,2,8,1,4,1,1,3,38,14,3,2,2,5,5,9,9,9,9,4,31,25,1,7,4,2,11,4,16,3,2,13,14,15,10,9,6,6,2,6,3,9,6,1,8,4,4,5,11,1,2,7,1,37,0,39,7,0,35,0,0,19,5,13,6,13,3,17,2,29,1,11,3,7,0,4,1,3,1,2,1,7,9,1,6,5,10,0,3,1,2,0,0,2,2,12,3,1,6,3,6,11,19,0,1,4,8,3,3,0,2,6,6,8,14,17,3,0,6,10,6,20,4,17,1,2,0,20,0,0,5,3,13,5,12,9,18,3,6,8,18,13,0,9,1,8,3,5,13,2,3,10,4,3,9,0,3,1,1,4,0,0,0,30,35,0,0,3,4,2,7,0,2,4,2,0,0,19,1,6,8,8,4,0,1,7,8,5,11,1,6,2,4,1,4,5,18,5,0,11,7,10,16,5,1,1,4,7,3,13,6,18,17,1,1,0,0,13,3,4,15,9,4,19,11,4,32,0,3,17,3,5,5,11,2,7,1,10,4,5,11,21,27,7,3,14,0,6,2,0,2,1,8,2,9,11,1,1,0,1,0,1,11,6,23,0,5,14,9,3,0,6,8,10,3,2,0,6,12,10,8,3,2,6,12,11,3,8,3,12,0,7,3,9,1,3,5,0,4,15,5,12,23,1,17,17,6,1,4,3,3,1,5,6,0,1,15,2,13,1,7,2,65,16,4,1,5,4,7,17,1,1,6,2,4,0,0,0,0,0,4,9,7,7,3,9,6,9,2,2,15,0,0,27,13,1,4,2,0,2,0,12,6,0,5,2,37,1,22,0,1,1,8,16,1,7,1,10,3,7,7,0,3,1,5,0,4,15,12,14,5,4,2,2,3,0,9,7,5,6,3,4,7,4,10,8,6,9,19,6,5,34,8,5,7,15,5,1,1,5,12,0,4,9,5,2,6,3,11,3,8,1,10,6,3,2,1,5,8,4,7,7,6,1,4,0,4,5,8,3,1,4,5,3,1,5,6,4,4,1,2,5,12,1,5,7,3,39,11,35,7,2,1,2,4,5,4,4,8,6,3,7,2,0,1,18,5,1,3,2,1,5,3,0,0,0,10,27,5,7,3,1,4,2,3,2,3,4,6,6,12,4,3,5,2,1,3,4,3,9,1,8,6,3,21,0,4,5,1,0,23,0,0,2,0,4,3,4,1,2,1,1,7,3,5,0,0,1,5,0,1,7,7,0,3,0,1,9,1,5,2,0,7,7,21,5,7,1,6,4,5,5,0,1,5,8,3,1,4,5,2,0,11,0,3,5,11,8,2,2,4,0,1,5,2,1,1,0,6,5,1,1,7,6,2,2,2,3,5,6,0,1,30,0,5,4,2,7,11,5,10,7,3,6,1,2,0,19,4,23,14,12,0,32,7,4,1,3,2,7,1,6,1,6,8,1,4,0,8,0,3,12,1,9,4,3,1,3,1,1,5,1,1,5,4,3,0,1,1,1,9,5,3
good,5,42,22,179,14,38,30,81,7,10,35,23,30,189,10,16,19,54,23,11,12,74,66,71,57,36,62,47,28,38,13,353,328,43,174,216,116,25,57,16,16,39,17,17,70,37,56,28,363,141,99,30,49,130,49,6,137,51,35,34,38,26,9,25,52,21,271,38,19,30,43,3,9,10,328,41,69,9,151,76,96,15,19,38,386,51,31,12,48,8,16,14,19,48,109,35,32,12,104,46,22,51,42,37,24,57,19,14,28,10,40,15,31,46,31,66,4,9,101,302,102,81,43,155,20,14,19,7,3,7,39,29,21,111,77,189,17,11,21,33,34,67,37,6,8,164,27,48,36,19,133,17,27,13,30,41,109,33,14,64,34,9,33,7,9,61,11,73,43,19,38,198,98,12,21,15,337,10,35,172,85,23,28,77,14,1,109,47,72,80,8,12,25,9,5,5,31,13,15,32,126,12,9,21,40,21,11,73,30,50,155,29,46,28,33,29,6,11,22,9,17,57,15,33,74,241,81,69,12,41,21,36,24,53,80,60,80,43,42,27,126,76,27,32,55,13,25,113,108,13,24,88,44,13,14,32,14,8,7,45,26,50,21,5,21,57,47,53,49,14,231,30,41,12,8,13,38,16,12,2,172,37,7,43,26,5,25,26,34,14,2,13,20,11,6,9,72,20,20,41,61,42,5,1,34,19,73,18,17,6,6,36,61,26,88,33,73,86,51,9,52,25,77,43,110,5,43,96,4,80,16,16,28,15,35,20,31,13,10,21,17,31,43,14,7,21,63,82,40,35,28,32,5,83,41,20,7,10,39,79,58,28,36,44,9,12,62,43,25,63,9,61,15,44,36,78,15,23,49,14,128,12,84,27,29,46,16,41,53,13,52,13,26,14,49,34,58,9,64,11,34,16,15,13,17,42,20,9,78,47,11,33,43,43,16,24,12,27,12,23,22,19,46,26,4,6,9,44,13,41,27,4,1,12,10,5,8,16,22,15,28,31,23,39,7,12,56,28,81,29,39,16,27,16,106,13,8,8,40,53,28,70,77,93,23,25,73,29,21,4,67,27,11,16,1,96,18,27,80,48,18,40,11,22,21,13,20,20,28,4,124,69,16,6,52,12,24,24,15,73,56,15,11,9,19,61,34,49,31,24,14,23,13,24,25,18,10,34,65,26,6,30,27,39,27,7,78,65,37,65,32,28,15,51,29,17,14,48,88,80,13,10,14,53,60,10,7,51,14,7,43,6,13,71,15,39,67,13,11,23,17,2,25,5,32,40,21,12,63,88,26,14,9,11,17,5,37,14,18,25,43,25,29,63,27,16,15,11,9,30,41,50,38,10,107,1,17,25,41,40,21,9,9,5,4,40,17,29,33,13,55,27,10,16,71,12,29,24,23,7,18,18,9,34,6,13,11,12,31,50,45,35,60,47,12,17,57,17,12,13,41,27,29,29,9,13,21,4,13,209,38,26,12,13,16,24,71,28,11,35,11,13,15,11,7,6,4,5,16,15,20,18,28,37,29,16,1,12,10,10,10,62,22,12,25,12,26,14,6,15,21,45,15,10,7,14,8,3,30,14,35,7,6,17,17,17,30,12,5,6,18,6,6,44,30,33,21,15,12,5,9,22,4,42,21,19,17,13,11,22,16,39,17,13,21,9,30,16,13,17,29,16,8,58,18,26,29,23,13,16,30,12,5,8,6,16,16,13,11,30,27,41,1,9,38,57,32,15,38,15,22,12,14,21,4,19,31,14,8,14,2,8,27,13,24,11,14,11,13,15,17,22,8,9,41,27,20,11,11,4,7,20,16,4,16,10,23,7,38,3,56,10,38,21,18,4,9,27,4,22,8,9,27,16,10,2,22,10,19,10,19,6,29,11,21,12,20,54,20,20,5,17,8,16,11,13,22,24,10,25,35,27,26,9,18,9,31,20,22,8,13,4,10,13,10,9,11,3,8,17,12,10,17,29,17,8,2,10,12,7,0,12,6,7,7,7,9,9,12,18,16,9,3,10,11,3,3,10,8,17,14,4,11,13,12,4,3,22,27,29,10,14,17,8,35,10,7,7,12,6,11,19,6,30,16,3,14,11,6,10,8,9,14,6,7,14,19,12,12,24,10,24,1,2,17,37,19,10,33,6,2,22,16,8,3,3,3,6,17,7,2,2,9,7,5,35,1,0,4,5,14,9,28,18,9,10,6,12,18,3,10,16,12,23,10,8,13,24,17,4,15,12,8,8,11,8,18,6,5,15
much,19,56,39,329,23,26,22,130,7,15,50,17,27,215,13,14,12,76,17,14,22,108,43,89,83,55,39,39,31,37,27,530,411,33,181,236,113,35,59,18,32,29,13,19,79,47,69,48,645,84,171,22,49,121,40,17,177,94,20,56,46,17,8,36,71,29,324,37,32,37,71,13,17,18,284,34,82,16,268,75,217,10,37,28,568,84,60,7,97,7,38,28,13,83,191,73,59,25,115,49,45,83,96,30,64,69,34,24,56,35,62,19,40,62,24,98,15,20,152,554,148,67,61,292,47,9,9,16,14,11,41,29,35,145,78,171,25,13,20,33,27,135,86,15,15,219,19,54,73,55,177,13,57,27,22,91,96,29,25,47,75,22,43,10,26,49,15,74,91,23,63,294,65,14,26,25,435,9,60,147,142,42,25,80,16,109,1,68,102,133,18,18,22,7,21,13,50,20,27,57,136,14,9,40,57,26,18,127,36,72,215,29,68,47,8,22,10,24,40,15,9,63,26,59,147,286,124,124,30,37,58,66,86,76,108,98,103,33,27,32,177,119,31,38,38,17,21,93,133,24,34,108,63,30,37,72,28,18,14,75,25,88,52,9,17,127,35,24,45,33,399,38,99,22,16,14,51,54,23,15,192,45,8,60,46,13,27,47,64,20,14,9,43,26,11,23,93,13,20,78,108,93,8,10,35,7,65,31,24,10,12,63,66,17,126,48,56,114,69,32,92,26,91,32,150,17,48,71,12,72,14,59,19,11,23,51,47,20,16,51,32,26,44,33,21,18,106,143,41,34,36,38,17,131,46,23,18,20,73,77,76,42,29,72,19,14,108,36,30,67,8,61,20,34,51,101,26,18,49,27,179,11,128,38,26,160,24,50,74,25,62,12,51,27,78,36,162,16,62,17,63,9,14,9,26,22,14,12,85,37,14,24,22,71,26,19,10,30,12,7,25,23,57,37,10,14,8,35,34,55,35,15,13,27,23,8,3,27,28,17,48,75,33,48,14,14,44,20,107,24,61,17,12,14,161,35,5,23,35,84,50,83,100,106,29,12,76,53,44,13,62,30,8,15,14,69,12,39,96,36,35,43,12,12,33,20,33,18,27,15,232,115,10,10,33,17,27,43,26,54,58,24,24,10,25,64,38,49,21,23,39,21,34,17,43,68,12,32,15,22,20,49,18,60,13,17,81,32,41,70,38,27,14,37,22,27,32,44,113,66,13,13,6,39,40,28,21,45,28,23,105,15,11,121,22,29,93,21,21,27,62,20,39,18,50,49,30,33,100,105,51,32,52,14,28,13,41,24,37,42,32,40,44,60,29,36,32,22,15,35,53,73,30,13,118,18,24,29,59,83,63,10,20,12,23,69,19,73,28,25,88,49,27,17,101,24,42,23,24,11,44,28,13,58,14,25,18,26,43,67,39,65,84,61,25,18,43,29,22,42,52,15,41,62,29,73,22,10,23,301,51,24,19,30,14,32,98,46,17,38,24,10,17,31,13,13,8,30,26,36,56,35,75,89,48,20,12,19,13,17,21,77,38,27,31,20,28,14,18,38,29,29,42,46,17,33,26,15,50,33,34,14,14,24,36,26,68,25,15,12,5,24,18,71,53,43,19,25,21,36,29,18,18,72,15,28,36,6,12,40,19,55,27,21,23,16,45,19,81,30,34,24,14,52,44,19,42,48,25,22,29,26,20,34,24,35,24,39,16,77,74,33,5,22,46,60,34,35,38,30,31,16,23,29,17,37,23,10,36,27,15,17,50,16,44,27,17,30,21,48,20,37,13,8,49,54,25,30,14,13,18,16,30,11,23,9,32,25,46,16,36,17,19,17,14,15,18,23,11,31,19,10,26,32,16,20,17,22,32,17,32,23,31,8,14,20,20,71,23,13,10,17,23,19,24,25,19,14,23,28,56,54,27,19,7,16,35,23,15,11,17,17,20,17,22,17,16,10,15,37,22,14,32,47,21,26,4,16,32,35,5,20,10,8,18,7,16,17,20,17,19,27,8,8,10,18,8,12,23,23,20,14,16,18,16,19,8,22,17,55,18,29,21,24,29,14,20,32,23,9,23,14,14,50,6,19,6,19,10,15,20,9,23,18,18,20,15,21,14,41,9,59,27,17,41,42,40,49,91,11,13,9,18,23,15,13,11,17,18,16,33,8,12,10,11,46,17,11,7,23,29,14,25,23,11,12,8,23,14,16,23,28,22,25,22,30,30,18,25,6,19,11,20,5,7,26,16,14,9,4
course,18,36,8,214,18,19,18,73,6,11,25,16,18,171,6,23,14,24,17,7,8,80,28,48,61,25,34,27,20,13,22,354,220,23,121,131,73,11,28,10,9,24,8,11,68,43,41,34,471,52,96,20,25,78,29,15,91,51,10,26,38,21,8,34,57,17,191,22,21,29,32,16,13,13,226,39,65,12,169,56,93,4,25,10,393,42,22,1,58,8,15,11,4,53,152,42,48,8,73,35,36,71,70,27,27,66,6,15,25,10,40,14,14,26,9,59,6,8,95,336,103,44,30,153,12,10,6,12,5,5,37,12,16,79,47,100,20,9,9,17,13,75,46,11,7,170,17,32,35,27,112,6,18,17,9,51,67,12,29,32,33,19,29,6,12,37,13,56,43,17,41,188,68,12,7,25,296,8,36,111,56,27,10,56,9,47,68,1,96,106,7,24,14,6,11,8,35,11,19,29,76,4,6,23,54,21,13,64,28,65,168,14,46,20,4,26,12,4,15,6,5,43,10,53,80,190,59,60,14,18,36,29,36,49,81,36,70,23,20,10,127,70,10,20,40,6,10,58,71,8,26,37,42,9,14,43,15,3,10,33,22,55,30,3,11,81,19,15,28,12,273,12,51,8,4,3,33,19,19,8,117,18,5,29,22,4,6,20,30,7,3,2,25,13,12,13,64,11,11,37,61,56,7,7,32,1,56,11,14,5,7,47,56,18,68,19,40,72,22,11,73,13,80,29,111,10,17,59,9,44,4,37,15,15,31,33,51,11,6,16,23,24,21,30,16,19,88,119,30,25,40,19,7,88,46,12,9,13,29,64,47,17,35,51,6,11,60,29,16,48,6,27,5,31,29,36,18,9,26,7,131,6,89,30,11,66,15,44,52,10,68,11,11,23,63,26,124,6,61,8,35,5,7,6,13,10,30,4,58,18,9,28,14,50,20,61,12,14,11,5,11,10,48,36,12,10,11,35,33,36,21,7,7,17,9,13,2,26,23,30,22,34,18,36,4,10,29,14,64,15,29,11,11,10,112,15,1,25,38,64,30,43,59,78,18,23,35,34,27,3,40,19,6,8,15,52,11,15,53,18,23,33,8,12,10,26,16,11,20,8,146,61,9,16,10,10,14,34,19,19,43,13,15,4,17,47,16,17,18,8,10,12,16,12,21,30,9,35,13,11,0,32,15,59,16,10,46,21,32,65,28,16,10,31,23,19,22,23,68,54,16,3,5,23,21,18,12,33,32,21,41,11,8,72,24,22,44,7,10,19,39,16,51,8,23,29,32,22,52,80,22,11,29,6,17,6,26,19,20,41,9,24,24,47,24,27,20,26,6,36,43,79,30,14,44,18,10,9,87,50,35,7,7,11,13,47,10,41,19,9,68,36,15,15,70,14,38,10,25,6,25,14,11,30,7,11,8,21,26,39,28,32,69,55,19,3,30,21,1,16,18,9,35,32,28,43,16,10,18,248,53,15,17,5,15,22,57,52,21,33,14,13,26,34,15,8,5,22,24,20,38,17,105,80,43,15,5,16,10,20,7,62,46,22,9,26,20,14,6,20,21,21,26,17,14,24,22,9,26,16,19,11,8,32,22,14,42,16,12,4,9,6,12,52,40,71,21,16,15,17,19,11,20,52,17,25,17,8,14,19,17,28,6,15,9,16,73,13,53,12,26,13,17,41,27,9,27,24,15,13,28,7,3,11,8,17,16,13,8,21,22,34,3,5,28,29,19,15,11,19,22,13,7,31,10,36,23,8,16,35,10,13,30,12,16,13,18,36,15,30,6,17,7,13,31,44,15,13,5,7,9,8,20,24,15,8,28,15,34,12,11,3,21,17,13,11,13,16,8,16,14,5,10,17,19,11,9,13,13,11,23,10,20,10,17,20,24,52,17,12,16,19,14,22,16,26,16,19,12,20,45,60,21,13,14,4,17,8,10,2,18,8,11,10,9,24,20,9,19,22,5,6,6,30,13,9,9,31,26,14,4,8,10,10,14,6,12,16,18,9,14,43,9,5,17,10,9,12,10,11,7,22,4,15,8,5,2,11,12,50,6,17,9,21,12,10,18,15,12,11,14,14,11,9,9,18,9,31,11,10,9,9,13,6,16,9,12,11,7,31,14,21,5,9,14,35,22,16,35,8,3,16,14,15,9,4,6,4,36,14,1,10,7,20,7,52,6,1,7,12,14,11,18,12,14,8,0,24,25,8,12,16,9,18,19,9,15,4,54,6,8,5,5,2,2,6,6,10,12,6
question,46,54,64,470,41,9,13,175,24,10,80,32,10,208,9,25,39,31,20,9,15,109,29,63,131,58,39,35,13,31,34,493,357,28,144,142,132,18,11,9,16,18,17,8,96,73,84,59,1213,51,182,25,31,67,44,24,162,75,7,56,104,31,5,45,83,15,326,23,36,68,12,11,11,9,242,39,46,22,253,75,98,0,44,27,824,40,22,2,127,3,17,12,0,102,171,31,80,10,99,23,33,70,126,40,56,66,10,10,49,13,48,10,9,28,10,106,34,12,220,557,119,55,58,119,14,8,8,23,9,8,31,9,21,131,68,101,32,6,21,11,12,111,97,9,23,204,19,69,34,18,207,6,34,13,15,88,106,3,43,23,32,8,22,13,5,21,9,66,77,33,65,320,81,1,7,40,626,7,48,90,83,49,5,45,11,72,102,96,1,264,12,17,20,2,7,12,38,24,22,38,75,2,10,38,70,27,14,63,49,68,231,19,95,34,3,8,5,3,42,7,6,85,16,74,110,293,72,75,9,12,45,33,30,66,90,41,102,22,20,34,219,105,21,22,54,11,22,56,128,27,45,36,81,22,30,46,39,7,14,46,20,62,122,21,10,113,27,20,44,9,419,17,62,12,6,2,45,18,81,15,168,26,9,67,45,9,13,15,50,4,26,18,30,21,10,30,148,19,24,66,84,78,1,12,87,5,73,29,22,3,3,53,55,10,77,26,41,145,42,19,133,31,92,20,330,57,39,77,56,102,28,34,39,28,30,34,73,36,8,38,49,39,35,60,11,25,155,181,40,22,40,61,39,75,99,11,24,10,57,77,82,20,34,55,14,6,122,45,27,44,17,42,17,36,48,51,25,9,58,19,273,9,112,68,15,97,31,58,94,22,108,15,59,71,145,36,307,16,104,10,91,8,30,2,14,11,10,16,60,29,22,38,5,66,65,25,37,39,6,4,22,29,61,54,10,21,8,37,52,56,25,21,7,40,18,23,1,87,22,17,44,58,21,44,7,11,24,23,105,23,33,24,10,14,292,37,6,60,24,84,37,53,96,84,27,7,40,51,34,6,53,12,6,12,11,88,7,60,75,14,18,36,19,30,20,84,32,9,20,13,199,143,13,25,28,18,8,48,35,42,47,6,12,1,35,41,10,50,14,8,12,17,29,25,35,85,18,43,16,39,15,64,26,104,40,19,87,32,64,70,43,17,7,42,68,33,40,30,142,65,12,15,11,14,18,20,53,67,113,37,164,12,23,137,31,31,89,10,24,30,127,22,97,6,61,38,59,35,90,121,33,24,18,14,30,64,44,30,28,34,13,35,33,40,39,48,28,28,20,39,82,148,36,10,109,17,24,13,279,77,80,2,28,13,68,87,14,106,27,14,83,95,43,19,123,28,55,15,55,14,39,10,10,92,4,33,27,28,37,90,17,96,205,102,29,13,77,27,11,24,40,20,51,83,28,74,26,21,37,686,91,16,27,23,26,33,140,62,41,50,22,39,74,174,20,25,28,74,49,42,47,34,117,186,92,21,21,33,42,23,43,92,72,43,42,10,49,14,3,37,58,39,58,40,36,18,24,24,55,50,41,35,36,32,29,13,36,13,14,20,13,32,13,108,56,59,21,37,45,14,28,21,17,59,7,24,16,8,21,39,12,38,5,22,40,8,30,12,179,23,41,29,11,25,28,12,29,14,15,35,35,18,3,35,7,30,33,22,12,24,17,41,17,12,47,23,33,21,17,69,22,20,11,43,15,86,16,7,35,41,12,20,43,9,34,18,20,76,13,46,25,66,37,25,31,74,19,21,13,22,22,15,61,18,13,10,17,25,60,20,12,18,52,42,12,33,10,44,28,35,28,13,39,24,12,20,14,20,3,26,15,21,14,8,16,32,29,85,57,20,30,35,43,96,19,20,33,30,15,34,146,82,34,13,17,22,23,21,28,4,40,30,25,11,14,24,14,14,50,27,25,14,28,34,22,19,34,38,49,21,34,17,22,28,39,16,26,19,21,9,21,58,2,15,22,47,19,17,9,5,18,26,5,32,52,31,32,18,12,104,16,17,20,27,73,24,20,18,9,15,36,67,16,34,13,25,28,78,26,15,32,18,32,21,10,6,13,12,26,17,10,31,5,6,7,32,24,8,50,14,3,16,9,4,11,3,5,20,31,26,1,5,11,12,2,77,12,3,41,27,23,21,32,10,51,10,2,20,36,22,7,25,28,20,27,19,40,4,82,17,3,2,6,1,2,12,0,16,2,2
two,37,118,61,607,29,37,44,81,27,28,184,90,48,339,18,34,48,68,21,12,24,194,46,132,83,48,59,99,43,94,48,858,700,54,166,228,213,26,43,31,24,39,30,26,135,91,156,88,1526,157,219,26,56,175,51,18,233,114,49,78,137,35,8,112,67,39,302,24,77,95,130,31,17,17,246,57,95,15,379,101,174,10,80,37,1063,66,45,10,287,8,82,27,28,168,231,52,77,22,164,43,109,130,149,55,70,96,29,39,102,38,139,18,38,72,31,140,45,22,318,669,153,133,65,614,83,15,17,30,52,14,63,31,30,202,91,231,40,25,24,25,9,157,217,23,37,314,32,73,57,62,224,26,80,29,19,65,140,24,70,77,57,28,38,22,24,51,39,97,79,38,77,743,77,22,29,56,619,22,61,146,105,61,33,68,23,80,133,106,264,1,19,45,37,26,19,39,63,27,110,38,101,11,5,70,108,40,36,88,74,103,301,34,127,31,17,18,27,19,72,17,30,96,26,72,153,287,118,97,64,67,64,165,99,99,102,72,158,29,42,27,253,149,47,25,52,30,34,92,197,36,45,83,121,40,33,79,56,24,30,89,16,142,120,39,23,159,31,49,63,30,430,30,125,12,14,19,58,60,59,33,197,14,12,76,58,14,30,46,73,11,56,42,78,46,23,43,215,28,37,63,126,116,17,40,48,17,116,22,50,9,14,44,152,39,165,68,57,194,67,25,216,30,105,39,242,28,37,117,18,95,36,54,49,16,37,61,99,51,11,69,48,60,67,50,27,37,220,286,58,55,38,65,29,138,136,14,24,30,83,148,74,40,26,65,27,15,174,31,50,68,18,64,30,46,33,107,40,16,73,28,248,10,155,67,30,141,33,112,122,10,123,22,119,117,142,50,296,13,143,14,92,20,22,10,26,13,21,37,119,44,25,49,47,64,56,42,49,58,17,23,27,49,71,65,10,19,14,59,58,84,53,50,48,84,18,43,15,168,44,22,82,68,35,75,13,21,57,37,137,32,70,37,35,21,371,56,8,69,31,138,63,108,72,116,29,13,61,70,50,9,68,13,20,27,13,59,30,76,92,23,28,60,31,22,44,43,67,32,24,12,341,173,14,22,24,24,19,92,38,25,40,22,14,22,85,48,29,61,41,21,11,22,42,31,48,64,27,28,26,37,13,73,27,68,24,20,119,29,70,131,48,25,18,32,48,14,54,36,158,54,29,12,17,17,28,56,63,62,78,30,76,20,37,187,32,50,142,17,35,35,120,23,102,31,54,55,73,29,168,133,41,40,68,13,29,81,40,37,37,93,22,63,57,70,32,34,20,43,15,41,124,131,45,24,78,20,19,14,430,89,87,7,22,58,73,94,25,124,34,14,125,105,97,22,141,40,76,22,27,23,45,23,9,78,10,29,45,19,52,138,80,81,76,77,19,24,34,47,14,42,40,21,38,88,63,112,21,42,34,1056,105,24,40,31,36,69,149,104,48,97,24,48,182,244,98,62,68,74,72,63,66,19,383,106,198,12,9,46,51,25,77,126,68,51,55,31,61,26,20,98,90,54,51,103,38,84,44,34,49,65,35,36,41,31,38,42,95,32,12,18,23,99,28,110,75,100,44,42,45,30,45,24,54,114,31,40,44,10,9,42,24,66,29,23,32,14,104,30,196,41,54,26,20,229,69,24,88,31,25,25,30,27,31,80,30,35,34,35,13,62,62,70,39,38,96,56,40,27,25,78,25,23,6,60,17,74,48,14,43,51,12,17,60,24,44,29,42,175,30,67,43,53,45,35,34,86,15,34,31,35,29,23,60,38,22,15,31,27,72,37,34,40,100,45,21,36,17,70,36,47,49,23,55,90,39,19,22,48,30,36,21,45,22,19,21,24,46,120,34,28,43,36,27,53,27,52,22,74,26,60,156,105,40,16,17,23,30,25,35,13,63,27,21,23,25,52,18,43,34,40,19,27,30,54,30,21,55,103,65,35,43,39,22,44,71,43,43,27,43,37,33,104,27,26,48,100,23,28,93,35,14,35,25,52,32,51,60,89,17,86,18,30,27,49,63,50,25,56,25,25,53,93,35,58,31,30,35,144,42,9,30,43,37,53,27,26,20,24,21,41,12,29,49,18,31,90,53,65,111,25,29,35,17,31,24,19,32,39,87,32,25,18,17,26,15,129,14,9,19,76,33,37,33,27,52,49,15,35,58,31,24,16,36,62,30,5,48,27,110,12,14,12,14,11,3,22,11,45,11,19
happen,0,13,9,51,1,6,5,6,2,2,4,1,4,25,3,1,5,2,9,0,1,22,18,16,5,9,7,15,4,6,1,52,24,5,17,24,14,5,5,2,4,1,1,2,21,4,4,1,87,30,15,7,5,29,12,3,19,2,7,4,6,1,2,6,14,4,49,2,2,2,3,3,2,2,50,5,24,2,31,8,3,0,6,4,43,4,2,2,12,0,10,0,1,6,9,7,3,2,8,7,3,9,9,15,5,24,0,7,8,7,5,0,9,14,19,8,3,8,21,50,11,13,10,38,7,1,0,0,0,0,10,4,4,16,22,18,2,0,7,11,2,22,17,1,1,23,5,5,4,4,22,1,12,6,1,5,12,7,5,11,5,3,3,3,6,13,3,5,14,2,10,39,13,3,2,5,37,1,5,13,2,6,5,7,4,8,18,7,12,19,1,2,3,3,4,2,10,2,2,14,23,3,3,2,7,4,2,9,4,4,36,11,36,6,5,26,9,5,11,0,3,11,0,8,12,35,8,9,0,4,4,3,4,7,13,6,7,4,2,3,13,15,9,8,4,1,2,9,5,8,2,6,6,7,1,8,3,1,0,10,2,18,2,1,3,7,1,7,8,1,81,2,8,1,0,3,9,2,2,3,21,2,0,3,7,2,3,5,11,6,4,1,16,1,2,2,8,1,1,7,6,2,0,3,4,1,3,0,6,3,0,0,8,1,14,3,2,10,2,2,15,0,13,2,16,3,3,22,2,2,17,5,3,1,10,1,2,0,0,6,4,3,15,2,0,3,6,14,2,6,0,6,2,9,1,1,3,3,0,9,5,1,3,9,0,0,30,1,9,8,0,7,2,5,15,1,2,1,2,3,11,7,13,1,0,12,2,10,12,1,6,3,35,8,4,2,12,3,12,1,6,2,1,4,6,3,7,0,2,3,1,0,4,3,1,4,1,1,0,3,0,1,5,7,5,2,0,2,3,8,3,6,0,6,1,2,1,1,7,2,1,10,2,6,5,1,4,0,6,4,9,1,8,1,12,2,1,3,3,5,6,7,8,10,1,5,13,7,4,0,9,3,0,2,2,4,2,15,8,0,3,4,0,5,2,3,1,6,1,2,30,8,2,3,3,2,1,2,0,2,3,7,1,0,5,2,0,3,5,2,1,1,4,1,7,2,5,9,2,2,1,7,2,12,2,3,6,2,3,8,5,5,3,3,5,3,6,4,11,1,2,1,2,1,2,2,18,3,4,2,7,1,3,10,0,4,6,1,1,1,3,1,5,1,0,4,6,6,8,7,3,3,3,0,1,0,2,2,2,8,3,4,1,9,2,1,5,2,1,4,2,6,7,2,2,0,5,2,1,2,4,2,1,1,0,8,1,1,0,1,19,6,6,2,17,6,2,3,2,3,1,0,0,9,1,2,0,1,4,8,1,5,17,6,5,2,4,1,2,1,2,0,1,7,0,5,1,2,3,49,2,1,1,2,2,4,14,1,6,5,4,3,4,1,2,0,0,3,3,2,3,2,2,12,7,2,0,3,5,2,1,4,1,4,1,0,1,3,1,1,2,5,2,2,2,0,2,1,4,3,8,0,0,0,0,5,4,4,1,1,6,7,1,5,3,4,6,1,1,1,0,3,0,3,1,1,2,2,0,1,6,5,3,2,6,1,0,3,8,5,4,6,1,4,6,3,6,2,3,0,3,2,0,6,1,3,4,1,0,0,0,6,2,0,5,6,3,1,1,0,5,3,3,7,0,3,3,1,1,4,0,3,3,0,10,1,2,0,3,4,3,7,2,1,3,5,2,6,0,0,1,1,3,5,5,1,1,3,6,2,6,6,5,2,0,0,0,3,0,2,2,1,2,0,0,4,3,2,3,0,4,0,2,0,9,1,3,7,1,3,3,2,1,3,1,1,0,0,1,3,4,6,3,0,0,0,1,0,3,0,3,3,2,1,1,1,8,0,1,2,0,0,1,0,2,0,0,2,1,1,0,1,1,0,0,0,1,1,1,0,7,3,1,0,1,11,0,2,2,5,1,2,1,0,8,7,3,1,1,6,2,2,0,4,4,4,2,0,0,1,1,0,6,4,1,3,0,1,1,1,1,3,2,0,2,0,1,1,3,3,1,4,0,1,0,0,2,4,11,0,0,4,3,0,0,2,0,2,1,1,0,0,1,0,2,8,2,0,31,1,3,1,3,1,1,2,0,1,1,1,0,0,1,3,0,0,0,1,5,2,2,1,0,3,3,2,5,2,0,2
moment,0,22,4,82,11,9,3,24,5,3,3,5,11,79,7,7,5,13,9,3,5,32,24,18,18,9,12,18,14,18,13,96,75,9,26,57,41,7,12,1,3,6,2,2,23,9,9,7,136,30,42,6,11,23,6,6,23,2,7,16,2,4,2,13,22,3,74,0,9,2,9,2,1,5,58,22,32,3,68,24,15,0,10,8,94,21,8,1,13,0,2,7,0,21,12,4,12,3,18,10,7,10,25,11,10,27,2,6,12,6,12,3,5,6,4,26,1,3,37,128,19,12,4,44,8,4,1,4,2,0,27,3,7,14,19,28,7,1,3,24,4,25,29,7,4,64,7,8,11,6,31,6,13,8,5,25,30,2,7,9,3,11,8,1,6,12,3,13,13,9,15,76,14,7,2,2,78,4,12,33,18,2,3,18,4,12,18,24,17,45,2,1,3,1,6,1,6,3,6,10,18,0,1,6,17,9,6,19,14,14,36,16,18,5,5,15,1,2,5,1,3,15,1,4,20,40,10,14,3,14,11,10,7,18,17,10,25,5,6,5,44,19,9,6,21,2,6,18,13,5,4,11,7,4,10,14,4,0,0,7,3,13,6,5,3,10,6,1,9,2,64,3,15,3,3,4,15,4,11,1,39,4,1,7,12,1,2,14,19,3,3,1,10,3,0,6,14,6,2,13,27,7,0,1,4,4,17,5,3,1,0,17,23,6,20,10,9,14,6,5,25,7,25,10,27,2,16,26,3,17,3,9,4,3,7,6,12,2,3,4,9,4,8,7,6,2,24,36,6,5,5,6,5,24,21,7,9,0,6,13,8,2,6,16,3,4,34,13,1,15,3,14,4,8,15,10,4,3,11,3,39,1,19,4,5,29,3,17,29,0,9,10,6,2,20,13,23,3,28,2,11,1,2,2,5,1,11,1,14,2,4,5,1,9,8,4,2,7,4,8,4,8,7,12,4,3,1,6,10,9,14,4,0,4,7,6,8,11,9,1,14,9,4,12,2,1,12,8,23,6,16,3,7,5,37,2,4,9,5,18,9,16,18,30,3,1,10,11,7,2,21,5,5,16,3,18,7,4,16,9,10,11,5,5,5,3,6,6,8,3,36,24,6,4,5,9,4,10,6,7,18,7,4,0,8,32,8,4,2,9,2,4,8,4,4,5,4,9,2,6,5,11,2,8,5,4,18,6,6,17,10,5,1,4,6,3,7,11,33,21,5,1,3,3,8,11,8,13,11,1,11,5,4,25,6,1,15,3,6,2,7,4,7,0,8,6,5,7,16,22,11,3,7,1,2,6,2,7,8,11,4,7,6,8,10,3,2,8,1,8,11,20,7,4,21,7,0,0,12,13,12,1,2,0,3,11,4,9,7,1,23,3,1,4,11,3,9,4,6,1,13,16,2,20,0,5,2,1,9,13,18,8,23,12,5,2,6,8,1,6,7,3,9,11,4,6,1,1,8,88,3,7,10,5,7,8,12,7,8,7,1,7,7,9,2,2,0,8,16,3,11,6,29,25,9,4,3,7,3,7,1,12,8,6,6,2,6,2,4,8,6,11,7,4,4,7,5,3,6,10,2,1,3,7,4,5,7,9,3,3,5,1,6,9,6,15,8,5,6,4,2,2,3,2,4,3,10,2,0,11,6,7,0,3,2,3,6,2,15,6,13,2,4,7,6,4,4,4,2,4,10,0,0,1,0,7,5,3,1,3,3,16,0,0,3,11,3,7,1,3,3,5,3,12,3,9,10,2,3,5,3,2,7,6,4,4,3,24,8,5,1,1,4,6,8,12,4,1,0,1,3,3,8,7,6,4,3,2,11,0,1,0,4,6,2,1,2,5,4,4,4,2,2,0,2,5,3,3,9,4,5,6,5,9,3,3,13,20,10,13,6,10,6,1,5,3,10,2,3,10,9,11,3,2,2,2,2,5,1,2,4,2,5,5,6,4,3,2,6,3,2,4,3,13,5,7,1,9,0,0,1,6,3,6,1,0,6,1,3,4,2,13,2,3,3,3,5,1,1,4,2,3,4,5,2,0,3,4,0,8,2,2,3,3,8,2,0,2,6,1,9,4,0,4,1,6,2,4,1,8,1,1,3,7,3,4,4,2,3,2,2,4,0,0,7,6,10,3,9,3,3,6,2,2,0,1,3,1,11,0,2,4,4,2,0,5,0,1,0,6,7,1,8,2,3,1,2,4,3,3,2,0,3,9,3,0,2,2,7,0,3,0,4,1,0,0,4,8,1,1
product,2,5,4,78,1,10,5,6,1,7,4,3,11,59,3,6,3,13,3,3,0,25,3,14,5,8,7,8,2,19,3,116,138,8,49,64,12,20,68,6,11,4,1,8,29,7,4,11,149,25,27,1,28,56,13,1,62,21,4,18,8,5,3,8,12,2,104,6,4,19,22,1,3,2,69,20,27,7,48,15,117,3,11,5,58,13,27,0,27,0,5,2,5,10,16,16,17,25,20,54,9,17,22,9,4,12,12,6,22,7,12,5,7,17,8,17,6,5,30,104,24,21,12,83,11,0,9,5,2,1,4,3,10,33,8,49,1,2,6,11,2,33,20,3,3,50,1,16,27,6,18,5,26,5,7,9,23,1,2,9,26,3,9,4,5,14,8,21,17,4,21,56,28,4,10,4,142,4,12,35,22,2,4,14,6,25,22,14,20,37,3,3,1,4,6,3,6,2,7,6,28,1,3,13,22,2,2,16,12,20,68,5,11,11,1,8,1,3,4,0,9,8,6,6,24,58,48,16,12,11,6,9,24,16,20,15,37,16,39,1,42,45,5,5,18,12,5,18,35,5,9,49,9,13,6,12,1,2,3,15,4,9,5,3,11,30,0,2,15,6,74,4,33,2,4,2,8,5,5,2,61,1,28,16,20,9,11,5,11,6,10,3,12,3,2,3,23,7,6,14,12,16,5,1,12,1,20,4,5,5,4,16,18,6,46,20,22,41,26,3,24,1,11,2,13,2,11,18,2,31,0,11,4,2,6,5,16,3,6,3,5,12,23,3,3,9,17,39,17,8,9,10,1,42,14,11,0,4,9,24,21,12,11,11,9,2,17,3,5,12,5,18,8,8,9,10,3,10,8,11,30,1,39,7,6,24,2,21,13,3,6,4,6,11,11,9,38,4,15,6,11,0,2,1,6,6,1,3,67,18,1,20,85,11,15,5,7,2,4,2,1,4,14,2,3,4,4,10,0,10,5,3,1,1,1,0,0,8,5,3,14,7,3,29,5,6,27,5,17,12,2,1,9,8,60,4,0,1,9,37,7,12,13,6,16,20,47,34,6,3,25,4,1,3,5,7,3,2,11,4,7,15,2,1,8,0,6,1,4,0,9,7,0,4,30,3,12,8,10,2,13,3,5,0,9,5,83,17,10,5,4,4,3,4,6,8,5,5,8,7,4,7,3,1,0,4,8,7,8,17,5,4,0,3,10,8,6,3,31,9,4,3,3,47,90,8,3,12,4,5,4,2,4,25,6,6,34,1,17,4,10,4,12,4,13,12,9,8,12,38,3,2,3,4,4,6,47,3,10,15,42,13,24,6,9,6,10,9,7,3,9,13,14,0,63,23,10,38,27,4,16,2,7,4,3,14,2,17,14,3,23,10,5,11,18,5,7,17,8,3,13,6,10,7,0,6,3,8,7,15,16,14,12,4,8,3,13,4,5,11,14,1,7,0,7,30,13,4,8,112,50,5,8,0,4,9,33,10,2,20,2,6,0,15,3,9,0,6,2,8,5,8,6,7,7,5,2,1,3,3,2,24,2,6,12,0,2,4,4,14,3,4,2,10,1,9,6,2,15,2,6,3,2,6,6,4,6,3,3,0,0,11,3,18,6,2,3,2,8,5,8,3,3,3,2,12,5,3,0,6,4,24,24,0,4,3,5,7,18,8,7,8,3,16,11,2,11,12,9,8,6,1,3,13,9,16,10,10,6,41,63,12,2,11,12,52,6,8,51,9,11,8,11,3,3,14,13,0,0,7,0,2,6,9,4,7,5,6,10,15,9,2,2,4,11,7,5,8,6,1,4,2,7,5,3,1,4,6,8,0,33,3,18,3,13,1,5,8,3,10,3,5,2,8,8,3,2,9,3,5,11,1,4,3,4,7,3,11,7,4,2,3,1,7,7,15,14,13,5,1,3,11,4,5,6,3,6,14,4,2,12,2,1,4,1,6,5,1,4,5,4,9,9,19,3,6,0,4,8,14,0,6,3,2,7,4,3,7,2,4,5,9,2,4,0,3,0,1,5,4,7,6,2,3,4,8,2,24,9,9,2,4,4,2,9,2,2,6,3,4,2,2,3,33,9,1,2,5,0,1,4,3,6,2,6,6,12,6,3,9,8,14,1,0,30,8,14,13,16,2,2,4,1,1,0,1,3,5,15,2,4,10,12,5,4,6,4,0,0,3,1,3,8,4,4,5,0,3,4,0,0,3,8,9,3,4,1,9,6,0,3,3,7,1,0,3,7,4,4,1
decade,0,8,3,13,1,12,1,3,3,2,1,2,11,33,0,1,8,2,7,4,1,10,27,19,4,10,12,18,5,18,0,36,38,9,9,45,24,3,6,2,3,8,1,6,14,0,10,1,21,67,10,6,6,53,18,0,0,4,14,11,2,2,1,2,16,12,22,6,1,1,12,0,2,1,42,7,14,0,19,15,23,8,2,3,17,6,1,4,11,1,4,1,10,12,12,4,13,0,12,4,1,8,0,5,5,8,1,4,13,6,12,0,13,12,18,19,0,1,10,18,5,19,10,75,14,4,2,3,4,5,13,1,11,12,9,35,0,4,2,8,4,11,8,1,2,29,4,17,3,0,6,3,5,3,5,6,30,10,5,16,17,2,7,4,5,15,3,4,6,2,6,30,3,7,7,1,2,1,6,23,7,2,8,8,1,9,7,6,2,26,3,1,4,1,7,5,5,2,8,1,12,2,5,1,3,9,1,7,5,5,20,11,5,3,4,17,14,13,4,1,4,3,0,2,6,8,4,7,3,7,1,16,10,7,9,4,8,2,1,3,13,7,4,5,7,0,1,22,7,4,0,3,7,0,0,6,0,3,0,8,0,13,0,0,3,2,4,14,3,1,16,2,2,3,1,5,5,1,1,0,19,0,0,1,5,2,20,15,1,4,0,2,4,8,1,1,2,1,1,4,10,0,0,4,0,6,11,1,7,1,0,3,7,4,9,1,5,6,0,1,4,0,15,7,6,1,12,25,1,4,5,4,3,0,1,0,5,3,0,2,1,6,14,1,2,2,2,5,3,16,1,4,0,8,1,3,3,0,4,27,2,6,7,0,0,8,3,3,8,14,1,17,1,11,2,5,0,0,2,1,7,2,7,4,5,1,2,3,8,1,1,3,4,3,1,5,1,0,3,0,7,8,2,8,3,2,3,1,4,5,1,1,6,1,2,6,4,1,3,8,0,3,3,0,3,1,0,1,0,4,0,2,0,3,5,4,3,6,6,5,3,2,0,6,1,7,23,4,6,7,13,0,12,1,12,1,5,3,1,2,7,6,7,9,0,1,16,4,1,2,12,4,1,2,1,1,1,1,5,4,1,2,2,2,3,1,3,6,0,0,19,2,3,5,11,0,0,2,1,0,0,0,0,3,3,1,2,0,4,2,0,0,0,1,0,0,7,0,0,5,0,0,0,4,0,0,8,0,1,3,1,1,4,3,3,2,0,2,6,2,1,1,3,0,9,2,1,2,1,1,0,0,0,9,0,0,4,1,0,1,0,2,0,1,2,0,1,1,2,4,5,1,0,1,1,0,2,0,4,9,0,1,2,5,0,0,2,0,0,3,5,2,5,3,2,0,1,4,2,4,1,1,3,1,0,1,1,2,0,0,7,1,1,3,3,0,0,0,0,0,1,3,1,4,0,0,0,1,0,2,4,0,5,3,2,2,4,1,1,1,1,3,0,0,0,1,1,1,3,15,2,0,3,0,2,4,3,3,1,1,0,0,0,0,0,0,1,2,0,1,0,0,1,0,0,0,0,0,0,0,1,4,1,0,0,0,3,3,0,0,0,10,0,1,1,3,1,1,1,1,3,0,0,1,1,3,5,3,0,0,3,1,0,2,2,1,5,1,0,0,0,1,1,2,2,0,1,2,0,2,0,0,3,1,1,0,6,2,0,7,4,0,2,7,1,0,3,5,1,0,3,0,0,0,2,2,0,0,1,10,12,3,0,2,3,5,0,0,0,1,6,0,3,1,0,0,5,0,0,0,0,0,2,3,1,3,0,0,2,2,5,0,0,1,1,0,0,2,0,0,0,0,1,2,7,3,6,1,1,0,3,2,1,2,0,0,0,5,0,1,0,1,0,0,0,0,7,0,1,0,1,0,0,3,1,0,0,6,0,2,0,1,0,1,1,0,0,1,0,2,4,1,0,0,3,1,1,0,0,2,0,1,0,2,0,0,1,0,4,0,1,0,1,0,3,2,2,0,1,1,1,0,0,0,0,0,0,1,0,1,3,0,5,0,0,3,0,1,4,6,0,0,2,2,1,0,0,0,1,4,0,1,3,0,0,0,0,0,4,0,0,1,1,0,1,0,1,0,0,0,0,0,0,1,0,0,0,0,0,0,1,7,0,1,4,2,4,1,1,0,0,2,1,0,0,1,1,0,0,1,0,0,0,0,3,0,0,1,0,1,1,1,5,5,0,0,4,0,1,2,0,0,0,0,0,0,3,4,1,1,0,1,0,4,4,2,1,0,2,10
spend,2,8,7,28,0,14,1,3,3,0,0,4,12,36,2,0,3,3,14,2,1,6,20,27,8,17,7,4,5,16,5,87,39,5,36,48,7,0,6,3,6,4,0,8,10,1,13,6,43,33,15,4,5,22,21,0,7,5,10,8,0,4,2,4,12,5,39,1,4,7,30,1,3,4,55,6,18,1,36,12,22,6,3,4,86,65,1,21,10,8,6,3,27,2,10,15,7,4,15,1,6,15,6,11,13,14,4,23,12,9,12,2,26,18,17,13,1,5,5,49,20,17,41,94,10,3,3,5,3,7,13,1,2,15,21,27,2,1,7,8,5,9,9,3,2,45,2,19,5,12,6,5,9,3,4,41,29,7,3,28,20,12,11,5,65,25,1,9,9,3,9,41,22,7,2,5,26,0,4,36,6,0,21,15,9,5,21,11,7,19,4,6,6,7,1,2,9,4,5,3,7,12,7,1,6,4,5,8,3,6,23,4,14,8,6,27,28,32,8,2,7,16,1,8,8,14,15,18,4,61,14,12,15,10,14,3,26,4,6,4,14,12,5,4,5,6,2,18,12,10,2,4,9,1,0,11,1,8,0,14,5,8,3,0,0,10,18,3,8,0,17,17,12,3,0,4,2,19,1,0,47,1,4,3,10,0,17,26,2,3,0,4,11,11,7,1,5,1,2,1,7,2,9,2,2,9,1,0,8,1,2,7,13,5,27,3,7,17,2,1,3,2,20,15,10,0,9,32,1,10,3,6,1,0,6,4,7,1,2,6,1,8,7,1,2,3,6,10,1,20,3,3,4,21,5,4,2,2,6,9,9,4,12,8,0,1,4,2,18,22,1,6,2,1,3,4,7,0,5,0,10,7,11,0,3,10,5,6,11,2,1,2,6,3,3,5,3,0,9,2,2,2,2,2,4,1,1,0,2,1,0,1,1,7,1,0,0,1,1,1,0,3,11,4,2,2,0,4,3,2,3,0,0,0,4,4,3,0,14,0,6,2,4,0,2,2,11,1,8,1,14,2,5,2,9,3,1,2,5,14,4,13,11,9,3,2,10,12,3,2,19,3,1,9,2,10,3,1,6,6,5,2,1,8,3,1,2,1,1,1,30,10,1,2,1,0,1,2,1,2,4,14,2,1,3,3,4,0,1,3,0,0,3,2,0,1,4,5,0,5,0,0,1,0,1,0,6,2,4,3,3,3,4,1,1,3,0,7,13,5,2,1,0,2,5,5,0,6,2,1,2,1,0,10,0,6,5,1,1,0,2,1,1,3,5,3,4,3,11,11,4,0,15,1,2,0,2,6,5,15,0,1,1,7,1,1,3,2,0,7,2,5,4,1,1,1,6,1,3,3,3,6,0,0,0,7,2,1,2,2,14,7,2,0,6,1,3,1,0,0,2,0,3,2,4,1,1,1,2,2,0,6,6,3,6,1,6,4,6,4,3,3,2,1,3,7,0,10,2,19,3,0,3,1,3,6,11,4,3,0,1,1,0,1,1,0,0,0,2,0,0,1,0,1,1,0,0,0,3,2,5,5,1,0,0,0,4,2,0,0,0,2,1,1,3,8,0,0,3,1,1,0,1,3,0,3,8,1,1,0,3,1,1,6,6,7,4,3,0,9,2,0,1,4,0,2,7,2,0,3,1,4,3,5,1,1,18,3,1,1,4,1,4,0,0,2,7,9,0,1,4,3,7,4,6,4,2,0,1,3,2,6,0,8,5,5,0,5,2,2,1,2,2,2,0,1,3,5,6,3,0,1,12,3,2,2,2,1,2,0,3,1,0,0,8,13,2,1,2,0,4,1,0,0,5,10,3,3,3,2,2,2,0,3,0,0,4,4,0,4,0,2,1,2,4,1,3,4,3,7,4,2,1,4,2,1,1,5,0,2,0,0,1,0,2,2,3,5,2,1,3,2,1,2,3,1,0,0,0,3,1,0,6,0,1,2,3,0,3,1,1,3,4,0,0,1,0,0,1,2,0,0,0,1,1,2,4,0,1,0,7,2,3,0,0,2,1,13,6,4,1,0,3,0,5,0,1,0,0,5,1,6,0,1,1,0,0,2,0,4,0,1,1,1,0,1,0,0,2,0,1,4,0,1,1,1,1,0,3,4,3,1,5,1,9,3,5,14,6,1,2,4,2,0,3,1,0,0,4,1,0,1,1,0,0,8,1,0,0,1,3,0,3,3,0,0,7,0,2,0,0,0,3,0,2,8,2,6,0,10,0,0,1,4,1,7,3,1,2,3
second,0,11,1,48,7,8,2,10,1,2,8,10,9,39,3,2,8,11,2,3,4,14,6,9,5,4,8,7,2,10,5,61,41,2,15,33,27,6,13,2,8,12,1,4,21,7,12,19,84,21,19,6,7,37,5,0,19,7,9,3,5,3,1,10,19,4,40,3,2,6,6,0,1,0,60,11,7,2,41,7,31,1,5,8,101,2,7,5,21,4,9,3,2,15,32,11,9,1,19,6,5,14,15,10,11,4,9,7,7,6,86,5,16,10,6,10,2,4,34,55,10,18,20,52,5,3,2,5,5,1,9,2,4,19,7,31,1,5,4,2,0,17,17,3,1,34,10,15,7,5,23,2,6,7,3,23,23,3,2,23,5,7,8,3,19,7,3,17,15,5,3,49,8,6,0,5,57,1,3,21,7,6,10,9,1,5,13,8,12,39,2,1,3,5,2,1,19,7,11,10,18,2,4,9,14,4,5,16,9,8,23,7,8,5,0,10,5,6,10,4,4,13,1,12,7,25,10,8,3,14,6,23,18,19,13,15,9,5,8,1,36,6,6,3,10,1,7,16,21,2,4,11,12,2,0,8,4,0,1,2,1,9,6,2,1,12,2,7,7,3,32,9,13,2,2,2,7,7,1,2,27,9,3,8,7,1,5,5,5,3,3,3,6,3,2,6,22,1,3,5,12,10,3,2,7,2,11,3,6,2,6,17,12,4,25,6,3,9,2,5,15,1,11,5,15,2,6,13,5,15,5,10,4,0,2,6,8,2,7,13,5,3,5,4,5,9,14,25,1,12,5,5,0,27,7,2,2,1,8,17,4,6,9,8,2,7,9,2,8,8,0,14,8,8,5,16,5,5,5,5,36,3,10,6,0,27,3,7,6,0,5,3,2,4,11,7,15,2,13,1,6,3,3,0,1,6,4,0,9,4,2,2,2,12,6,3,1,5,3,6,4,2,10,3,0,3,5,5,4,9,7,3,0,4,2,1,3,2,10,2,10,8,3,7,2,5,10,6,10,4,10,8,6,1,14,3,1,7,9,12,4,11,10,12,3,1,7,7,5,0,10,0,2,6,4,8,3,8,8,4,4,2,0,2,2,0,4,3,1,4,34,14,1,4,2,5,2,8,7,4,13,2,0,1,6,5,5,5,5,2,1,0,1,5,3,5,1,1,4,5,2,5,5,7,1,1,10,5,5,9,3,3,1,3,5,2,4,1,19,13,2,4,5,4,7,2,5,5,3,3,9,0,5,27,1,2,12,2,2,4,7,1,6,1,2,7,4,1,9,13,6,3,4,8,2,5,3,5,3,12,2,8,6,5,2,1,1,3,3,6,4,6,8,5,15,1,9,7,9,4,4,3,1,4,2,4,1,14,5,4,11,9,5,2,4,5,8,3,0,1,6,9,3,12,4,2,3,4,2,9,10,4,6,8,3,0,12,3,0,1,8,0,7,16,3,9,6,5,3,44,2,7,3,8,2,4,9,6,1,7,0,5,5,5,3,4,0,7,2,4,6,3,10,6,2,3,1,1,5,1,4,13,3,7,4,9,7,3,0,3,8,9,3,5,1,9,5,3,4,3,2,2,2,1,4,4,5,3,3,1,3,4,2,4,8,14,4,2,9,7,9,0,4,8,8,8,2,3,3,5,1,2,10,4,4,3,8,3,11,4,0,3,1,7,6,2,6,12,2,2,4,1,7,4,2,8,2,4,8,6,3,8,5,10,10,11,0,0,4,2,2,3,1,6,2,5,2,3,2,1,1,2,3,0,5,5,4,4,3,2,3,3,2,1,9,2,0,4,0,2,1,5,3,8,3,1,3,5,6,1,2,1,0,9,1,6,2,0,2,7,2,2,22,10,3,2,4,4,5,1,1,1,3,5,5,1,0,15,3,0,1,2,1,3,2,8,5,3,2,4,2,9,3,1,2,6,2,4,0,34,2,0,1,2,3,5,2,1,2,6,4,2,5,14,3,2,0,6,5,1,1,8,5,4,1,7,2,2,5,2,4,8,1,1,0,4,3,2,8,9,2,0,3,3,9,3,0,10,1,8,2,2,1,3,2,3,1,3,3,3,1,0,1,2,1,4,2,0,3,5,4,6,3,2,4,3,3,1,1,5,0,7,6,3,3,19,5,8,18,1,3,3,1,1,1,1,0,2,3,2,29,9,3,3,0,4,0,1,0,1,4,1,4,3,0,0,2,6,2,0,0,3,0,9,1,2,1,4,8,1,3,3,5,3,1,4,2,1,4,4
plan,4,42,21,281,11,28,5,39,10,6,16,45,28,93,8,6,16,22,15,9,15,68,43,79,30,60,13,24,14,18,8,363,168,13,71,86,46,25,22,17,6,9,7,12,48,17,136,29,272,44,65,17,8,42,39,5,45,72,25,28,16,2,8,34,71,24,129,21,12,22,46,10,12,14,225,36,53,13,122,43,93,8,26,17,280,45,39,13,27,11,14,9,30,28,81,36,21,13,61,30,45,57,39,14,24,50,20,41,20,10,42,22,41,43,33,38,9,14,90,312,69,62,101,176,12,5,6,7,12,22,37,2,12,91,29,188,3,8,20,9,7,63,36,7,6,123,7,20,24,27,83,13,19,17,20,78,40,43,9,79,72,14,32,24,30,48,8,24,50,35,46,115,48,14,23,8,159,8,16,142,55,27,48,46,14,31,50,35,38,63,10,6,6,5,9,19,1,23,36,25,79,30,30,21,35,20,34,97,27,47,128,28,38,11,11,40,35,34,27,34,9,25,7,33,76,109,37,41,18,21,33,49,46,52,39,27,23,21,31,7,95,41,13,7,27,23,19,59,121,26,44,25,35,19,13,43,14,17,9,28,17,45,59,10,17,101,20,9,17,12,195,39,34,17,9,16,35,20,10,29,86,10,10,33,12,9,70,60,20,5,4,3,31,20,16,15,64,8,11,19,31,96,4,15,13,23,37,6,13,12,4,57,62,14,83,39,39,55,47,6,32,14,42,20,64,11,26,68,6,37,2,20,3,18,9,31,22,17,16,19,24,16,49,11,9,22,74,71,24,31,18,17,9,66,18,22,18,16,21,42,30,41,34,51,5,11,64,10,31,20,7,33,8,32,23,38,10,10,15,14,90,9,60,14,7,56,5,24,39,2,21,21,25,12,51,29,80,34,59,6,26,12,13,12,20,15,8,1,29,26,4,10,5,30,3,11,8,10,10,8,4,6,55,14,2,10,5,18,12,14,62,12,3,13,11,12,3,9,37,8,16,27,19,19,2,7,35,5,48,15,59,4,21,27,52,33,3,4,22,42,27,23,54,54,10,5,40,15,34,7,20,14,4,6,8,8,4,23,36,14,5,26,5,10,7,11,31,7,8,2,102,91,6,12,10,6,6,24,8,15,14,14,4,35,23,86,9,22,18,6,7,4,12,11,21,26,17,16,7,14,3,15,15,22,3,13,41,9,15,35,17,16,17,11,21,14,12,17,47,32,7,4,1,15,19,38,2,36,16,19,26,8,5,52,27,20,32,4,11,14,62,7,26,14,25,33,16,13,57,86,15,14,21,1,10,3,6,9,20,51,10,24,18,18,15,15,17,7,2,25,32,36,20,23,32,4,10,9,13,38,79,9,11,0,3,47,10,41,28,6,39,70,29,5,35,12,40,2,14,7,41,28,14,88,21,15,7,48,16,45,34,36,27,22,8,13,27,21,9,11,16,9,12,56,13,81,10,11,17,111,10,12,9,7,6,8,54,16,7,9,27,11,1,6,4,2,4,8,18,13,19,16,25,39,14,9,13,8,6,14,34,75,10,11,18,8,12,23,2,10,15,21,21,11,10,38,12,4,10,21,3,16,3,12,18,30,19,29,6,4,2,5,3,40,32,39,7,7,20,24,14,8,4,40,7,15,12,8,5,24,26,25,7,12,4,11,50,4,30,11,21,6,22,25,12,18,22,48,14,5,17,5,6,1,6,26,5,32,8,43,41,29,7,12,34,20,54,11,14,14,14,3,12,15,5,27,26,11,22,23,6,4,9,18,10,9,15,11,15,17,19,37,18,10,8,42,27,9,1,9,13,9,19,4,10,15,12,8,18,5,1,8,2,8,6,9,6,19,4,20,2,4,12,62,27,6,20,35,7,6,24,6,19,4,13,4,13,31,5,14,3,13,8,6,9,10,17,8,24,7,12,43,10,4,10,10,19,13,3,9,6,9,13,12,1,18,4,25,11,43,11,11,29,43,3,7,1,4,17,3,1,7,13,3,13,4,10,9,11,29,6,21,10,5,2,9,9,13,9,11,15,8,6,10,6,3,16,29,3,32,21,5,8,11,13,13,15,19,6,6,10,8,12,5,3,20,2,2,7,26,5,23,11,7,1,3,19,8,2,53,11,12,6,2,10,34,17,26,99,2,17,12,9,24,12,6,8,7,45,4,5,10,7,23,14,13,13,12,6,7,12,8,14,12,5,6,4,5,12,2,27,12,4,17,7,4,13,20,2,10,4,10,1,7,12,15,13,8,6,4
base,4,12,3,71,3,9,5,13,2,3,10,7,20,82,1,6,5,14,9,6,0,18,18,22,19,19,20,17,8,17,6,134,71,18,22,61,43,4,4,17,6,13,1,6,24,11,17,17,88,33,31,27,9,46,7,2,16,13,7,16,8,9,4,9,27,9,67,4,2,12,11,1,4,1,115,12,15,1,61,23,36,8,4,9,113,14,11,2,17,4,6,7,9,17,28,16,20,5,39,14,7,20,7,9,21,18,12,6,7,4,14,5,12,21,10,12,6,2,51,77,26,25,23,52,9,4,5,1,0,4,18,10,9,43,12,52,9,4,4,9,8,35,15,9,3,33,3,11,6,4,35,2,12,10,9,21,23,4,6,27,19,1,4,5,13,9,5,11,25,6,17,58,19,3,6,3,159,8,7,45,11,7,18,15,1,13,20,11,24,27,2,3,2,2,4,7,23,1,9,17,14,6,3,6,13,12,10,37,12,30,36,7,14,7,4,11,7,6,14,1,9,14,4,2,24,58,25,22,4,7,15,11,13,22,25,21,15,10,10,4,44,18,3,8,17,4,5,28,37,5,11,5,14,1,3,13,3,1,3,12,6,28,11,2,8,35,6,19,17,3,61,11,17,3,7,4,15,14,0,0,42,5,1,14,10,10,16,17,17,2,8,10,5,2,7,1,15,3,4,27,12,17,4,6,9,8,18,3,9,2,5,14,27,18,27,10,10,33,10,11,14,4,24,5,51,1,11,30,0,17,5,6,8,2,8,5,10,0,2,9,3,10,7,6,6,4,24,19,5,6,5,8,4,23,12,2,12,3,14,25,18,4,18,13,2,5,12,8,22,15,3,28,6,15,10,28,2,3,22,4,41,9,20,10,15,18,1,15,9,9,26,6,2,7,8,12,23,4,17,4,8,3,8,5,2,7,1,5,21,10,7,3,1,12,1,8,5,4,3,14,7,10,22,8,4,3,3,10,9,13,9,4,0,11,7,4,5,9,13,6,13,17,4,15,3,4,22,6,30,5,33,0,6,2,31,5,5,2,14,12,13,14,25,30,5,12,13,6,1,3,25,8,2,4,5,23,1,3,11,8,3,10,1,2,3,4,2,9,2,3,42,14,3,5,7,0,5,1,6,3,8,7,3,8,15,14,4,12,5,3,2,2,3,2,6,11,5,11,6,8,1,6,3,9,2,10,10,14,11,19,8,6,14,7,12,3,4,6,23,10,1,4,4,3,6,4,2,12,7,4,9,0,2,19,14,4,11,5,3,2,6,2,10,2,6,6,12,5,29,22,4,1,5,1,10,1,7,5,2,13,2,4,6,17,2,8,1,4,0,6,32,20,13,4,17,1,12,6,9,9,10,5,3,2,5,9,7,10,12,0,14,18,9,4,16,5,4,4,7,2,9,5,1,16,5,2,0,3,10,25,3,8,18,12,6,11,11,8,2,2,22,5,18,14,3,11,6,3,7,56,7,6,1,3,6,9,20,11,0,6,0,4,2,8,3,2,3,1,4,5,7,7,3,9,5,5,2,2,2,3,11,22,6,10,4,3,7,6,0,4,6,23,7,8,6,4,4,2,5,3,6,2,2,1,2,3,8,6,0,1,7,6,0,15,4,13,6,5,10,1,4,8,1,8,3,1,3,5,7,12,1,4,1,6,3,6,12,0,10,2,11,4,4,4,7,8,4,12,4,4,5,9,6,7,7,5,2,5,4,14,10,19,1,6,9,9,3,4,5,5,10,5,3,7,4,4,15,2,0,4,0,2,9,6,3,7,2,0,2,5,4,8,9,3,4,10,8,1,1,3,7,0,7,2,14,2,2,2,10,3,0,2,1,3,4,6,2,8,4,10,0,0,3,10,0,0,10,10,5,3,3,3,9,4,6,8,3,17,4,2,1,0,0,14,4,7,2,12,0,2,6,13,8,0,3,5,8,4,2,6,1,3,4,6,1,1,1,0,3,12,1,2,4,16,1,3,1,3,10,3,0,4,3,1,6,0,7,3,3,4,2,2,6,3,0,0,0,0,7,11,0,1,4,2,2,3,1,8,2,12,4,8,2,3,3,3,2,3,3,3,2,9,3,0,9,4,2,4,5,7,8,3,4,2,1,2,7,2,4,1,0,5,6,1,7,6,3,17,10,0,5,3,2,4,3,3,1,3,8,3,2,0,1,6,1,7,3,11,2,1,7,3,4,10,2,3,2,2,5,1,8,3,3,4,0,1,8,15,2,2,4,7,2,3,1,5,3,1,2,6
four,0,41,8,111,6,14,5,20,3,2,8,19,27,48,4,5,14,22,9,7,6,40,21,19,11,20,11,8,9,23,5,184,114,19,42,52,26,6,17,11,11,12,1,11,34,7,41,34,216,32,34,8,8,41,26,4,24,38,12,28,9,8,3,9,24,11,77,10,4,12,94,6,6,3,61,12,40,4,100,17,83,8,12,8,153,15,16,6,83,10,42,8,14,24,53,15,24,7,40,11,30,22,31,3,66,25,15,21,45,26,30,4,25,20,23,30,8,4,56,139,19,35,35,370,28,2,5,8,33,6,19,5,18,46,16,68,4,14,8,12,2,24,24,5,7,75,13,17,11,12,32,4,12,14,3,37,25,17,5,32,26,5,7,11,23,18,25,20,38,13,41,171,20,6,6,5,108,3,2,38,13,13,15,18,2,15,27,19,22,110,2,6,7,8,5,11,36,9,1,13,27,7,9,7,25,9,13,24,9,28,52,17,25,16,11,11,9,13,32,3,15,20,4,15,34,80,43,34,47,28,11,79,33,20,36,29,24,13,10,4,60,22,20,9,12,5,4,34,72,8,11,21,21,30,11,8,9,10,3,50,3,22,19,3,7,49,13,12,12,5,86,7,61,7,7,6,13,20,11,1,51,9,2,23,18,13,16,8,8,3,10,7,24,20,11,8,37,11,4,20,15,32,11,17,4,8,15,11,8,4,8,14,24,11,59,18,12,39,19,6,30,4,29,17,20,3,22,27,7,37,10,12,6,2,11,14,12,2,5,22,7,13,13,8,8,4,29,31,18,27,10,8,6,33,19,3,15,7,18,41,23,17,21,10,0,7,22,9,16,15,4,26,7,17,14,52,6,10,10,7,46,4,24,8,11,21,5,25,35,2,15,7,8,10,18,8,27,4,24,7,16,9,3,3,6,9,10,0,18,8,1,6,13,14,3,9,3,3,1,1,1,8,15,11,6,10,4,9,13,24,24,15,8,20,8,5,1,2,17,8,6,16,3,19,6,5,23,5,22,12,21,2,10,6,48,4,3,6,6,10,13,31,24,41,12,3,28,9,8,3,15,3,8,8,4,15,2,16,20,8,2,13,8,6,10,17,13,7,6,5,63,38,5,7,6,6,4,17,6,5,12,7,12,12,2,55,20,12,8,3,4,1,3,7,18,8,6,5,1,7,2,9,3,21,2,8,14,13,22,21,6,7,6,7,4,3,4,6,22,23,3,6,6,11,8,5,19,14,9,8,32,3,12,55,7,4,18,4,5,13,14,8,17,8,11,9,16,12,21,19,14,2,19,5,10,4,5,4,7,31,4,3,3,13,5,3,7,3,4,12,21,15,18,2,16,3,5,7,19,7,12,4,9,6,6,22,4,20,5,3,24,26,9,6,36,13,8,6,5,2,10,24,4,18,8,10,4,5,7,34,21,14,7,23,5,5,6,27,5,21,11,10,8,31,2,37,10,10,10,91,14,4,11,8,4,14,25,12,3,16,5,5,17,9,6,1,1,1,5,11,20,4,29,14,28,5,3,1,12,5,8,16,7,7,14,7,11,3,13,31,21,13,12,21,9,22,10,3,6,4,20,3,4,5,6,8,9,11,0,0,0,19,1,16,18,38,8,3,0,13,6,5,4,40,11,9,10,2,5,16,7,11,2,5,0,5,48,6,18,16,4,1,13,48,6,4,25,21,7,1,7,14,9,44,20,12,6,9,4,44,42,12,14,17,12,7,20,6,17,6,6,3,6,3,2,13,15,8,6,6,4,1,8,7,21,8,9,8,18,4,7,11,7,7,2,14,0,9,4,6,2,8,13,4,2,2,6,3,10,4,8,3,5,22,2,1,6,5,7,8,0,9,7,31,2,5,7,11,15,3,12,11,8,2,3,5,6,17,7,1,3,11,5,5,11,14,5,4,11,9,11,15,5,4,7,6,2,7,2,8,4,1,3,17,2,5,3,9,10,21,5,6,15,13,5,9,2,3,4,6,2,10,6,2,17,2,5,8,8,10,8,9,15,2,4,19,1,9,37,14,4,9,2,5,34,14,2,8,6,12,8,14,1,24,10,9,8,2,13,1,1,2,3,7,5,3,3,7,1,19,3,8,7,3,4,8,7,8,2,10,5,10,15,9,13,29,12,39,45,6,15,6,8,2,3,10,18,13,22,0,7,9,7,3,10,37,1,8,10,3,9,8,6,7,4,4,3,3,6,1,14,2,3,17,5,4,4,11,5,6,0,2,11,3,6,10,4,8,9,6
individual,8,14,19,113,12,15,11,65,4,6,10,9,18,203,5,27,6,27,8,5,6,42,17,32,30,19,24,13,7,20,14,217,128,15,90,81,69,7,8,7,17,31,4,5,59,17,30,15,337,20,56,20,21,44,17,15,86,12,3,27,15,22,10,5,26,12,157,22,7,16,21,5,5,3,152,16,20,4,73,36,64,3,13,6,354,29,22,1,29,3,1,7,11,29,71,16,24,13,29,24,10,23,31,18,15,23,10,7,9,6,25,11,13,16,6,26,3,7,72,179,64,19,75,73,12,7,11,4,4,3,23,5,15,57,24,49,47,6,6,19,19,55,24,2,3,57,9,25,14,19,114,3,23,8,13,39,50,18,16,15,13,5,19,3,10,6,7,52,46,13,9,190,30,2,7,14,222,12,29,38,42,20,18,40,3,32,57,29,38,38,14,10,6,1,3,10,25,17,13,1,68,9,8,17,29,23,8,58,11,34,97,7,29,17,2,2,1,5,14,4,2,71,3,14,53,168,24,40,2,18,24,13,15,57,66,19,51,22,12,8,80,38,8,12,27,14,5,64,51,10,11,26,16,12,16,29,12,3,4,12,9,29,19,2,14,31,14,15,15,9,163,13,32,11,2,2,33,7,7,4,104,16,2,26,19,6,7,16,38,3,3,5,21,4,1,10,38,7,6,56,36,28,3,4,14,8,54,11,16,7,5,55,28,7,44,21,39,48,17,9,59,15,41,10,161,9,14,35,7,37,6,19,26,4,15,17,33,5,3,9,18,7,6,16,5,8,49,71,21,17,20,15,15,41,50,3,4,10,26,39,26,16,14,34,13,3,35,13,9,35,0,20,4,35,24,23,12,9,39,18,81,10,60,14,10,59,20,28,45,28,50,6,5,3,29,22,61,2,37,1,33,1,4,4,12,23,8,5,19,25,12,6,3,39,6,12,4,8,8,2,23,12,44,22,0,7,3,44,14,24,12,5,1,2,8,6,0,2,10,8,16,27,10,11,7,1,12,5,41,5,17,13,9,10,78,12,6,11,7,30,17,42,66,45,7,5,19,13,24,0,32,13,10,10,3,73,6,13,27,1,8,31,1,12,9,9,9,7,19,6,93,29,4,9,13,6,3,19,10,23,17,11,5,8,11,63,7,20,4,14,7,12,11,12,17,23,11,20,12,10,2,28,14,53,16,9,25,61,19,55,17,19,11,31,11,16,16,16,70,40,17,2,5,9,10,8,6,18,17,10,70,9,6,45,7,20,38,10,18,6,24,0,23,7,19,18,18,16,41,54,19,10,9,2,10,4,5,4,10,16,7,6,14,30,20,29,8,11,0,9,32,47,13,12,35,12,12,5,13,29,31,5,6,4,4,21,6,30,14,4,29,9,13,7,46,10,33,3,14,4,20,11,10,22,3,11,5,5,22,34,10,16,57,44,20,11,50,16,7,11,24,20,14,25,11,17,7,2,11,117,9,12,16,8,12,13,42,30,11,19,6,6,3,21,2,2,1,6,8,15,37,13,17,22,23,13,2,6,3,4,8,27,25,8,13,7,19,16,2,7,9,26,22,7,1,3,13,3,24,11,8,13,4,11,12,9,24,6,3,4,11,7,12,18,13,15,4,12,1,9,4,9,10,22,4,7,7,9,11,13,14,12,5,15,4,4,14,8,24,18,19,6,5,8,11,9,14,10,4,8,13,5,5,3,2,10,8,13,7,12,10,20,3,3,18,34,7,7,21,7,14,4,2,16,6,24,19,5,27,22,10,5,18,11,21,4,9,11,6,21,3,3,1,11,22,25,3,14,0,5,11,4,12,4,5,5,15,20,18,4,9,2,6,3,5,2,5,9,4,20,8,5,3,15,3,7,7,7,13,5,5,4,33,13,10,12,9,36,7,3,4,14,11,4,13,13,12,7,6,13,9,47,23,15,4,4,27,9,7,3,4,12,16,3,4,12,14,1,8,16,6,2,9,21,8,12,4,11,4,1,0,4,6,4,7,2,2,4,3,1,2,4,0,4,9,2,2,3,5,14,13,3,3,6,4,1,4,23,1,18,8,13,9,9,7,4,1,3,3,4,8,7,9,3,1,10,1,6,3,9,7,13,3,7,10,2,7,3,8,10,8,16,4,1,7,17,34,4,31,3,0,10,8,10,4,3,1,4,11,11,5,3,7,2,6,13,5,4,3,3,6,19,12,7,4,8,1,6,7,6,3,7,5,8,10,19,16,3,6,3,5,6,6,0,1,25,2,5,3,17
business,3,26,25,274,15,28,15,42,20,16,12,14,35,151,7,24,20,47,20,9,16,99,67,105,78,57,31,42,26,41,3,526,424,37,148,125,27,33,71,6,24,12,9,25,95,31,70,78,453,82,119,37,69,122,45,0,134,70,32,37,17,12,6,33,113,23,268,25,29,32,67,0,27,10,304,47,85,13,207,92,206,33,30,25,535,82,45,9,86,9,51,23,25,33,243,96,39,31,86,99,25,94,60,30,42,93,43,42,52,18,50,14,61,104,90,79,15,23,126,387,109,73,115,228,39,8,11,6,17,11,26,7,16,126,53,189,28,11,32,21,23,149,61,12,13,161,26,64,76,38,144,36,43,19,31,128,137,41,12,93,71,13,31,19,34,73,16,92,86,26,59,241,96,8,29,23,399,5,14,191,103,23,33,111,11,126,136,76,75,101,23,18,28,12,7,18,79,14,27,68,1,26,58,18,54,18,23,136,25,78,205,39,64,40,15,60,26,21,55,5,20,40,8,27,113,343,102,81,15,32,41,30,94,103,100,99,86,68,59,15,154,71,20,29,51,25,17,94,131,28,24,100,54,26,31,52,29,7,11,41,33,40,31,4,32,214,37,20,30,22,226,36,113,12,3,8,44,64,20,18,193,52,12,64,40,12,33,41,51,14,9,7,43,19,11,16,72,29,19,48,62,55,7,10,66,5,39,26,47,19,21,104,76,36,111,67,57,130,83,32,63,12,75,26,112,11,42,82,13,61,6,58,27,24,32,40,48,21,24,31,35,16,44,18,9,12,113,89,52,40,38,65,8,104,60,21,17,9,48,89,110,29,70,47,23,16,66,29,45,82,16,49,22,117,49,61,18,40,46,26,106,10,94,49,23,62,33,63,62,11,46,8,45,16,59,25,121,20,68,18,31,7,16,27,31,65,42,2,85,41,8,16,35,73,1,16,1,10,15,5,24,20,82,32,17,20,7,62,12,48,56,12,4,9,18,11,6,8,4,14,60,30,27,29,3,10,46,12,138,16,39,7,27,11,126,26,1,10,55,64,51,68,71,167,30,26,83,31,24,17,29,27,8,10,5,108,7,25,77,27,34,30,8,10,52,26,38,14,24,11,64,88,6,9,54,11,24,33,13,64,59,36,15,32,66,158,46,43,35,24,18,28,16,50,56,45,19,35,66,31,3,64,37,94,18,10,104,120,59,101,37,27,19,51,21,31,10,69,91,129,16,12,20,70,50,29,3,45,38,24,36,9,27,76,43,40,97,18,24,38,42,11,47,9,35,40,40,50,73,132,22,12,19,19,15,6,77,22,19,57,27,24,33,68,34,50,30,30,20,27,60,72,38,22,155,19,52,60,15,52,31,28,16,1,14,44,18,46,46,16,98,68,24,19,101,16,38,50,37,11,44,43,19,63,18,20,5,30,29,72,61,58,99,64,43,11,76,17,9,22,45,6,32,36,16,57,41,8,30,159,51,11,26,13,16,24,48,54,17,31,9,7,8,20,3,0,0,13,23,23,34,23,12,164,35,11,9,11,2,5,4,77,19,11,29,11,27,11,5,8,12,41,25,3,17,21,16,5,34,20,36,11,12,14,27,13,61,9,14,8,7,7,9,54,48,7,2,11,13,24,10,24,11,30,11,26,40,23,5,31,33,37,29,26,25,6,16,20,33,17,46,3,18,22,7,15,28,50,18,20,24,39,19,31,28,24,19,19,22,80,79,37,5,18,44,66,36,43,54,13,14,14,14,26,9,41,67,23,5,22,4,11,40,24,36,19,19,3,20,44,16,14,6,13,114,49,39,15,12,17,23,6,18,8,34,12,27,13,37,4,32,4,16,21,20,14,15,26,6,23,4,16,35,42,12,5,20,14,39,11,32,15,33,7,14,20,10,59,14,17,7,19,36,27,40,39,20,28,18,39,27,60,24,20,18,21,41,24,20,6,13,14,15,24,20,9,15,8,7,33,32,7,32,99,18,20,6,5,21,6,3,26,6,4,17,5,14,19,7,8,17,7,11,14,15,1,4,10,21,4,28,3,6,20,1,14,1,38,15,32,18,29,15,23,16,5,22,2,20,11,8,10,12,19,3,7,2,12,10,37,11,21,14,5,12,27,19,18,20,14,9,25,34,2,51,53,31,36,91,4,0,13,10,10,7,9,6,1,21,4,19,3,9,9,13,13,9,7,5,3,6,7,38,12,6,6,9,8,19,4,20,23,6,57,14,20,19,36,0,12,13,17,12,2,14,25,36,8,9,1
saving,0,3,4,35,1,6,0,2,2,0,2,0,6,23,0,1,1,14,3,0,1,12,14,7,6,14,1,4,5,11,2,84,32,6,10,11,4,9,8,0,8,2,0,2,13,2,21,8,45,14,7,12,6,6,7,1,8,16,5,4,3,1,0,0,7,1,52,7,4,6,24,0,3,1,57,4,17,4,26,18,37,12,2,1,66,38,7,4,4,5,11,2,11,13,18,8,10,2,15,10,2,11,6,3,7,13,13,13,11,5,1,3,22,3,9,7,1,9,9,63,21,25,37,44,2,0,2,6,2,1,3,0,6,21,8,25,0,3,4,8,1,23,8,3,1,13,2,7,16,10,11,5,0,4,6,19,5,7,0,23,22,0,21,5,25,9,3,9,11,8,4,19,9,0,5,2,38,0,1,16,4,4,12,10,0,12,14,4,2,11,3,0,1,2,12,2,30,6,7,9,26,1,17,2,6,6,6,20,1,9,27,1,7,7,0,14,5,13,14,0,5,4,1,6,14,18,10,10,1,22,4,3,21,12,12,6,12,16,4,1,17,9,8,2,6,4,6,21,17,13,1,15,8,3,2,7,4,5,0,25,6,5,8,0,3,4,12,5,2,1,23,14,29,2,0,2,12,9,0,0,30,4,1,9,5,2,28,15,1,1,1,1,5,12,3,6,12,1,1,3,8,11,6,2,11,12,7,0,5,4,1,4,13,3,28,10,12,28,12,3,5,0,6,1,10,2,15,1,1,5,0,6,0,1,4,4,3,2,6,5,1,4,7,1,1,1,8,10,3,14,3,12,1,22,0,2,5,1,8,16,11,8,0,8,1,1,1,0,15,16,0,6,7,5,7,21,5,2,1,0,13,1,12,5,4,6,0,2,7,5,0,1,1,0,3,5,5,2,11,4,1,1,1,0,4,8,1,0,4,6,0,2,2,4,0,0,3,2,2,0,0,3,11,0,6,0,1,0,2,0,11,3,0,0,0,3,0,0,8,4,3,6,1,0,0,0,4,4,9,3,26,0,2,5,18,2,2,0,4,13,7,12,9,15,2,0,19,3,3,5,18,4,3,0,1,4,0,1,8,4,2,0,0,0,3,0,2,1,3,0,17,19,1,0,4,2,4,4,1,7,4,16,5,22,14,50,14,4,5,2,4,1,2,5,7,1,2,8,0,6,0,10,4,2,3,1,7,8,0,1,5,3,1,2,2,5,0,13,20,12,0,3,2,11,12,2,0,11,1,2,3,0,0,11,4,8,6,5,3,2,4,2,1,0,3,3,0,0,4,12,5,0,4,0,1,2,0,0,4,7,0,5,8,0,2,0,3,0,0,3,5,4,3,5,17,0,2,11,0,7,4,4,3,0,0,3,0,2,4,3,10,4,0,3,3,1,6,1,2,0,4,4,0,7,5,0,0,1,0,2,8,10,7,7,6,0,3,1,2,4,0,2,3,2,0,12,7,0,8,21,0,2,1,0,0,3,6,2,0,1,0,0,0,0,1,0,0,0,2,2,6,2,2,0,4,0,3,0,1,0,2,12,1,0,1,3,4,3,0,0,4,6,5,1,1,2,1,0,2,1,0,1,1,0,3,1,13,3,0,0,0,1,3,5,7,2,0,0,0,5,0,0,0,2,0,0,3,4,0,3,3,10,2,4,1,2,4,1,0,1,1,0,2,0,2,2,4,4,2,4,1,7,6,2,4,3,2,5,0,28,30,4,1,7,10,13,1,6,3,0,9,0,8,10,1,4,18,4,0,2,0,0,6,12,13,10,5,0,3,4,5,0,0,4,3,9,7,0,0,1,1,4,0,1,1,6,0,3,1,3,2,0,2,2,1,0,1,4,3,4,0,2,1,6,0,1,5,0,6,5,17,2,5,0,0,0,0,7,1,2,0,1,0,2,4,2,3,0,1,0,3,3,2,0,0,0,0,1,1,2,3,1,1,5,0,3,1,2,2,12,0,0,21,9,3,1,0,0,2,0,0,0,0,0,1,0,0,7,0,2,2,1,8,0,1,0,1,2,3,1,6,2,0,4,0,0,0,5,0,4,10,20,0,3,1,2,2,0,3,0,2,2,1,3,0,2,0,1,2,29,1,6,0,0,0,6,6,1,2,4,0,1,4,5,7,7,21,8,23,0,0,2,0,1,2,0,3,2,3,0,1,1,0,0,6,2,0,11,3,2,2,0,6,3,0,1,1,3,1,0,1,0,0,8,2,7,0,8,0,2,0,2,0,1,5,6,6,0,2,1
investment,1,2,6,48,1,14,0,1,5,0,2,1,7,35,0,3,2,8,12,1,2,11,18,10,9,6,3,8,1,4,1,108,38,0,22,26,8,3,8,4,3,2,2,10,4,6,26,9,44,26,16,7,10,33,15,0,19,9,13,9,1,0,2,2,17,3,40,8,3,5,21,1,6,2,66,5,11,3,27,8,60,9,6,5,84,13,3,10,7,10,7,2,19,6,51,33,6,1,25,12,4,10,9,8,4,10,17,21,10,6,13,11,28,30,34,9,0,4,14,57,13,17,67,34,1,4,2,3,5,5,22,0,1,42,1,39,2,6,1,5,2,21,6,2,1,29,1,13,9,7,7,9,6,11,15,26,15,16,2,24,21,1,1,6,33,11,2,13,17,5,21,24,23,1,4,2,53,1,3,40,10,1,25,13,0,9,9,6,10,5,3,1,3,5,7,4,30,3,9,8,58,17,1,6,7,6,1,19,7,14,19,7,17,14,4,16,16,26,3,7,3,3,1,4,20,29,3,11,4,18,9,7,24,9,10,18,6,25,7,1,19,9,4,1,16,7,1,18,22,12,8,10,6,2,2,10,9,7,1,7,2,6,0,0,5,13,24,9,7,2,29,18,13,0,1,4,13,11,2,2,25,0,4,4,11,12,13,14,3,4,0,1,11,8,8,8,13,5,3,7,9,15,1,9,10,1,8,2,1,12,2,6,13,11,36,6,12,14,31,7,5,8,17,9,10,1,9,15,2,8,0,1,1,0,3,6,18,2,6,6,2,5,8,3,1,1,14,2,6,12,5,9,0,19,4,12,5,1,5,7,11,16,13,6,9,2,13,1,9,16,7,22,5,6,3,5,0,6,5,5,13,6,15,6,2,5,4,6,6,1,3,2,3,1,4,0,6,2,6,1,7,3,0,2,1,4,2,0,29,8,2,1,11,7,1,3,1,2,2,3,0,4,9,0,1,3,2,3,2,2,2,3,0,2,3,2,0,3,0,2,5,11,3,3,3,2,9,6,10,4,18,0,6,0,13,2,0,1,5,6,7,8,12,11,6,5,25,7,9,3,3,4,0,1,1,1,1,0,14,1,2,5,0,0,7,1,9,1,2,0,11,16,1,1,6,0,0,4,1,1,1,2,0,6,13,7,2,11,1,0,2,1,3,4,4,3,2,4,2,4,0,1,2,0,1,1,11,2,4,10,7,3,3,0,2,3,3,4,7,9,1,3,0,4,10,3,2,16,5,2,3,1,6,9,4,1,8,2,4,3,5,4,8,2,7,1,0,3,5,13,2,5,1,3,4,0,2,1,1,24,11,2,9,3,0,3,3,0,4,1,7,6,6,0,5,1,4,4,2,2,3,0,0,0,1,4,0,2,3,0,9,4,0,8,7,0,2,10,1,3,0,3,0,6,4,0,0,2,3,12,8,4,10,3,0,10,7,7,2,2,6,3,2,3,1,9,9,1,1,23,14,0,2,1,2,2,11,5,2,3,1,4,0,0,0,0,0,0,1,2,2,2,4,1,5,1,3,2,1,0,1,6,1,3,3,0,5,6,2,1,3,12,1,2,1,5,4,0,12,1,0,1,0,2,1,3,10,1,6,0,0,4,0,19,4,1,0,1,0,9,1,1,0,1,0,0,2,4,0,1,4,8,5,2,0,0,4,4,0,4,3,0,5,3,0,0,2,20,7,3,4,0,1,5,5,2,1,1,3,40,36,5,0,8,8,12,7,5,2,3,7,1,6,0,0,8,20,3,0,6,0,3,2,13,9,6,6,0,5,12,3,2,1,0,4,7,4,0,1,0,1,1,1,1,2,1,4,1,6,2,4,0,2,2,2,4,2,7,1,2,0,0,0,3,0,0,7,1,3,6,5,1,6,0,4,4,1,7,1,1,0,0,0,2,1,2,10,4,2,1,5,6,3,5,2,1,1,5,1,2,0,4,1,4,0,3,2,0,1,2,1,2,20,7,3,1,0,0,2,0,0,2,1,1,0,0,1,0,0,3,2,4,1,1,2,0,1,8,4,1,3,0,1,0,0,0,0,3,1,7,2,11,1,3,1,2,0,2,2,3,1,2,2,7,0,1,0,0,0,3,0,6,1,2,1,2,3,1,0,11,0,17,2,4,5,11,12,3,10,0,0,2,2,2,1,0,2,2,6,3,0,2,0,0,6,5,1,3,1,1,1,1,6,5,0,1,3,1,1,0,1,6,0,1,1,7,2,14,0,5,1,4,1,1,7,7,9,2,10,1
remove,17,29,7,159,11,4,4,30,5,5,22,11,13,47,2,4,6,10,6,8,9,25,12,19,28,16,13,11,5,15,10,221,130,4,55,69,35,12,11,4,15,10,5,7,38,21,35,23,322,21,47,10,7,27,12,14,70,21,5,15,35,6,5,10,19,11,88,5,23,15,9,8,4,4,81,10,16,6,74,19,38,1,26,5,229,13,17,1,39,2,8,5,2,41,56,12,22,6,49,17,16,30,39,8,16,28,18,10,12,3,27,7,11,23,5,40,9,4,71,193,56,21,25,57,9,6,6,6,7,0,14,1,5,51,15,44,10,7,5,3,2,41,32,3,1,84,5,22,9,9,84,2,16,10,5,20,22,6,10,16,17,3,10,10,6,7,8,32,25,8,24,83,18,1,3,6,191,1,8,30,31,13,13,28,3,21,40,23,38,70,2,6,13,1,1,9,21,6,7,17,18,2,6,1,27,8,6,18,17,38,93,16,37,10,4,5,5,7,24,2,6,12,10,19,42,98,19,20,7,4,18,11,35,33,31,18,46,14,12,7,70,43,8,5,13,10,11,14,61,7,13,24,27,6,10,16,8,2,7,18,8,28,34,7,3,37,8,1,23,4,143,9,18,7,4,0,21,6,16,1,60,10,9,14,8,5,1,5,13,5,9,13,11,5,4,9,54,22,10,16,36,47,1,4,11,4,29,7,9,3,3,7,27,14,27,13,13,39,7,5,42,10,28,12,73,6,4,20,15,22,6,14,8,8,3,5,17,11,6,10,10,22,18,20,3,3,41,69,17,9,11,17,9,27,28,4,6,1,25,34,23,16,10,22,7,1,59,3,14,15,2,30,8,11,6,19,4,6,12,7,79,2,43,12,7,32,6,17,23,14,26,2,13,30,49,10,72,5,41,3,35,5,18,3,8,0,10,7,40,17,6,11,15,8,30,6,11,15,6,1,7,8,18,10,0,4,8,15,9,18,10,5,3,20,0,13,0,22,5,6,14,19,8,8,0,9,15,6,25,13,17,13,3,7,54,19,0,8,3,37,9,17,45,19,12,8,28,21,6,1,23,8,4,1,5,8,1,16,35,5,2,10,6,9,10,4,15,4,12,6,78,28,5,9,10,12,5,17,7,14,12,4,2,3,2,8,7,13,12,9,7,10,12,7,18,19,7,8,2,8,2,22,6,29,11,5,21,0,15,35,9,4,4,15,15,7,20,9,26,12,12,4,2,10,9,13,8,18,15,8,42,11,10,47,15,9,41,3,9,14,30,4,29,7,30,14,11,3,39,34,12,11,16,9,12,4,37,9,6,23,8,30,15,13,7,3,5,11,9,12,24,52,9,3,12,2,5,7,101,31,28,4,7,6,13,25,7,27,7,12,16,23,25,7,33,7,25,1,11,14,14,4,3,22,1,10,8,13,12,30,28,25,25,18,8,8,12,5,5,12,16,2,18,31,21,33,8,10,9,187,41,7,13,16,13,13,45,18,15,9,9,6,30,26,13,7,5,14,36,15,18,9,32,50,41,5,3,14,7,7,8,23,21,10,8,7,14,8,3,8,14,14,21,10,14,6,9,7,14,21,6,7,12,8,8,5,22,3,2,8,5,11,2,26,30,35,20,11,10,6,13,5,13,30,1,19,8,9,4,12,9,13,4,5,5,3,13,7,51,7,8,4,6,14,16,5,11,12,10,7,16,4,1,11,6,22,11,11,2,12,7,10,4,5,18,7,10,11,8,27,11,13,8,14,4,13,7,4,69,13,26,6,12,3,6,9,7,2,10,22,17,9,1,5,8,24,2,12,2,8,9,11,10,3,10,8,6,5,23,7,13,8,26,11,2,4,3,10,9,26,10,3,8,18,4,6,7,5,6,4,10,6,8,4,8,11,11,60,8,6,11,8,5,9,3,8,7,16,3,15,52,33,16,5,6,6,8,3,5,5,16,6,11,9,7,13,6,11,9,19,3,13,13,12,8,8,12,11,11,2,5,10,8,6,16,7,10,7,9,3,6,13,0,6,9,14,1,12,4,6,10,9,2,12,12,5,5,12,6,28,10,5,8,9,8,10,2,10,6,3,17,12,5,14,4,18,9,35,11,3,6,5,10,13,11,1,7,5,9,9,5,8,2,2,8,16,11,6,25,6,4,5,3,7,4,2,9,6,17,11,2,20,26,4,2,24,8,0,7,13,10,4,4,4,7,11,6,15,10,10,8,9,9,6,11,9,7,5,35,1,1,4,6,0,3,4,3,9,1,4
maintain,20,62,23,237,37,19,8,122,12,7,74,11,18,236,16,36,18,36,27,15,10,106,26,56,26,24,32,29,10,30,47,371,325,23,121,191,190,29,52,31,18,51,16,6,86,35,73,36,736,76,95,31,47,135,11,16,126,43,0,47,52,31,9,33,36,13,205,27,8,47,35,21,13,16,252,33,36,25,166,65,124,10,38,13,599,59,49,4,77,2,16,20,6,76,127,36,33,24,158,44,39,65,76,25,33,54,15,9,27,20,43,16,33,35,16,65,12,6,132,389,85,38,25,192,20,18,23,6,7,4,31,6,13,116,70,78,22,13,15,21,7,75,81,5,14,145,12,36,49,37,169,2,31,25,17,46,51,9,59,40,37,6,25,7,16,13,8,71,47,32,61,184,37,10,10,23,311,7,26,86,62,62,32,41,3,40,57,54,70,108,7,17,22,3,6,14,35,13,25,29,54,6,7,27,1,20,33,63,27,79,157,14,42,27,2,4,14,12,35,6,20,29,7,31,109,240,68,54,9,24,24,38,54,69,81,50,64,24,22,15,171,74,16,13,49,21,13,70,118,15,19,44,49,25,21,43,34,6,8,48,8,102,43,10,18,74,11,32,38,12,283,32,69,21,10,9,73,28,16,7,133,13,4,62,34,8,11,25,28,6,16,6,25,17,10,23,66,8,14,50,65,50,4,12,28,7,72,8,11,17,11,28,83,34,108,36,43,92,33,19,114,19,54,12,170,17,20,68,10,69,14,26,20,12,21,26,40,16,13,49,23,21,33,35,20,25,112,138,45,14,16,26,9,84,66,13,21,12,38,61,37,31,29,38,19,4,94,34,16,34,5,49,16,17,18,97,23,9,40,13,190,17,119,20,6,64,9,59,53,16,63,11,16,17,62,31,87,10,103,23,45,11,9,7,19,7,26,21,60,40,10,45,15,30,32,29,10,25,10,16,9,28,62,34,12,10,19,28,33,39,57,21,2,34,15,16,9,22,56,6,39,65,13,66,9,13,32,26,89,17,63,10,8,13,128,24,3,39,21,50,27,67,92,61,23,4,47,32,15,2,39,10,9,4,6,21,15,26,50,27,19,34,27,7,28,14,31,20,19,11,257,70,4,27,32,21,10,33,27,16,29,14,15,2,19,42,16,29,17,10,8,9,18,15,33,33,12,19,26,33,21,45,21,50,16,15,53,8,34,59,32,15,8,18,27,22,18,30,84,43,21,9,7,24,33,11,33,49,20,15,89,21,10,93,16,25,74,25,13,13,51,7,38,20,24,36,24,16,84,72,26,20,27,10,18,25,25,17,22,33,18,36,36,54,34,8,13,20,5,36,94,64,23,11,31,9,27,36,95,57,51,11,22,5,15,39,8,58,23,18,78,19,15,19,68,35,35,16,13,7,32,42,10,71,10,15,24,18,29,115,112,35,45,57,30,12,16,19,8,30,12,9,25,65,19,87,22,14,15,463,54,17,28,12,31,25,115,50,25,25,15,27,19,53,18,14,3,24,18,38,44,20,94,51,59,14,8,7,29,18,31,62,33,16,22,29,49,31,11,34,28,18,29,32,15,20,20,13,39,32,29,13,17,13,17,25,36,25,5,11,14,20,15,67,42,74,27,18,25,32,22,10,25,52,11,37,26,7,10,28,16,29,19,7,11,6,91,26,96,32,17,15,11,36,52,19,54,15,29,17,29,15,12,25,19,25,18,29,5,27,28,47,14,19,59,29,23,17,21,15,20,11,8,27,26,29,10,9,27,23,15,12,26,13,24,13,25,51,25,26,17,21,14,12,16,38,18,13,10,4,14,17,31,4,14,10,17,8,44,16,14,17,25,16,14,14,18,18,17,26,10,13,16,27,7,18,12,7,29,21,17,10,18,26,25,24,23,60,34,11,14,12,10,23,9,20,24,20,10,32,40,72,24,13,5,9,18,15,21,15,14,11,16,15,17,22,2,7,28,16,9,10,28,39,12,16,12,36,25,19,3,12,12,15,10,12,17,8,15,18,11,34,3,15,14,30,15,11,7,15,19,15,19,25,17,10,16,24,9,44,11,17,8,28,21,8,8,13,18,9,20,20,7,12,15,15,7,36,9,18,12,5,16,14,10,12,16,22,12,16,15,23,15,5,18,44,21,21,84,11,8,21,9,20,9,9,9,20,24,12,8,18,11,9,7,49,6,19,11,20,21,13,15,14,9,13,12,26,14,18,12,13,6,59,9,19,23,15,65,0,11,12,15,12,2,14,8,11,7,8
responsibility,4,47,14,176,15,17,3,23,2,5,19,6,26,136,6,8,6,29,12,5,7,45,37,41,16,32,29,43,20,31,6,190,112,30,60,124,52,2,5,12,7,27,3,5,44,20,25,36,237,72,47,16,25,109,49,9,73,9,22,22,20,11,5,13,24,24,153,8,6,5,24,2,4,11,167,15,28,7,77,34,39,5,12,12,236,12,7,6,23,1,3,7,0,29,39,8,33,2,37,9,11,26,22,10,14,26,5,8,10,6,13,7,20,17,24,30,5,4,65,145,34,52,13,75,11,8,6,7,2,0,34,12,11,41,28,89,6,3,8,7,9,43,11,6,6,83,9,20,13,11,60,6,10,7,9,57,37,2,10,66,25,3,13,1,2,37,5,17,25,14,11,104,29,6,17,11,161,9,15,74,25,22,30,23,5,21,26,21,27,40,4,9,2,9,4,4,20,12,9,23,18,6,6,8,20,1,7,32,6,35,86,14,25,5,16,30,10,18,28,1,2,18,2,20,55,98,24,20,3,3,8,10,15,30,25,8,27,10,8,13,70,32,5,17,28,11,5,41,54,16,11,9,31,5,5,14,6,5,6,3,8,28,15,3,11,41,23,22,24,3,96,4,10,9,5,7,22,9,7,6,90,6,8,18,6,6,30,45,14,5,1,5,17,2,1,15,28,2,5,12,24,28,0,1,13,7,27,13,27,2,9,38,64,12,24,15,19,36,7,12,37,14,25,18,91,4,29,51,4,39,11,7,6,14,8,14,21,7,7,9,15,19,29,56,4,8,35,44,18,30,11,14,6,14,15,3,11,10,7,37,33,16,10,12,1,8,30,11,31,37,6,44,5,35,9,31,11,5,16,6,75,8,32,16,23,29,5,24,22,17,30,8,19,20,23,33,21,3,33,2,24,14,3,11,2,7,9,3,15,26,2,6,2,11,22,13,8,5,8,11,6,14,23,7,0,12,5,8,14,15,8,3,0,11,8,7,3,12,31,8,17,20,10,10,1,4,37,9,32,11,27,5,23,7,27,15,8,7,4,14,20,19,24,38,4,10,29,4,8,8,35,8,7,8,6,13,6,23,39,10,3,13,1,20,13,4,9,9,5,3,71,24,4,6,7,4,1,16,8,10,13,2,2,14,0,10,5,4,6,6,0,6,5,8,13,11,8,10,1,12,4,11,7,37,14,4,20,1,10,21,12,10,3,9,16,8,9,14,33,16,8,2,7,9,4,9,2,16,13,3,37,6,5,41,6,6,7,9,5,10,10,2,13,8,13,9,8,8,28,23,10,7,17,15,4,4,0,9,4,15,0,7,9,24,7,1,3,8,1,19,27,38,13,3,20,0,1,4,21,20,14,3,6,2,9,20,3,47,8,2,29,18,14,3,24,9,3,3,8,1,13,2,4,18,2,3,7,6,14,21,13,16,22,19,8,4,10,6,8,7,11,8,19,6,0,9,10,10,13,110,26,11,5,2,2,8,26,28,7,10,7,0,6,5,3,2,1,4,13,4,10,6,5,18,9,9,6,2,2,4,12,21,11,4,8,14,27,15,6,3,8,45,12,9,6,8,13,5,12,9,1,7,2,2,11,8,19,10,3,3,11,1,3,25,10,14,18,6,16,7,9,5,1,14,4,10,3,6,0,15,11,10,3,14,1,3,19,5,22,8,12,6,4,6,10,6,22,6,7,3,8,2,5,4,4,8,12,7,4,3,1,15,1,1,23,20,8,5,9,5,11,6,3,6,5,14,11,15,7,7,0,2,3,2,11,7,6,16,7,26,4,5,1,2,8,12,2,5,3,6,5,0,15,3,12,9,4,7,14,0,1,4,4,1,3,8,10,9,3,13,5,5,12,9,3,1,15,9,14,4,8,4,6,13,7,8,11,22,13,7,5,9,1,11,2,4,2,9,6,9,43,40,5,2,2,10,1,1,2,4,6,6,4,11,2,9,2,2,15,19,7,4,1,5,17,5,6,3,12,3,0,2,5,5,7,4,1,1,6,6,8,4,13,3,8,1,9,5,2,10,10,1,5,14,8,0,1,9,4,25,20,4,15,3,13,3,2,0,6,1,5,6,4,0,2,6,0,6,4,4,5,7,6,3,3,1,4,5,7,8,2,25,0,0,6,2,7,4,19,0,3,7,4,9,6,1,4,5,4,2,0,1,7,6,2,12,3,1,6,5,2,7,20,32,4,1,10,9,2,5,3,6,3,6,6,0,8,14,23,14,6,10,4,6,4,3,9,0,5,10
reserve,0,8,12,83,3,5,1,19,1,3,3,7,15,38,12,3,4,17,1,3,5,16,2,6,17,3,10,9,3,17,4,98,71,9,23,35,14,6,12,5,7,5,0,7,16,5,15,15,150,13,46,5,11,12,1,1,13,11,3,9,6,7,2,11,16,1,55,5,2,4,20,0,3,4,46,11,26,10,62,7,51,3,9,6,156,32,54,6,7,3,12,0,5,24,43,13,18,9,27,8,16,25,23,3,12,31,7,7,17,3,17,4,6,36,3,12,2,1,45,91,27,10,3,73,2,3,1,6,3,6,18,7,1,31,25,33,1,2,1,4,1,14,26,5,1,38,1,10,9,27,55,2,10,10,8,61,13,5,2,6,5,9,9,5,9,5,2,4,5,5,14,47,12,10,1,6,93,1,8,52,16,13,9,21,4,11,18,13,14,36,2,6,2,1,5,5,34,10,13,8,23,6,1,6,33,7,1,64,6,26,55,2,15,8,2,3,8,2,8,1,8,12,0,9,31,47,13,17,0,9,9,48,19,20,24,16,23,7,14,3,35,11,9,1,6,6,3,23,57,3,12,9,11,0,8,10,4,1,2,14,0,18,6,17,7,38,6,1,8,2,79,23,29,4,2,0,20,3,1,5,32,1,10,10,2,16,0,10,7,1,2,0,14,3,4,6,24,4,3,10,14,25,3,10,8,7,11,3,3,2,5,45,31,11,36,20,6,27,10,5,16,9,15,4,43,1,7,9,3,19,1,4,3,14,5,21,11,1,9,15,10,10,4,6,13,2,19,30,14,7,5,2,3,49,7,3,2,0,22,17,16,6,11,11,1,1,25,9,4,10,2,15,2,1,5,9,3,7,4,5,31,4,35,13,4,74,0,20,16,1,8,6,8,12,20,3,33,5,13,10,11,2,2,0,5,3,7,3,13,12,0,1,7,13,4,6,0,2,4,3,0,3,12,2,4,1,2,3,5,7,24,5,0,7,1,1,0,5,8,2,4,10,5,5,1,2,14,6,35,14,24,1,3,2,18,0,0,3,4,14,6,8,15,23,2,0,16,10,21,0,2,5,0,5,2,11,2,5,23,17,5,1,1,0,3,3,4,5,3,0,48,25,1,2,9,4,5,13,5,3,13,8,0,2,7,79,14,1,4,9,2,4,3,6,9,8,2,2,2,4,0,8,4,18,4,0,37,8,6,11,5,3,1,5,4,10,6,4,31,16,2,4,2,8,11,6,1,6,4,3,25,5,0,21,6,5,6,6,7,7,15,1,14,3,5,8,5,4,16,18,7,3,6,0,4,2,2,4,6,27,4,5,3,8,7,0,3,11,6,5,10,13,5,4,1,8,3,1,11,9,5,5,1,0,5,20,6,11,9,3,18,7,9,4,23,4,9,0,5,7,18,3,2,42,6,7,1,3,9,21,113,11,17,13,4,1,4,13,1,7,6,0,0,17,2,21,4,4,5,73,2,4,9,4,4,6,37,4,2,10,4,2,7,6,3,4,0,4,2,2,13,2,4,7,7,1,1,6,4,11,4,14,5,4,6,2,11,6,11,4,6,6,7,1,7,7,9,2,3,6,2,4,2,6,6,9,7,5,4,2,6,11,1,16,11,22,2,2,5,9,1,2,1,14,10,10,9,0,0,2,14,11,24,5,10,0,31,8,14,6,22,2,7,18,10,10,22,8,8,1,14,3,10,13,7,5,2,13,8,10,8,5,4,3,16,9,6,11,17,4,4,7,1,7,6,8,14,6,4,3,1,2,11,23,3,5,13,0,7,7,5,5,1,2,5,10,8,5,0,1,5,2,6,2,2,0,4,3,9,3,1,1,6,14,5,1,2,5,7,15,0,7,4,18,3,5,0,7,3,5,3,3,8,4,5,3,2,5,3,3,0,0,3,2,6,11,7,7,4,2,4,17,1,2,10,8,2,23,2,4,8,2,2,5,0,6,5,1,1,2,10,5,51,29,2,4,0,1,5,0,0,3,4,4,1,4,3,1,0,9,2,8,1,2,2,6,2,10,11,2,9,8,4,1,0,8,3,8,0,10,4,18,8,6,5,2,4,3,2,3,8,2,3,1,1,5,0,2,0,8,3,2,2,24,9,7,6,7,2,3,4,12,2,2,10,20,12,6,50,1,1,3,1,9,1,6,2,0,19,5,69,1,2,0,4,12,4,1,4,2,1,6,5,3,0,3,0,6,3,2,4,3,1,7,2,2,3,10,4,0,1,1,1,5,1,4,0,2,3,0
system,4,56,35,406,9,30,15,98,6,12,30,23,23,153,23,20,22,52,27,18,16,142,44,47,54,33,19,45,14,23,16,554,420,41,166,144,46,38,41,17,37,28,4,22,100,46,80,96,619,43,112,31,34,87,39,5,215,128,11,43,30,12,14,37,137,29,291,47,23,26,67,12,15,12,354,48,55,13,219,77,199,14,48,20,569,100,66,5,96,7,16,25,14,59,169,68,43,50,112,55,31,80,90,27,43,83,33,15,49,11,71,34,52,62,32,95,2,10,150,514,106,62,150,256,28,12,6,13,13,21,45,10,12,155,56,222,10,13,15,33,3,110,80,16,15,170,29,33,60,60,170,10,32,23,27,161,71,24,24,54,86,24,38,13,12,39,19,64,80,22,66,245,81,11,18,12,479,21,26,193,60,42,46,50,19,73,127,64,63,88,9,19,16,7,8,16,97,37,24,58,136,20,19,18,63,32,64,1,60,85,214,21,61,42,5,42,4,36,93,10,14,39,25,36,142,317,75,82,11,31,43,62,60,101,101,174,72,36,30,27,201,103,27,27,40,15,23,89,172,18,41,104,56,21,42,61,35,5,13,54,29,57,40,12,29,158,19,21,56,36,365,44,111,18,21,3,63,43,36,20,181,37,17,60,55,7,88,104,53,24,10,4,36,22,11,35,100,17,20,68,60,140,8,7,42,51,54,21,57,7,16,97,90,46,132,96,132,142,43,36,80,32,82,24,117,12,27,72,10,50,10,34,17,30,28,44,54,10,18,36,35,12,70,24,31,15,141,126,37,24,41,46,18,106,38,40,15,21,59,83,80,67,42,74,11,8,96,23,96,48,12,74,35,44,49,144,21,26,46,22,168,9,139,21,10,186,19,45,84,23,52,15,34,24,85,16,162,23,99,10,70,7,16,4,34,31,40,4,75,52,2,16,16,52,8,22,9,10,10,6,23,29,42,34,9,20,16,51,17,61,39,19,7,11,8,10,5,6,38,23,32,74,15,36,3,17,31,14,92,29,103,13,14,10,145,50,0,14,27,102,35,70,90,77,27,11,69,49,12,6,51,23,4,17,20,64,10,40,71,30,25,43,12,18,40,14,52,10,18,23,133,119,2,3,55,12,13,22,26,46,43,12,16,53,17,213,30,54,28,39,34,33,15,38,98,42,22,39,18,30,12,40,30,83,28,11,92,42,48,92,29,24,8,35,40,25,32,38,95,92,23,5,9,35,62,30,16,83,35,30,105,19,17,119,27,37,83,38,12,29,84,9,68,19,46,79,51,34,97,125,37,30,31,22,13,11,47,22,28,72,40,33,61,47,31,26,24,38,13,48,89,91,37,30,73,21,25,26,29,40,104,8,30,2,4,63,17,63,48,36,60,96,36,32,58,34,52,14,24,16,68,31,17,54,14,21,15,28,49,147,38,79,86,71,36,22,22,40,11,37,58,13,25,55,26,95,26,10,27,242,38,17,26,34,22,38,119,37,13,41,51,11,2,35,13,2,1,14,33,30,74,34,33,85,37,19,30,26,3,23,7,76,28,16,30,21,26,14,13,16,19,44,36,24,13,31,33,7,62,31,4,9,16,15,55,26,54,6,25,10,26,20,11,81,36,59,9,19,9,58,19,18,4,88,10,38,32,22,67,48,43,54,18,23,16,32,56,11,63,27,37,12,12,22,21,26,42,39,32,21,37,17,15,31,22,41,21,43,50,72,81,41,9,6,97,80,35,23,33,27,34,9,17,41,20,40,84,24,35,36,11,23,28,18,29,29,39,7,19,43,12,38,13,25,37,62,26,20,14,47,35,11,28,15,9,14,25,18,29,26,31,3,25,10,20,11,12,11,5,36,8,15,5,46,10,21,23,18,52,18,26,17,69,8,37,38,30,48,26,12,7,10,25,9,32,37,26,12,22,13,28,49,12,44,10,20,27,44,16,6,11,16,30,12,19,26,14,14,14,64,10,20,25,114,13,31,0,14,24,2,3,8,11,3,25,20,7,17,13,10,9,31,12,9,22,10,4,17,12,6,23,9,10,20,19,8,0,35,20,57,16,39,11,31,33,8,19,15,21,8,21,15,9,37,11,21,4,13,11,64,16,20,14,20,16,19,29,20,8,69,10,35,14,10,21,51,43,29,101,11,10,24,30,21,12,19,24,13,35,6,38,21,12,34,11,14,33,29,21,15,6,14,26,21,16,8,33,20,33,16,20,11,12,29,21,56,39,25,7,4,10,14,14,6,5,31,17,20,5,6
offer,9,22,20,141,16,14,3,34,3,3,30,12,18,95,3,7,11,25,10,1,8,50,24,33,23,16,15,22,6,36,13,266,134,15,59,100,64,29,28,9,9,18,5,10,40,26,55,24,313,35,60,6,15,54,21,4,69,25,16,15,11,11,2,26,26,10,95,6,8,19,19,8,9,4,93,14,25,6,74,40,59,1,12,11,217,29,14,2,46,4,14,7,11,49,73,15,18,2,30,21,6,34,25,7,17,33,11,12,11,1,31,5,11,15,19,32,9,5,75,189,38,37,20,89,17,3,6,13,2,3,16,5,9,56,30,84,4,8,3,9,4,45,28,3,2,76,8,13,18,6,51,3,27,7,7,26,48,2,21,31,12,4,19,9,1,28,10,30,18,12,9,91,32,4,12,6,184,4,11,34,41,13,9,22,5,30,36,28,49,74,4,14,12,5,3,9,27,12,9,11,25,1,7,17,27,6,6,60,1,27,92,14,23,15,5,20,5,3,12,3,3,17,12,15,38,90,17,20,4,5,20,14,32,24,37,24,50,13,11,4,71,40,10,6,14,4,8,20,46,10,6,16,18,11,7,21,9,5,2,9,3,30,34,13,9,37,18,12,37,4,111,15,26,8,9,5,24,7,12,4,72,6,5,11,7,2,19,16,18,5,11,4,13,4,6,18,42,12,9,22,41,21,0,8,15,19,28,2,25,2,3,10,24,8,59,12,26,36,15,8,57,10,28,9,60,2,8,46,8,30,10,7,13,12,13,13,22,9,5,10,13,17,30,10,2,13,43,60,25,17,12,21,9,34,22,11,18,8,14,32,16,7,7,17,3,6,49,8,28,26,7,39,12,18,9,25,5,6,20,13,61,4,29,6,3,67,2,37,26,10,15,8,23,26,33,14,64,3,44,9,28,6,5,9,5,6,8,7,27,13,1,23,5,16,14,13,15,9,10,7,4,19,17,8,3,10,4,16,10,19,3,10,0,11,5,6,3,45,15,6,16,22,7,23,1,0,17,11,22,6,32,3,12,4,72,7,6,13,11,31,13,27,29,22,12,1,30,27,7,1,31,11,1,1,4,19,4,16,31,6,2,25,5,4,11,10,12,6,4,4,69,40,6,4,18,12,2,16,3,4,7,6,2,4,15,7,7,19,11,3,5,2,5,9,11,25,7,14,7,16,3,14,8,20,4,6,20,10,31,30,20,5,1,4,3,5,19,5,33,18,2,5,3,8,19,12,6,34,8,7,25,4,12,49,8,8,42,7,10,11,34,9,27,5,12,10,7,3,51,59,9,12,4,1,14,54,6,12,5,22,12,23,9,13,6,6,10,12,7,13,31,33,11,5,27,4,3,8,61,25,34,3,5,7,13,30,4,18,6,5,20,24,15,12,32,9,15,9,6,1,14,5,1,22,7,7,8,8,13,30,5,24,21,38,10,2,5,11,2,14,6,2,4,19,12,30,4,10,6,220,47,15,3,6,5,15,44,19,15,16,7,10,32,47,15,6,10,22,9,14,15,11,57,26,46,7,3,8,9,5,10,20,18,10,19,6,9,10,3,13,32,45,14,15,7,7,8,11,19,22,7,1,11,6,6,7,17,11,2,6,3,7,7,25,18,33,8,13,43,8,4,6,7,15,6,12,12,6,8,11,12,14,6,10,12,3,21,2,40,16,10,8,9,10,14,5,3,12,4,7,12,8,0,5,3,10,6,15,3,24,20,10,9,1,26,12,6,8,5,29,9,0,3,25,3,9,6,2,11,11,3,12,16,13,10,6,6,51,9,10,13,7,26,4,9,17,7,7,1,10,10,4,11,7,9,2,9,6,31,8,7,2,34,16,3,3,4,13,8,10,14,12,20,8,6,8,8,8,2,14,5,6,12,9,15,8,10,26,12,4,14,10,8,9,4,9,7,15,8,10,31,21,10,5,1,5,5,23,3,3,13,6,6,2,2,14,7,2,10,18,10,8,19,5,1,8,8,16,17,4,4,2,2,2,7,8,7,10,5,7,9,35,11,7,11,9,5,4,13,9,8,8,7,3,24,5,3,11,16,22,3,13,7,15,22,1,1,11,2,4,10,19,7,14,4,5,9,25,7,8,7,27,9,12,1,1,13,12,2,11,5,11,7,4,10,26,12,6,34,7,0,8,3,9,5,7,5,6,26,8,7,2,8,4,5,17,4,1,2,7,5,5,4,3,12,9,5,7,7,3,6,9,5,8,14,4,6,8,31,7,4,3,2,4,4,8,8,9,3,11
policy,16,37,12,285,26,21,13,69,18,9,44,8,43,231,10,30,18,32,24,15,14,66,16,49,61,21,28,29,8,28,27,356,300,20,132,150,140,38,40,12,26,23,9,11,81,38,58,92,679,58,93,16,32,137,14,24,103,55,9,45,65,29,8,32,54,16,222,20,21,77,29,12,7,12,233,33,44,13,197,63,137,4,30,30,563,38,36,2,61,5,18,26,20,64,149,24,31,14,118,50,54,81,79,19,38,52,27,12,23,4,41,28,31,55,12,61,11,8,117,388,96,32,50,147,23,5,23,7,5,4,32,10,17,121,56,146,21,5,28,22,8,89,88,13,5,156,19,36,44,36,152,10,30,39,8,80,72,41,32,43,33,18,23,6,7,14,16,55,57,23,44,186,65,7,10,13,404,10,33,118,61,23,37,48,14,50,72,65,68,103,4,14,20,5,6,8,47,30,28,34,78,9,14,38,79,35,26,85,27,1,181,24,48,16,12,10,6,9,32,16,17,36,9,24,106,191,55,61,13,19,34,27,57,60,81,66,55,46,27,9,136,72,23,14,55,12,24,49,99,5,26,65,62,16,26,37,17,6,11,43,7,71,58,5,23,72,21,29,39,14,311,18,53,27,10,3,45,30,23,14,153,12,15,39,25,13,15,31,45,9,7,17,22,14,8,33,65,17,16,45,69,70,1,12,24,6,89,4,13,9,8,47,78,20,59,36,65,114,21,12,82,20,49,9,106,6,28,51,9,61,2,19,23,12,21,49,42,15,11,31,31,27,27,23,24,22,110,123,46,28,31,23,7,75,40,42,10,13,42,62,66,30,42,46,25,8,72,20,28,20,17,55,47,34,19,51,18,8,45,22,129,11,88,38,6,164,14,48,67,13,46,17,18,17,83,35,140,15,55,10,65,6,23,5,20,19,13,13,82,49,20,23,20,44,36,87,17,20,10,4,32,19,55,48,2,26,25,31,17,60,19,10,6,15,13,23,11,25,44,21,38,55,28,46,8,8,39,18,107,16,41,13,14,20,148,9,1,29,14,79,36,56,73,53,21,18,44,31,24,5,44,5,8,9,5,26,16,25,51,7,12,33,21,7,17,16,40,15,14,8,231,70,13,21,28,22,13,25,21,22,36,23,10,41,19,39,18,45,16,14,23,5,17,22,41,44,17,51,9,16,19,39,15,44,10,5,52,21,25,68,21,17,20,22,31,16,33,25,78,64,20,15,7,17,49,14,17,44,29,17,41,10,8,115,19,17,85,16,22,18,65,8,35,14,48,49,25,10,86,84,31,30,36,10,17,10,28,17,14,43,10,30,41,45,42,21,21,27,12,20,97,95,14,15,55,15,7,17,82,65,94,14,17,6,13,49,20,52,19,14,62,23,10,25,55,11,44,25,20,15,38,7,11,30,9,15,12,27,30,108,29,42,55,44,11,6,32,20,9,15,13,7,14,49,25,67,24,11,22,380,44,23,20,6,12,31,91,49,16,36,22,20,13,60,12,5,11,43,20,27,46,23,104,21,41,18,10,19,12,14,23,85,29,28,17,18,40,13,3,22,37,40,19,35,15,34,26,10,25,41,46,22,14,24,28,20,55,19,8,14,17,18,17,56,61,48,18,22,20,15,21,10,24,21,6,18,19,4,4,28,11,42,33,16,21,12,77,20,83,30,28,19,10,26,38,10,27,47,19,12,38,16,4,14,8,44,18,33,15,29,19,50,4,6,62,35,15,26,17,35,15,20,6,18,17,48,34,21,77,39,24,32,28,7,23,11,22,39,14,22,14,13,4,20,24,41,22,14,9,10,9,15,16,15,13,6,34,8,42,19,23,5,11,19,22,16,21,15,15,23,12,13,20,24,14,6,16,13,5,12,14,19,28,20,16,38,25,49,14,12,6,8,2,8,9,18,17,19,22,30,24,44,17,19,13,13,19,38,10,7,20,5,12,34,12,32,13,7,28,25,11,11,19,24,9,17,2,20,29,15,3,10,5,5,16,12,25,10,31,16,11,23,0,11,18,12,18,3,8,5,22,15,5,24,5,7,4,20,8,57,23,28,13,9,26,11,5,12,16,8,23,23,17,20,9,16,10,23,9,6,11,16,22,23,16,8,18,16,15,26,11,11,16,8,16,20,42,30,55,7,2,13,13,17,14,6,11,10,32,18,24,19,22,12,6,29,28,7,2,29,38,22,12,10,15,24,4,25,14,17,14,17,4,8,18,14,21,32,27,5,9,10,6,10,4,7,6,14,13,5
give,62,189,79,954,72,77,49,240,35,28,94,82,56,433,37,82,55,104,71,45,43,241,176,230,169,152,114,110,74,151,66,1186,765,137,387,546,257,65,77,36,47,109,41,49,266,120,202,96,1638,248,313,62,96,324,163,34,429,188,83,108,108,57,27,96,131,64,747,65,48,100,96,25,49,42,675,110,213,33,494,171,354,7,94,75,1350,150,90,7,205,11,62,48,33,172,288,162,127,44,240,116,90,220,197,90,77,198,57,51,94,42,124,36,34,118,59,208,38,32,428,986,262,213,132,499,70,34,39,20,25,18,123,36,67,346,157,458,55,22,39,64,49,207,151,34,33,507,54,89,79,68,520,28,102,64,35,184,237,47,75,185,91,28,97,30,37,125,39,151,161,47,118,676,192,23,50,58,1036,40,72,363,192,84,64,138,40,155,215,168,231,301,36,36,68,20,23,23,128,36,52,97,205,27,19,93,157,86,55,214,92,181,1,102,196,103,40,105,31,45,114,21,25,145,32,96,280,703,202,170,60,66,95,75,106,187,212,178,184,87,43,55,409,218,61,77,100,70,54,204,312,49,70,178,152,44,66,120,54,22,21,130,53,186,97,34,54,248,107,77,114,33,840,64,131,30,37,24,141,57,61,25,432,52,24,125,51,25,81,87,106,41,40,36,118,49,34,82,261,47,65,122,150,246,9,24,72,18,143,43,62,12,31,127,188,57,240,86,124,276,80,43,241,49,185,83,397,60,94,272,32,193,57,97,72,37,74,129,124,50,30,81,72,101,137,64,39,45,246,317,141,130,60,94,42,235,146,35,52,55,72,211,166,54,85,133,28,40,191,75,78,139,28,227,31,136,70,202,67,34,101,53,461,27,275,74,65,229,54,147,159,39,132,42,103,102,164,77,382,56,253,33,140,50,27,31,42,47,39,27,153,95,20,72,39,105,86,92,46,52,34,38,38,66,135,87,35,36,26,113,70,112,100,44,10,89,57,43,10,83,75,38,97,157,50,81,23,31,101,43,217,61,133,48,56,56,309,71,39,50,80,219,112,118,193,261,55,98,160,104,67,13,202,64,22,42,38,131,27,105,133,52,64,82,25,47,71,70,59,53,44,26,427,214,21,44,58,43,47,72,44,73,77,43,42,29,84,164,48,85,55,48,51,35,57,68,73,121,50,79,38,50,26,130,67,208,48,46,162,79,105,192,81,54,31,96,83,47,80,77,221,142,44,33,25,55,85,65,51,122,58,47,212,44,46,281,54,72,196,31,47,60,175,33,152,31,99,98,83,48,225,242,73,49,73,20,61,46,83,47,45,121,46,130,101,117,59,43,50,48,17,85,140,199,77,37,187,36,56,51,287,133,124,27,37,37,38,132,53,176,73,37,203,192,97,69,215,56,108,38,73,32,82,39,19,136,27,55,60,53,103,193,93,146,172,121,48,26,101,47,56,67,82,45,96,172,50,210,49,49,51,935,240,42,47,37,56,82,211,96,64,86,34,53,101,105,42,37,18,44,49,69,92,65,186,196,129,42,46,62,37,39,57,176,73,47,45,43,75,47,20,72,71,143,85,80,41,76,42,30,97,85,56,20,36,59,66,54,106,36,27,39,59,70,48,172,105,204,87,55,55,61,65,50,38,211,38,69,53,33,28,70,54,105,39,49,42,36,140,31,169,66,94,59,49,79,74,37,82,83,52,54,75,38,15,45,28,82,72,80,38,106,102,109,27,49,136,127,81,59,64,51,69,30,28,85,31,89,68,32,121,60,31,35,66,43,68,56,56,79,37,85,58,75,29,33,130,125,67,54,31,41,40,40,72,30,45,35,62,41,126,53,43,25,100,63,25,25,42,54,36,72,42,16,42,57,30,41,58,62,40,38,73,48,74,25,56,69,58,182,71,65,66,68,34,70,51,52,49,58,45,69,138,261,67,52,42,35,58,51,35,12,52,46,61,39,26,58,36,29,45,108,43,35,46,87,39,34,37,82,70,44,27,42,33,51,85,28,42,39,39,37,39,61,51,85,50,43,30,70,42,61,37,101,46,61,60,33,26,62,40,122,38,51,60,37,73,37,25,55,43,33,61,37,24,91,21,42,17,139,23,33,44,42,53,41,30,21,36,47,35,58,19,81,27,10,30,77,63,53,171,37,26,38,31,43,26,29,28,37,105,51,32,28,41,41,20,121,45,31,33,42,60,45,99,53,36,46,38,32,72,43,46,47,27,73,58,31,49,41,141,46,31,28,28,20,26,23,39,39,35,33
back,4,19,10,81,14,33,4,28,3,6,4,22,29,83,1,4,12,22,26,8,9,32,56,52,16,29,41,48,21,55,5,158,122,35,43,114,38,0,12,10,9,23,7,22,36,17,19,14,127,138,65,18,19,108,60,1,14,19,34,32,2,3,3,18,31,22,132,8,8,44,27,1,13,8,124,62,108,3,98,38,35,7,6,45,100,23,4,5,22,5,18,12,10,35,18,22,28,2,36,19,9,32,12,19,20,24,5,31,20,11,28,3,35,24,68,30,1,10,39,136,31,81,50,133,35,11,4,5,5,6,55,19,22,35,41,124,6,8,17,26,10,67,15,11,8,86,19,30,7,8,44,25,21,18,5,18,82,12,8,72,15,7,14,7,8,82,9,23,21,7,25,129,37,9,25,12,67,4,6,86,17,5,28,44,7,29,29,14,19,34,11,16,5,11,4,7,28,7,17,7,39,1,7,16,14,14,2,21,14,24,102,1,40,15,26,73,7,13,13,2,9,25,5,17,22,51,14,26,10,11,13,18,17,15,38,8,23,19,14,11,57,38,16,14,13,2,6,54,33,16,11,23,26,3,5,31,3,3,4,25,2,47,10,2,2,13,27,42,25,6,64,6,5,4,3,7,16,7,7,3,74,3,3,16,15,6,34,26,15,15,2,11,21,8,9,6,27,6,9,16,23,12,0,3,3,2,17,3,22,5,2,5,28,13,41,12,18,18,6,1,22,6,37,28,57,0,11,103,4,44,23,4,4,1,5,3,23,6,3,3,8,30,48,9,7,15,16,33,12,33,5,8,2,40,9,8,13,6,1,35,13,15,10,15,2,18,23,15,23,54,6,59,5,58,4,14,3,5,27,3,26,2,22,7,32,22,19,12,20,2,10,32,14,4,10,17,15,2,11,3,6,19,6,12,3,7,12,1,11,8,6,5,7,14,14,23,10,14,10,25,1,9,18,11,14,4,2,7,2,15,15,0,0,9,9,4,6,14,24,6,14,5,4,21,7,8,69,21,19,17,28,5,34,7,39,6,23,4,13,11,28,37,20,69,6,12,49,24,12,6,35,19,1,19,6,14,6,4,16,8,5,12,3,8,7,5,9,18,4,3,68,20,6,12,14,2,8,1,3,4,6,2,5,8,14,11,7,7,10,4,2,6,4,6,6,9,9,5,0,8,6,6,1,9,4,6,15,6,8,10,20,14,15,11,4,11,4,8,16,3,3,3,10,6,14,4,8,11,9,0,14,3,4,29,3,5,17,1,4,3,6,1,6,8,8,8,9,3,12,25,13,0,6,3,3,3,1,2,2,19,3,8,10,25,3,5,4,1,2,12,10,8,17,7,16,4,5,3,10,5,2,1,4,1,3,15,5,9,3,2,21,7,4,5,15,2,7,0,1,0,6,3,5,26,3,3,0,5,2,9,22,13,15,8,3,1,10,2,8,7,6,12,2,16,3,7,7,2,5,65,27,11,2,0,6,15,12,11,7,7,0,5,1,4,2,2,1,8,11,4,4,1,10,3,6,3,0,1,2,2,5,22,2,4,5,1,12,2,4,5,8,27,4,6,5,10,5,5,7,5,11,3,0,2,3,7,8,10,2,3,2,0,3,10,3,22,20,1,6,6,7,3,1,20,2,10,6,3,3,7,7,5,0,5,0,5,23,3,7,7,12,8,15,15,12,1,12,12,10,2,12,2,0,1,5,3,3,1,3,8,5,17,0,0,16,17,14,1,4,2,9,2,9,9,4,3,6,3,1,7,3,0,3,1,0,6,4,2,4,14,9,5,3,1,4,15,5,8,0,0,2,2,10,3,24,8,13,6,9,5,3,6,5,2,0,2,1,6,3,5,1,1,3,0,2,4,22,7,4,0,5,0,4,8,6,4,2,16,2,3,0,2,0,8,3,6,1,5,1,8,8,10,7,1,7,6,4,1,0,1,2,5,4,7,1,1,2,2,10,8,0,7,4,7,3,3,2,2,5,7,0,6,0,3,3,4,8,1,8,1,24,4,19,0,0,0,4,5,4,28,2,0,11,4,4,0,0,7,1,8,1,9,2,3,4,4,5,1,11,1,2,2,2,3,4,0,6,8,3,4,1,1,1,5,1,1,0,2,1,9,7,9,2,0,3,6,3,5,10,1,3,11,4,5,1,0,6,3,5,1,0,8,0,0,4,3,4,0,0,1,27,1,18,18,3,3,9,4,4,2,5,4,3,4,4,0,5,15,6,12,7,4,3,11,5,2,11,2,2,18
pass,20,119,43,682,21,25,6,87,14,10,59,33,37,125,15,16,24,37,28,9,14,86,63,91,49,79,38,45,17,64,18,372,260,22,105,134,56,18,21,3,10,31,11,44,83,49,57,53,774,105,109,17,21,87,62,9,117,43,29,39,34,15,7,27,54,31,222,21,13,40,58,8,19,10,246,27,78,5,180,51,95,7,36,23,434,48,24,8,75,9,20,7,9,72,90,30,58,13,51,29,18,89,72,29,34,68,15,42,33,22,49,13,39,56,39,84,28,8,383,364,80,58,110,238,35,12,11,13,6,14,38,15,23,127,50,130,19,15,15,23,14,64,75,11,12,175,41,34,29,24,150,19,47,10,16,69,89,21,24,62,37,20,33,11,36,50,11,52,75,35,50,214,66,10,15,30,399,3,36,101,56,27,29,53,13,46,68,46,95,127,36,18,11,5,14,8,38,14,25,29,64,7,17,37,42,25,15,61,23,48,196,40,1,34,8,44,14,50,39,8,20,59,9,40,133,407,69,48,11,23,36,38,48,55,74,47,79,15,8,23,182,78,19,17,21,17,12,53,162,16,52,54,54,17,11,44,18,7,10,45,26,56,46,27,10,89,16,26,26,8,310,22,68,8,6,19,76,32,37,11,123,11,8,35,45,9,55,47,34,12,9,26,219,19,15,16,83,15,26,19,44,84,10,14,26,24,43,12,24,9,8,56,56,20,90,31,29,67,27,20,72,20,84,19,180,26,30,78,6,72,64,29,26,5,21,33,43,17,10,23,20,33,40,31,13,23,99,129,25,52,38,27,10,77,59,10,23,5,28,65,101,19,21,43,9,11,140,20,54,43,7,52,12,25,24,76,20,12,26,24,195,9,87,22,28,109,27,57,66,10,53,15,189,112,70,28,125,12,62,10,44,7,22,8,25,4,15,5,60,19,4,32,17,46,22,10,8,16,6,1,16,20,59,27,14,4,5,18,41,43,39,15,10,49,12,15,1,20,23,13,23,48,19,30,10,8,16,9,71,17,42,26,20,13,100,18,4,47,12,69,32,55,56,43,17,8,37,53,23,8,66,17,11,20,11,23,11,91,33,16,16,25,10,13,6,18,24,12,13,17,101,86,9,10,15,17,2,27,17,26,17,20,14,23,30,38,13,28,11,17,7,19,19,14,27,40,16,20,7,17,5,47,19,67,26,11,46,16,47,69,39,6,10,17,14,11,32,21,95,47,9,9,5,13,23,18,7,27,29,22,178,35,27,86,10,20,45,8,20,22,47,29,73,7,34,33,44,17,76,68,30,11,45,18,15,7,10,14,20,63,8,32,19,24,21,13,11,13,7,27,38,63,27,18,32,13,8,5,99,29,49,4,13,20,28,39,6,66,10,10,96,52,34,17,102,19,34,15,30,8,20,6,7,63,9,20,25,13,16,85,21,41,54,55,27,6,24,27,13,17,21,7,15,33,18,57,14,21,22,417,41,6,17,31,15,38,66,40,30,44,21,22,34,40,13,14,11,16,18,27,40,18,95,100,56,29,7,35,25,10,36,73,21,8,21,14,31,12,10,11,49,30,34,33,19,26,30,15,47,31,24,17,12,17,23,14,36,11,28,7,9,21,14,85,36,38,8,18,27,16,31,14,6,31,9,51,10,7,8,34,21,41,13,11,27,8,21,7,99,9,30,19,14,19,20,8,31,18,18,11,23,21,20,30,12,26,17,22,12,40,37,28,11,17,67,25,33,12,13,17,13,17,7,47,9,25,25,9,24,24,1,14,20,10,37,10,14,105,18,27,12,41,16,11,28,44,12,32,2,18,4,7,29,34,9,9,22,11,36,13,18,18,29,25,6,16,13,31,15,22,16,8,16,18,11,16,10,67,8,18,15,8,34,12,13,22,24,42,28,16,21,30,28,28,9,21,23,33,10,21,59,72,29,10,9,8,15,16,20,3,15,20,13,3,20,10,19,28,16,21,7,20,26,18,17,6,8,30,36,6,3,22,11,14,14,14,16,10,13,9,19,58,12,8,7,18,5,25,16,7,14,18,8,14,50,9,19,19,5,52,13,16,10,21,31,14,7,11,7,9,18,10,23,18,3,14,5,31,7,5,12,21,10,15,5,12,9,13,8,14,11,27,8,8,16,38,15,21,72,9,7,22,9,10,25,11,2,24,48,20,13,12,4,19,9,48,13,15,67,19,3,21,19,14,16,13,10,15,22,21,8,13,11,14,14,15,8,18,41,15,9,9,6,7,11,13,18,12,2,13
raise,4,9,8,153,5,9,2,16,3,4,7,9,7,64,1,4,9,10,5,4,8,15,39,27,16,32,9,12,7,15,4,189,105,12,55,65,23,29,40,3,11,9,2,10,32,10,30,9,159,45,51,9,11,54,69,7,150,21,23,12,4,13,3,30,23,9,86,31,12,17,44,3,5,11,111,11,39,5,53,13,104,5,20,9,174,52,20,9,25,2,25,7,14,18,37,56,11,7,21,19,13,19,18,23,10,40,15,27,16,3,15,4,25,19,17,42,3,6,65,170,30,37,126,120,13,4,11,2,5,10,17,6,22,61,28,76,6,2,9,7,2,30,26,4,4,60,9,18,14,17,64,9,12,16,5,26,23,5,3,55,22,2,10,3,29,31,7,25,17,4,14,90,25,6,5,9,130,2,9,70,25,11,12,17,5,28,47,20,34,31,6,5,11,3,8,5,11,7,16,17,40,7,14,10,27,5,8,42,15,16,103,15,34,1,9,25,17,30,4,3,10,21,4,36,46,80,19,40,9,29,28,16,36,13,55,145,26,19,14,7,63,39,12,15,11,12,6,17,64,14,5,57,10,20,17,15,5,10,3,17,9,44,10,2,2,16,13,5,6,8,131,15,55,5,4,8,30,11,8,2,54,7,11,9,9,5,13,27,15,7,5,5,22,7,6,7,25,5,7,29,31,34,4,5,14,9,25,1,6,13,5,9,40,11,85,18,35,24,15,5,32,7,20,15,39,8,5,29,4,13,8,18,5,6,8,11,20,4,11,9,4,9,15,5,5,6,24,45,11,52,12,4,3,30,17,3,4,1,18,26,23,7,17,16,7,9,20,12,18,16,9,59,2,24,17,37,8,8,16,6,44,5,44,3,10,32,2,23,25,4,17,8,6,2,21,7,21,2,20,5,14,5,5,3,4,4,12,2,16,15,6,4,9,11,5,3,2,4,3,3,5,3,27,10,4,7,4,6,10,23,5,4,1,11,6,5,0,6,15,6,8,44,6,11,1,1,11,4,26,11,16,4,13,4,41,4,1,14,11,23,23,26,35,18,8,9,33,16,8,9,18,4,5,5,4,17,4,10,17,10,16,15,7,3,9,13,8,10,3,3,61,22,5,10,13,6,3,6,4,7,15,3,4,3,15,14,6,9,8,5,27,2,9,6,31,8,6,9,1,12,7,9,6,15,11,4,20,5,12,24,9,2,5,23,6,6,9,6,37,14,4,8,0,25,15,7,1,34,6,2,33,2,5,46,9,8,30,4,7,7,13,4,27,7,16,11,9,12,21,17,15,3,12,0,9,1,15,9,4,15,18,10,21,17,1,7,5,6,7,16,15,16,7,6,22,10,51,30,16,13,11,1,3,1,4,10,4,6,8,28,16,12,3,3,13,7,27,12,8,5,5,4,3,14,1,11,7,10,7,22,10,17,36,7,10,4,5,8,8,16,7,8,5,17,8,23,4,2,6,72,22,3,4,2,4,5,34,5,4,15,4,4,12,13,4,3,1,4,5,5,14,15,31,9,15,6,2,10,0,5,0,23,4,5,9,11,7,4,6,7,9,17,12,7,4,6,4,3,54,17,4,2,4,3,6,11,10,13,3,2,2,7,17,28,14,20,14,3,6,5,5,6,3,13,4,8,12,7,0,11,10,16,13,7,8,5,20,2,18,16,11,6,5,9,14,2,23,8,9,6,8,4,2,5,19,6,4,8,2,57,58,16,0,19,14,26,5,5,17,4,14,5,21,13,6,13,14,2,13,8,6,4,7,5,4,8,23,3,10,9,4,2,1,9,9,17,3,7,2,1,1,4,9,6,6,1,4,6,18,3,44,3,7,7,7,5,3,10,2,4,2,2,1,7,3,3,18,3,2,5,4,3,5,5,5,9,3,15,8,8,4,3,2,8,6,3,4,4,3,5,9,21,4,24,5,1,6,18,6,6,6,4,5,4,8,4,3,1,4,8,2,3,4,6,5,3,3,8,8,2,1,1,2,4,7,4,5,5,5,2,6,7,7,2,4,4,7,6,8,3,10,3,5,4,2,1,0,4,7,10,8,13,2,14,10,2,2,7,3,3,3,8,6,58,5,8,4,11,3,2,4,9,7,4,1,3,6,6,3,12,3,30,3,8,14,16,9,12,32,2,0,7,6,3,3,5,5,3,21,3,3,5,1,5,4,7,3,10,2,5,9,1,8,14,6,1,5,4,5,1,2,3,8,10,5,14,10,7,4,15,5,3,0,5,4,42,20,2,11,2
tell,5,17,11,38,9,14,1,11,3,12,0,6,13,47,0,8,8,12,14,3,1,17,49,56,19,23,36,16,15,30,5,78,68,14,49,124,27,2,8,3,11,12,4,9,20,4,7,2,55,65,40,8,11,55,34,1,11,8,29,7,2,3,0,10,28,4,94,12,6,2,25,1,7,6,40,13,71,2,40,28,21,4,5,12,57,14,2,4,8,2,7,4,13,19,9,14,16,0,17,10,2,12,5,21,7,16,1,15,7,4,14,1,14,5,24,21,0,3,21,50,15,54,48,66,11,9,2,5,4,2,20,6,5,26,28,54,9,3,3,13,8,10,7,0,3,50,8,15,4,1,18,8,11,2,3,8,42,13,4,46,8,1,7,0,8,44,8,13,16,2,6,87,25,2,11,1,41,3,5,45,12,2,9,26,2,33,8,4,3,17,5,5,1,4,6,0,11,4,11,2,15,0,4,4,2,16,2,5,5,12,40,26,8,9,1,69,4,5,11,2,1,10,1,3,8,26,13,12,12,4,12,15,10,11,18,2,9,2,2,7,23,17,7,11,7,3,7,25,16,2,2,5,11,1,1,20,4,1,1,10,2,18,1,1,3,8,1,29,9,0,31,2,5,0,2,8,6,1,2,0,56,3,4,5,10,1,19,20,8,16,0,8,13,13,1,2,16,3,4,12,19,3,0,1,2,6,11,2,4,0,1,4,16,7,35,4,10,8,6,0,6,6,25,10,35,0,10,93,4,10,16,5,3,1,2,4,13,2,2,1,2,18,35,1,0,5,5,9,7,28,1,3,0,23,3,0,7,0,0,20,6,3,2,10,0,6,10,9,8,31,3,30,2,19,8,10,4,4,15,3,15,2,14,5,19,8,7,5,12,0,9,5,7,2,4,8,4,2,4,0,8,13,0,7,1,4,7,2,6,10,4,4,0,6,2,10,8,11,7,14,1,3,10,1,5,1,2,6,4,6,1,0,0,5,2,1,6,7,12,6,6,1,3,7,1,1,20,11,10,3,18,2,9,0,17,0,11,3,14,6,17,19,9,25,3,7,22,4,0,11,23,11,1,10,0,13,2,4,12,10,3,2,0,7,4,2,3,9,1,1,43,3,6,10,9,2,1,3,1,4,7,3,2,15,5,6,4,5,2,2,3,1,1,2,4,2,3,2,5,7,2,4,0,9,1,7,9,7,4,6,3,3,6,13,3,3,2,6,6,8,3,2,16,6,3,5,4,4,2,1,6,0,2,10,2,1,3,0,2,3,1,1,0,3,0,4,1,1,10,1,0,3,2,0,3,0,2,0,4,7,2,3,6,15,2,2,2,2,0,8,5,6,9,12,0,2,3,1,0,1,4,2,6,0,1,6,3,2,1,0,10,2,3,3,8,0,1,1,1,1,1,0,2,8,1,2,0,0,3,3,2,3,11,4,0,1,4,5,7,3,8,4,3,5,3,5,1,1,2,34,8,2,2,0,4,8,4,12,2,3,1,6,2,1,3,0,0,1,1,1,2,0,3,9,2,4,1,0,0,0,2,3,3,0,3,0,3,0,1,3,2,13,1,0,0,4,2,0,10,0,2,0,0,2,2,5,3,3,2,0,0,4,1,2,9,8,14,1,6,2,2,4,2,11,4,1,3,1,1,4,4,1,4,2,1,0,8,0,0,0,3,0,5,4,4,3,2,5,2,0,10,0,0,0,0,0,4,1,0,3,2,17,0,0,4,7,5,1,1,0,10,1,1,1,1,1,7,0,0,2,0,0,0,1,6,0,1,3,2,7,2,4,1,0,10,0,2,1,0,0,1,2,0,0,13,4,1,2,2,1,0,1,1,2,1,0,0,9,1,2,0,1,0,1,1,0,5,1,2,0,3,0,0,2,4,6,1,4,1,2,0,2,2,1,1,0,4,2,0,9,9,2,2,0,3,2,0,1,0,1,2,1,1,1,0,0,0,0,9,3,1,0,2,0,2,1,0,4,2,0,0,3,3,0,0,1,4,1,5,1,4,2,26,0,0,0,1,4,6,18,0,0,6,3,7,0,0,3,1,5,1,4,1,0,2,4,0,1,7,0,0,0,0,0,2,0,0,0,0,0,0,1,0,1,0,2,0,2,2,3,2,9,1,1,3,2,3,1,1,0,3,3,7,1,2,0,4,0,1,1,0,1,1,0,4,0,0,0,1,1,5,0,9,9,1,0,4,0,2,0,0,3,2,0,4,6,2,10,3,14,2,2,0,3,0,8,7,0,1,7
nt,8,48,20,89,8,45,0,13,8,9,2,14,37,51,0,1,29,25,47,9,2,19,134,109,34,62,32,48,17,46,5,230,105,19,56,194,10,1,6,8,12,24,3,25,36,10,27,14,59,152,47,20,10,81,118,0,2,12,69,19,1,7,2,12,69,16,151,13,23,13,66,1,8,27,106,35,116,3,73,45,30,5,11,22,82,28,0,14,23,4,12,10,31,19,11,14,18,1,32,15,9,30,3,35,19,29,10,66,8,16,28,2,44,45,112,67,0,16,43,96,15,122,100,192,39,6,2,12,2,7,54,16,29,52,38,233,14,18,12,19,11,35,33,4,15,101,30,35,4,10,19,25,13,5,11,22,70,26,2,134,39,15,34,9,28,178,7,10,24,12,26,117,52,12,25,0,4,1,9,148,25,3,39,54,5,29,22,26,8,18,26,15,8,17,27,10,40,11,11,2,60,14,16,5,4,30,3,42,20,10,105,73,44,25,69,1,53,50,12,2,14,22,0,17,36,33,22,19,10,15,6,25,25,16,28,8,18,13,5,6,55,23,35,36,11,5,14,55,28,20,11,10,27,1,0,48,0,3,0,15,7,24,5,1,7,6,29,30,16,8,33,10,4,0,0,15,26,4,1,0,93,9,9,7,14,3,71,61,21,35,0,14,47,16,8,3,12,2,13,26,37,3,2,5,4,17,4,6,19,6,3,4,24,16,109,1,12,7,6,1,18,18,72,46,68,1,41,171,9,17,24,12,3,0,1,5,31,8,2,1,4,31,83,1,0,12,10,24,6,92,1,7,0,41,14,1,7,0,1,52,11,12,10,2,0,17,7,8,48,97,1,41,4,39,15,6,0,1,10,5,0,17,10,3,17,9,10,10,33,3,4,13,16,6,5,20,6,3,8,1,10,18,11,12,10,3,11,2,6,13,9,0,7,11,3,8,4,9,8,10,1,2,12,1,18,1,2,1,6,8,1,3,0,5,10,5,15,3,24,3,3,3,2,4,4,5,44,12,7,13,44,2,19,0,8,20,13,3,7,1,22,39,2,8,4,2,56,14,4,31,34,50,1,12,11,6,12,1,21,32,15,5,0,15,10,4,1,13,0,1,26,2,7,13,7,1,12,0,2,0,5,7,1,28,27,13,0,6,17,5,2,0,0,4,4,2,7,1,0,8,1,0,0,1,0,3,10,6,2,3,12,9,9,1,3,3,0,1,16,1,1,1,2,5,15,5,1,40,0,0,13,0,0,16,1,7,2,1,1,0,0,0,3,2,3,0,5,0,3,7,13,0,0,3,3,0,0,0,3,16,4,9,5,19,2,2,3,0,0,18,6,3,25,12,3,0,4,18,4,0,5,2,4,0,0,8,2,3,0,0,23,4,1,2,9,0,0,3,0,0,0,0,0,19,4,0,0,0,1,1,1,5,9,2,3,7,3,0,22,0,10,17,3,1,0,2,1,3,7,33,0,3,6,0,4,7,1,5,3,7,0,3,2,0,5,0,0,1,0,0,0,0,0,7,4,3,0,0,0,0,1,5,0,0,1,0,1,3,0,0,1,36,1,0,0,2,2,1,1,2,11,0,0,0,1,4,16,7,6,0,7,0,0,9,10,4,10,0,7,1,0,3,0,7,4,1,7,13,2,6,2,3,12,4,0,1,2,0,0,1,0,0,3,5,2,0,13,9,7,0,4,0,0,0,9,8,3,2,0,1,3,26,0,5,9,27,8,0,1,0,6,4,9,6,0,4,15,3,0,0,3,0,6,6,1,0,0,0,3,6,18,2,2,0,6,7,0,1,0,0,0,1,0,3,13,5,2,6,10,2,0,3,0,2,1,2,5,26,1,3,0,0,2,2,1,2,28,4,4,2,14,4,2,6,13,5,0,9,2,7,0,0,2,9,4,0,2,3,2,4,27,7,4,0,12,2,1,2,0,6,0,13,5,1,1,0,0,0,3,4,0,0,1,0,2,0,0,0,2,1,0,1,0,0,0,0,2,0,6,0,17,0,44,0,0,2,0,6,13,29,2,0,4,2,6,0,1,1,1,6,1,6,1,0,5,1,4,0,11,2,0,0,0,0,4,0,2,0,0,3,1,5,0,1,0,1,0,5,3,1,0,6,1,0,3,2,12,4,5,0,1,20,7,5,0,1,4,0,0,0,2,1,0,0,4,0,0,5,1,2,4,3,18,20,0,0,5,0,3,0,1,0,0,0,4,0,0,13,0,27,2,1,0,8,14,17,38,0,12,16
deficit,4,14,8,70,1,2,3,1,7,1,2,7,20,12,0,0,8,1,23,2,3,10,48,43,6,33,5,21,3,13,0,96,26,1,33,59,7,3,6,8,5,3,0,35,7,0,17,6,18,29,19,3,13,24,8,0,3,16,21,10,0,2,0,6,21,23,51,12,6,7,23,1,0,10,97,5,25,1,40,10,59,11,0,7,91,9,5,52,36,5,8,4,57,8,16,17,6,1,32,5,6,17,5,3,12,7,39,99,16,17,12,4,30,25,40,21,0,5,16,77,8,22,115,167,17,1,2,11,4,4,17,0,9,16,6,36,4,5,11,11,7,38,27,2,1,64,7,16,11,23,1,17,3,5,15,54,29,14,3,20,35,8,7,11,88,26,2,9,9,6,6,47,16,8,4,2,19,2,1,46,10,1,18,19,0,6,10,12,5,27,9,1,1,14,28,5,35,7,9,1,26,5,16,5,14,10,8,4,5,6,31,7,14,17,4,53,1,120,28,12,43,8,3,9,25,21,20,27,18,34,8,21,78,20,18,45,7,9,3,1,21,11,6,8,3,2,0,17,23,11,3,12,6,10,3,10,3,9,1,3,0,6,19,2,3,25,10,12,6,2,12,9,28,0,1,10,7,42,0,0,18,4,5,0,12,4,28,32,5,6,0,0,13,35,6,3,2,3,0,4,6,14,3,16,1,3,8,5,2,3,3,0,35,2,46,6,11,16,3,6,4,4,23,8,16,0,27,31,3,6,2,6,2,0,0,0,14,0,10,7,3,16,11,2,1,5,4,9,7,24,6,8,0,12,7,3,2,0,6,42,5,2,2,2,0,3,7,1,17,26,0,7,1,5,3,8,1,1,1,8,11,0,7,2,0,1,1,4,13,0,0,2,10,1,11,7,3,1,16,0,3,7,8,7,4,0,3,0,12,8,0,0,1,1,3,3,0,4,2,0,0,0,4,4,3,0,2,0,2,3,3,4,0,1,2,3,0,0,12,2,2,0,0,0,1,0,6,0,7,7,6,0,11,3,4,0,0,2,3,5,12,6,2,2,1,1,9,1,0,4,3,4,3,4,1,1,2,0,6,3,2,1,1,1,5,1,2,0,1,0,19,21,1,5,3,0,0,8,1,0,8,6,9,4,4,4,2,3,5,1,0,0,2,1,3,3,4,2,1,9,0,1,3,2,1,2,3,0,0,8,4,2,2,2,11,1,2,0,4,2,0,0,1,0,9,2,0,11,5,0,1,0,2,14,3,0,2,2,0,0,0,2,3,1,1,2,2,2,4,2,5,5,7,1,0,0,4,0,2,20,0,3,0,8,0,1,10,0,4,0,7,2,5,6,3,1,1,0,3,4,6,0,1,0,1,6,1,3,3,0,7,3,0,1,0,0,3,0,3,2,0,0,0,8,2,1,0,2,1,3,8,5,9,2,0,8,5,7,4,0,1,0,0,2,2,24,2,0,13,11,2,0,3,1,0,8,8,5,1,0,0,2,0,0,0,0,0,0,0,2,1,2,6,0,3,0,0,0,11,0,11,9,1,0,0,0,2,11,3,0,4,3,3,1,1,1,1,0,9,1,2,0,0,0,2,0,3,2,1,0,1,12,0,9,6,5,0,0,2,5,2,0,0,0,0,0,7,1,0,3,0,1,4,5,0,9,7,1,0,0,4,0,1,1,1,0,24,0,0,2,3,21,17,24,22,6,1,0,2,9,12,5,1,27,6,4,3,0,4,1,2,0,5,0,1,1,9,1,0,0,0,0,6,2,8,0,0,0,7,5,0,0,0,0,1,7,0,4,1,1,4,1,1,0,3,2,7,5,6,1,1,0,0,0,0,1,0,9,0,4,0,5,0,1,1,1,6,7,0,1,6,6,1,0,1,2,3,5,0,1,0,0,0,0,10,4,0,9,7,1,10,5,1,2,1,0,0,1,0,1,1,1,0,2,2,1,0,1,0,6,2,1,11,0,0,1,0,0,2,0,0,0,2,2,0,1,2,0,1,0,1,1,4,0,1,5,0,0,2,3,2,0,2,0,2,0,0,0,2,3,0,6,0,10,1,1,0,0,1,8,0,0,0,1,0,1,1,0,0,0,0,7,0,1,2,3,1,2,0,1,1,2,35,4,21,19,24,45,34,0,0,7,0,6,1,12,4,1,5,0,1,0,0,1,14,0,0,0,0,0,0,0,6,9,2,0,3,1,2,0,7,0,0,0,6,8,0,7,0,0,0,1,3,13,1,11,3,1,0,1
budget,10,29,12,203,9,21,2,6,10,1,1,7,28,58,0,0,14,3,25,9,4,11,63,33,4,37,10,30,9,23,0,164,33,11,33,79,11,2,7,9,14,15,2,29,24,2,54,20,40,79,23,14,9,47,35,1,2,11,28,8,1,1,7,5,13,25,49,16,4,9,65,0,8,4,161,9,29,5,66,21,110,24,3,8,144,19,0,89,16,7,9,7,47,25,27,29,12,0,72,4,7,24,18,8,11,14,45,105,17,28,24,12,59,21,24,27,0,7,23,60,9,39,132,180,12,1,6,13,4,18,29,5,13,49,15,91,3,11,9,8,3,34,20,4,1,58,5,22,11,13,9,12,3,11,36,134,39,11,2,56,34,10,14,12,140,32,4,20,20,7,19,82,19,16,10,2,13,6,3,85,22,7,74,28,0,11,24,4,3,19,5,2,3,13,32,6,34,6,13,5,21,13,26,7,12,18,2,36,3,9,45,13,50,30,5,50,120,1,30,12,83,15,2,10,41,22,23,27,12,73,8,14,88,19,39,18,18,15,12,6,41,14,11,10,6,6,4,56,57,18,5,18,34,3,5,11,3,23,5,11,0,37,58,3,4,8,32,19,17,6,28,37,15,1,0,16,30,89,2,5,40,4,3,0,13,9,44,34,4,5,1,4,46,57,15,8,12,26,2,6,21,37,23,28,11,23,16,4,5,21,2,10,48,15,52,9,12,23,9,16,4,8,29,17,25,1,17,40,2,27,9,3,0,14,1,10,8,3,15,6,3,39,24,1,2,4,10,17,13,41,13,13,0,27,3,2,6,1,2,38,28,7,9,7,2,11,6,5,40,30,2,38,6,13,8,14,2,1,5,9,30,1,12,3,13,3,5,8,30,3,1,3,14,1,8,10,3,5,14,0,0,13,4,5,7,2,7,0,7,14,0,0,3,4,0,6,7,8,2,10,1,4,14,7,2,3,3,2,2,4,2,5,0,3,6,1,4,4,59,21,5,0,2,2,0,3,17,9,9,7,43,1,13,11,7,2,5,0,2,5,20,12,5,15,4,2,22,3,3,3,13,10,5,3,3,2,2,3,20,12,3,4,0,5,2,3,4,4,0,0,54,22,2,8,4,0,2,12,0,0,9,4,4,9,2,12,7,2,4,3,2,0,1,0,0,0,6,2,0,16,0,0,0,4,1,0,8,11,3,20,6,1,5,2,13,2,0,7,9,7,0,6,2,7,6,2,0,9,4,3,2,1,1,30,3,2,5,4,3,4,5,7,4,5,7,3,1,8,8,9,7,0,28,6,3,0,0,0,3,70,1,2,1,6,0,2,1,0,0,14,8,3,9,8,3,2,0,5,1,1,12,5,4,0,3,2,2,19,1,3,16,5,1,0,6,1,1,2,5,0,2,0,4,4,4,1,0,3,3,10,1,3,3,7,2,3,7,11,3,2,1,9,1,7,0,8,13,17,16,14,0,2,0,4,1,11,12,9,0,0,1,2,0,0,5,0,0,1,1,4,0,0,0,3,7,0,1,4,0,0,1,7,2,0,2,0,6,17,1,1,5,13,5,0,0,2,3,0,11,2,0,2,0,0,2,31,14,6,2,9,1,10,0,16,6,2,5,0,5,12,1,0,0,2,3,0,1,4,0,7,3,4,5,3,0,0,4,3,0,2,8,0,2,3,3,0,16,21,2,1,4,20,31,14,11,15,5,6,1,2,4,4,1,25,13,7,9,0,8,0,5,1,0,2,2,3,12,3,0,1,0,0,14,2,8,5,3,0,7,8,2,2,0,6,0,10,0,13,2,0,7,2,2,8,3,1,7,5,3,3,0,0,0,1,0,5,1,7,0,9,0,1,1,2,0,0,11,9,2,2,3,1,0,2,2,1,0,15,0,4,1,4,0,4,0,5,0,11,5,6,10,12,3,0,4,1,0,0,1,5,1,1,2,3,1,0,4,0,1,28,13,0,3,1,3,3,0,0,2,0,0,1,2,5,0,0,1,2,2,2,5,0,6,1,0,4,0,8,2,14,4,0,13,0,3,1,0,0,0,6,12,11,2,3,0,2,0,0,1,15,0,3,0,0,0,0,0,0,0,0,9,12,0,2,0,3,1,1,0,4,0,5,59,10,42,9,28,70,18,1,1,13,3,8,4,3,0,0,8,0,0,1,0,2,8,0,0,4,0,2,2,0,9,10,5,0,24,1,1,0,0,6,1,0,4,14,0,24,0,10,0,5,2,12,2,20,8,0,7,6
office,9,113,34,250,16,15,10,40,8,6,22,8,15,80,9,0,14,26,14,5,5,74,21,34,31,21,31,19,12,39,4,262,141,32,62,65,26,12,20,5,10,6,5,9,50,18,34,47,287,49,48,7,15,44,3,1,94,91,16,18,14,8,6,21,41,19,123,12,9,9,43,4,9,9,87,17,21,4,142,37,116,5,19,10,263,26,15,4,45,6,21,11,18,53,45,17,26,17,45,13,12,28,43,15,16,64,8,15,55,9,32,11,36,32,12,37,4,10,95,225,28,37,12,224,17,6,5,10,13,5,19,4,4,75,33,88,11,17,11,15,9,53,62,2,6,168,10,39,19,33,96,6,15,8,4,34,51,11,5,30,26,2,14,8,31,19,13,30,28,11,34,142,18,7,22,13,233,10,18,45,36,7,21,34,11,22,40,15,42,72,11,5,4,4,8,10,27,14,32,14,55,14,3,24,35,28,8,93,12,32,114,13,39,4,11,12,28,30,1,7,4,29,6,26,83,196,47,38,9,32,23,18,39,25,34,43,30,10,3,21,83,47,8,7,16,10,11,40,89,14,8,15,16,20,17,21,12,7,6,54,15,48,34,4,4,226,13,21,22,9,181,24,54,4,6,6,26,49,17,19,72,12,4,23,13,7,18,25,10,5,2,10,41,18,11,15,32,8,4,22,29,73,4,10,11,5,13,28,8,5,6,10,31,16,48,41,17,56,10,13,30,9,35,5,62,8,7,49,4,56,15,15,14,16,6,28,29,4,1,21,5,15,24,16,8,8,50,60,20,19,19,26,18,41,10,11,22,11,10,62,16,13,11,9,1,6,38,8,29,42,6,61,6,19,11,69,10,2,13,10,66,3,55,25,7,157,11,18,33,3,22,7,37,35,43,17,57,17,57,8,41,14,3,7,10,2,13,1,10,37,2,9,1,39,10,17,7,7,5,12,8,20,27,10,5,0,7,13,8,18,18,8,6,28,5,7,2,13,18,7,17,13,8,7,3,4,20,13,34,17,27,9,13,9,46,26,6,9,6,41,16,25,29,52,9,6,24,15,6,3,27,4,11,1,3,21,5,33,19,9,8,15,2,8,9,11,38,9,10,11,51,53,4,4,9,11,4,31,7,20,13,13,5,8,4,23,9,23,5,10,4,4,6,13,22,15,9,8,1,18,1,21,14,43,5,5,22,8,22,39,15,8,5,17,23,13,13,12,58,49,6,4,4,4,16,12,3,18,24,11,75,9,13,62,18,34,30,8,5,14,32,6,51,3,18,28,14,11,38,52,5,20,38,13,16,12,0,8,2,42,1,17,20,22,8,8,18,11,17,12,45,38,25,9,28,7,7,3,21,12,22,13,8,2,11,28,20,66,34,10,30,46,72,11,42,16,16,1,20,12,13,4,6,40,5,9,8,12,23,70,10,44,37,14,11,6,8,25,12,17,13,6,18,97,6,71,4,13,13,152,18,5,4,22,7,26,38,12,6,21,11,7,12,12,5,0,0,14,4,11,23,10,31,34,35,3,12,6,2,6,5,30,7,14,20,30,17,11,12,16,32,23,32,17,10,19,15,15,22,13,11,6,8,4,29,14,11,10,10,8,10,19,2,26,17,32,12,4,7,24,7,4,0,89,1,17,13,9,14,18,7,34,17,5,16,99,26,11,49,13,9,12,7,1,4,12,30,12,9,13,12,30,11,30,25,7,10,36,18,24,15,12,4,12,42,15,15,31,12,24,12,5,9,25,9,14,9,11,6,11,0,11,16,3,14,7,13,22,16,20,12,41,15,16,9,29,3,9,3,87,5,8,16,8,10,3,6,5,25,6,1,3,14,10,3,2,10,12,10,20,3,12,8,17,30,6,6,32,18,8,28,18,14,7,8,17,10,40,6,14,8,6,3,22,4,16,6,11,12,9,40,36,9,5,8,21,14,23,13,2,4,8,16,11,9,10,3,12,12,31,40,9,10,6,8,7,6,6,13,3,4,5,19,5,58,7,6,13,8,3,8,13,3,10,2,7,3,20,15,6,14,2,15,14,39,6,5,10,12,28,10,6,8,18,15,8,4,1,10,14,8,3,6,9,3,8,2,16,2,23,12,11,9,8,6,9,14,14,5,24,3,9,23,5,15,18,9,46,64,4,12,12,5,2,9,9,31,7,23,9,41,6,42,19,7,1,24,46,15,4,3,10,6,13,6,5,11,9,12,6,33,8,19,6,10,5,4,13,10,3,6,10,16,7,2,9,2,10,4,9
project,1,3,5,66,3,4,3,7,0,1,7,5,5,22,3,0,4,3,2,1,4,15,5,6,5,7,0,4,1,4,0,97,32,5,14,18,9,1,2,2,5,3,3,8,8,8,17,8,102,12,11,1,4,7,5,2,9,14,3,7,5,1,1,7,11,2,24,5,3,8,11,9,0,0,43,4,7,2,16,12,33,1,8,3,85,7,10,5,11,7,5,2,5,8,20,5,5,3,31,4,29,19,11,2,6,5,5,3,10,4,3,3,13,3,10,7,0,0,18,40,12,6,13,48,2,0,3,1,5,7,13,0,0,17,3,54,0,1,3,9,0,8,14,2,0,37,1,6,9,4,30,11,5,22,4,55,13,5,3,7,18,2,5,6,29,2,2,15,6,4,19,31,15,4,0,2,56,12,2,26,15,3,12,8,7,9,15,6,7,17,0,1,0,1,2,4,34,1,3,4,5,0,7,2,6,1,1,10,3,16,21,2,8,3,2,2,12,12,7,1,3,9,1,9,25,25,14,10,1,13,4,9,5,24,9,7,7,3,4,3,20,4,1,0,5,12,6,5,30,3,6,6,1,2,1,1,0,6,0,8,0,5,11,0,2,20,3,1,0,5,33,14,11,1,3,2,6,17,5,3,17,1,0,3,6,5,4,7,2,1,0,1,8,12,2,1,16,0,2,4,6,27,4,4,4,1,11,4,3,4,2,12,19,4,10,3,8,15,13,1,9,7,4,3,13,4,13,8,4,1,2,2,1,2,0,11,5,4,6,3,1,3,5,2,3,3,7,26,10,0,4,1,1,24,3,5,1,1,11,9,13,8,12,1,4,2,3,2,4,7,4,11,10,11,0,10,0,0,3,2,7,3,20,9,3,14,1,6,10,2,5,0,4,3,13,3,16,0,8,3,5,2,1,0,4,2,0,2,1,8,1,3,0,5,1,1,4,3,1,0,0,3,13,5,1,4,1,2,2,7,3,0,0,3,1,1,3,6,3,5,11,8,19,5,1,1,9,0,12,2,4,1,5,0,27,0,0,1,7,4,3,2,8,4,4,1,9,4,51,0,2,0,1,3,1,0,1,3,5,0,0,8,0,3,3,0,4,0,0,2,17,11,0,0,2,0,2,7,1,0,1,4,3,1,6,0,3,6,0,0,0,2,6,0,2,8,0,1,0,4,4,7,1,4,0,0,4,4,0,9,3,1,0,1,2,3,2,3,14,15,4,2,0,3,0,7,0,3,3,6,3,3,2,13,5,1,10,5,5,0,13,3,10,1,2,8,2,2,5,17,8,2,11,1,0,5,1,4,2,19,0,7,7,3,2,2,0,4,0,3,7,3,3,2,4,2,6,0,14,11,10,2,1,2,8,7,1,5,10,0,11,12,3,0,6,3,4,2,3,3,0,1,1,2,9,5,3,8,4,12,1,9,6,2,5,1,0,16,0,4,0,2,3,6,3,18,9,2,3,57,3,1,2,1,3,2,7,2,2,3,0,4,2,3,3,2,0,2,3,3,2,1,12,5,8,1,1,3,11,3,14,9,1,4,6,3,8,5,2,5,4,3,5,14,3,18,0,0,5,8,0,3,1,1,2,3,3,1,3,1,1,0,2,4,5,2,2,2,4,1,1,1,1,2,1,2,9,0,0,1,1,1,1,2,6,0,11,2,8,5,3,0,3,4,2,0,9,37,2,2,3,1,6,3,2,10,2,4,3,0,0,1,1,1,3,2,16,1,6,2,3,4,1,4,2,7,1,2,3,2,1,4,1,2,7,2,0,1,3,5,1,8,7,0,3,7,2,1,3,0,1,3,2,10,1,0,5,0,6,0,0,1,3,5,3,4,2,2,1,5,0,0,5,7,14,0,2,6,0,0,2,1,2,1,0,2,1,4,1,3,2,2,0,3,1,10,1,3,2,4,3,4,1,0,7,0,2,2,1,11,0,0,1,2,0,0,1,10,3,3,10,3,0,2,2,3,3,4,2,2,0,0,5,0,5,2,2,1,2,2,8,45,1,4,1,0,0,1,1,0,5,1,4,4,1,0,3,0,0,12,6,4,2,1,1,0,2,10,1,5,5,3,1,2,0,2,1,2,3,0,0,6,2,2,1,0,5,2,1,23,1,0,7,0,3,5,1,17,12,0,9,3,2,3,9,0,4,10,13,0,1,17,0,0,1,0,8,0,0,1,4,2,1,1,2,2,0,2,12,0,0,6,0,0,1,1,2,2,0,0,0,2,4,3,0,0,2,3,3,1
balance,1,8,6,61,1,4,3,11,0,2,1,2,9,31,1,1,5,12,8,0,1,22,15,7,5,11,3,24,8,26,4,150,54,4,25,46,16,12,12,2,7,9,1,5,17,2,16,6,98,22,22,3,8,31,11,2,18,33,2,12,6,5,1,6,11,6,32,1,4,8,66,2,4,2,76,3,14,2,48,10,61,3,2,11,116,34,14,14,74,3,13,1,4,70,60,7,5,5,32,17,4,31,17,4,5,7,23,11,17,6,36,7,16,7,23,14,6,3,53,65,18,9,44,188,2,0,1,4,2,2,7,3,5,22,19,29,1,2,3,7,1,21,28,6,3,26,1,4,11,20,32,7,10,10,4,28,19,4,0,17,11,4,5,5,21,4,5,10,9,10,7,68,16,6,5,4,59,3,6,27,12,6,13,6,5,17,9,5,6,30,3,3,9,4,7,4,9,9,15,2,20,5,3,6,20,2,8,14,3,17,25,9,20,10,1,14,43,83,4,3,1,12,5,2,29,31,31,20,14,30,3,29,35,13,22,69,20,3,15,3,33,15,7,4,10,5,1,17,25,5,3,16,6,36,5,5,1,6,4,8,3,17,11,2,5,53,6,8,4,2,43,25,210,0,1,8,13,84,8,0,23,2,1,14,4,4,4,2,4,0,3,2,6,30,12,6,24,1,2,13,1,8,14,6,4,6,10,2,2,4,1,8,16,3,71,14,3,16,10,1,6,2,23,4,12,0,10,20,4,16,1,14,3,0,8,3,3,2,17,16,6,2,5,3,2,0,19,18,5,8,25,10,0,23,11,12,3,2,8,93,5,11,4,12,3,2,11,0,7,5,0,11,6,4,2,25,2,5,2,38,21,1,12,8,2,23,0,9,90,2,3,3,5,8,11,5,22,8,4,3,8,2,9,2,7,4,7,1,24,6,0,3,25,5,0,5,6,3,1,3,1,10,5,6,1,1,2,4,4,11,32,61,43,19,1,4,1,0,7,6,3,3,2,31,0,1,8,4,24,14,16,3,6,3,26,1,3,0,1,14,5,15,15,6,1,0,13,2,2,0,1,2,2,2,0,2,0,7,10,5,5,5,10,3,4,4,11,2,2,1,48,52,2,4,12,1,4,21,7,1,9,10,5,1,1,11,20,20,4,7,3,0,1,1,2,5,3,2,0,4,1,2,4,4,2,3,11,4,2,27,5,1,0,11,6,9,2,4,14,12,2,4,4,2,14,2,1,5,5,0,10,0,2,29,2,1,12,3,0,3,4,2,9,4,1,3,3,2,14,9,14,8,28,0,4,2,8,5,2,84,5,9,1,9,1,1,2,5,6,5,9,14,4,6,14,1,0,2,7,6,5,2,1,1,0,9,6,11,1,6,9,1,1,0,4,6,12,0,0,1,5,2,2,23,9,1,0,3,1,8,14,9,9,16,2,6,2,8,1,5,2,1,3,10,2,45,4,2,4,56,0,2,3,1,1,18,18,9,2,6,0,5,9,5,4,1,0,9,7,8,5,5,13,2,23,2,1,2,8,2,8,13,2,3,2,9,4,11,0,0,5,6,14,2,3,8,8,2,12,3,5,2,2,2,10,4,13,3,2,1,0,66,2,10,10,6,1,1,4,3,4,0,1,6,1,4,4,0,0,13,1,7,11,4,5,6,18,0,7,9,4,2,2,6,3,0,19,7,8,5,4,101,53,88,51,9,2,3,0,32,30,5,10,16,9,12,6,2,10,7,9,0,1,5,1,3,15,2,7,10,0,1,8,5,4,0,1,0,7,7,6,0,0,4,3,4,0,0,7,0,7,4,9,1,1,2,6,3,3,2,20,1,0,6,3,1,1,5,0,8,0,8,0,1,0,2,1,2,0,8,41,22,5,0,0,0,3,9,3,1,2,2,0,2,1,7,5,1,3,0,9,4,2,17,2,2,1,29,0,4,0,1,0,7,0,1,0,0,1,10,0,3,17,6,0,2,0,2,3,7,6,3,0,4,5,3,1,4,0,2,1,5,0,0,0,3,0,0,0,2,5,0,5,2,0,15,0,3,23,6,1,50,1,66,2,20,4,2,2,3,1,8,2,4,0,2,0,2,7,10,0,0,3,4,3,10,0,6,2,7,6,10,68,59,31,82,34,101,277,0,1,1,1,11,8,102,2,1,21,2,6,1,3,1,3,8,5,9,1,1,2,2,5,5,5,0,0,2,2,0,6,0,3,1,1,6,4,8,4,2,0,1,7,4,0,17,5,8,1,3
another,14,47,23,174,13,20,13,103,1,12,34,16,11,189,9,23,10,23,22,11,9,50,30,65,42,21,37,41,19,47,24,277,190,17,115,138,89,12,26,11,25,18,10,7,58,30,42,24,495,75,85,20,20,74,34,14,95,28,17,32,37,18,13,12,31,12,184,19,16,43,35,5,10,8,192,24,53,5,126,39,77,4,24,21,341,28,15,2,55,8,15,17,11,44,86,25,23,13,58,25,15,63,36,20,30,51,10,17,31,11,27,6,14,30,20,64,10,15,112,302,74,51,51,155,20,6,3,9,9,9,37,14,30,97,50,99,55,10,13,17,25,68,45,10,15,118,16,26,20,22,111,10,27,14,16,38,78,8,19,51,20,14,32,13,16,29,17,31,55,24,42,451,51,16,11,18,248,10,21,59,43,22,14,32,4,57,63,43,85,96,11,15,8,3,16,13,25,14,20,71,40,4,3,12,29,18,12,39,17,36,145,25,59,21,10,22,8,15,29,9,12,1,9,29,60,176,72,64,11,20,21,35,28,43,86,29,75,13,16,13,114,64,17,32,29,8,13,73,81,13,23,31,41,9,8,31,14,14,11,29,14,47,26,12,13,51,29,19,26,6,181,10,36,14,5,2,34,14,23,6,112,15,4,27,25,2,19,29,25,10,16,12,31,17,10,17,51,16,13,56,36,23,5,11,18,7,46,14,15,3,2,35,46,14,87,20,40,67,46,11,90,17,62,28,160,19,38,66,7,58,10,29,18,5,23,20,41,19,7,22,28,31,18,17,13,14,52,89,22,21,20,19,18,55,43,14,10,9,25,57,41,14,13,32,6,8,64,19,34,35,3,28,10,22,20,43,20,10,35,13,121,10,80,29,18,63,24,38,42,12,37,14,23,15,43,8,74,9,45,5,39,5,10,2,13,17,7,11,43,21,19,25,7,32,17,11,7,10,8,5,16,11,41,27,5,9,9,23,25,39,27,11,5,15,10,9,7,15,17,12,24,30,5,21,6,15,29,12,58,10,29,9,14,6,94,22,7,24,16,43,27,50,76,67,8,12,29,31,12,5,51,13,9,17,8,80,14,24,28,13,20,27,12,19,10,23,17,12,13,6,172,60,8,11,15,13,7,31,12,36,35,6,8,5,30,22,18,32,7,4,5,16,12,18,20,19,9,17,10,17,5,41,13,44,17,11,50,18,38,54,14,16,20,20,8,5,10,22,63,44,12,6,11,32,8,14,24,35,22,15,80,6,17,60,13,17,44,3,9,12,32,9,29,8,11,20,24,22,50,60,15,10,14,7,17,18,13,10,16,29,13,18,22,34,13,20,13,18,8,17,40,41,22,14,55,12,25,10,59,29,28,3,7,11,8,36,5,30,19,3,41,26,12,10,62,15,30,13,14,4,16,2,15,38,7,6,11,18,24,58,26,32,51,54,10,4,38,15,9,12,43,23,18,31,24,20,5,13,10,246,25,8,8,6,17,22,64,24,14,32,8,11,23,26,12,5,6,13,15,14,29,15,59,58,49,19,6,12,10,15,9,31,27,9,23,14,18,15,6,15,34,19,16,17,8,14,11,7,26,10,6,10,5,17,14,17,15,11,12,6,11,23,14,40,16,22,20,11,10,10,8,9,10,31,9,18,13,6,12,21,15,19,5,9,7,5,23,14,32,12,26,7,10,22,34,6,27,20,10,12,22,1,0,16,8,16,13,12,8,22,23,26,3,14,29,15,21,20,21,18,8,12,20,30,6,10,11,10,15,29,9,10,31,7,26,14,9,5,9,16,14,27,16,6,20,24,9,9,7,5,5,10,31,6,9,7,16,26,39,10,10,8,28,10,6,7,11,10,12,26,10,11,22,14,11,6,7,12,9,8,7,9,17,12,11,9,14,34,20,10,12,12,15,13,9,8,9,9,6,28,44,34,14,6,7,8,32,12,7,11,8,8,17,4,7,13,16,10,17,12,12,24,12,15,6,6,4,25,10,6,6,8,3,12,12,7,2,7,7,11,9,22,9,8,9,19,9,4,12,18,9,2,5,15,21,14,4,12,4,35,7,7,8,10,16,8,5,8,12,11,8,14,6,19,5,9,9,14,8,12,9,10,12,12,8,7,7,11,9,12,9,22,2,3,10,28,24,12,21,4,1,7,16,7,6,4,2,13,18,9,4,7,7,4,1,29,5,3,12,15,35,20,25,5,10,4,2,11,14,10,8,7,9,6,8,12,16,6,25,4,4,6,7,4,3,15,9,6,7,6
highly,3,11,4,65,6,4,5,16,0,2,12,8,2,31,3,5,7,11,3,4,2,24,1,13,11,1,4,2,4,7,5,103,69,7,34,32,36,2,12,7,2,5,0,4,17,13,14,2,141,8,34,2,11,23,9,0,45,20,0,18,12,2,1,7,17,4,63,5,7,3,5,2,2,5,30,4,7,1,40,15,27,0,9,7,103,6,5,0,23,1,5,3,1,16,43,6,11,5,23,14,8,14,19,6,4,15,10,1,5,1,15,4,6,15,0,15,9,0,44,94,28,14,6,38,1,2,1,1,2,0,8,3,7,34,6,34,3,3,2,4,1,12,13,4,0,32,3,10,7,8,31,0,7,5,6,15,11,1,4,1,8,1,2,1,2,8,4,11,11,2,15,36,13,1,2,3,91,5,5,14,11,9,3,8,8,15,26,10,16,26,0,1,6,0,1,1,7,4,4,3,8,1,1,10,7,2,0,25,12,9,32,5,9,4,1,0,3,2,6,1,5,9,1,8,20,57,14,20,2,2,17,5,13,17,19,17,19,6,5,7,36,20,1,3,10,4,2,7,22,3,8,13,5,9,6,6,7,3,3,15,1,11,10,4,7,36,7,5,10,6,51,4,20,4,2,2,10,9,9,0,28,2,4,13,7,2,9,3,8,2,7,2,5,3,2,5,18,3,5,9,17,21,3,2,11,1,14,0,4,0,1,3,15,4,23,13,7,35,4,4,19,5,13,5,20,2,9,15,2,11,1,4,5,4,6,8,6,8,7,5,3,5,8,3,5,3,23,27,6,4,8,3,3,18,7,8,4,0,8,9,7,8,5,17,5,0,12,8,1,9,2,8,1,10,5,22,9,2,12,1,18,2,12,15,4,7,2,10,12,2,12,2,10,8,19,7,32,3,22,3,13,3,2,0,4,6,1,2,18,13,4,0,2,5,3,3,3,3,1,1,1,8,6,9,2,5,3,13,6,13,1,9,5,7,0,3,1,19,4,8,5,10,8,9,0,0,6,11,19,6,6,7,3,3,26,8,0,3,6,21,9,11,16,16,2,2,7,7,12,1,10,5,0,4,4,5,3,4,14,2,4,19,0,5,3,9,8,4,0,5,40,23,1,2,6,5,1,5,4,6,9,2,5,0,1,7,3,12,1,2,7,1,3,6,10,14,1,3,1,6,2,4,3,12,1,0,8,3,9,19,0,2,1,8,4,1,7,8,20,8,2,4,1,3,12,1,2,15,5,6,13,4,4,21,3,11,20,0,4,5,12,3,6,3,3,4,14,1,20,17,4,7,17,1,2,2,15,2,0,12,8,9,9,5,5,9,3,0,2,4,9,22,4,3,18,1,3,6,32,12,14,3,3,5,1,12,2,22,3,5,7,7,2,4,14,2,14,2,5,3,4,1,6,12,1,9,5,3,10,13,0,11,16,11,3,3,8,4,2,8,4,3,15,14,7,21,0,4,7,80,4,3,4,0,6,8,25,10,4,4,1,4,10,8,10,7,0,7,8,8,15,3,37,18,15,4,6,3,2,1,4,7,11,6,7,4,5,1,1,4,10,3,5,7,2,6,7,2,5,10,4,2,3,2,8,6,13,6,3,3,2,7,1,18,2,16,2,7,12,6,5,7,5,20,6,4,3,3,5,6,5,7,3,1,0,4,22,2,16,11,5,2,4,14,5,3,7,13,6,4,5,10,0,4,3,10,4,11,3,6,6,6,0,1,7,5,13,7,12,2,2,2,2,5,1,5,3,1,9,3,5,3,7,4,7,5,3,34,1,4,2,9,4,3,7,7,4,5,5,0,1,5,3,1,3,3,6,6,13,5,9,3,8,4,3,3,4,5,2,5,7,3,7,4,3,4,2,3,1,5,7,3,10,2,3,8,3,16,4,3,9,7,3,13,6,7,7,1,5,3,11,9,2,2,1,3,4,0,6,0,8,3,5,3,0,3,3,1,3,7,5,2,8,0,1,4,0,10,14,4,0,0,2,2,6,11,4,10,2,7,2,3,0,2,2,5,3,0,1,2,5,5,3,3,8,2,1,7,4,7,3,2,5,7,10,5,3,14,4,1,5,4,1,8,2,3,4,15,1,3,3,2,6,4,4,4,2,3,2,15,6,4,3,4,3,10,9,11,23,3,5,3,4,2,5,5,0,5,11,2,0,5,0,8,3,8,3,0,2,4,3,0,3,0,6,2,0,2,4,1,4,5,3,0,7,2,6,2,17,0,5,2,11,0,1,2,3,5,2,0
point,15,19,11,164,10,14,14,48,13,9,22,9,10,84,5,12,13,22,10,11,9,44,22,49,31,7,17,33,9,18,22,263,133,18,69,106,59,5,7,14,8,15,5,9,36,19,39,19,325,33,70,14,11,58,18,6,97,59,9,35,13,12,1,20,30,8,114,18,30,44,13,14,10,10,148,8,44,14,102,38,67,3,31,23,255,38,24,4,40,5,7,5,4,38,52,27,60,6,42,21,25,52,33,12,13,35,6,13,19,9,32,3,11,15,11,41,2,11,100,271,61,34,61,94,14,9,5,6,3,9,16,10,18,75,34,86,9,3,10,13,6,50,39,8,5,85,10,30,25,17,58,10,17,11,11,39,31,10,5,30,19,2,12,3,9,19,9,33,30,10,37,113,50,4,14,8,252,5,11,84,39,14,13,24,5,33,59,53,74,72,8,4,6,2,8,12,33,2,15,14,27,6,4,19,31,20,9,36,15,24,96,17,40,36,3,17,9,10,26,9,2,29,8,1,57,118,35,41,12,9,29,20,27,19,54,49,34,13,13,14,87,51,9,10,23,9,9,43,73,13,13,45,24,13,15,15,12,4,5,45,11,46,22,6,5,34,17,8,18,7,193,10,28,6,8,1,25,14,14,7,96,9,5,23,12,7,12,21,19,8,16,9,21,8,4,13,48,12,13,23,32,35,3,8,19,6,28,6,11,8,3,31,37,8,40,28,20,54,16,9,40,8,38,9,95,9,24,40,8,32,11,28,10,3,22,7,32,8,9,20,21,14,30,9,9,16,49,58,25,13,19,12,5,45,33,4,5,8,26,34,29,10,15,29,6,4,55,12,12,32,5,28,6,14,8,39,9,7,17,11,87,6,61,12,3,38,4,25,36,8,32,12,18,13,66,26,72,12,38,4,24,3,5,4,6,13,12,4,20,8,4,17,7,30,17,14,4,18,4,3,4,16,30,15,3,11,8,13,11,23,9,8,6,18,4,4,2,21,25,12,20,32,13,18,6,4,13,11,46,14,15,6,10,9,89,15,2,15,14,46,21,29,33,55,24,13,28,13,20,2,19,15,7,3,10,42,6,18,46,10,11,21,4,11,13,23,7,4,4,3,102,49,8,6,14,7,20,11,10,14,15,17,9,1,6,13,4,12,11,2,15,6,6,11,39,34,10,8,5,13,8,23,8,36,14,7,26,12,20,29,28,15,12,20,23,11,12,14,40,28,10,3,9,7,9,15,10,22,31,6,50,6,6,56,13,12,33,3,4,9,29,5,37,8,24,26,13,7,39,37,18,13,22,7,6,15,3,7,18,18,6,21,19,20,16,12,11,10,3,22,36,42,8,9,45,10,11,4,67,27,21,7,13,10,5,42,4,32,14,17,38,24,19,6,37,14,28,8,20,11,13,7,7,25,8,17,14,14,20,32,28,38,41,34,15,7,12,18,7,15,15,7,11,25,9,37,10,6,3,165,40,10,11,14,8,15,43,26,5,17,12,12,11,36,14,15,6,18,13,9,28,12,48,28,18,14,6,11,8,13,22,29,17,16,16,14,16,12,10,44,23,17,19,24,5,19,10,6,31,14,5,10,7,8,9,12,24,13,4,3,7,15,19,34,25,95,21,11,23,13,10,11,6,50,13,51,16,8,10,17,17,17,13,17,5,19,41,9,44,18,18,12,9,19,24,4,23,9,17,6,23,6,5,4,6,12,13,13,7,25,23,18,5,10,26,14,11,5,12,19,16,12,5,16,9,12,4,6,15,13,10,5,18,7,15,8,23,13,10,16,15,17,14,13,13,36,8,10,4,9,5,14,21,10,14,9,7,4,22,19,10,3,19,14,4,10,9,24,7,15,3,4,12,23,35,15,10,8,10,5,5,8,19,11,10,11,9,27,19,6,8,9,7,12,10,10,13,13,4,12,38,29,7,15,8,8,15,10,5,4,5,9,10,5,10,10,4,4,18,21,4,9,10,12,6,4,5,21,9,1,9,4,8,6,27,5,8,15,12,4,7,42,3,7,9,12,12,5,8,9,7,12,10,14,5,7,1,15,3,38,7,6,3,15,16,8,13,11,2,8,7,13,11,29,1,13,5,22,3,4,8,9,6,9,3,5,6,8,8,19,11,21,7,1,14,14,12,14,31,1,12,6,11,8,10,3,17,9,20,2,2,15,11,1,5,19,12,3,9,13,25,7,11,11,9,7,4,14,13,6,1,10,10,18,12,12,11,7,27,6,7,9,5,0,1,19,6,11,2,1
require,18,118,64,692,32,18,18,141,16,9,40,27,31,236,25,17,23,47,22,15,24,131,49,74,55,64,36,43,17,72,41,743,393,35,190,191,138,36,73,26,35,26,13,21,134,67,127,79,997,75,170,23,49,123,49,16,288,142,16,53,70,38,7,52,90,22,318,44,22,64,114,22,32,17,279,35,62,26,329,68,237,7,49,19,739,97,80,14,135,6,22,17,23,99,219,63,71,27,156,47,80,124,135,34,46,129,59,28,48,48,58,21,58,81,23,116,18,24,312,727,143,46,69,305,25,16,12,15,16,16,48,12,22,219,56,197,15,15,17,11,7,108,89,13,17,203,22,51,64,77,211,12,82,32,18,113,81,27,18,38,72,10,40,22,28,30,23,64,93,45,87,267,75,8,26,20,575,19,52,136,97,45,39,49,31,74,147,80,110,153,12,20,24,6,8,7,76,24,34,53,113,14,20,42,109,55,31,142,38,106,280,22,133,46,8,36,25,41,83,25,29,60,20,57,1,465,77,85,38,111,51,66,113,68,126,131,111,31,33,19,264,127,34,9,43,33,14,113,196,31,51,94,58,40,50,69,47,16,20,80,28,121,87,25,26,187,30,21,39,22,631,74,199,41,14,14,93,115,49,19,195,31,20,54,34,13,26,46,66,12,15,19,92,58,21,53,181,26,20,67,88,162,15,17,52,15,83,36,22,13,10,58,145,36,191,75,68,158,66,29,141,22,102,27,224,22,40,83,18,120,34,70,38,15,33,66,69,18,29,50,40,52,69,38,23,23,177,163,69,39,54,41,24,125,71,32,17,14,50,126,110,32,33,62,14,15,166,25,40,41,11,104,12,55,29,196,54,18,53,36,340,13,206,34,7,119,24,91,89,16,79,14,74,52,121,37,246,31,125,19,72,19,20,12,27,20,36,11,90,53,6,30,27,44,36,42,14,21,11,8,11,34,77,45,12,17,12,62,41,57,84,29,43,53,18,14,8,28,62,18,59,108,36,39,6,9,48,22,133,29,82,36,9,27,135,57,3,43,18,114,38,63,87,90,39,15,67,39,53,5,57,14,14,4,21,32,15,51,77,18,27,46,16,19,32,36,48,12,10,17,373,195,10,18,29,25,23,68,40,32,36,22,24,18,36,172,5,57,37,22,24,25,28,28,73,81,18,34,6,50,10,66,38,77,42,30,70,24,45,118,34,16,19,32,39,30,48,20,118,79,16,10,14,25,49,32,29,65,63,23,206,27,17,171,33,48,81,24,27,32,92,22,121,16,60,89,49,29,162,116,53,38,83,31,22,21,41,27,33,69,46,65,58,62,33,19,24,16,23,39,85,127,51,24,76,13,36,21,147,60,113,16,20,22,25,84,29,112,23,43,78,77,50,22,123,23,64,17,28,29,68,71,25,101,18,25,33,50,60,94,110,98,87,92,26,19,25,45,8,58,49,10,40,68,23,173,28,21,37,559,53,21,25,32,22,47,134,42,34,61,29,14,49,45,25,27,6,25,27,36,75,42,131,101,89,21,21,36,25,15,19,109,73,33,44,53,73,26,28,34,53,44,73,61,28,42,37,12,74,65,29,24,24,17,65,37,77,30,20,15,23,30,18,135,64,129,44,36,34,34,42,15,14,127,15,16,55,10,15,47,36,54,21,18,30,30,123,31,129,46,31,24,28,35,48,20,57,39,31,38,50,42,58,105,46,56,38,67,25,75,74,50,21,22,60,72,36,24,25,24,31,6,11,53,28,63,30,17,38,49,15,21,44,14,26,25,20,68,57,67,23,42,9,22,58,78,12,36,20,36,12,14,49,39,19,18,36,19,57,26,38,7,43,34,14,17,25,26,29,57,12,12,5,47,23,16,13,40,53,23,25,29,44,22,28,29,36,72,65,34,19,45,25,33,34,67,36,19,33,33,103,99,30,39,15,20,23,50,28,8,19,19,26,20,28,26,10,24,37,57,21,20,62,91,18,13,15,25,38,13,10,27,12,17,46,18,31,25,25,23,18,26,15,18,31,30,25,27,31,8,28,42,17,42,36,19,13,48,11,85,36,74,26,73,48,20,24,41,21,18,34,25,18,53,7,31,5,53,19,65,22,14,23,30,18,20,26,53,14,62,22,45,82,27,44,108,76,138,199,26,14,17,17,33,30,33,22,36,111,27,16,15,18,22,10,108,27,12,20,28,44,22,28,20,25,25,18,23,31,27,49,30,30,74,31,19,42,20,51,18,18,9,22,12,8,16,5,32,8,13
law,29,250,105,1431,69,31,54,252,26,26,107,62,63,459,45,106,45,131,35,49,39,332,104,212,241,94,118,85,63,175,89,1612,982,90,445,306,225,120,143,26,54,63,49,44,258,138,183,186,2512,80,388,27,70,164,91,44,599,203,28,99,103,48,27,73,185,73,775,57,35,151,110,38,45,58,680,78,154,30,622,186,354,11,107,64,1696,137,99,8,250,17,77,63,23,243,369,172,136,67,230,138,61,256,274,82,79,285,52,42,104,19,118,71,57,146,26,222,48,44,758,1243,338,128,225,451,64,29,28,27,39,21,62,29,64,397,149,311,97,58,53,45,30,300,212,32,14,613,49,115,133,137,597,25,158,49,30,403,303,42,51,73,126,21,70,33,37,75,54,187,194,73,134,668,209,11,43,51,1458,37,100,346,230,93,32,187,23,241,286,190,293,287,35,40,58,8,14,25,109,58,80,168,343,18,29,98,240,98,47,317,90,191,703,51,407,80,26,33,21,22,196,25,31,176,57,118,465,1,264,167,56,72,103,87,144,264,303,247,216,75,66,115,623,299,69,86,159,66,35,198,570,50,120,132,130,81,92,123,84,18,34,227,105,235,162,54,60,463,42,51,106,43,1278,69,241,70,51,9,215,117,78,32,477,142,27,138,64,19,42,96,120,26,42,35,220,52,23,88,268,58,109,197,181,363,17,19,117,27,137,53,62,22,23,246,200,74,283,194,152,313,112,76,438,80,247,35,624,118,61,196,24,273,86,120,74,77,60,132,103,65,24,82,72,80,109,71,45,50,560,402,160,80,170,121,55,336,224,72,74,43,172,226,333,68,71,198,58,16,271,68,88,197,37,181,56,126,126,289,91,44,135,63,709,32,398,113,57,491,163,161,228,39,334,30,169,92,242,95,597,57,288,27,244,19,37,16,46,58,93,15,195,105,29,61,42,178,46,78,26,63,49,15,49,53,184,138,31,63,24,162,73,135,146,41,24,89,31,27,3,36,68,54,192,254,43,49,7,19,71,49,282,75,117,82,25,25,322,124,17,138,101,268,123,165,237,255,45,53,173,117,66,12,169,66,22,33,29,229,32,139,218,68,81,92,16,59,48,87,75,14,57,92,364,299,10,18,94,57,34,158,74,151,101,44,53,24,79,157,32,126,90,52,41,89,64,122,118,164,39,97,217,80,29,162,146,254,90,48,312,194,167,244,114,66,39,102,85,74,117,63,373,300,55,17,43,32,81,71,19,126,155,93,531,147,172,439,75,133,231,66,61,111,178,140,343,48,115,182,106,96,343,420,95,55,124,222,90,23,126,60,47,156,50,169,93,136,76,80,62,85,44,66,202,245,129,45,261,21,62,44,218,167,168,22,49,18,51,180,51,272,100,58,293,288,134,72,440,61,170,61,132,51,88,80,41,231,64,64,39,124,133,294,95,250,301,188,88,48,166,58,43,100,141,48,153,204,70,252,74,35,229,1288,121,49,61,113,60,67,276,142,70,141,38,40,69,80,27,19,3,57,75,82,187,54,136,577,203,71,53,69,15,53,13,238,103,74,96,88,115,38,34,58,126,74,120,60,82,55,92,34,163,116,51,65,66,108,92,44,99,49,153,38,58,71,54,191,163,155,47,57,58,62,76,69,45,316,20,95,73,21,63,100,106,140,64,59,72,36,125,32,362,72,101,46,45,59,70,49,137,63,62,100,70,58,42,100,53,102,89,84,57,160,164,96,32,49,257,131,86,77,66,90,61,33,31,234,54,121,59,30,105,73,26,57,96,36,84,43,55,111,61,160,56,222,76,52,190,171,96,84,37,87,29,30,108,55,59,16,53,51,178,39,62,3,135,80,35,29,49,56,32,113,38,50,34,111,49,64,27,90,102,40,84,41,100,49,91,102,50,208,87,45,38,115,129,133,33,92,53,57,53,109,141,306,247,49,32,55,88,53,148,20,37,74,92,23,72,64,26,49,71,150,62,100,74,94,60,46,19,59,98,14,6,68,44,17,102,35,55,41,70,39,18,56,6,27,62,33,34,59,67,33,60,41,50,49,182,19,11,63,65,151,59,27,85,73,115,30,36,29,32,41,55,24,48,74,25,153,14,53,17,65,111,26,58,55,30,30,54,45,41,85,33,120,70,27,39,168,65,103,364,24,22,69,45,41,42,62,22,22,200,70,62,25,37,95,15,175,73,60,71,40,51,68,25,31,43,57,20,57,58,56,79,47,50,123,50,61,57,23,67,16,30,34,44,5,13,47,14,32,12,21
show,11,38,22,270,25,20,34,54,9,17,41,27,47,189,9,28,7,45,17,19,13,73,39,76,66,23,37,37,20,37,14,447,340,40,133,163,75,17,42,16,20,38,18,9,59,39,50,40,541,90,128,20,30,115,39,21,123,198,13,71,34,15,6,28,72,20,296,30,16,35,42,7,13,13,186,27,92,15,186,83,282,2,25,38,435,63,27,6,141,5,36,5,5,47,123,65,42,31,88,41,36,64,91,23,37,62,42,20,52,23,53,13,29,31,10,85,19,10,109,342,108,59,48,392,47,5,13,10,12,8,35,23,28,120,52,164,26,28,12,49,17,102,89,23,18,179,33,58,47,46,114,14,51,18,19,51,108,8,23,50,80,15,36,14,18,31,39,51,58,17,83,208,70,12,12,15,357,12,25,148,70,21,16,58,16,81,124,59,72,118,8,10,48,4,15,10,37,25,43,24,102,10,3,19,68,24,13,75,17,55,202,14,69,19,13,22,20,23,47,14,31,72,14,35,77,264,1,90,28,40,22,79,62,60,83,97,100,31,34,17,116,73,21,32,24,23,9,72,119,11,31,81,34,53,24,31,23,4,9,98,25,59,37,9,28,177,28,18,27,14,258,21,155,7,7,8,31,135,30,13,146,14,9,42,29,6,13,37,39,7,17,11,26,20,13,21,81,12,12,32,57,51,28,15,36,13,85,24,30,15,5,67,76,9,98,57,23,146,41,15,69,21,75,18,103,11,26,90,3,69,28,37,12,19,20,20,36,14,12,34,16,39,44,26,21,16,100,113,42,30,41,23,16,97,45,18,13,27,32,165,44,30,30,40,11,10,37,21,26,59,6,44,16,31,35,100,18,9,44,29,98,12,92,23,24,115,15,55,82,9,60,10,33,24,55,27,94,13,52,23,60,21,24,7,18,23,45,18,50,29,14,22,66,56,26,15,8,23,22,12,13,16,66,18,10,22,20,50,24,38,36,23,20,26,11,5,8,13,18,16,29,38,20,27,14,21,38,16,123,28,24,12,17,11,141,23,4,15,42,59,30,57,72,134,20,35,60,29,20,5,66,21,9,21,14,65,9,25,58,20,44,42,8,13,11,28,23,11,20,15,189,117,11,8,38,11,16,51,14,37,35,14,53,2,33,60,20,45,15,23,18,18,22,22,71,30,20,33,67,27,22,32,15,66,16,22,82,46,33,60,24,15,4,21,25,16,17,22,108,59,8,15,11,29,19,16,27,43,14,32,43,8,25,105,18,23,65,15,20,13,48,16,45,18,33,43,50,30,75,78,15,20,52,9,23,9,27,20,22,65,18,30,22,44,17,39,14,22,20,17,48,68,21,27,62,26,16,16,51,50,39,7,11,5,10,48,13,44,26,20,131,63,24,14,91,12,22,13,24,12,33,37,8,45,13,14,17,20,40,47,32,53,56,44,22,2,39,33,22,32,37,24,46,59,15,125,17,14,23,322,67,9,17,18,15,30,91,25,15,17,13,14,12,26,1,2,3,9,8,26,40,19,33,63,40,13,13,20,25,12,27,67,27,29,34,19,29,11,20,26,20,28,32,25,15,30,20,5,25,26,49,9,12,25,28,15,45,10,6,15,25,42,11,41,28,48,20,13,15,34,15,17,19,60,14,19,32,6,25,39,7,30,9,9,18,13,70,17,37,25,44,17,7,36,26,13,50,30,8,14,29,77,76,124,101,35,21,22,20,138,132,52,20,38,38,70,56,22,27,21,26,33,5,43,7,29,20,8,35,13,15,11,29,11,25,18,17,13,25,24,17,29,9,16,51,34,46,21,27,9,19,12,18,9,10,7,14,26,35,13,39,5,15,20,11,2,15,22,9,30,6,38,14,31,17,16,11,11,33,6,36,20,26,4,11,27,18,62,19,16,10,13,12,24,21,26,19,22,13,23,26,35,12,12,18,10,29,16,5,7,8,6,9,11,13,15,44,4,10,35,32,9,23,27,14,9,8,12,18,64,8,15,11,5,26,8,16,29,12,7,18,42,11,8,18,22,5,10,23,36,11,4,15,22,33,40,12,6,10,32,9,17,21,40,29,15,30,12,24,18,15,7,7,18,10,4,4,19,3,14,12,6,15,16,3,41,13,21,10,32,12,32,83,20,46,27,28,118,109,9,15,18,17,16,13,20,33,11,30,16,16,11,19,19,9,22,17,16,6,11,25,6,29,16,8,4,8,10,16,18,56,17,11,21,7,14,11,8,19,7,9,6,20,4,2,16,9,18,9,8
less,25,43,20,234,23,28,15,91,12,12,41,21,32,204,8,24,15,45,22,8,10,79,33,71,48,30,42,40,24,52,21,412,268,21,142,174,110,24,47,10,29,22,17,29,73,35,57,28,599,53,133,18,46,126,24,13,122,80,16,48,30,29,8,24,59,19,230,23,14,23,63,25,12,6,293,30,85,9,223,58,191,11,28,13,455,60,36,21,123,18,32,17,33,72,169,53,38,28,102,46,30,49,69,25,47,53,33,45,64,37,37,13,31,37,19,99,7,17,104,402,126,38,74,361,37,12,14,7,17,13,25,12,19,122,74,150,12,13,24,26,16,69,88,8,21,145,22,40,60,54,151,7,48,21,16,73,119,16,29,58,72,11,33,22,38,25,10,41,72,21,64,252,52,1,19,26,328,9,15,117,74,26,17,47,11,69,124,60,75,97,9,14,16,7,18,8,41,22,34,40,81,10,11,20,54,20,17,82,20,61,170,26,48,40,12,19,27,27,38,10,20,64,20,41,85,167,90,1,17,74,51,54,85,38,80,106,97,19,29,22,167,84,16,12,38,23,23,71,97,20,27,76,47,53,44,53,19,20,13,89,11,71,61,12,17,106,20,21,36,14,299,34,170,18,7,6,46,89,17,5,131,17,9,43,32,5,20,31,54,17,11,6,33,22,12,38,107,15,13,52,51,58,20,19,36,10,58,9,26,6,4,39,77,20,145,40,89,121,61,19,83,20,104,18,113,10,39,68,11,71,19,33,19,14,40,25,40,9,16,39,18,18,38,20,20,18,91,103,26,39,26,25,12,69,58,15,10,16,47,112,45,25,27,33,9,2,75,38,15,46,3,53,11,38,31,58,19,17,28,18,138,4,97,37,20,61,12,49,62,14,47,11,34,23,67,29,112,13,72,9,54,14,15,4,27,15,18,3,49,28,6,25,18,43,24,28,9,22,5,13,21,30,49,33,9,13,7,27,29,40,46,26,14,24,12,7,3,20,35,15,33,38,6,51,8,13,32,16,98,32,42,15,27,20,130,20,6,19,17,53,24,62,77,111,13,9,54,28,22,8,59,9,13,18,5,100,15,36,45,14,26,30,11,11,25,12,23,10,18,11,224,95,5,14,40,6,14,46,30,28,60,19,29,5,12,90,22,33,20,16,25,14,17,16,54,38,13,25,11,24,16,48,24,52,9,14,54,16,39,82,26,23,17,45,19,20,13,31,103,57,9,4,37,31,28,25,20,56,26,10,80,10,21,105,18,28,68,18,14,21,59,8,33,12,34,47,44,19,74,78,20,13,67,7,12,16,20,15,26,61,16,33,48,41,20,20,18,25,15,36,54,86,27,12,106,13,24,30,71,39,27,9,7,6,10,59,14,39,16,34,77,29,14,26,77,26,55,8,21,10,38,42,7,72,5,22,8,15,23,51,82,40,62,53,23,16,28,29,14,22,38,13,27,48,11,66,10,13,8,276,41,14,22,10,13,52,81,42,19,45,11,18,24,18,7,7,12,15,29,30,43,23,77,53,51,24,5,16,9,12,14,57,31,17,16,15,36,14,17,19,25,24,38,21,7,21,20,8,28,22,8,8,16,20,28,13,50,16,13,4,13,27,21,64,40,44,19,15,16,34,14,14,18,34,9,21,37,6,8,33,18,41,31,20,17,13,53,13,47,31,26,11,8,39,47,12,40,16,28,16,29,52,36,50,46,26,11,24,9,104,111,69,16,37,38,55,32,16,26,15,21,5,5,31,7,39,29,12,16,15,9,8,56,14,38,2,23,28,46,29,13,20,10,20,30,42,12,17,11,12,6,9,32,9,20,6,21,20,37,17,26,2,19,20,15,9,9,25,7,29,7,38,12,27,6,18,14,10,32,23,44,28,35,10,32,30,15,65,23,7,6,15,10,11,11,28,28,14,17,23,26,59,12,34,11,14,19,26,16,7,14,10,14,11,10,15,33,10,19,29,23,6,55,50,15,20,7,26,27,18,2,30,10,6,13,12,9,6,11,18,8,26,8,9,16,9,8,7,21,27,16,13,19,13,24,24,7,27,32,36,11,17,9,38,20,12,23,20,18,17,23,12,7,26,9,13,15,14,8,26,9,14,8,19,8,18,15,23,9,19,13,50,60,27,40,55,58,84,124,10,15,8,12,10,20,20,42,10,34,9,11,10,16,18,17,30,5,20,17,23,22,14,19,24,7,10,8,21,18,17,24,19,12,46,12,17,20,11,53,1,8,6,15,6,4,23,13,20,4,4
hundred,3,8,3,51,4,15,6,14,0,3,5,5,9,47,4,6,6,15,4,0,0,19,16,24,9,19,20,14,18,23,4,132,90,14,28,55,20,17,2,12,3,9,1,9,18,7,18,6,96,31,33,5,7,33,26,4,24,15,15,10,7,4,2,7,10,2,75,6,2,11,109,2,3,0,58,10,23,1,43,10,44,1,7,9,112,12,25,5,30,3,14,6,3,27,23,6,24,6,36,10,7,36,17,4,14,11,16,9,46,15,11,2,8,11,9,21,3,2,18,137,13,27,21,163,29,2,7,4,20,2,9,8,8,42,19,46,1,3,5,7,8,20,21,9,4,60,5,12,11,18,12,4,10,5,4,17,31,8,4,29,24,8,15,5,25,16,90,15,14,5,16,162,23,4,7,2,83,4,3,31,18,4,9,16,4,12,30,14,9,64,0,3,12,3,4,3,18,4,47,2,15,1,4,7,9,3,0,11,4,13,60,10,11,9,12,10,18,12,9,1,14,11,2,12,38,56,28,17,1,58,11,78,22,15,14,16,19,3,5,8,32,19,5,8,6,2,3,34,27,2,12,14,10,13,7,11,5,2,0,28,2,34,6,4,7,36,13,9,9,1,60,3,51,3,5,5,6,20,1,3,31,6,2,9,14,2,11,13,5,4,6,6,4,12,9,6,18,3,2,14,11,10,4,9,2,2,10,4,4,1,3,13,18,4,24,8,10,17,11,8,13,5,15,6,16,0,14,33,0,27,4,12,1,7,7,6,13,6,1,20,0,16,13,7,8,6,14,22,3,12,11,2,1,28,3,2,3,3,8,44,6,8,16,9,5,4,12,7,6,26,4,25,12,9,6,41,10,2,6,2,20,4,33,3,8,23,1,15,13,1,5,5,5,2,19,9,18,1,12,2,14,7,4,9,5,4,3,0,11,7,3,10,6,21,9,12,6,4,3,6,2,10,13,2,1,4,3,10,6,21,23,2,16,10,5,0,1,4,9,8,15,5,9,10,4,4,15,9,14,5,21,1,8,2,30,2,4,2,7,10,7,12,16,40,18,19,24,5,6,4,29,6,1,6,4,9,1,2,15,1,6,3,3,4,8,4,5,9,2,1,70,37,3,4,6,4,2,7,0,5,10,4,17,5,7,31,2,5,8,3,7,3,0,2,3,3,2,2,3,6,4,4,1,6,3,11,6,3,17,7,3,7,10,3,5,6,2,3,19,9,1,2,2,9,6,3,0,6,7,7,9,1,0,22,4,3,11,3,3,2,5,0,10,3,1,7,9,5,21,13,3,2,10,2,6,0,1,2,5,25,3,4,6,8,2,3,5,3,0,5,14,6,9,6,11,8,7,3,4,3,6,3,7,2,2,4,4,10,5,2,20,5,6,11,15,1,1,2,0,0,4,26,8,22,7,4,1,4,3,8,21,6,10,5,4,4,9,30,4,5,9,2,1,9,4,17,3,1,2,61,26,9,0,0,6,12,21,4,1,9,3,4,8,6,1,0,1,4,0,5,11,12,21,7,13,2,3,0,8,7,10,25,7,7,2,1,7,2,10,18,2,8,2,23,9,14,6,0,7,2,15,1,2,4,6,12,5,12,2,2,1,14,4,10,6,39,16,2,3,8,6,2,4,17,11,13,11,1,2,19,10,13,2,9,3,0,21,3,16,12,3,5,4,16,5,3,22,8,2,5,4,5,20,35,16,9,2,0,6,39,36,7,4,7,14,6,12,2,12,6,13,8,2,6,4,16,8,0,5,2,2,0,9,2,8,5,7,6,13,4,3,5,2,2,4,7,3,2,2,1,1,13,5,3,5,3,5,2,4,9,22,3,2,5,1,1,1,6,2,2,0,7,0,4,16,3,2,6,31,4,12,8,3,0,1,2,3,9,2,3,2,1,0,4,7,3,4,4,1,1,6,10,3,3,9,8,3,2,1,1,2,2,3,1,5,4,5,1,4,1,1,4,6,15,2,3,3,7,4,1,0,4,1,0,4,1,17,1,11,13,9,10,7,3,0,1,0,2,30,6,1,0,9,4,6,4,0,1,3,6,2,2,3,22,3,16,3,8,2,4,0,2,5,3,5,4,0,1,0,9,4,1,0,10,10,6,2,8,2,10,1,10,24,9,7,20,8,31,38,0,16,1,9,5,3,10,14,5,10,0,10,15,1,3,3,8,8,5,1,10,9,6,6,6,2,1,2,1,2,2,4,3,11,20,5,4,1,5,6,6,0,1,4,1,0,8,2,4,1,9
dollar,9,7,9,144,2,16,10,13,2,1,5,10,8,65,2,3,4,22,10,7,3,21,17,26,9,21,6,9,4,22,1,196,119,10,39,45,11,24,63,8,14,5,0,16,27,6,56,98,229,36,33,5,8,47,33,2,29,19,7,14,5,4,5,3,24,9,86,17,9,24,580,7,4,2,83,7,22,5,89,13,127,14,12,1,245,52,41,38,52,44,50,8,37,39,67,47,32,9,45,17,18,47,35,3,20,16,41,50,55,58,23,3,42,12,18,74,5,13,55,198,33,35,104,251,20,3,8,10,23,20,12,6,7,57,18,59,3,5,5,12,4,26,38,4,0,62,3,26,17,44,56,19,24,26,10,101,36,12,4,40,86,12,47,20,449,21,25,19,26,18,15,109,17,4,4,9,114,6,8,74,18,12,83,15,3,41,37,18,12,67,4,14,11,7,61,14,21,7,28,18,32,22,18,4,24,3,9,31,5,19,66,11,23,29,4,15,34,73,32,13,30,20,2,9,111,72,40,74,58,1,16,36,75,27,35,47,29,6,20,0,54,21,8,8,7,25,5,45,89,20,16,29,9,34,8,8,5,24,26,22,6,14,10,12,16,96,44,8,7,9,91,52,178,3,2,8,15,212,2,4,97,0,13,10,44,7,35,23,8,6,3,1,25,35,32,6,38,23,3,7,23,83,77,12,14,6,9,5,8,6,12,25,25,8,100,25,33,50,42,16,9,4,35,17,16,2,9,36,2,42,2,24,6,5,21,33,18,7,27,30,6,10,14,17,14,0,64,25,19,20,10,11,10,47,19,7,4,2,6,70,39,14,8,14,3,3,15,2,9,21,5,48,10,9,2,62,7,9,6,18,49,7,41,2,16,29,2,28,32,1,5,6,12,2,24,10,16,5,27,2,17,1,9,3,4,6,8,1,29,13,3,2,23,11,1,3,12,4,3,3,2,7,19,11,11,0,4,7,1,14,67,12,8,2,1,3,5,1,23,5,11,7,7,23,0,0,9,5,35,20,52,5,7,12,22,1,0,18,8,18,11,21,12,22,19,0,24,14,6,8,16,7,2,2,4,10,2,4,34,1,8,16,7,4,14,5,10,5,2,10,207,52,3,5,8,1,5,22,10,4,15,12,41,9,7,178,28,9,8,4,6,1,3,1,16,10,7,4,2,17,1,42,9,17,3,1,17,39,3,19,7,6,4,5,12,3,1,5,34,32,1,8,0,13,28,5,1,19,14,16,12,3,3,38,2,7,11,2,10,4,14,5,26,5,9,13,4,9,46,44,7,2,84,1,12,6,4,6,12,93,5,12,10,19,6,10,0,2,13,8,8,16,8,13,13,9,4,10,11,10,11,22,6,1,5,15,0,11,5,6,33,26,3,7,23,3,5,2,4,2,13,94,2,46,15,6,0,13,1,24,128,5,7,8,10,10,11,39,11,8,8,7,2,31,3,35,5,18,12,157,3,1,2,4,4,9,46,22,4,3,5,0,2,8,2,1,0,9,4,13,13,2,18,9,19,0,4,1,21,2,19,29,9,8,6,3,22,9,15,4,5,8,16,22,5,10,8,0,26,11,1,5,4,2,12,10,77,3,29,5,1,39,4,24,27,6,3,2,0,8,4,0,1,2,3,5,14,3,0,18,12,14,12,2,10,8,28,12,12,11,11,4,5,8,5,9,13,26,6,4,2,50,260,59,53,16,2,8,5,55,87,16,19,47,21,80,11,13,41,16,6,0,10,7,5,34,50,2,7,4,1,1,15,12,25,6,10,4,50,15,6,2,1,8,4,28,6,8,0,0,6,10,16,1,7,3,11,12,7,11,18,3,1,6,4,3,2,9,3,18,0,8,6,9,5,0,4,3,32,21,35,8,8,4,5,2,1,18,2,3,0,1,4,4,12,68,5,5,1,12,5,34,4,9,17,12,3,18,3,4,0,3,3,5,15,1,3,3,3,15,10,1,45,41,2,7,0,5,2,6,1,12,2,10,4,1,5,4,6,15,6,11,9,1,3,4,2,3,20,9,3,0,8,5,2,1,0,19,11,12,18,66,0,18,0,2,3,7,6,19,1,3,3,1,2,0,0,0,5,52,6,6,0,3,0,13,15,14,0,10,4,11,100,20,69,73,55,219,100,1,4,5,3,10,11,10,5,1,32,2,5,2,2,10,22,3,1,8,1,8,4,2,21,12,2,1,42,5,2,2,5,1,4,126,0,16,1,11,3,5,0,17,4,22,2,29,8,0,6,2
important,4,28,13,207,9,13,7,36,6,4,26,12,20,78,6,10,6,22,11,2,6,41,13,23,34,15,17,21,14,7,12,245,169,12,63,76,54,14,9,11,13,11,3,5,27,23,38,28,300,50,36,12,13,62,25,9,87,32,8,21,37,12,5,16,25,13,121,16,12,15,15,13,8,8,134,19,36,3,90,28,77,6,12,10,208,28,16,2,36,0,8,16,9,28,67,38,25,11,58,37,39,40,51,16,12,27,4,11,23,8,15,8,21,23,10,38,0,4,70,171,61,23,58,108,9,0,3,11,7,1,12,7,6,101,29,100,8,7,15,9,5,49,21,2,5,81,9,33,25,23,84,10,17,14,9,44,38,10,11,26,23,9,14,6,5,11,16,32,35,11,26,143,36,6,3,10,185,7,17,58,38,18,28,39,15,21,58,36,45,64,4,11,6,1,14,6,33,15,11,24,41,4,9,18,24,8,9,43,20,34,95,13,36,28,12,6,8,8,23,4,3,21,17,29,51,103,22,51,11,16,1,20,28,26,54,38,45,21,14,12,70,33,17,7,24,7,12,37,64,2,15,31,18,6,12,30,11,6,5,31,7,24,18,4,10,46,23,17,11,6,170,18,31,11,3,9,24,18,14,6,61,8,4,21,21,7,8,16,18,7,5,12,23,12,4,14,47,6,8,26,32,55,3,8,20,10,21,5,15,4,10,28,33,16,30,17,16,63,17,16,39,10,53,13,61,5,10,41,1,24,8,23,5,5,12,29,22,8,9,15,8,15,20,8,14,11,33,88,28,15,19,8,10,41,34,16,4,10,19,37,40,22,28,35,7,9,41,13,12,20,9,25,5,16,14,63,13,3,18,6,64,2,53,19,13,59,7,28,35,7,9,6,21,11,51,18,85,7,38,7,31,6,6,5,9,8,6,5,36,27,4,23,4,47,15,10,6,10,4,7,5,6,35,7,10,3,5,17,8,14,12,3,2,11,10,6,2,13,24,9,20,41,12,14,8,11,17,9,42,11,36,8,7,7,75,3,2,15,12,38,13,31,45,54,13,19,18,14,13,3,32,15,5,6,2,35,9,26,35,16,7,18,5,5,10,12,13,8,6,3,68,45,5,5,12,11,10,17,5,23,23,16,13,7,17,34,15,15,15,9,5,4,11,11,23,27,8,18,7,13,4,24,17,31,10,11,27,11,24,44,8,7,6,19,9,5,10,13,54,22,6,11,1,8,15,8,3,19,19,9,32,6,6,51,18,20,46,13,11,16,41,8,19,5,11,10,11,8,49,49,17,10,29,5,12,11,12,4,9,26,11,12,21,19,5,4,19,11,4,23,31,51,16,4,28,5,10,6,37,21,22,7,11,6,11,28,11,19,12,10,28,32,16,7,24,10,31,10,17,11,20,13,5,9,6,14,16,16,26,28,10,34,43,20,11,6,13,19,8,7,14,3,9,21,10,30,13,6,8,149,54,12,5,7,8,15,29,20,7,21,9,12,13,23,9,5,8,13,14,9,20,11,47,28,23,3,10,14,6,11,6,35,15,11,18,9,5,3,13,33,9,17,13,25,9,24,17,8,22,33,19,5,5,12,23,12,24,10,2,2,3,7,9,37,25,41,12,10,11,21,9,7,2,32,6,12,14,6,7,14,11,17,6,12,12,8,49,10,48,15,19,14,11,31,17,5,17,39,9,4,11,4,3,10,7,18,9,18,4,14,13,15,4,2,29,26,18,15,13,10,9,11,5,12,3,15,13,4,18,13,9,8,15,5,14,16,10,9,18,8,9,19,9,13,10,28,12,10,8,10,4,10,15,13,3,4,12,5,21,15,4,10,15,11,3,4,3,7,3,12,4,10,9,12,11,9,7,7,8,8,7,14,14,9,14,17,10,28,11,5,9,8,6,9,7,9,10,14,12,11,24,25,10,14,4,6,6,8,3,2,6,5,4,9,2,7,10,4,5,14,8,7,6,10,7,5,4,9,13,4,0,4,3,6,9,4,19,8,4,6,12,21,2,4,11,7,14,6,5,9,9,5,8,11,11,2,9,12,2,28,5,11,5,3,11,4,8,24,12,5,10,16,10,16,0,3,2,22,12,9,13,9,10,8,9,7,4,8,6,21,5,24,3,3,6,13,11,13,19,3,12,6,9,6,15,2,6,14,30,5,5,14,8,9,4,17,10,2,12,16,17,3,15,10,2,7,2,5,21,9,10,14,13,9,5,15,21,8,10,4,9,11,7,3,2,12,2,7,9,3
three,11,41,27,193,9,21,5,47,0,9,32,22,35,96,10,2,7,20,4,6,8,65,21,44,25,30,14,20,11,35,17,313,172,35,62,71,60,23,20,11,9,12,8,18,45,21,39,47,353,47,66,2,24,33,20,2,67,66,13,25,26,6,7,19,37,15,114,21,11,29,134,15,5,4,108,20,41,11,150,20,148,4,26,13,252,34,43,5,121,9,52,6,14,70,89,33,39,11,45,20,47,57,47,22,50,42,28,16,75,30,60,9,23,29,26,58,15,12,88,164,61,36,21,444,44,1,6,13,36,6,35,12,13,67,29,88,7,8,6,13,6,41,62,27,8,99,13,28,29,28,69,11,26,22,12,40,50,13,8,19,49,18,15,16,26,21,29,27,29,7,42,216,31,12,7,22,176,6,12,67,27,12,35,27,11,36,66,29,33,165,3,10,9,16,12,23,49,11,79,13,30,3,7,11,38,10,48,62,14,27,75,18,38,16,15,25,21,14,18,9,29,35,5,20,66,87,79,54,78,36,20,1,44,32,34,52,48,1,20,8,104,52,12,5,12,18,16,46,91,9,21,33,25,32,19,28,14,11,14,55,10,45,32,13,12,126,7,9,12,9,129,20,109,7,7,2,20,67,12,8,93,6,3,35,28,15,5,26,16,3,17,9,31,31,15,14,64,12,3,31,16,53,15,25,10,7,14,17,9,6,9,40,52,6,80,27,19,63,44,13,46,7,35,12,37,7,13,40,8,47,7,25,10,14,7,22,21,6,19,49,16,21,31,19,19,15,46,50,10,31,32,13,7,79,29,12,10,8,31,92,27,22,15,27,3,5,37,15,12,29,4,16,14,8,11,82,18,7,12,18,73,10,72,19,5,71,10,31,58,5,19,5,24,18,37,19,55,15,56,9,24,7,4,4,3,6,3,2,26,12,2,20,21,14,5,7,7,9,6,4,5,15,37,13,3,8,7,12,16,46,24,37,38,34,5,5,4,15,11,16,19,32,9,19,4,11,34,7,40,14,26,8,18,9,93,19,2,10,7,50,17,41,40,89,22,6,30,16,15,4,29,7,9,12,6,25,7,20,29,14,12,12,2,2,10,13,23,12,6,8,163,67,5,2,15,11,9,46,15,10,22,11,17,5,24,54,33,18,11,6,10,7,11,11,18,15,10,10,4,21,1,19,4,25,11,19,29,13,34,33,12,6,5,12,8,9,5,14,52,22,2,7,6,7,20,13,22,22,18,9,25,7,11,76,14,14,25,4,10,13,19,6,30,9,15,22,11,10,41,46,19,11,24,1,22,4,28,11,8,57,9,23,10,13,4,7,9,12,6,24,20,28,14,6,23,11,8,7,62,13,22,6,4,6,13,30,11,21,10,7,44,41,48,7,40,19,17,2,8,6,36,19,6,34,6,5,6,7,12,39,25,33,15,31,9,8,10,20,6,23,12,3,17,29,12,81,14,14,14,187,48,14,14,8,6,20,45,13,12,32,2,12,36,31,14,18,7,15,7,13,13,16,57,36,42,6,5,11,24,23,24,54,6,11,20,10,9,7,16,42,27,21,16,42,19,41,9,7,10,15,10,7,11,10,9,12,28,14,3,6,5,43,4,28,27,58,12,6,10,15,17,7,5,52,12,14,25,2,13,23,6,24,12,6,7,7,79,6,34,25,29,6,13,59,21,8,30,18,18,11,10,42,24,103,67,16,7,8,7,75,74,24,18,30,47,26,30,11,23,10,10,10,4,27,6,29,14,6,19,9,11,1,9,16,14,11,20,14,14,19,3,27,12,8,6,16,11,15,8,16,7,5,15,10,6,10,5,5,16,9,8,6,11,22,6,6,5,19,1,24,3,20,11,78,17,3,7,18,23,7,17,61,8,2,8,8,8,32,9,10,8,7,14,20,20,20,11,19,6,15,23,36,6,12,10,8,3,16,5,24,3,3,7,5,3,9,7,4,11,25,10,6,28,21,8,5,3,16,14,6,9,11,17,6,45,7,23,5,6,9,6,26,8,3,9,35,5,11,52,15,5,2,5,7,18,18,8,28,21,14,7,26,6,44,4,29,10,6,10,11,6,7,11,6,11,11,2,17,4,13,13,4,5,14,10,15,13,10,5,24,4,15,55,26,25,49,23,133,117,6,16,4,6,10,11,35,23,18,33,4,15,13,7,9,9,49,13,15,6,21,8,15,12,9,10,4,9,6,17,7,18,4,7,16,8,11,5,13,13,6,3,8,12,10,6,8,4,19,6,8
reduce,2,23,19,271,8,18,3,30,1,9,4,3,32,83,3,6,20,26,16,6,8,51,40,46,20,51,25,43,12,71,23,346,184,18,71,113,52,36,89,13,50,16,4,37,39,17,95,64,325,55,80,19,39,84,42,6,123,65,21,25,19,12,4,35,58,14,125,26,13,30,91,1,16,10,192,16,36,10,143,37,215,33,26,15,366,51,45,44,97,11,40,18,49,70,135,119,35,28,109,48,13,70,79,22,35,41,105,65,60,36,56,8,56,49,28,82,17,4,110,276,54,50,210,335,24,6,14,6,18,15,33,3,11,102,29,134,5,7,14,17,7,90,68,17,4,121,13,27,38,62,73,20,26,20,28,84,65,44,18,77,98,13,32,26,107,26,16,55,48,30,39,162,43,8,17,21,233,4,20,88,37,16,58,39,6,24,86,36,30,99,4,7,24,10,15,18,46,13,33,15,94,21,24,35,54,15,19,60,32,57,106,17,48,36,10,25,78,88,39,5,35,28,13,27,113,144,62,85,22,75,28,44,1,62,61,146,51,26,49,9,108,43,19,12,25,29,15,66,102,21,18,65,28,39,19,31,9,29,13,86,31,69,24,13,18,133,18,17,34,13,228,42,169,15,9,12,28,144,8,9,101,16,10,18,21,13,56,50,17,7,8,12,39,60,24,25,45,14,10,33,40,91,11,29,14,11,32,10,4,15,5,30,65,31,114,53,40,94,40,24,59,9,53,12,49,3,18,41,5,38,10,19,11,8,11,23,38,14,20,37,10,15,51,8,18,10,78,66,25,42,38,19,6,64,25,19,1,10,21,139,38,34,25,34,10,8,32,15,45,43,6,48,15,34,13,78,17,19,14,24,118,10,76,17,19,99,25,46,62,5,17,10,16,4,51,13,72,15,37,17,17,11,12,9,21,7,19,2,37,25,2,8,12,22,2,22,13,8,7,14,7,10,32,18,6,11,8,7,10,17,25,28,37,33,10,6,6,17,34,10,15,20,12,22,6,4,28,12,55,29,46,9,19,10,68,18,7,10,11,62,25,34,38,58,9,13,53,20,15,6,39,14,4,6,9,15,13,19,46,15,11,15,9,7,18,6,52,14,6,7,197,110,5,10,26,3,8,25,13,10,14,16,13,22,30,39,35,20,21,8,32,7,9,17,32,24,9,17,12,18,6,9,7,23,9,3,42,16,18,50,30,8,8,9,22,11,13,11,40,46,13,7,7,22,48,8,3,28,14,9,21,2,15,92,11,14,41,12,15,12,31,14,28,19,19,35,12,13,66,32,16,8,51,3,15,5,55,12,12,60,26,22,14,21,7,5,11,20,7,19,43,30,30,15,50,5,17,34,17,22,40,14,4,5,11,24,14,23,21,28,32,38,10,14,35,12,34,28,8,7,12,23,15,46,6,14,16,24,7,47,14,42,37,26,13,10,12,31,6,26,18,7,4,26,14,83,23,18,18,183,21,15,11,12,4,20,74,13,5,25,9,5,18,23,11,6,0,9,10,19,28,17,60,38,25,6,7,8,7,1,5,31,14,17,25,18,16,14,5,7,8,28,31,9,2,10,21,4,48,21,8,8,5,5,21,15,30,8,9,7,5,34,10,44,49,64,23,7,10,32,22,2,13,47,10,4,21,10,2,21,11,35,15,12,13,6,50,18,10,18,28,7,4,13,15,5,36,20,7,8,15,36,53,94,54,23,13,20,9,102,92,25,21,53,30,30,15,14,37,10,12,1,15,15,8,20,40,9,28,13,4,5,17,11,17,12,20,13,8,36,8,4,2,8,29,33,10,13,11,3,9,14,13,15,11,12,12,16,18,12,37,0,16,19,8,8,5,20,14,21,3,14,12,17,6,4,13,19,6,17,26,24,10,5,11,9,0,42,11,4,11,9,7,4,13,26,9,28,15,16,24,25,12,21,8,12,10,30,9,11,11,9,3,21,9,9,10,5,10,36,18,11,51,22,7,11,0,23,10,3,0,17,2,7,14,8,9,8,11,6,13,5,10,8,17,9,4,10,13,14,26,2,9,14,7,17,4,9,27,17,13,55,9,57,11,16,6,14,7,13,5,17,22,31,3,7,4,8,6,17,10,12,12,14,6,10,16,26,9,17,10,31,101,58,64,46,66,140,133,1,9,9,8,12,20,48,8,1,27,5,24,6,7,8,30,25,12,15,4,7,3,3,21,13,10,2,13,9,14,11,22,5,10,7,8,42,15,30,5,15,2,8,13,9,2,43,8,18,0,5
control,8,40,21,276,5,13,12,67,5,10,22,29,29,110,6,35,10,66,10,9,18,98,27,57,56,17,14,22,19,28,34,331,196,18,106,103,74,16,70,13,2,19,4,10,76,39,84,57,610,38,109,27,13,104,31,11,82,43,11,40,29,11,4,44,41,19,217,23,13,44,34,16,7,8,223,43,31,11,133,45,92,30,36,16,525,48,44,12,54,4,23,15,24,61,112,38,38,11,86,39,33,77,86,16,31,42,12,16,33,14,53,24,32,42,7,61,5,13,108,335,81,43,26,147,22,7,8,10,9,1,28,8,16,92,25,116,14,5,12,15,1,76,50,10,8,125,18,34,29,23,243,8,16,17,26,107,78,21,26,45,48,11,22,0,18,27,9,72,59,18,33,200,67,8,5,18,337,12,28,83,62,36,43,55,7,53,76,49,66,99,7,18,16,7,10,19,52,22,20,57,103,12,9,33,69,30,20,101,24,60,187,15,55,13,11,16,20,19,25,24,13,43,17,19,68,264,60,38,15,27,26,32,62,1,84,24,61,14,29,21,146,69,25,24,41,14,8,62,99,28,33,30,39,21,23,44,21,10,7,28,16,35,47,7,20,92,14,13,39,10,216,14,40,10,11,9,45,23,10,8,122,19,13,37,40,24,50,40,36,5,12,11,32,10,9,29,46,21,17,41,49,50,1,5,35,15,47,13,16,11,6,120,38,26,21,43,44,77,36,19,60,20,48,13,154,32,32,70,9,73,10,25,13,19,12,53,43,18,6,25,33,11,19,28,15,16,94,94,24,16,23,31,12,99,64,14,18,12,38,55,74,15,19,46,10,5,77,23,22,27,9,27,15,22,25,38,10,14,32,12,148,11,89,32,14,126,17,50,64,15,44,13,22,21,51,27,131,22,78,6,36,14,7,3,11,50,19,1,65,23,4,14,15,41,37,18,4,19,2,7,7,12,63,45,12,15,9,46,27,44,35,8,6,6,4,18,11,17,16,10,47,31,22,31,2,6,33,21,71,15,37,10,11,11,121,22,3,15,22,71,36,37,59,48,7,7,28,27,64,5,31,19,6,7,8,24,6,43,46,14,19,26,20,11,12,22,33,8,14,5,142,57,0,12,12,14,13,18,12,38,34,7,9,12,62,106,14,21,10,16,15,18,22,26,31,33,21,18,51,24,18,32,51,150,37,15,91,58,24,62,23,15,8,36,21,15,12,16,77,87,37,12,5,15,22,20,4,17,31,21,96,15,32,127,24,19,76,30,18,11,53,10,30,22,21,38,19,23,63,84,36,12,18,16,27,12,9,18,20,37,8,44,23,27,24,14,14,15,7,18,41,68,18,20,31,8,12,14,74,43,49,14,15,17,10,47,6,89,24,9,67,84,24,14,72,27,33,39,27,4,32,12,7,46,7,4,32,8,25,65,19,27,70,41,24,10,46,12,9,24,14,7,17,51,10,39,17,4,24,324,58,19,21,15,8,22,79,44,9,30,6,8,13,39,7,14,0,12,21,12,30,22,68,78,34,14,3,5,19,11,55,58,20,15,9,11,12,11,11,20,26,24,37,20,7,31,15,10,23,23,13,14,7,12,21,7,25,22,10,16,10,11,11,53,61,26,11,17,10,12,21,12,14,32,2,12,10,7,5,29,20,27,14,13,7,5,21,9,66,16,26,9,9,16,20,14,17,34,12,13,21,10,13,16,10,18,16,29,16,23,21,11,3,4,43,24,27,18,13,19,12,12,7,26,10,23,39,25,31,22,9,16,19,28,32,21,22,37,16,30,10,26,17,6,77,23,29,8,5,7,10,9,17,10,21,4,19,8,27,8,8,7,17,19,9,8,10,23,12,45,4,10,12,38,11,12,16,14,19,14,22,13,40,7,12,44,15,46,40,8,11,29,24,25,9,15,21,43,13,16,44,114,25,18,13,19,21,25,18,5,16,21,15,14,13,19,8,8,26,29,17,2,11,39,10,22,2,26,26,6,3,5,15,5,16,6,9,7,13,13,15,54,0,6,10,13,4,15,14,6,10,6,15,22,29,7,11,32,7,33,37,11,26,9,26,8,4,16,17,6,19,15,9,9,8,15,7,13,9,26,11,19,16,19,11,8,26,10,10,24,9,15,7,4,9,16,20,15,69,3,4,17,10,13,7,8,10,11,33,17,9,24,6,5,6,30,15,5,10,14,19,15,26,9,9,3,6,17,43,12,9,12,10,19,17,8,25,20,28,8,9,10,11,4,9,2,6,4,8,8
mean,7,43,15,319,18,25,12,86,15,9,43,13,44,281,15,31,31,66,24,10,14,115,66,85,55,45,66,46,42,43,46,471,383,63,165,260,165,43,40,25,39,41,8,14,75,51,68,37,654,103,143,33,57,187,54,13,135,69,28,42,31,23,11,46,64,21,344,23,24,41,59,6,19,15,358,52,91,20,253,85,211,14,43,21,543,87,66,9,82,4,23,19,30,63,152,44,67,15,96,49,15,86,84,43,48,86,36,28,56,18,53,17,37,54,38,104,11,19,135,535,128,83,107,234,26,16,14,13,10,7,69,31,54,145,88,170,40,9,27,32,20,133,47,10,5,191,19,46,42,42,174,15,46,54,35,70,100,21,25,80,55,30,38,14,20,57,15,88,98,17,50,284,89,18,36,29,452,19,43,139,69,55,39,78,16,80,108,81,90,102,13,17,20,9,14,13,39,25,36,66,100,12,10,31,81,25,24,101,37,81,212,38,74,55,18,28,18,39,34,9,22,86,19,54,126,303,83,80,14,35,54,34,61,84,1,103,109,42,42,24,213,121,33,20,73,33,14,95,207,22,33,62,56,31,32,38,28,9,12,46,14,95,42,10,15,114,25,38,49,13,395,35,80,27,13,13,71,55,28,20,276,34,15,48,43,4,41,54,60,26,8,14,50,35,10,33,94,23,26,69,72,79,7,10,47,7,92,16,25,15,9,72,81,29,138,45,59,117,47,11,145,25,87,33,200,10,49,105,8,70,17,25,21,15,29,41,55,21,16,30,33,32,47,38,28,26,122,159,60,60,55,29,18,144,61,26,15,21,55,110,71,34,58,52,32,11,102,33,47,84,9,87,18,54,35,77,25,17,54,31,196,11,143,37,30,108,24,66,88,11,86,11,34,20,81,39,135,8,60,19,56,10,9,9,20,30,42,16,82,56,15,35,21,49,28,30,13,19,20,18,22,18,59,41,18,14,6,47,28,49,44,28,7,35,16,17,4,23,48,24,42,64,30,59,6,9,80,24,112,33,56,16,26,17,137,28,15,27,29,79,39,66,97,99,24,18,64,61,25,11,79,24,21,15,13,71,19,24,78,29,35,54,20,15,23,20,37,15,22,11,253,93,6,20,45,23,19,44,27,54,35,33,15,23,17,97,28,42,18,23,17,27,26,21,47,34,18,33,24,42,16,61,31,78,33,8,93,37,65,83,31,19,24,44,17,25,25,45,119,68,7,9,17,53,35,22,31,92,26,22,97,18,13,172,23,33,103,10,29,26,57,10,53,23,37,44,35,23,103,120,39,27,50,19,26,9,41,29,28,42,28,39,51,48,28,20,34,28,5,47,70,85,32,21,74,18,26,30,61,58,53,12,21,12,11,59,13,58,32,21,84,49,21,36,67,21,79,21,26,19,50,25,19,59,17,16,29,28,44,71,55,53,84,50,30,14,38,22,21,46,41,16,28,47,22,59,17,13,16,349,41,27,24,15,12,35,101,39,23,34,15,11,22,18,10,8,6,32,25,24,64,20,74,45,53,27,14,10,16,24,20,74,37,32,32,30,53,18,10,32,32,59,35,42,24,29,32,7,36,24,19,11,15,17,29,26,38,52,10,9,9,15,19,82,55,61,21,21,25,27,31,19,21,60,16,16,27,14,24,43,26,60,28,23,11,5,77,22,83,43,41,21,31,43,48,14,55,35,25,17,41,19,4,23,14,41,23,28,25,40,30,44,7,16,44,60,32,34,39,31,34,19,29,51,12,33,44,15,31,19,17,23,46,21,31,39,21,17,30,44,15,14,7,16,40,63,24,17,10,10,7,14,27,13,23,20,17,21,53,15,25,11,27,27,16,12,17,24,14,37,14,11,23,13,13,22,23,12,28,11,22,15,49,21,27,43,34,50,47,19,11,24,13,19,27,42,29,15,17,32,39,61,25,19,9,10,30,14,11,7,8,15,11,20,17,26,17,7,17,23,19,9,43,46,18,12,6,24,27,7,2,9,4,6,23,11,11,12,19,16,14,32,10,8,25,18,25,19,16,21,11,1,12,20,25,14,8,23,7,70,13,20,27,34,23,8,8,18,12,12,13,18,16,26,10,17,4,27,6,24,14,12,16,12,15,12,17,15,15,43,10,41,23,25,38,72,62,44,96,13,2,15,11,14,21,20,23,24,32,20,5,16,9,11,5,59,15,16,8,30,25,11,31,20,21,13,12,34,39,10,30,13,15,23,21,33,27,28,27,10,19,12,15,3,1,23,15,8,10,15
revenue,2,14,7,347,4,7,4,66,2,6,14,2,20,52,8,9,13,35,11,4,6,97,8,19,33,18,13,24,8,24,4,317,235,13,87,64,40,39,50,6,33,4,4,16,74,24,47,41,344,10,75,9,41,33,1,1,505,125,7,30,19,12,5,74,82,7,205,54,13,13,101,8,9,21,146,16,35,5,154,36,393,7,35,13,520,125,51,10,178,10,37,9,4,69,189,173,24,34,93,37,17,49,80,21,18,47,115,13,70,12,58,7,29,24,7,87,20,7,171,403,100,21,263,419,14,6,8,6,19,26,11,1,8,118,30,42,1,3,16,9,4,46,52,9,6,129,10,46,58,101,68,1,25,25,7,43,48,17,2,10,62,8,8,21,48,12,6,36,49,20,36,142,39,0,8,5,380,1,11,91,40,8,12,22,8,60,98,36,41,72,6,10,15,4,3,15,27,21,29,19,99,6,18,18,50,8,16,174,24,66,178,8,47,145,2,8,45,18,43,7,69,29,17,49,131,247,97,106,16,47,38,52,146,24,103,1,70,25,31,8,146,79,10,6,11,8,12,36,94,13,17,183,15,140,42,37,27,11,28,48,9,18,29,3,25,196,12,2,19,18,405,74,326,9,7,4,19,304,27,9,102,20,5,25,30,4,5,24,18,17,4,0,38,45,17,21,90,8,10,50,50,91,16,16,43,2,24,5,1,2,4,19,89,7,174,92,30,88,31,13,52,16,57,2,34,8,10,44,5,25,5,29,11,19,24,26,23,3,35,41,18,12,47,14,23,6,114,87,28,5,85,14,6,79,40,21,5,11,21,166,58,24,11,31,7,0,55,10,44,17,7,94,14,24,19,75,22,30,25,75,139,0,123,10,0,55,4,36,93,7,16,3,32,22,71,18,117,25,51,18,30,1,15,5,13,14,23,2,44,24,2,3,23,29,2,12,3,9,0,0,6,7,16,29,2,4,7,18,10,63,38,44,43,44,5,10,0,14,16,10,24,126,19,15,0,1,6,5,76,44,27,20,6,8,91,8,2,13,18,88,16,35,60,12,5,7,70,27,9,4,25,3,5,6,7,18,5,20,43,18,35,27,6,3,14,2,48,10,11,3,66,114,0,4,30,8,6,29,21,19,25,9,38,4,2,48,5,42,11,19,102,5,9,11,66,38,9,21,2,33,1,21,17,38,10,4,31,5,16,73,33,3,3,45,13,14,19,5,74,42,13,2,2,8,34,3,2,92,43,24,48,6,8,137,5,22,64,19,20,12,42,7,52,8,36,56,26,9,107,67,68,32,60,4,11,10,124,9,14,110,63,28,58,19,20,10,10,23,15,25,47,55,14,13,37,4,55,21,50,44,55,10,10,8,11,44,18,26,21,146,46,9,17,20,44,26,87,15,24,34,26,14,19,34,12,29,8,35,15,88,57,62,61,74,13,15,12,39,10,18,34,2,4,47,10,105,10,6,20,159,29,9,16,18,6,27,82,7,8,46,18,5,15,23,8,6,4,8,10,27,33,46,26,18,40,11,14,28,10,8,16,37,21,18,24,36,23,5,10,10,18,17,41,13,15,13,19,7,132,28,4,5,15,10,34,9,50,2,47,12,4,32,44,72,33,21,1,7,17,25,11,2,5,33,2,15,43,6,11,23,14,26,17,12,15,30,23,15,27,20,23,4,3,8,12,10,67,16,18,18,18,182,82,142,123,30,27,40,21,190,191,30,14,59,63,45,10,17,19,15,14,3,13,16,7,13,29,8,3,25,2,18,18,6,21,12,49,30,35,34,11,25,5,23,12,38,3,12,23,2,12,11,42,9,7,3,15,14,49,16,95,0,35,29,13,2,6,16,5,31,5,53,5,5,3,12,6,15,28,47,40,27,18,3,25,19,12,44,11,11,7,16,3,4,27,25,18,4,14,9,20,33,9,92,1,8,11,51,12,15,19,6,15,4,12,25,2,4,9,31,6,21,49,37,12,10,1,12,20,1,1,15,4,2,12,10,14,14,7,18,1,23,3,6,16,6,3,7,23,1,26,2,10,9,1,11,1,27,78,32,6,30,14,107,22,16,10,23,18,11,10,22,14,186,5,15,8,0,14,29,16,6,16,23,4,62,23,32,0,28,21,60,134,88,161,103,40,199,334,5,1,9,2,16,15,50,56,2,35,5,8,5,10,13,16,23,6,20,0,11,3,5,22,22,4,5,2,19,18,9,92,13,50,16,16,61,27,4,10,0,9,8,26,2,2,61,0,14,1,0
yet,20,51,34,332,20,32,19,103,9,9,48,20,50,246,21,22,23,42,17,16,18,101,35,78,71,47,57,39,23,60,25,517,326,30,119,199,131,27,39,14,21,48,10,7,91,50,64,41,696,77,144,24,38,124,44,17,167,62,12,62,42,18,8,37,69,25,270,24,39,33,61,16,11,6,298,45,78,13,193,71,106,5,50,30,550,60,39,7,110,5,34,13,18,109,126,21,56,22,110,47,31,87,124,30,50,84,18,17,60,34,39,17,39,39,16,140,15,15,195,354,156,57,27,195,31,10,6,26,11,8,71,20,43,119,79,157,28,7,14,39,23,90,81,20,16,177,25,60,54,33,169,7,42,32,29,78,104,16,32,35,34,26,24,9,11,39,21,57,85,34,59,266,58,19,12,34,439,10,32,124,93,42,14,56,19,80,103,70,102,158,7,25,37,8,26,9,23,15,24,51,86,12,6,46,64,27,23,72,50,55,184,23,79,26,9,18,7,18,30,7,20,75,19,34,111,216,100,97,19,29,45,48,51,61,109,70,1,26,22,13,185,113,27,20,39,17,24,84,112,21,29,52,73,21,30,55,36,10,22,59,11,68,65,11,19,79,31,27,48,15,401,19,110,14,10,8,54,48,28,11,161,16,13,52,34,10,35,51,49,15,15,18,43,20,18,27,129,18,20,67,103,45,7,14,38,18,85,15,34,6,8,47,81,17,96,38,42,107,20,21,105,29,94,34,157,11,32,97,17,65,29,32,30,14,31,32,59,32,12,42,30,31,43,32,23,17,103,143,41,23,36,27,26,104,56,8,14,14,73,68,53,17,38,51,8,11,83,33,23,50,10,46,21,35,40,58,10,8,52,30,175,6,108,33,19,118,20,58,78,14,59,16,56,57,85,30,150,9,72,15,63,7,12,2,28,26,16,11,60,28,6,40,17,42,32,17,15,20,15,11,17,27,54,31,17,17,6,36,35,46,38,27,9,33,20,17,9,56,30,15,52,48,30,39,2,17,39,23,99,25,57,14,12,13,165,21,7,24,29,103,31,76,98,86,10,14,48,48,23,4,71,19,11,21,17,58,19,64,72,44,37,41,20,20,38,23,33,10,23,11,175,112,8,21,26,20,14,47,27,49,47,19,16,9,15,75,44,33,21,25,18,24,28,18,45,43,14,33,8,40,16,45,23,58,21,18,68,30,57,82,34,19,8,31,33,20,35,38,91,60,16,9,13,46,35,33,26,46,41,12,98,15,13,107,28,28,79,16,19,28,68,16,61,21,43,36,30,19,92,93,25,30,41,8,17,47,18,24,18,47,22,43,30,49,31,10,32,31,13,25,64,96,22,18,76,26,17,21,129,53,62,12,19,20,24,67,20,61,24,10,89,39,36,19,85,26,66,8,18,15,26,19,19,44,9,19,19,24,38,67,39,69,65,68,17,5,41,14,13,27,27,15,14,46,37,57,11,23,15,400,48,27,39,16,24,38,103,48,31,47,11,24,55,59,35,30,14,33,34,104,61,26,100,58,81,26,5,24,17,21,11,76,41,15,25,31,42,11,15,33,33,33,39,25,16,46,23,18,31,37,6,10,16,20,19,34,64,26,10,13,22,33,22,71,48,46,24,15,29,22,13,20,11,44,12,19,19,12,14,33,14,40,12,21,14,4,51,18,82,26,50,13,21,43,36,11,44,21,24,21,36,37,20,31,15,34,31,25,14,36,44,49,18,13,50,48,26,18,47,40,27,29,10,39,11,36,31,9,36,29,16,16,67,23,37,23,18,30,31,30,20,28,16,14,30,61,12,28,11,13,11,20,33,17,14,19,25,26,50,15,12,6,21,24,13,17,14,29,19,29,31,19,18,23,19,17,16,24,25,13,25,18,34,18,37,27,25,77,25,11,21,23,20,20,18,29,23,29,10,32,62,67,22,13,9,11,22,15,9,4,23,20,21,6,16,21,18,10,32,23,8,11,26,36,28,28,11,26,33,7,12,10,10,15,29,15,22,16,22,21,14,27,10,21,13,24,18,16,22,35,15,17,13,18,28,18,11,26,5,42,10,23,20,30,35,15,11,14,13,8,17,35,14,31,8,24,14,56,20,14,14,14,21,17,3,13,10,16,9,31,13,26,25,18,20,59,35,35,96,19,10,12,16,7,12,14,27,11,45,18,21,11,14,9,7,36,11,6,19,24,22,23,30,13,15,12,3,19,26,20,9,15,26,28,21,14,20,12,69,9,14,15,12,7,4,8,4,23,13,10
encourage,2,2,14,104,8,15,10,16,8,2,4,6,14,78,3,4,8,24,9,4,6,30,21,15,22,18,9,11,3,7,10,184,122,16,55,70,42,9,20,4,9,16,4,10,30,9,39,33,180,33,35,10,16,51,27,5,47,18,7,20,12,16,7,10,22,7,118,16,10,24,18,3,4,1,125,11,35,4,62,29,74,6,11,10,176,31,16,4,22,1,3,9,2,21,58,18,10,8,46,37,21,38,21,8,12,29,6,10,13,6,21,16,28,21,26,19,1,3,37,171,42,24,61,62,5,1,3,4,0,3,14,7,12,55,6,91,7,8,7,8,3,40,16,4,5,65,8,18,25,21,47,11,12,21,15,31,29,24,9,57,20,4,15,5,12,15,8,37,17,9,25,88,41,5,9,3,122,3,9,65,16,13,40,30,5,43,33,23,22,29,4,5,16,2,4,5,21,10,13,22,68,16,25,14,24,10,7,36,13,46,87,19,15,19,2,13,9,15,10,3,3,13,6,13,31,75,31,19,3,6,21,1,26,14,42,25,26,1,38,9,39,26,9,5,29,6,6,36,65,11,13,38,26,4,11,12,4,4,1,16,7,28,9,5,13,32,36,8,10,3,103,11,21,15,1,2,25,4,7,2,60,6,7,12,13,9,17,11,17,1,0,1,14,8,5,8,18,11,4,14,24,28,1,1,11,6,31,5,13,6,6,25,29,19,34,16,33,36,27,6,35,9,25,27,41,0,15,17,1,23,1,9,4,5,6,19,23,4,7,2,12,8,15,9,7,8,31,34,25,12,8,11,5,40,21,6,7,12,19,30,26,27,26,28,14,2,23,7,13,14,11,38,7,24,11,28,5,7,17,10,35,9,36,12,9,46,10,19,25,3,14,6,13,11,25,9,39,5,37,5,13,8,6,7,4,14,9,1,34,23,7,13,9,18,7,10,1,12,6,5,6,8,23,10,7,5,5,10,9,16,8,3,0,4,12,5,4,2,4,4,16,22,8,5,0,3,20,9,28,4,22,2,13,8,34,6,2,2,12,25,11,13,39,30,15,5,34,8,7,0,27,3,2,5,4,26,3,10,37,17,9,6,1,2,9,5,9,4,3,2,63,28,7,5,17,7,6,5,9,9,8,13,5,7,11,20,20,10,9,10,5,4,4,9,13,15,7,10,4,10,4,24,4,11,7,5,27,16,11,25,5,11,13,6,8,7,6,9,31,19,6,1,1,27,27,4,4,13,3,8,8,6,2,30,8,12,23,2,9,10,12,4,9,7,16,13,6,8,23,28,9,5,9,7,10,5,9,9,5,11,12,10,19,13,9,9,9,7,7,11,15,20,13,3,38,19,6,8,20,17,19,2,1,2,5,15,12,15,15,8,21,7,5,2,18,2,20,21,8,9,16,8,4,11,7,11,7,7,12,38,11,22,22,16,9,2,23,1,3,5,17,6,2,11,6,15,10,1,6,89,27,3,0,3,5,13,20,15,5,11,5,5,1,4,3,1,2,6,6,7,23,6,14,5,13,3,5,10,2,6,3,26,8,11,11,0,9,3,3,4,5,18,6,5,1,11,4,0,9,7,22,1,7,6,10,11,15,6,1,6,2,0,4,23,11,20,2,5,5,8,5,3,7,14,8,6,10,16,7,7,10,18,3,15,5,4,12,10,25,14,13,9,11,14,8,7,13,39,7,3,16,5,0,1,1,4,11,19,6,7,7,14,0,3,18,19,12,10,29,11,12,6,5,8,4,21,22,8,10,4,6,8,12,8,8,13,5,0,3,10,10,5,3,6,12,21,13,5,5,1,8,5,11,4,7,10,8,4,13,2,13,6,11,6,10,3,6,2,6,5,4,2,9,8,3,2,11,5,8,8,7,3,11,6,9,12,9,25,5,7,1,3,2,1,4,15,6,2,9,14,4,15,6,1,2,8,7,6,4,3,1,2,0,8,6,6,9,5,4,17,3,7,2,20,6,2,1,3,4,3,3,1,7,2,6,2,10,4,7,11,8,3,5,4,5,1,9,3,1,5,5,10,3,10,1,1,3,6,1,14,12,11,6,3,11,1,3,4,5,2,9,7,2,8,3,2,3,5,3,7,5,5,9,1,3,7,12,7,7,13,4,10,3,1,8,8,9,11,15,4,4,10,0,4,3,1,4,2,11,5,4,1,1,2,2,7,8,2,2,4,13,3,8,6,4,2,3,7,9,4,2,5,2,8,6,9,4,15,5,11,6,17,3,6,13,8,3,8,10,4
production,4,8,4,113,2,7,7,11,2,3,4,1,20,66,2,2,5,12,3,5,2,39,12,8,14,13,10,9,8,23,2,184,141,11,41,67,26,22,93,3,10,10,2,7,22,15,24,17,176,25,45,15,35,64,1,1,83,26,1,25,11,6,3,5,36,13,96,23,13,20,22,1,1,5,122,7,17,4,72,21,149,14,7,8,137,15,40,5,27,5,25,7,24,12,36,36,26,16,50,50,10,24,33,11,19,23,18,14,13,9,28,9,18,25,15,23,12,9,79,116,23,14,36,109,12,0,7,9,12,10,13,2,2,48,20,64,4,12,9,13,3,47,34,7,1,61,5,21,24,5,48,3,23,10,12,32,29,55,5,37,66,5,17,13,28,17,7,25,31,8,34,66,25,7,9,5,120,6,7,76,16,10,42,23,1,42,27,20,20,42,2,6,39,1,6,8,31,10,10,12,59,4,7,12,22,8,14,30,11,27,43,14,8,14,2,5,3,12,3,4,15,16,5,13,33,66,34,29,5,20,14,20,49,29,42,31,22,38,1,8,48,35,6,5,19,6,7,21,63,6,14,83,11,10,8,9,3,10,3,13,6,16,8,2,6,34,3,10,20,12,84,8,39,2,0,9,15,17,4,5,65,5,47,7,18,10,6,3,9,1,5,6,4,12,5,7,17,5,5,19,19,25,8,5,16,2,22,2,6,15,12,18,44,12,37,12,18,40,29,9,21,3,24,10,19,4,28,18,4,31,0,6,8,7,3,8,13,7,4,13,6,7,19,5,15,14,41,47,17,4,13,8,5,55,16,10,8,4,21,35,14,26,17,13,11,3,27,8,1,9,4,27,13,18,12,20,7,16,12,6,47,2,47,10,7,30,1,51,20,4,8,7,7,4,11,6,40,2,22,17,17,1,5,1,7,15,6,4,43,16,0,13,40,19,7,2,2,7,4,7,4,8,20,12,4,6,9,8,5,9,9,6,4,11,2,0,2,5,26,10,15,14,14,21,6,2,25,8,27,10,16,3,10,8,66,0,1,6,9,27,13,33,25,15,14,4,49,15,14,2,22,7,3,8,0,14,6,10,13,7,4,13,2,2,10,0,15,2,5,0,113,22,0,4,39,3,20,10,8,5,16,6,10,3,4,32,58,19,7,5,8,4,3,5,19,5,3,10,19,12,3,16,11,12,3,1,23,27,10,35,9,7,2,8,14,10,3,11,28,13,7,9,6,58,46,10,6,16,3,8,6,0,9,22,7,8,31,0,14,1,15,2,16,13,4,16,9,8,34,35,12,2,7,1,8,4,59,6,2,29,44,14,14,7,4,2,14,6,12,14,18,12,19,2,59,18,9,29,20,10,9,8,0,1,5,23,5,8,15,6,30,8,10,9,15,1,9,14,6,2,5,14,6,10,13,4,3,7,8,30,20,13,10,13,8,2,14,7,2,6,8,2,1,11,5,10,29,5,13,108,23,12,7,2,4,11,24,2,1,17,2,8,3,23,8,1,0,2,12,6,16,9,4,7,9,6,0,4,0,6,2,24,6,9,16,3,5,7,1,7,14,15,14,4,6,8,9,2,17,5,0,2,4,3,4,6,14,7,13,2,2,17,7,16,18,8,1,2,6,6,3,0,0,3,1,9,11,2,2,7,5,19,15,9,5,0,12,3,11,15,11,4,12,8,6,7,13,40,3,7,9,1,5,8,12,6,5,8,7,41,30,11,4,8,15,37,4,9,61,8,16,13,18,6,5,14,18,14,1,10,0,6,12,8,14,12,10,5,11,12,8,1,0,5,3,17,0,4,5,1,12,2,8,2,2,4,5,0,19,4,52,3,34,3,8,3,2,6,1,14,3,2,5,25,2,3,2,10,12,9,12,4,5,5,5,9,3,22,6,9,2,1,1,1,8,6,10,4,2,4,12,16,2,8,10,2,7,12,11,3,12,6,3,8,3,4,4,4,4,11,4,6,9,18,3,7,0,9,3,6,2,6,6,0,3,3,2,5,1,6,0,6,0,6,2,6,3,2,2,4,8,3,1,4,0,4,0,11,14,18,7,8,7,5,20,9,2,7,3,5,2,15,5,32,8,0,1,1,6,1,8,3,5,5,8,10,20,9,2,11,8,13,9,1,26,15,8,24,14,2,2,4,3,6,4,6,0,3,18,3,6,6,4,1,2,41,3,0,2,6,6,2,24,8,5,7,3,2,4,3,0,12,8,19,3,11,2,20,14,0,12,9,3,0,7,6,13,2,2,1
difficult,7,14,5,82,3,7,5,18,4,1,32,3,4,57,1,5,9,17,11,6,4,29,15,31,12,10,22,13,15,22,8,158,104,16,34,62,21,3,3,8,9,5,5,5,32,12,11,11,180,34,42,13,13,34,13,5,34,20,12,10,15,8,2,9,12,15,69,6,4,23,6,1,6,5,88,8,25,3,49,34,27,3,6,8,120,17,8,5,16,0,11,7,3,29,41,8,22,6,35,9,4,28,17,15,14,17,5,3,6,1,16,0,8,9,7,24,14,6,56,129,37,22,16,38,3,4,5,2,3,1,18,5,14,38,26,53,7,4,11,5,4,38,27,1,1,65,5,15,15,8,23,2,10,6,10,26,31,8,10,24,4,2,8,0,3,15,7,23,29,5,10,95,22,0,21,7,99,8,6,40,26,3,13,23,7,27,32,10,34,27,3,5,1,3,4,1,7,4,4,8,15,1,1,7,15,13,3,27,4,9,55,11,23,7,7,6,1,6,21,3,3,13,7,14,19,115,17,22,8,0,12,8,9,21,24,8,13,9,8,1,57,41,7,14,9,3,2,24,30,5,5,9,6,0,2,8,8,0,4,10,2,31,5,2,6,12,4,13,20,9,60,2,12,3,2,5,8,7,5,3,43,6,4,22,6,2,12,12,10,0,3,7,12,5,5,5,27,2,5,18,23,22,3,4,12,4,35,3,12,3,1,18,20,8,21,9,18,24,9,10,29,7,35,9,61,7,20,27,1,15,8,14,8,5,17,7,15,4,2,8,12,14,14,13,5,8,26,35,14,12,6,10,11,20,19,6,5,8,17,26,16,8,7,13,2,2,27,9,10,28,4,29,1,19,28,18,14,1,21,6,40,1,31,19,8,22,4,12,17,2,33,2,7,11,17,3,34,4,10,3,15,7,6,4,6,12,10,1,13,15,11,14,0,11,10,13,7,9,6,13,8,11,8,10,1,1,1,22,4,9,3,1,0,13,9,1,2,9,13,5,15,10,9,6,0,5,19,10,23,7,22,8,10,0,30,7,8,15,19,21,8,25,29,51,5,10,20,12,12,1,25,10,1,1,4,32,4,13,30,5,3,6,2,6,4,6,3,9,5,5,52,26,0,6,8,4,0,10,2,15,11,3,2,2,4,12,2,10,2,2,1,3,3,5,10,16,3,8,23,9,4,8,1,23,8,3,26,14,9,10,10,7,4,12,7,8,4,12,31,14,6,4,4,2,4,2,1,7,16,7,19,4,10,34,6,7,21,6,3,2,6,2,15,5,11,5,23,19,10,41,8,3,6,9,5,1,6,4,7,13,1,10,12,25,7,21,8,10,0,10,18,35,10,4,32,3,12,1,34,19,13,3,6,3,3,21,3,6,1,4,35,13,9,6,44,12,7,2,6,5,3,1,1,9,1,8,5,5,9,25,3,19,16,20,10,1,24,6,5,2,19,7,9,7,7,15,8,3,4,95,19,3,2,2,10,11,24,24,9,4,9,4,7,10,6,0,0,1,22,4,16,5,16,23,14,5,3,0,0,5,2,18,10,4,2,5,17,1,4,5,7,12,8,8,5,5,10,4,13,7,8,10,3,6,6,2,8,11,1,3,2,7,4,18,16,14,15,9,6,10,5,6,5,16,3,26,7,5,7,14,6,9,3,5,2,0,8,4,31,7,7,1,4,5,9,5,13,10,4,8,11,2,2,2,0,14,11,7,4,3,2,10,0,2,24,7,3,4,3,4,7,3,2,13,1,8,3,2,18,6,4,3,13,1,8,5,1,36,4,5,5,11,1,6,18,15,12,4,6,3,5,3,10,1,10,11,3,7,10,8,4,3,12,1,4,4,5,10,3,9,2,2,3,2,0,9,8,0,4,2,7,2,7,2,5,8,5,5,17,2,2,4,7,10,2,2,7,12,4,6,24,16,12,6,3,5,10,0,3,2,3,9,3,5,3,1,1,1,11,7,4,7,1,0,1,3,0,1,8,1,0,4,5,0,8,4,4,2,6,0,5,21,0,5,6,0,10,1,2,13,4,1,11,10,2,0,0,2,2,18,7,0,2,3,9,4,1,10,3,2,1,4,2,3,2,6,8,3,5,0,4,3,2,6,3,1,2,0,8,2,4,10,0,0,4,11,7,12,11,3,3,2,4,0,1,3,3,8,3,4,5,8,4,0,1,12,6,1,2,3,10,3,15,5,1,6,4,1,5,11,0,6,5,2,6,14,11,7,20,6,2,4,1,2,0,1,1,1,3,6
without,42,163,49,819,60,44,16,222,23,18,105,41,55,370,41,80,53,99,44,41,45,263,92,138,129,77,94,81,46,122,61,1001,720,75,297,363,240,45,67,29,54,90,39,30,219,103,132,104,1602,150,360,43,84,217,78,40,329,120,30,92,93,47,24,64,135,40,568,42,45,77,87,34,40,30,454,107,131,21,446,128,227,19,67,51,1155,114,94,11,191,12,50,52,15,181,261,65,109,36,220,88,64,156,192,82,55,170,76,53,106,31,122,42,72,87,57,196,26,36,387,985,231,138,150,367,39,26,18,41,19,13,85,23,49,246,154,285,64,14,32,55,30,178,136,36,18,384,61,87,93,93,368,8,88,61,29,133,175,41,63,97,89,27,33,18,25,79,32,122,117,65,81,498,126,15,50,85,989,27,65,202,175,88,41,134,22,126,177,127,219,253,13,44,42,13,14,36,95,44,60,80,154,17,19,70,171,70,35,201,71,136,409,57,182,63,23,55,21,41,83,20,33,114,36,87,264,623,116,167,32,54,70,104,108,146,213,146,185,39,48,57,1,237,58,55,98,41,46,158,236,39,90,112,116,63,56,109,62,16,22,104,31,178,126,23,37,182,19,51,101,32,777,49,186,34,30,15,110,73,92,18,328,44,19,99,91,12,60,72,82,28,24,31,104,45,22,63,186,28,50,113,146,178,9,14,82,19,101,27,46,13,26,105,161,47,255,76,119,248,109,30,317,52,221,35,415,50,47,192,24,165,57,63,63,27,47,86,89,38,22,58,74,77,95,75,43,26,264,276,106,61,86,85,31,196,159,36,47,23,124,153,119,42,44,89,20,12,241,61,53,109,32,146,27,89,76,179,64,23,93,40,459,18,232,81,41,198,47,91,207,20,135,29,92,68,190,67,374,29,206,19,113,31,24,16,39,45,39,16,144,67,21,70,21,90,70,77,32,42,28,33,31,59,117,70,22,23,23,89,77,77,112,28,17,71,31,28,14,71,81,34,86,148,35,93,11,21,95,56,192,50,121,44,46,32,262,72,21,84,60,192,107,133,170,203,41,13,119,66,60,9,125,42,27,25,30,98,25,84,134,45,47,72,18,37,51,49,56,39,34,29,399,214,12,33,57,47,27,74,69,78,80,26,22,31,34,175,34,77,55,46,27,35,58,43,86,115,42,50,49,59,19,170,52,130,46,31,130,61,117,175,79,28,37,79,54,46,76,49,193,118,48,19,36,30,62,96,39,123,85,35,298,35,68,285,53,61,139,32,45,40,120,29,122,14,87,111,79,87,172,185,69,48,106,22,26,43,68,52,35,90,48,81,80,102,57,30,35,44,25,75,139,211,66,40,146,30,31,47,243,105,144,7,36,44,53,125,46,156,48,37,180,84,78,66,196,48,114,37,51,36,70,78,27,132,23,43,30,56,79,156,112,127,143,173,58,20,65,41,28,72,43,33,62,148,43,137,47,30,43,844,114,31,62,32,44,57,245,89,41,93,37,38,71,95,49,36,12,70,67,67,114,51,221,222,174,54,29,34,17,37,44,160,89,38,66,72,75,27,28,61,77,83,87,61,36,44,56,66,89,75,21,27,40,40,64,33,88,60,35,21,30,46,41,163,97,170,69,45,63,55,70,21,40,144,17,53,61,15,41,70,34,96,28,30,35,34,110,38,204,39,55,34,22,67,71,20,81,45,53,65,78,36,13,44,14,73,49,84,14,75,76,89,23,29,107,63,45,45,30,54,37,28,12,117,33,95,50,19,62,68,27,29,85,30,43,26,48,91,57,87,40,69,34,38,40,119,33,43,15,24,23,20,62,40,53,29,55,37,84,30,53,20,75,53,41,38,26,59,41,89,47,22,20,56,17,37,35,59,59,26,40,44,80,21,46,53,66,159,65,29,48,48,54,73,59,51,54,43,47,83,166,193,62,30,16,33,39,44,82,17,25,42,31,18,26,57,35,25,66,72,28,37,41,66,35,51,23,62,94,12,14,36,28,28,53,29,34,30,38,32,18,59,6,33,79,40,33,25,29,33,53,41,27,45,100,18,18,76,27,89,28,45,32,68,67,24,17,33,30,26,56,50,23,75,19,59,24,78,32,65,32,24,38,25,34,32,25,44,31,61,24,90,24,34,47,100,99,61,216,22,25,46,38,20,22,21,26,26,108,35,11,28,39,40,10,127,32,31,34,29,45,48,41,31,27,33,23,70,47,44,37,49,46,66,46,66,51,38,110,20,23,21,26,12,0,35,21,24,8,23
find,32,72,31,325,22,39,22,80,22,17,42,33,38,215,19,32,22,47,15,34,19,118,44,67,68,37,40,51,28,50,34,462,362,33,158,230,112,38,58,23,23,36,28,15,104,45,67,52,755,111,138,12,53,145,24,16,189,93,22,69,60,20,17,43,67,28,339,33,23,50,48,22,23,15,269,54,92,19,225,72,148,3,46,34,565,59,56,6,101,10,23,23,10,87,121,63,72,26,102,47,50,82,95,39,53,73,24,25,50,15,44,25,47,58,49,104,7,17,155,465,135,76,33,218,38,29,13,10,14,8,69,17,39,144,66,185,19,20,10,31,12,114,71,21,7,232,29,61,62,31,161,15,53,26,19,55,114,21,16,74,46,18,28,16,8,50,16,51,78,30,56,251,119,13,22,26,464,16,44,135,82,48,22,50,13,76,119,70,105,149,15,19,45,7,12,6,41,18,22,38,71,9,9,43,74,32,11,103,40,72,218,38,78,39,17,23,11,14,47,4,15,64,20,51,127,299,73,84,19,21,33,52,43,69,121,79,113,26,35,41,237,1,30,19,67,23,20,71,108,26,26,100,69,23,25,59,20,13,12,56,19,76,45,14,22,134,23,24,61,10,380,18,87,26,10,8,65,24,32,16,191,29,11,71,52,16,49,55,32,14,8,8,37,19,15,32,106,23,16,74,75,72,11,6,50,11,69,14,28,7,13,39,87,25,98,44,48,105,48,18,104,24,97,23,188,17,42,122,23,59,17,28,35,13,19,48,66,15,12,36,30,44,62,46,21,21,139,118,40,28,33,33,25,126,61,29,25,16,42,80,72,26,47,42,15,19,110,32,47,56,15,73,12,73,46,71,22,22,51,14,188,10,176,39,18,154,19,66,102,12,56,21,33,33,90,41,150,15,84,23,67,21,14,8,17,29,19,6,91,50,7,34,34,41,36,29,12,29,19,15,11,29,43,32,5,13,16,39,29,56,39,15,5,23,18,18,9,48,30,15,47,84,26,51,9,15,43,21,127,37,52,15,27,23,152,37,11,32,28,89,42,67,109,99,33,6,84,47,29,14,69,22,16,17,17,52,11,41,55,22,31,53,18,22,32,27,27,17,25,7,193,121,5,16,57,25,24,40,20,38,24,13,8,13,27,83,32,44,28,20,15,30,21,30,53,31,22,24,16,28,22,52,24,58,21,12,75,30,56,88,41,24,23,21,22,22,31,27,81,61,31,7,9,43,67,19,13,54,40,24,100,14,15,155,26,54,110,13,23,24,62,14,52,10,35,47,39,30,103,120,36,22,36,12,26,20,33,27,26,34,43,42,51,65,27,12,21,21,14,39,63,88,31,15,89,37,25,25,91,55,63,4,26,5,22,62,19,71,32,17,90,66,29,29,95,31,62,31,21,28,41,20,17,46,10,31,22,25,40,82,51,59,66,58,22,11,44,22,17,30,19,18,28,62,36,87,26,23,19,413,87,26,35,18,23,46,117,47,12,41,11,25,45,49,21,7,6,48,49,29,44,27,63,59,74,16,10,14,6,23,15,91,43,27,27,30,24,16,17,45,42,44,40,39,26,29,20,11,38,28,29,13,18,28,28,34,39,33,23,7,11,16,24,72,65,49,25,22,11,16,37,19,22,71,12,53,26,15,12,30,23,53,31,19,24,7,52,25,109,38,33,23,13,51,56,10,39,23,29,19,30,16,9,18,14,49,26,25,11,48,70,39,15,19,62,70,38,21,29,37,26,33,21,40,17,43,27,13,59,32,16,16,34,19,30,26,29,36,11,59,19,28,12,14,18,59,13,27,13,21,21,19,34,16,18,21,31,19,63,24,51,10,37,30,18,16,16,23,17,26,15,17,18,20,14,21,28,20,26,12,29,22,46,6,21,35,26,65,36,30,20,21,16,21,21,26,25,20,12,36,68,64,30,22,10,18,22,32,17,3,17,17,26,13,17,31,30,17,27,22,15,13,15,35,17,25,15,28,36,9,13,18,13,13,31,27,14,15,29,13,21,43,6,12,21,23,16,12,14,26,18,19,8,38,34,12,7,31,21,64,21,32,27,28,36,14,12,20,23,11,21,25,12,39,12,24,25,42,16,20,19,16,22,21,17,11,20,24,6,31,15,29,21,7,30,33,36,39,85,18,4,23,14,18,11,20,6,31,32,22,7,16,18,10,9,81,18,7,17,19,21,10,27,20,12,26,10,19,25,18,13,17,23,38,16,13,23,23,54,8,18,23,21,5,5,10,20,15,15,9
lose,9,17,12,69,11,10,3,21,5,6,5,10,16,47,1,3,7,15,9,13,4,29,26,40,15,19,12,15,10,41,9,125,77,8,47,60,29,4,14,10,4,16,4,8,25,16,17,9,138,40,35,7,10,44,33,2,42,18,13,7,8,3,1,16,19,14,95,3,5,28,36,12,5,2,105,12,37,7,77,22,22,8,15,14,113,10,17,2,36,1,18,3,4,14,21,6,14,3,30,7,7,20,27,3,15,27,2,7,17,15,16,6,15,17,65,29,4,4,34,141,27,53,16,94,9,9,10,4,3,1,19,9,7,47,32,78,4,4,8,12,8,33,40,5,2,62,17,26,11,13,33,11,13,5,12,13,33,8,13,31,18,2,37,2,8,30,10,12,36,7,12,84,28,7,8,3,94,3,13,37,28,13,16,19,8,27,31,10,21,47,9,9,5,4,5,6,13,3,20,8,20,8,4,8,16,5,9,27,10,23,61,16,19,12,7,35,6,11,8,1,7,17,1,9,34,69,21,16,5,8,17,12,19,25,33,10,27,9,6,7,58,30,1,7,10,7,5,19,27,5,10,14,19,6,6,11,3,6,1,28,4,21,14,4,11,25,6,5,17,3,78,7,16,5,3,2,11,9,7,1,47,4,2,16,15,2,50,36,15,8,8,1,11,4,4,5,24,3,4,19,24,17,4,6,16,4,13,6,13,7,7,9,15,7,20,12,23,28,12,3,35,11,25,16,30,2,14,32,4,29,7,4,9,2,6,7,10,10,1,3,7,11,25,6,4,10,19,28,9,23,1,7,2,17,22,4,1,3,15,21,22,15,2,18,4,3,21,2,14,16,3,23,7,11,8,27,4,8,11,10,34,5,22,5,10,26,4,13,29,2,13,3,13,4,18,15,32,4,15,4,10,5,3,3,5,7,12,3,27,12,3,11,5,9,2,8,2,10,2,3,4,9,17,8,5,5,5,4,5,9,6,3,0,4,11,6,5,9,8,2,13,15,2,17,6,4,9,7,24,17,20,7,8,3,33,4,3,4,6,12,8,23,24,37,6,1,17,12,6,5,46,15,5,2,4,17,6,10,11,8,10,8,7,3,7,0,9,11,3,2,49,16,6,5,9,1,1,13,1,6,4,6,2,33,13,12,16,10,6,5,4,2,3,2,12,7,9,7,22,5,4,21,3,9,3,3,18,8,9,23,6,3,10,6,2,4,1,2,37,14,3,0,5,27,16,6,5,23,4,4,15,1,3,25,4,2,26,5,6,7,13,1,9,1,8,14,7,3,19,18,5,6,13,2,5,1,3,6,2,10,8,11,14,16,5,1,5,3,4,13,9,10,6,4,19,4,7,12,19,8,5,1,6,0,0,22,2,12,1,10,19,6,3,4,20,2,11,8,6,2,3,5,1,13,5,3,8,3,15,24,20,20,25,7,3,1,13,10,7,9,11,5,2,18,3,15,4,1,2,86,17,3,4,2,11,15,26,14,4,8,8,4,5,7,1,0,0,10,1,7,15,2,12,8,8,6,1,6,12,5,2,21,2,11,5,4,5,4,3,16,4,17,8,10,3,11,12,0,5,12,8,2,1,4,5,4,8,9,4,4,4,10,7,22,16,13,8,1,1,3,9,4,2,15,2,12,9,3,0,6,7,8,3,3,1,5,8,6,10,8,10,7,2,13,11,3,8,3,8,4,12,5,5,10,5,4,10,4,2,8,4,12,1,6,18,26,16,2,12,3,4,3,3,18,3,10,6,3,8,6,2,3,9,3,12,5,7,2,4,6,4,5,1,2,7,8,9,4,1,2,4,4,6,8,11,4,18,4,7,5,6,1,12,9,1,2,6,8,8,2,3,5,5,15,3,3,6,6,1,8,4,2,10,7,13,5,8,21,7,5,7,5,3,11,11,2,9,6,5,3,13,15,6,7,3,1,13,13,5,3,1,4,3,3,3,3,12,0,4,6,1,0,8,7,14,4,2,12,5,4,4,6,9,2,3,1,5,2,6,1,6,10,3,4,9,5,5,3,8,11,4,4,3,4,5,0,3,6,3,9,3,7,10,10,4,2,3,5,9,2,7,4,3,10,1,1,3,5,1,2,6,2,5,5,1,1,6,0,4,12,2,4,3,2,6,4,10,10,14,3,0,6,8,6,4,6,6,3,10,4,1,5,1,1,2,15,8,5,4,6,23,6,13,6,3,5,0,3,8,5,4,8,2,14,3,3,1,5,8,11,5,7,3,0,4,5,13,5,2,2
try,10,36,7,67,4,12,5,15,3,1,12,13,7,58,3,7,11,19,5,14,3,25,49,29,13,11,21,22,12,23,8,108,92,17,51,101,44,4,4,6,9,25,7,5,32,19,13,4,115,37,40,21,10,54,13,5,12,10,8,10,3,6,2,5,17,11,92,2,6,7,15,0,4,7,105,13,27,4,46,31,25,3,6,11,120,9,6,3,23,2,9,4,7,26,33,5,14,1,26,5,0,23,10,17,19,17,1,10,8,2,17,5,5,14,11,31,2,3,43,96,28,43,54,55,9,3,4,1,1,3,20,15,17,33,26,85,19,7,4,20,15,31,10,4,4,90,9,14,7,9,51,8,4,5,8,17,36,5,7,36,18,0,9,1,14,49,6,26,15,5,8,94,33,5,15,9,104,2,15,39,24,8,13,20,2,32,38,20,22,25,8,6,5,5,4,3,7,8,9,12,29,2,1,5,13,17,1,27,6,14,77,14,17,15,11,36,8,10,7,0,4,32,3,10,9,86,32,12,8,8,7,5,12,24,20,6,20,5,5,14,55,19,7,1,20,3,6,33,39,8,5,11,23,6,1,12,3,3,2,11,7,22,7,0,4,8,8,14,15,12,68,3,9,5,7,5,12,0,3,1,46,12,2,15,3,1,40,27,25,25,2,4,5,2,2,3,12,2,3,19,18,10,1,2,4,3,18,8,10,6,1,20,24,4,37,9,7,29,5,6,33,8,37,13,40,14,20,43,3,34,9,18,3,2,7,1,8,2,3,6,10,17,23,7,0,12,25,29,9,13,7,4,2,31,25,2,6,2,9,26,14,3,10,15,1,4,24,6,16,31,1,23,3,15,10,8,7,2,23,1,48,7,14,8,9,8,27,14,17,5,25,11,12,8,7,14,19,1,34,0,13,5,9,6,3,12,7,3,5,9,10,10,0,15,12,12,6,15,8,7,8,8,24,8,1,6,2,5,4,15,2,0,1,4,7,2,6,4,8,4,11,11,1,8,6,15,16,14,17,7,24,1,7,2,33,4,3,6,10,10,18,19,41,53,9,15,24,4,3,6,28,17,2,14,3,36,3,11,19,12,12,7,3,5,10,13,6,12,15,3,50,17,5,5,8,5,7,10,7,21,9,3,6,15,8,2,3,13,3,3,2,6,6,11,5,4,8,7,21,14,2,17,2,12,1,7,25,13,10,6,13,11,7,8,4,5,9,10,31,14,3,5,6,10,11,1,6,11,7,2,25,2,9,27,2,8,6,6,4,6,6,3,6,3,7,5,13,12,13,30,3,3,3,10,7,1,2,2,8,8,0,10,8,15,8,10,5,4,0,12,15,21,12,3,14,4,6,6,16,15,4,3,2,3,2,11,3,13,7,0,22,15,5,3,32,1,5,9,4,1,5,0,2,11,4,6,0,4,3,21,1,8,24,9,1,4,25,6,2,4,16,10,9,17,5,7,2,3,5,62,35,5,5,5,6,11,11,9,8,12,1,7,1,9,0,0,2,6,1,4,9,4,11,35,8,1,2,2,4,2,2,11,6,2,7,2,6,7,0,6,4,13,6,7,2,3,4,4,15,5,20,4,2,7,0,2,11,5,2,0,6,2,4,7,9,12,11,2,2,2,6,7,2,20,7,4,6,2,3,5,7,7,0,11,3,4,4,6,14,8,6,9,0,2,4,2,7,5,4,6,18,0,1,1,2,7,5,3,2,6,7,13,0,1,5,4,9,8,2,1,8,2,5,8,3,10,1,5,20,5,3,4,13,2,7,5,2,0,6,12,3,8,3,2,9,16,7,8,1,0,3,6,5,3,12,1,5,2,7,4,0,0,5,7,6,1,6,10,3,4,1,0,11,8,0,3,5,3,2,7,4,2,5,5,3,3,5,24,3,1,3,17,7,13,3,12,1,6,2,17,16,17,8,1,3,2,10,1,6,1,5,10,7,2,1,5,4,2,12,2,2,4,2,2,9,1,1,10,4,1,1,5,3,3,9,1,2,0,6,1,6,2,5,2,6,2,4,4,6,12,3,2,3,5,1,1,0,0,2,5,4,0,2,1,10,6,2,0,5,0,4,6,3,1,1,7,0,6,0,0,0,4,5,0,1,2,0,4,1,1,1,15,2,0,0,9,9,1,2,0,1,7,2,7,1,2,2,2,3,3,0,1,3,1,2,8,0,0,3,5,8,2,10,9,0,0,4,1,2,0,2,2,4,0,2,8,4,6,5,6,2,3,1,2,1,6,7,2,1,6
seek,4,23,8,119,15,36,13,68,3,15,31,8,22,196,2,21,9,36,20,9,7,35,39,41,29,23,33,33,9,29,26,203,181,31,67,148,151,4,10,13,18,40,8,10,48,28,29,38,348,91,63,29,24,183,23,17,39,15,12,34,30,25,8,9,44,22,210,8,15,16,19,8,11,4,178,26,38,7,85,41,58,5,14,30,293,27,19,4,29,3,7,16,11,29,66,11,28,3,75,45,8,38,34,27,22,33,7,8,16,9,26,12,19,40,12,39,6,8,73,188,45,48,26,71,12,17,6,5,3,7,28,13,19,79,64,96,18,7,21,12,16,64,35,9,7,80,17,28,20,13,109,5,35,14,10,52,49,20,23,48,11,6,20,7,3,8,10,41,44,29,7,149,47,7,6,18,200,6,18,53,41,17,13,20,11,55,38,40,54,52,4,21,18,7,5,10,27,17,12,27,51,6,16,13,49,28,6,40,14,55,100,13,21,11,7,11,3,6,16,5,10,29,10,23,43,159,24,38,6,7,24,12,25,41,73,11,39,29,19,9,98,67,10,20,1,26,13,34,54,9,21,35,54,6,7,28,12,8,3,16,5,51,17,2,15,41,22,11,44,9,193,2,18,19,4,9,33,9,6,4,115,34,6,44,30,16,11,13,34,4,9,11,16,5,6,16,32,3,11,69,47,25,0,3,18,10,59,7,20,3,8,31,36,21,31,11,29,63,34,6,79,13,47,6,105,3,29,65,4,30,7,15,29,8,13,13,35,9,9,6,15,9,26,21,9,14,51,86,26,13,18,17,5,63,26,14,8,7,33,55,42,19,23,46,11,12,38,16,22,41,8,52,11,26,35,26,11,8,50,11,76,10,65,25,17,31,22,45,27,15,53,11,9,14,39,20,45,2,65,7,24,11,7,9,13,29,13,7,58,32,21,17,6,25,7,23,6,15,6,14,9,7,28,36,10,7,11,21,15,29,12,6,1,8,20,11,12,17,11,17,34,42,21,30,8,13,26,17,56,18,35,10,11,18,68,14,7,8,19,25,36,40,50,92,15,4,33,21,11,6,54,9,7,3,14,46,13,12,30,17,30,30,10,12,16,6,8,7,15,2,118,32,7,16,17,2,7,9,8,26,11,9,6,1,9,19,10,22,7,6,5,13,4,18,13,18,13,19,7,16,14,31,13,25,16,12,36,24,44,25,14,16,14,26,18,14,8,12,62,22,7,8,11,19,21,10,15,31,17,6,53,4,8,57,19,22,55,3,15,14,19,14,19,11,22,18,22,10,50,54,19,10,10,17,5,6,18,17,12,17,7,21,24,42,18,16,9,10,2,20,39,30,17,8,77,14,15,20,48,44,38,9,11,9,14,24,8,24,18,9,26,14,8,7,35,11,40,12,6,4,11,2,6,19,9,10,8,10,15,34,19,15,35,33,14,16,47,6,6,10,29,14,7,26,9,9,17,8,15,207,22,23,5,11,8,14,43,33,19,23,7,6,21,12,10,7,10,12,16,15,18,9,50,22,27,10,4,6,6,9,4,37,10,9,11,10,21,11,3,8,28,38,15,15,13,7,13,8,23,5,18,4,4,8,15,16,16,13,3,2,5,7,9,27,22,10,4,14,22,6,8,16,14,14,4,1,4,7,3,32,11,15,8,19,4,2,8,12,32,20,20,11,9,13,12,7,19,16,11,8,22,3,0,7,4,10,10,16,5,11,8,18,2,4,24,39,16,14,9,18,9,12,11,21,3,17,13,3,6,10,5,11,17,4,15,8,6,27,10,18,11,6,5,7,12,25,2,6,6,8,8,3,15,4,29,8,16,6,30,4,14,11,15,9,5,2,11,12,3,12,4,0,12,13,7,7,16,3,2,9,3,12,26,16,14,22,15,64,11,9,4,8,6,6,6,14,12,23,7,23,22,34,13,7,8,4,14,7,9,2,10,14,10,13,10,5,17,4,19,13,2,7,8,21,10,7,3,5,15,26,6,4,3,4,5,3,7,2,4,9,3,9,3,4,8,5,4,1,6,23,6,2,7,8,12,0,13,20,10,22,13,17,18,6,16,4,0,16,14,5,11,12,5,3,8,3,11,9,10,6,3,11,7,6,5,5,8,7,4,12,8,25,1,0,10,13,25,7,21,2,0,9,9,4,3,3,4,5,18,7,0,5,8,8,3,12,4,0,13,10,20,3,8,15,3,11,2,10,15,4,5,11,5,11,6,3,18,14,8,2,7,10,9,4,3,7,12,6,4,10
relief,4,16,9,120,3,4,1,13,1,2,6,3,8,44,2,3,0,14,4,9,6,25,15,16,14,15,2,6,2,4,2,104,86,9,39,24,11,13,19,6,17,8,2,5,9,9,26,26,119,26,16,1,11,22,10,10,23,14,4,6,8,5,3,6,9,6,69,6,3,6,34,4,1,2,57,11,9,14,45,10,38,3,9,4,130,17,11,4,27,3,7,2,10,9,31,13,21,2,34,11,5,16,34,5,7,25,15,13,18,10,10,6,20,6,6,26,3,4,41,109,16,31,93,81,13,2,0,3,2,8,7,2,3,36,10,53,5,4,6,8,3,19,18,3,1,37,4,18,14,8,21,0,9,2,4,41,22,5,4,18,10,1,15,4,20,9,5,20,22,8,16,60,16,1,2,18,97,1,4,34,8,4,5,13,4,13,17,6,11,30,1,2,12,0,6,1,23,4,5,14,25,4,7,10,21,11,6,15,4,12,70,2,17,12,3,5,2,6,10,12,5,8,4,9,33,66,23,23,2,25,7,18,29,14,33,8,17,6,6,3,41,23,7,3,26,1,7,14,50,4,10,21,14,7,9,22,5,14,4,28,2,13,21,2,3,28,5,6,5,5,79,15,26,1,5,3,14,25,2,7,28,6,7,13,9,7,4,10,9,2,6,0,16,7,12,9,21,2,5,18,16,26,3,6,14,8,6,1,5,2,13,9,30,1,33,19,18,33,9,3,33,6,12,3,30,0,18,15,3,15,3,3,6,2,1,31,7,2,8,10,3,6,12,12,8,7,32,17,22,19,13,12,1,14,11,5,1,2,13,11,20,8,14,18,5,5,17,3,14,8,4,18,13,7,10,23,1,1,9,8,35,1,33,9,1,11,2,11,10,11,14,6,8,2,13,11,37,5,22,3,8,3,2,3,5,8,7,0,23,11,1,5,6,6,18,1,3,6,4,3,2,4,34,3,2,0,2,4,3,11,17,1,2,14,5,2,0,4,6,6,12,15,11,10,1,3,7,5,23,16,13,1,5,9,26,4,0,1,4,18,7,12,14,21,5,1,13,8,8,4,16,5,0,0,2,6,1,3,16,2,2,9,2,1,6,4,9,2,1,3,63,18,2,2,16,4,1,25,7,9,4,6,5,3,5,26,24,11,6,6,6,5,4,5,7,4,2,4,2,5,3,11,8,4,1,4,8,17,7,10,7,3,1,2,10,0,2,1,14,14,3,3,0,20,15,4,1,31,10,7,10,0,5,19,8,6,15,6,9,7,30,3,25,6,10,12,14,1,21,28,4,3,12,7,5,6,13,3,1,13,2,16,15,11,4,8,2,2,4,3,13,12,8,2,13,3,4,6,7,15,11,9,4,0,4,16,10,10,6,3,20,17,8,1,27,4,11,3,3,4,16,4,3,24,5,5,1,9,3,11,23,12,14,15,5,3,16,6,3,5,14,1,15,11,7,16,15,2,8,80,20,3,6,2,4,6,29,9,1,9,4,2,2,7,1,0,0,2,9,12,4,3,7,26,11,5,3,6,4,0,5,12,3,4,5,10,11,3,4,2,4,6,13,2,5,6,1,1,10,7,3,4,2,2,1,1,13,1,0,2,1,9,4,23,10,9,1,3,3,2,7,9,4,6,1,4,6,5,6,6,5,9,7,2,0,1,7,3,10,2,8,0,0,7,3,6,10,6,2,11,4,4,11,13,6,11,6,5,5,27,21,15,4,11,20,13,5,4,20,3,2,2,5,15,3,8,13,0,0,6,0,4,11,2,8,3,8,1,11,7,6,9,2,0,4,11,2,3,0,2,4,3,6,3,4,6,3,3,10,2,4,1,2,9,0,6,3,5,1,4,1,5,0,17,4,1,12,8,13,4,12,7,9,1,3,7,5,29,2,0,5,2,6,3,11,12,10,5,11,5,14,12,8,3,1,2,4,5,3,6,7,5,6,6,1,5,3,2,8,8,10,4,15,15,6,1,3,3,3,2,1,3,1,5,2,3,4,1,2,6,0,4,0,4,6,7,2,3,3,10,14,0,4,3,4,4,1,9,2,8,9,9,2,10,6,3,3,5,4,9,7,4,7,1,6,2,4,4,4,6,4,1,1,1,2,3,7,3,6,4,4,13,8,4,12,25,27,23,30,3,2,3,3,23,3,4,1,0,12,1,0,3,3,5,9,11,5,21,2,0,1,2,9,0,0,4,23,14,1,4,2,1,3,23,2,6,12,6,10,0,0,9,2,1,2,24,3,2,0,4
promise,2,10,7,77,6,16,5,34,5,3,14,10,6,46,1,8,7,10,14,7,5,20,12,12,16,10,12,16,5,18,8,118,79,7,31,56,38,3,5,4,4,25,4,5,22,14,20,9,116,38,26,8,15,43,9,4,28,19,14,19,14,3,0,10,28,4,66,8,8,8,8,1,3,2,65,11,14,6,58,14,22,1,9,5,134,6,8,1,19,2,8,2,3,12,24,4,7,3,21,16,9,20,22,11,16,16,5,2,10,6,14,3,14,12,5,21,1,5,28,89,19,23,13,71,9,11,2,1,2,3,11,1,11,39,14,49,4,5,3,4,5,27,23,7,5,29,7,15,11,10,36,3,4,13,3,11,22,5,5,19,11,2,6,1,6,9,6,16,13,11,14,47,19,1,2,6,71,4,3,25,11,10,8,15,2,25,21,10,22,34,2,6,5,1,2,7,19,5,4,5,17,6,1,11,13,5,3,23,8,24,54,6,12,6,7,14,0,4,11,6,1,13,2,9,14,35,9,23,3,5,12,16,15,8,14,12,24,6,7,2,46,20,5,6,13,7,1,40,20,4,7,16,20,3,2,15,5,5,4,17,2,16,17,4,13,25,7,12,10,3,56,5,13,7,2,3,12,8,3,3,20,5,3,7,8,2,7,14,11,3,2,7,4,8,2,4,26,2,4,11,13,14,0,2,2,5,15,5,3,3,1,9,21,9,20,7,9,33,4,4,28,5,19,4,29,3,3,18,7,28,3,6,6,5,5,10,11,6,3,14,5,5,19,6,3,4,23,18,11,4,9,9,2,17,9,3,5,1,4,28,7,8,5,12,8,7,17,3,22,14,1,7,5,8,4,10,7,1,11,5,41,2,16,7,3,12,2,13,18,2,10,4,4,6,11,8,28,7,34,4,14,3,3,3,8,5,5,4,16,10,2,12,0,12,13,13,5,8,1,10,2,6,16,5,1,2,5,5,9,11,11,5,2,1,8,4,2,11,7,6,4,10,6,9,1,2,7,7,15,5,15,9,6,7,22,10,3,7,4,13,8,21,17,16,6,4,12,24,5,6,14,7,5,1,8,7,2,4,14,5,3,5,5,3,6,7,5,4,3,2,41,23,0,6,5,6,4,7,8,6,4,2,2,1,9,9,3,13,2,3,2,2,13,4,8,10,5,8,1,6,2,10,5,5,1,3,8,4,12,13,10,7,1,6,2,3,5,8,26,3,1,1,0,3,8,7,5,13,4,2,15,5,3,26,5,3,24,2,8,2,10,2,13,1,5,7,13,4,14,26,7,3,4,1,3,3,4,2,3,10,5,16,10,15,3,3,3,5,1,4,11,13,12,2,9,4,4,0,30,15,16,6,8,6,2,14,3,13,9,6,8,16,6,5,16,2,13,0,4,4,8,3,3,22,2,3,3,7,6,13,6,8,13,8,3,0,5,3,3,9,6,3,2,12,5,7,5,6,7,71,16,5,5,1,1,8,17,5,4,5,3,8,5,9,3,6,0,5,4,15,5,2,31,11,19,3,6,4,3,1,3,16,11,1,9,3,8,7,7,13,3,19,12,6,5,8,8,2,2,6,7,6,4,1,4,4,9,3,2,2,4,7,6,16,22,5,8,2,3,3,5,6,3,8,2,3,3,2,1,10,10,9,7,8,5,3,11,1,9,8,4,6,4,6,5,4,5,5,5,1,8,1,1,9,10,6,5,6,1,2,3,7,1,0,18,6,4,5,6,11,3,0,4,4,3,8,6,3,10,3,3,7,9,0,12,6,0,0,5,3,10,5,2,2,3,10,0,4,5,0,5,1,3,2,10,4,11,6,10,2,1,5,6,8,6,10,7,2,3,6,6,1,7,9,5,2,4,7,2,2,6,7,5,4,5,5,4,15,4,1,1,2,1,3,3,2,7,5,0,8,16,8,6,2,0,2,3,9,5,4,2,3,1,4,3,5,2,3,6,8,6,0,7,10,2,8,2,4,9,0,2,5,2,4,4,2,3,1,5,3,3,3,2,8,6,5,4,0,1,10,2,4,1,3,5,3,7,14,0,12,6,2,4,9,1,3,5,8,2,0,4,5,2,1,6,5,5,13,5,4,5,3,4,5,1,1,3,3,5,4,1,9,5,3,5,10,3,6,19,5,2,4,3,3,4,3,2,4,8,6,0,6,4,3,0,8,3,1,0,10,9,8,5,6,6,11,3,6,7,4,4,6,3,3,7,3,4,7,21,0,2,1,5,7,3,5,5,3,5,9
keep,4,27,22,241,21,45,15,51,4,17,26,20,33,234,7,16,29,79,24,12,16,78,122,90,34,54,78,86,41,85,30,425,265,86,137,266,134,12,30,23,22,42,16,31,95,39,61,43,403,208,117,29,53,198,40,7,109,40,53,50,19,26,6,33,69,21,273,48,10,41,44,7,39,10,369,33,93,10,210,95,133,16,16,25,384,69,41,14,65,0,26,30,23,88,90,47,32,16,106,42,22,52,55,50,32,76,16,33,45,26,48,12,95,52,58,70,9,25,82,338,129,144,68,232,27,25,19,7,13,9,59,28,23,131,77,226,32,14,19,12,33,94,50,7,11,196,24,60,41,28,113,20,34,20,20,64,129,24,23,128,53,11,51,8,27,80,25,55,54,22,50,319,80,12,60,11,267,20,38,225,60,41,53,93,12,113,93,58,56,92,9,18,18,22,18,16,59,28,34,64,94,21,18,14,70,41,23,89,20,49,204,54,53,17,25,55,17,56,40,5,17,73,7,43,113,198,72,71,34,45,37,46,66,62,95,36,84,36,21,24,158,71,19,33,34,14,40,1,117,37,22,49,50,26,22,48,15,13,8,61,13,117,30,3,25,110,28,97,57,6,207,18,50,19,6,18,68,23,12,6,221,13,10,24,30,8,54,73,39,13,12,25,47,27,3,22,69,15,32,46,78,42,8,17,21,23,66,23,18,5,3,45,82,45,100,46,42,79,27,18,59,20,96,35,175,10,36,108,11,80,32,40,23,14,25,14,58,7,10,21,33,40,71,20,7,30,49,97,27,54,13,29,16,103,43,11,20,23,28,100,45,25,34,41,11,24,64,21,52,103,10,121,27,79,30,68,23,11,44,12,126,11,108,25,52,60,14,48,58,4,45,21,32,8,43,50,59,9,82,2,45,34,15,27,16,25,31,5,36,43,10,18,8,51,12,39,24,30,15,42,16,25,55,27,17,9,7,28,20,30,71,20,1,42,20,9,15,27,53,8,43,34,18,23,4,18,107,27,83,20,94,8,53,41,112,20,35,12,35,38,55,83,62,158,31,34,80,42,14,10,78,32,6,24,18,83,11,22,95,37,18,34,9,25,31,10,16,31,20,8,200,60,9,19,37,4,13,30,14,33,41,27,21,26,23,137,19,23,24,22,8,16,7,19,39,27,13,24,8,33,8,42,22,66,10,13,53,30,39,72,45,56,28,33,22,24,19,32,74,39,14,2,15,29,29,11,38,43,17,12,50,6,8,108,25,37,51,3,12,18,27,6,24,11,21,29,28,21,59,79,24,5,23,4,9,10,17,11,14,52,16,31,34,80,22,23,27,10,6,43,52,63,43,13,79,14,41,17,22,56,27,6,7,0,3,24,14,29,30,17,54,34,18,7,47,14,30,15,24,4,24,67,16,59,7,10,9,13,32,38,94,38,57,47,10,16,26,18,19,29,45,19,14,19,8,67,11,8,16,214,38,17,13,7,12,34,67,29,11,25,3,9,5,11,3,3,2,8,12,14,23,16,21,15,15,6,6,10,20,5,15,44,34,16,17,13,35,15,13,29,9,62,22,29,13,15,22,4,27,11,9,9,4,6,20,20,23,28,4,0,6,19,9,32,28,84,57,8,9,37,21,21,5,82,17,19,8,9,12,26,35,29,9,18,13,14,85,20,24,31,20,17,22,68,37,22,39,29,8,10,27,14,5,16,5,21,10,13,7,22,22,42,9,10,33,32,34,8,8,11,38,11,25,27,11,22,32,16,15,19,4,5,29,23,14,9,19,11,35,41,15,13,4,13,21,41,9,9,4,3,14,18,23,6,42,7,16,17,30,4,19,6,10,9,14,2,8,25,9,28,3,2,15,30,5,12,31,8,37,4,25,9,22,18,31,16,11,39,15,10,4,13,8,13,22,16,14,19,8,18,25,36,21,9,16,27,22,15,3,14,9,7,25,9,10,14,7,6,22,29,11,2,17,58,13,15,3,8,19,5,1,15,11,7,5,1,7,7,16,10,17,9,26,7,9,26,6,6,17,58,10,9,35,24,3,15,4,26,4,39,15,19,8,20,22,12,18,7,19,4,11,4,10,11,3,6,6,11,6,58,10,5,5,4,6,5,15,10,8,19,14,38,6,4,18,29,37,16,91,6,7,16,16,12,11,7,3,12,24,10,4,7,13,3,4,31,17,3,8,8,34,17,21,32,16,5,33,10,12,8,9,15,1,47,10,13,21,38,17,20,9,10,4,30,11,19,18,6,13,29
provide,19,130,55,858,30,30,20,102,13,15,67,50,62,284,14,35,23,57,18,22,20,144,64,114,92,73,43,52,9,68,50,840,417,67,209,207,145,44,56,18,28,24,10,42,107,64,168,101,1067,97,186,31,40,136,116,17,246,140,21,58,49,35,19,54,83,30,342,22,27,58,149,26,21,16,352,56,103,29,308,85,309,20,43,34,836,92,95,5,135,20,46,24,28,117,153,58,64,24,198,56,74,152,139,34,67,128,38,20,38,21,79,43,55,96,79,112,30,9,416,541,130,104,131,432,37,8,20,20,38,22,54,21,27,265,60,311,21,29,14,36,14,120,91,15,9,280,17,60,59,64,249,18,59,43,20,203,132,56,29,143,81,19,49,27,80,70,34,92,87,42,92,319,89,15,17,39,546,27,39,320,99,60,134,95,35,108,133,71,128,197,5,13,35,7,12,21,121,37,72,51,131,17,22,61,118,54,57,172,46,99,312,33,162,64,16,28,23,57,89,30,25,81,22,73,196,570,119,97,27,89,64,91,102,99,207,94,112,65,63,30,236,108,27,39,54,50,20,117,1,18,79,49,74,35,29,53,32,22,18,145,50,113,107,37,19,244,67,28,28,25,476,112,145,30,19,19,104,100,45,26,226,33,29,63,52,24,107,104,63,18,23,37,109,43,25,41,148,34,35,68,85,219,14,28,48,14,94,33,45,26,37,155,193,61,150,72,70,146,55,40,172,19,97,37,201,34,50,84,12,110,25,54,26,36,30,66,41,24,42,62,45,41,79,50,29,25,203,181,77,70,51,34,22,143,88,44,48,24,80,129,194,79,58,82,23,20,123,28,54,57,24,130,29,69,29,249,41,15,32,35,372,16,224,52,50,121,53,106,86,22,97,34,59,74,94,33,195,38,121,21,74,18,16,12,23,29,28,8,98,46,7,27,25,77,43,44,24,29,23,20,22,41,112,29,12,31,27,59,51,50,67,44,25,53,28,21,5,48,59,24,72,81,37,30,11,19,94,19,120,28,94,30,32,14,167,52,3,69,45,99,48,80,108,155,37,32,81,58,56,10,62,18,15,12,22,75,13,49,115,47,25,54,16,12,31,34,32,10,20,20,342,157,6,17,50,22,28,63,31,44,41,35,29,46,40,108,45,59,41,12,19,39,48,41,69,50,25,38,29,43,17,69,40,120,33,28,109,69,45,105,66,19,25,58,64,28,48,39,160,103,27,42,18,35,48,44,5,69,61,38,215,19,57,172,69,65,109,22,31,62,101,32,143,33,46,72,46,43,167,189,48,18,113,33,44,15,49,29,13,106,26,42,57,63,31,26,23,36,14,49,73,70,35,32,96,10,20,31,225,67,103,21,27,34,38,72,22,86,59,26,72,145,71,15,141,29,52,19,55,26,48,40,36,105,34,45,22,44,41,132,80,120,104,94,40,16,42,60,27,41,49,18,44,89,37,160,70,43,74,574,104,21,19,59,28,48,126,56,21,70,24,23,126,55,43,26,32,34,30,42,77,45,83,195,118,19,18,45,16,23,39,118,35,38,49,45,43,37,27,73,68,66,56,43,32,65,35,23,62,53,31,26,38,38,45,37,47,22,15,25,20,54,11,78,68,160,31,17,31,48,37,15,12,187,27,36,29,12,34,50,43,90,22,27,26,37,158,24,128,36,54,21,62,89,61,33,68,90,45,39,42,39,33,57,40,54,25,63,33,62,57,66,23,36,85,46,69,37,69,45,30,13,17,79,27,48,46,22,61,36,15,18,32,19,43,26,27,11,34,70,35,87,35,23,90,92,44,41,15,68,29,13,61,36,14,11,21,29,64,28,34,16,40,47,22,19,22,46,18,43,12,17,58,78,38,16,26,68,29,12,60,24,33,16,16,20,31,76,38,29,13,50,36,34,34,79,39,71,12,52,68,124,43,15,19,42,24,21,27,19,38,20,36,29,18,34,13,32,15,85,44,31,42,34,32,18,7,30,33,13,35,41,20,17,47,11,36,16,11,36,20,44,27,19,23,34,22,60,44,29,29,14,40,25,71,29,15,44,35,100,29,56,22,56,30,35,12,33,27,23,11,24,25,55,21,27,14,43,27,27,30,41,31,14,18,16,30,29,9,54,22,33,51,30,42,108,56,85,188,21,36,17,23,51,38,51,21,25,113,22,16,22,29,41,20,79,19,33,22,14,26,20,22,22,12,16,22,28,27,33,37,18,31,34,23,17,18,49,34,19,12,35,18,17,35,30,25,14,22,12
invest,0,24,8,73,2,18,4,23,5,1,12,2,9,45,3,5,4,13,9,2,7,43,36,24,13,17,11,18,6,17,7,102,55,16,34,47,26,5,4,2,7,7,2,8,22,10,34,8,154,39,30,9,14,36,14,4,46,6,16,12,12,3,1,13,21,3,84,10,2,6,18,0,10,2,68,7,17,5,69,31,24,2,9,5,120,27,12,7,14,1,5,2,9,19,32,14,16,2,20,10,5,13,11,8,6,16,3,19,11,2,7,9,33,31,29,22,5,6,35,93,33,29,39,59,4,7,4,3,4,5,27,3,10,21,16,57,6,4,6,4,1,27,16,2,1,38,7,20,11,11,74,10,10,5,3,23,14,18,8,36,9,4,20,1,33,21,7,15,13,0,9,62,21,1,12,2,93,1,7,39,9,12,14,18,4,13,24,8,27,36,8,5,5,4,10,2,26,5,8,10,28,13,12,7,15,16,3,18,10,5,49,16,16,14,2,20,11,18,14,3,5,13,3,13,31,50,11,20,2,20,2,9,21,28,22,13,21,11,6,5,39,26,5,8,9,4,4,37,18,1,10,24,17,12,4,7,6,12,3,23,3,14,9,1,6,12,16,8,11,2,70,13,12,6,0,3,22,3,10,1,51,6,7,12,6,8,13,12,6,2,0,6,30,5,8,4,23,2,3,9,13,12,1,5,16,9,7,3,1,5,0,8,21,9,20,8,17,17,29,2,27,2,23,15,58,5,7,22,4,18,7,9,1,4,4,10,15,5,2,1,13,13,13,5,6,1,32,25,18,14,3,16,6,22,12,3,3,6,8,21,14,9,9,3,6,2,34,3,11,30,4,30,5,17,9,12,3,6,7,2,38,1,23,3,15,24,2,10,18,2,9,7,6,9,12,10,22,6,22,1,16,9,2,5,2,9,9,2,13,5,0,8,1,7,25,5,4,2,3,6,2,1,10,4,2,1,1,5,6,6,9,3,2,6,4,9,4,9,14,1,13,7,3,11,2,0,22,2,21,5,30,4,9,2,25,12,4,9,8,9,11,13,16,22,2,1,19,4,6,1,15,10,3,2,4,8,2,8,9,7,5,7,3,6,7,12,6,6,2,1,42,19,1,4,11,3,3,12,5,4,2,10,1,2,14,16,8,4,3,5,3,0,3,9,11,10,1,4,8,11,3,19,4,34,12,1,13,13,3,15,11,10,2,4,5,6,4,12,25,10,2,2,3,13,12,5,3,15,5,3,40,3,6,30,2,3,23,4,5,0,7,1,14,3,8,13,5,4,15,9,8,4,2,3,9,2,0,1,4,9,13,4,9,8,6,2,7,2,2,10,8,22,7,2,12,3,4,5,15,12,7,3,4,1,4,5,2,15,4,4,11,7,10,5,12,8,5,12,8,2,10,7,3,12,3,2,6,6,5,19,8,5,13,10,5,4,8,0,1,14,1,7,2,13,1,14,1,7,4,78,11,4,5,3,0,6,28,14,6,8,4,2,4,3,4,1,1,8,13,5,10,1,19,17,12,3,0,2,0,4,2,14,5,3,3,5,8,4,2,0,9,15,6,6,5,3,3,6,9,8,7,4,5,1,8,5,4,5,5,0,5,3,3,15,3,10,5,8,1,0,6,0,1,7,4,1,4,8,1,4,6,11,3,4,3,2,4,2,20,6,1,1,2,5,5,4,12,14,6,2,4,1,0,0,1,5,4,4,2,7,5,7,1,5,5,9,4,4,8,0,12,1,1,3,2,6,10,6,11,5,4,1,6,17,12,5,7,12,2,11,1,7,2,5,5,7,4,2,5,3,0,3,7,1,5,0,2,0,6,2,4,0,3,3,0,3,1,4,4,6,2,0,1,10,0,2,2,4,7,6,3,1,5,3,8,4,5,24,17,5,0,3,7,12,1,3,6,2,3,5,19,23,5,0,1,4,3,4,4,1,2,3,5,4,8,2,3,3,7,6,1,1,7,3,5,3,1,3,5,1,2,1,2,1,16,1,2,3,1,1,7,4,3,1,3,1,2,2,4,7,5,1,5,6,9,5,1,18,3,13,6,4,3,4,4,1,1,8,3,2,4,4,3,7,0,5,2,12,5,5,3,2,6,4,3,1,3,2,4,2,3,11,0,4,7,9,13,7,20,1,0,8,7,2,1,2,1,4,7,2,1,1,10,0,1,17,4,2,8,4,2,10,10,6,4,1,6,4,7,2,0,7,4,6,5,3,3,14,18,7,0,4,1,6,4,2,10,0,5,5
urge,6,18,18,310,13,8,2,25,7,3,19,11,16,72,5,5,14,22,9,6,17,42,20,31,45,17,13,13,12,13,8,210,128,16,58,48,33,12,13,3,4,15,4,11,38,21,65,17,253,39,42,12,16,48,21,9,44,44,9,17,19,9,4,10,29,4,109,3,10,15,19,5,5,2,68,26,17,5,82,23,73,2,11,11,211,22,19,1,27,5,10,10,3,27,42,13,14,9,39,18,16,29,34,16,9,32,18,9,12,6,28,10,21,28,10,30,6,6,88,161,36,23,28,66,14,4,1,3,5,5,17,7,9,57,18,48,10,3,6,7,4,32,27,3,3,70,7,9,20,13,67,5,9,6,3,48,27,11,5,22,23,2,10,5,16,6,9,35,38,8,14,69,37,5,1,14,223,4,11,82,25,15,32,14,3,24,34,26,45,45,2,4,9,0,2,4,44,11,11,11,24,1,8,13,19,11,12,41,6,26,70,11,52,5,2,11,3,5,8,6,3,23,8,13,51,120,31,27,12,16,15,21,18,33,33,17,29,13,14,5,90,26,10,5,21,10,7,22,79,10,1,17,26,13,7,18,15,4,1,13,7,18,35,8,10,51,17,11,22,6,156,16,31,12,12,6,26,11,25,6,60,7,7,17,17,6,27,21,9,2,1,9,43,6,4,11,35,17,7,25,37,54,1,5,16,3,21,2,8,1,6,16,33,23,27,15,17,29,15,12,55,11,22,14,57,14,13,24,4,23,8,12,6,8,3,21,24,9,3,19,15,10,16,7,5,15,42,46,18,12,15,8,3,45,17,15,8,4,11,25,64,19,7,34,3,3,36,6,17,12,41,26,7,14,6,34,10,9,10,7,71,2,59,9,7,34,8,21,23,2,43,8,27,28,35,21,69,9,32,6,23,4,6,5,13,6,11,4,26,16,4,7,7,27,22,10,9,8,1,8,5,9,44,12,1,10,3,12,8,18,22,6,3,11,9,5,1,9,14,5,15,23,6,14,4,3,6,8,22,10,13,3,12,6,53,6,0,17,4,31,20,12,25,22,8,12,15,10,16,2,19,9,4,4,2,5,3,21,32,3,10,12,1,7,8,13,16,3,5,10,66,41,5,1,11,8,3,15,11,11,7,7,13,11,9,39,4,20,11,4,4,9,6,6,15,25,7,6,2,9,5,14,4,17,6,6,24,5,18,34,8,9,8,7,21,7,9,8,32,32,8,8,7,5,16,25,0,24,18,12,36,9,8,34,14,13,21,7,10,35,46,19,21,6,12,33,12,4,48,30,9,15,25,2,17,8,6,5,4,23,7,18,11,8,17,2,7,9,2,11,25,26,23,7,19,3,5,5,41,26,28,4,7,3,17,31,9,27,12,3,20,33,10,2,36,8,21,8,7,9,24,20,9,34,14,2,9,16,14,26,17,54,20,18,4,10,15,12,4,5,6,6,7,24,13,44,9,11,32,129,22,11,11,11,12,11,41,16,5,17,16,4,20,11,8,9,5,15,14,13,15,7,14,44,38,7,10,7,4,4,3,43,5,31,14,6,9,3,2,8,15,16,10,11,28,17,5,7,7,14,12,6,10,8,11,10,14,5,12,3,6,3,3,42,17,10,3,8,7,10,6,5,4,21,1,9,8,3,10,17,11,10,4,8,4,8,20,2,18,9,10,4,8,3,8,7,24,16,5,10,9,4,0,10,6,19,4,15,12,10,5,16,2,4,25,21,11,5,12,14,7,3,3,17,5,23,10,7,10,8,3,4,13,8,10,15,12,8,8,9,12,26,12,6,3,16,18,15,5,5,9,2,12,9,5,6,14,4,25,7,0,1,3,11,6,5,8,8,2,9,9,6,15,13,4,3,11,12,21,1,7,2,9,3,6,8,11,23,9,9,2,5,10,11,11,10,9,6,12,13,16,30,9,6,11,3,2,6,7,3,4,6,7,4,2,8,2,13,6,35,7,2,4,19,10,5,1,8,18,4,1,2,5,7,12,4,19,6,4,6,2,10,6,6,7,5,6,2,9,6,12,7,1,11,11,2,2,23,4,22,8,16,6,12,6,0,1,17,3,6,10,13,7,3,5,6,5,23,12,10,13,18,7,5,5,6,9,4,11,17,5,8,3,4,4,33,14,13,54,6,5,2,10,11,7,2,2,2,26,1,2,6,10,16,5,7,8,6,3,6,1,5,5,12,6,2,0,10,10,4,19,6,13,21,12,7,12,10,29,6,1,4,6,2,3,8,1,6,3,3
produce,8,12,8,238,9,10,13,60,5,6,19,7,20,113,4,8,16,35,11,10,11,63,14,29,30,14,14,35,6,22,11,257,272,19,89,117,66,35,85,8,23,15,8,12,69,38,39,19,441,48,104,7,38,78,13,14,250,23,9,27,31,13,13,50,44,9,188,35,15,18,55,1,11,7,234,25,80,11,140,42,210,4,28,25,358,71,72,6,83,9,23,21,16,55,120,78,33,18,72,69,21,52,59,23,30,31,43,23,35,20,50,10,37,52,12,61,17,6,159,407,87,36,83,172,23,2,7,11,6,18,24,10,16,109,31,104,15,12,10,21,7,89,59,5,11,108,10,33,46,35,109,10,49,17,24,32,87,53,16,38,54,8,21,5,22,19,15,40,48,25,42,161,54,5,9,15,337,14,19,79,38,18,12,32,11,88,108,37,36,83,6,11,49,3,4,11,25,5,21,26,100,15,10,24,44,9,9,104,16,65,178,23,54,57,5,10,12,18,15,6,16,31,13,45,94,132,81,76,14,29,31,33,65,30,62,183,52,38,83,9,112,100,14,11,35,21,16,49,49,24,17,1,56,23,36,30,17,7,11,53,9,45,24,1,22,69,16,13,53,16,258,19,97,12,5,6,33,34,26,9,108,20,23,36,38,8,8,15,20,16,10,7,36,12,7,31,88,7,8,56,62,41,9,5,40,8,25,12,12,7,3,32,59,11,112,49,83,116,61,13,55,10,58,13,55,4,29,32,5,38,12,20,21,10,8,37,42,16,12,24,14,15,54,13,16,13,80,114,41,19,37,12,15,114,34,9,4,6,29,59,44,15,24,31,14,2,60,21,15,28,10,39,14,32,22,44,5,24,41,21,106,2,93,17,12,86,4,51,62,9,34,8,24,9,53,21,101,3,53,3,32,7,12,2,10,32,21,9,65,24,4,21,41,25,18,13,5,15,6,6,17,5,35,19,4,5,11,21,23,40,27,20,7,16,7,4,4,8,10,17,32,46,9,37,4,12,20,12,67,29,22,7,12,16,96,8,5,7,14,98,27,55,56,56,14,10,101,26,17,3,36,9,7,6,6,53,10,14,28,15,35,15,3,9,14,8,30,7,9,2,103,73,5,9,45,11,25,32,18,31,37,13,20,2,8,97,46,43,20,16,28,18,13,15,39,29,6,17,32,23,9,34,18,16,15,4,58,35,26,69,19,14,5,33,9,18,9,20,91,41,12,4,12,79,76,17,8,46,23,16,35,8,10,61,14,21,84,21,17,10,40,11,30,7,26,45,24,10,60,55,36,12,14,3,15,16,68,16,11,34,103,20,57,18,18,20,26,10,14,20,54,66,19,6,114,35,28,21,52,27,37,4,17,4,7,38,22,25,17,31,52,22,11,12,53,15,43,27,11,9,21,21,6,31,6,25,7,17,30,41,43,33,49,48,10,10,20,17,10,29,35,1,16,23,14,24,18,5,13,241,58,16,19,1,9,16,87,18,6,50,9,12,19,23,13,5,0,18,18,24,38,18,45,19,39,17,7,15,5,7,4,58,25,9,26,8,24,8,11,20,15,17,24,14,6,13,26,1,49,20,13,2,12,20,20,15,52,5,17,6,1,15,26,55,23,11,5,16,8,22,24,9,11,19,8,16,31,14,9,45,7,51,34,10,16,1,12,9,41,27,13,21,4,30,18,8,53,31,19,13,22,13,12,33,37,11,14,22,6,92,99,35,2,18,43,52,15,13,48,10,9,12,12,14,3,28,44,9,10,31,15,12,26,23,17,24,39,17,18,21,8,6,4,15,24,38,21,13,8,2,9,12,20,8,5,5,25,9,30,12,77,2,36,7,15,5,13,12,8,16,10,15,4,12,6,18,5,13,30,17,27,18,27,3,15,24,14,57,17,7,7,11,8,12,18,10,15,6,10,14,37,29,9,30,15,10,32,37,10,5,15,10,14,11,17,16,9,3,5,12,7,8,12,54,14,14,8,13,11,23,3,10,5,4,12,8,6,8,9,16,6,22,4,16,14,7,2,3,10,5,10,8,1,9,6,1,0,33,10,33,7,27,8,24,23,8,8,16,10,10,23,14,7,143,8,12,5,29,7,25,10,6,12,12,7,16,16,28,6,21,8,24,17,14,44,49,24,26,78,14,1,8,8,11,5,9,12,8,25,9,13,19,14,2,5,48,2,8,7,9,7,10,18,18,10,9,5,19,18,5,12,8,11,29,8,25,17,15,35,3,11,4,8,1,4,26,11,11,7,2
hope,14,35,19,266,22,31,18,55,21,10,55,20,27,193,8,29,20,30,24,21,10,49,54,76,28,37,35,44,27,40,19,345,235,31,103,197,166,16,18,10,20,59,12,17,80,27,42,33,444,141,79,25,41,161,40,25,80,42,47,51,38,18,7,28,52,30,229,15,32,22,33,5,8,9,188,44,49,13,169,67,66,7,42,30,351,31,23,4,64,6,22,22,9,40,103,9,37,3,79,19,15,71,67,27,31,48,12,17,21,12,33,14,17,39,42,60,7,7,102,313,69,62,20,184,28,21,5,11,3,5,50,11,26,85,44,126,27,16,14,24,11,93,59,10,12,132,16,27,17,18,100,11,34,13,6,44,76,16,28,83,16,10,24,9,6,22,13,55,53,34,29,148,44,18,12,21,277,18,17,81,52,30,24,32,11,44,63,42,81,121,6,7,9,7,9,12,35,14,21,16,54,8,6,27,49,31,11,56,18,62,152,26,54,10,11,27,6,34,16,1,6,41,5,24,58,130,34,47,10,9,18,25,28,39,56,15,73,26,11,6,116,69,19,23,54,14,20,50,74,17,26,56,1,5,12,37,15,5,7,21,11,57,24,6,30,32,17,25,35,15,284,12,15,13,11,11,35,17,20,7,120,18,3,25,22,12,21,22,18,17,6,12,27,18,3,18,77,12,14,42,62,36,1,9,28,12,58,7,19,8,7,18,57,16,52,16,21,72,22,9,94,23,55,17,116,15,37,60,8,43,6,24,22,5,13,29,61,19,6,14,22,27,33,20,12,15,72,77,30,37,16,26,5,46,39,9,17,14,32,75,60,21,22,42,13,10,85,10,32,33,12,39,10,30,10,27,14,7,29,12,121,10,65,27,16,53,15,22,48,13,68,19,42,46,47,32,106,8,56,9,33,10,5,14,25,14,11,15,52,15,17,26,10,21,32,19,12,31,10,13,14,14,40,22,12,4,8,19,22,30,25,6,2,14,31,12,5,48,19,12,30,21,16,35,13,18,37,15,49,11,47,9,15,19,111,13,11,25,11,36,48,55,48,65,11,21,35,30,11,4,45,11,3,9,12,31,20,31,38,15,24,15,13,17,31,15,11,21,12,8,126,64,19,19,17,10,7,23,16,21,17,8,6,6,10,32,15,18,12,8,3,8,18,12,29,23,24,23,6,16,16,36,8,19,15,7,30,11,24,51,23,11,7,15,16,13,18,37,82,21,10,6,5,16,18,23,16,29,22,6,43,6,7,58,15,19,47,6,9,46,37,9,25,17,27,30,18,22,55,74,24,8,17,10,24,18,15,18,7,24,4,17,19,35,13,10,12,20,7,26,43,63,18,3,32,10,8,13,82,56,37,3,7,12,30,38,14,34,10,0,33,47,21,13,34,12,30,6,13,12,19,2,10,35,7,8,10,20,30,44,12,36,38,33,11,10,20,9,10,14,13,9,11,42,20,32,2,10,28,280,40,14,15,7,14,38,43,31,14,23,5,16,23,41,9,9,6,27,26,10,25,7,86,37,30,12,6,20,5,8,10,53,26,19,16,10,26,20,2,17,18,49,28,30,15,24,10,7,17,22,20,10,14,7,10,22,39,17,3,9,13,9,8,44,30,31,16,11,16,8,18,8,17,30,7,10,10,6,3,27,11,26,9,12,10,3,25,21,55,9,13,12,9,20,25,11,18,22,14,13,29,3,6,7,4,17,20,15,7,5,3,38,7,4,27,29,26,10,11,16,12,8,8,19,7,28,22,8,25,19,12,11,15,13,24,12,9,22,18,20,26,11,7,6,17,20,10,16,10,10,18,22,22,19,25,10,40,12,47,11,8,15,7,16,3,12,16,21,11,19,14,6,35,13,7,5,18,12,16,11,10,6,12,7,13,14,21,47,16,8,19,9,4,13,10,11,10,20,18,26,63,39,7,6,8,5,8,8,12,6,15,8,5,10,7,17,10,11,18,33,4,8,6,21,9,11,9,37,52,17,2,9,9,18,9,17,26,3,19,15,23,11,10,14,17,10,17,15,6,16,10,15,4,35,6,4,14,21,1,43,7,11,15,13,15,10,3,8,11,7,30,19,4,10,5,11,24,51,12,7,13,17,19,2,11,4,6,8,12,11,5,16,3,7,6,11,17,13,26,15,1,15,4,7,7,6,6,11,19,17,6,9,6,1,4,21,4,2,8,13,16,15,22,24,9,16,8,11,13,8,1,7,7,13,6,5,18,13,42,8,6,13,12,8,11,7,7,10,4,10
exceed,7,4,4,117,7,2,2,22,0,0,5,5,4,28,3,0,3,12,1,2,3,40,4,13,13,12,3,8,8,30,6,139,95,6,24,26,17,18,19,5,12,0,2,4,25,7,38,12,189,8,24,1,8,17,4,0,94,56,0,12,7,4,1,13,8,2,73,5,2,10,117,8,5,4,26,10,12,4,71,17,107,3,17,4,161,26,17,0,92,8,10,4,0,34,61,34,18,11,21,10,11,20,37,1,2,24,25,1,39,21,40,6,6,14,0,30,7,11,57,133,39,5,50,256,1,5,2,1,9,4,9,0,3,61,12,25,1,4,4,20,1,16,26,5,0,41,1,19,31,39,22,0,9,9,1,18,13,4,1,1,9,1,8,9,7,2,7,6,22,3,13,53,8,3,1,3,110,4,4,14,13,3,0,7,7,13,30,9,22,40,7,4,13,0,1,2,19,1,30,12,26,3,2,6,25,5,0,21,11,16,44,3,17,20,1,1,10,3,20,2,36,9,9,13,40,81,53,53,13,34,6,32,39,21,31,140,21,4,10,0,63,23,6,6,6,7,3,26,35,12,13,23,5,1,20,18,13,15,12,28,0,10,26,2,9,73,0,1,15,2,140,35,237,3,3,0,1,112,13,2,42,1,2,7,12,5,2,5,1,0,5,0,30,26,11,4,51,3,5,13,9,23,8,8,6,0,3,2,0,1,2,11,35,1,71,29,11,24,12,4,18,5,15,1,14,6,4,18,7,21,5,14,1,3,4,17,8,3,10,24,11,3,10,7,13,5,32,21,14,1,22,12,3,21,13,9,2,3,10,79,15,4,9,14,4,0,31,0,3,5,3,12,5,8,6,28,4,2,6,26,67,1,36,9,2,37,0,23,39,2,5,1,16,6,15,18,41,10,29,4,8,4,7,0,11,8,5,1,20,5,0,5,52,11,0,3,4,3,0,0,2,1,10,4,0,5,4,7,8,14,40,53,41,17,1,4,0,0,8,2,4,20,2,12,3,3,3,2,28,22,13,5,0,4,49,4,0,5,2,18,7,11,18,16,5,3,13,4,5,0,5,0,7,3,1,7,4,11,16,0,5,9,3,1,8,4,24,1,1,8,42,55,0,0,11,4,6,29,8,4,22,10,14,1,5,32,9,9,2,2,18,0,5,1,23,16,3,6,2,8,2,11,6,14,2,5,2,5,15,26,7,5,1,8,8,9,10,4,28,18,1,2,1,6,9,1,2,25,11,3,16,8,6,53,2,5,13,4,6,2,17,8,15,1,8,24,11,0,31,22,15,7,34,1,4,8,8,7,5,52,12,12,14,5,7,3,5,7,7,6,9,18,8,10,10,1,13,3,18,10,14,0,0,0,4,19,4,11,1,22,30,13,6,4,23,18,19,1,5,6,22,23,5,43,9,8,1,9,7,21,21,15,10,25,3,4,6,16,4,5,9,3,3,26,6,73,1,2,3,85,5,3,9,3,1,13,37,4,1,16,8,1,6,5,1,5,1,4,13,13,9,6,28,14,6,3,7,13,5,3,4,13,6,4,2,21,8,2,8,13,9,2,20,18,8,11,7,3,28,11,1,4,3,3,10,10,16,8,11,2,1,24,9,12,16,12,4,6,3,7,2,1,2,16,1,3,16,3,0,6,9,20,19,1,5,23,17,8,22,18,5,3,3,6,4,8,22,7,3,8,3,89,27,64,45,15,7,11,10,77,69,10,10,21,18,59,11,4,9,5,2,2,0,9,3,11,19,5,3,9,0,4,7,15,4,3,14,8,26,13,3,16,7,8,8,10,2,9,11,2,5,9,13,2,1,2,6,2,13,4,52,2,3,15,5,0,5,2,1,17,0,33,1,18,3,4,2,8,15,6,23,6,12,0,0,6,9,24,6,1,3,2,5,5,5,12,4,0,6,3,4,26,3,16,1,2,3,20,2,1,2,3,7,2,2,3,3,2,3,11,2,1,17,14,3,6,0,11,4,0,1,5,5,2,10,4,2,5,1,9,0,5,0,2,1,2,3,0,14,0,11,2,2,2,2,6,0,32,18,8,9,45,5,91,12,33,6,3,5,3,8,3,8,22,2,3,1,4,1,18,3,2,4,7,2,18,12,16,3,17,4,17,59,51,15,45,25,127,193,4,8,3,3,5,6,39,29,7,41,2,25,8,13,5,6,17,7,8,7,5,1,7,4,2,6,2,5,9,5,4,21,1,18,23,2,18,5,1,0,0,1,3,17,1,1,14,2,4,1,0
extent,4,7,5,121,6,1,0,33,5,3,6,2,4,28,8,1,5,14,3,1,5,35,3,17,18,2,5,8,0,10,6,153,123,2,51,45,27,14,18,3,8,5,3,5,21,14,26,7,268,8,32,3,15,9,0,1,72,49,0,16,12,4,1,13,11,2,68,3,9,14,3,8,6,1,45,8,9,5,69,19,74,2,10,7,179,28,15,0,34,4,14,5,0,30,44,11,13,6,21,10,20,19,41,3,7,31,6,4,33,10,13,6,9,17,0,27,2,8,39,152,39,5,15,70,7,3,0,2,9,1,7,2,4,32,13,29,5,3,7,7,1,24,18,2,3,45,3,12,27,20,69,2,16,9,2,22,13,2,3,4,14,2,6,2,3,5,3,9,18,2,24,87,10,0,3,6,155,3,11,19,18,6,1,6,7,14,37,14,30,33,1,10,6,0,0,0,13,3,11,16,31,2,2,10,21,5,8,42,7,26,66,5,11,17,1,0,3,5,17,1,5,8,6,15,50,92,24,44,7,8,12,19,19,23,32,42,30,11,8,2,56,25,6,1,7,9,2,22,29,4,7,36,12,20,1,23,9,3,10,25,4,31,21,2,5,42,3,2,11,4,127,22,49,6,2,0,15,26,14,1,54,11,2,13,10,14,2,8,7,2,4,2,10,13,4,8,38,3,9,17,19,26,0,2,18,0,18,4,1,0,1,8,25,7,39,23,20,40,17,5,23,8,24,1,39,9,2,15,4,28,2,21,5,6,6,15,20,9,5,13,4,6,15,7,5,5,41,45,16,2,20,13,7,32,16,8,3,2,17,27,14,10,2,10,5,2,42,11,5,4,2,20,14,8,6,34,8,8,13,14,50,2,39,11,0,43,2,22,25,3,18,2,11,3,41,7,73,8,16,3,26,9,5,0,4,11,4,1,22,3,1,14,11,11,5,5,4,7,1,2,3,6,13,1,2,6,6,13,12,16,31,9,9,6,3,7,0,4,7,2,10,20,8,26,2,8,5,1,19,7,21,6,1,10,64,9,0,8,6,31,6,10,30,17,7,0,23,6,11,0,3,4,4,0,2,3,2,11,11,5,3,6,3,1,6,4,15,0,3,2,63,41,0,0,13,8,8,14,13,14,22,4,6,2,14,71,3,9,8,7,11,7,6,7,18,18,5,10,4,8,3,17,15,18,8,3,22,12,13,29,9,3,0,8,6,14,10,2,20,19,3,1,1,10,11,10,4,27,20,7,37,8,7,54,13,16,28,6,6,6,30,5,12,3,19,21,13,8,31,30,16,13,13,1,6,14,21,5,7,42,9,13,12,13,10,1,12,10,15,12,22,33,10,8,16,6,7,4,26,8,19,5,9,0,3,20,4,25,6,21,23,18,7,3,17,16,35,5,7,5,14,16,7,19,4,14,6,7,23,25,24,24,22,23,9,1,4,34,3,12,8,1,5,29,6,41,6,3,5,129,21,3,13,5,10,6,41,13,2,12,6,10,9,16,8,0,1,7,10,12,24,17,49,13,22,5,6,11,2,15,18,26,19,7,5,8,9,3,20,42,4,1,28,31,2,12,10,3,13,18,5,7,4,5,15,9,15,10,4,4,5,9,10,24,22,29,3,6,3,7,5,0,6,26,4,8,9,3,1,13,12,15,9,2,6,4,24,7,59,13,9,11,7,9,18,9,17,2,11,7,15,9,8,20,12,13,13,16,5,27,33,7,1,5,16,23,4,9,12,5,11,6,2,8,10,17,25,4,15,16,5,8,15,6,7,8,6,28,28,19,8,13,6,8,10,15,4,18,7,5,8,6,15,5,4,1,6,5,13,8,18,1,13,10,8,6,7,4,4,18,3,8,0,12,29,4,1,4,19,6,4,12,15,4,10,14,12,18,18,5,2,5,2,2,13,14,13,2,11,4,4,21,2,15,2,6,4,14,6,0,11,4,9,3,7,11,7,1,11,17,6,4,11,38,2,10,3,18,3,4,3,5,5,1,12,3,4,5,2,6,2,20,1,3,9,2,12,1,4,0,3,8,3,6,4,6,4,10,3,13,6,8,6,13,9,3,3,2,3,6,16,8,7,15,2,7,9,10,3,13,6,2,7,11,9,9,6,11,6,12,3,6,19,8,17,23,23,51,47,4,10,4,4,7,7,13,75,17,20,4,21,18,7,5,1,11,11,1,3,8,8,8,5,2,4,1,3,8,16,1,19,10,9,20,5,6,12,4,14,0,4,1,10,0,0,7,1,11,1,0
think,8,40,14,204,9,30,6,44,4,8,20,15,16,106,4,12,6,27,24,11,2,57,31,76,34,30,23,41,16,26,15,270,173,18,97,120,55,11,20,3,15,15,6,8,76,16,46,23,350,49,84,7,20,92,32,9,91,31,20,19,16,16,6,13,49,15,177,16,19,27,30,10,13,14,111,34,55,7,116,46,61,5,20,14,242,44,19,5,53,2,14,15,3,22,87,18,28,2,44,22,8,38,50,32,20,40,21,19,25,9,30,11,17,20,18,53,5,11,114,291,61,48,40,137,20,14,4,10,7,6,30,6,13,81,37,77,25,14,17,24,12,67,48,8,10,100,12,22,20,18,105,11,24,16,5,19,55,13,20,41,23,8,16,4,6,32,8,19,35,12,21,130,43,8,6,14,214,7,28,64,37,14,18,31,12,32,72,43,46,79,8,14,12,6,11,8,43,13,8,29,52,7,10,16,43,14,10,61,21,37,120,31,44,15,20,48,10,11,21,1,5,31,6,15,69,123,31,53,11,8,30,28,31,44,38,37,55,12,9,8,109,59,11,12,28,22,15,48,53,7,18,30,37,18,23,1,13,8,8,25,6,33,43,5,11,45,20,12,32,11,206,12,27,16,6,4,21,28,16,3,111,15,7,28,12,4,24,26,27,7,1,5,27,4,3,16,33,7,12,37,30,39,5,4,28,3,31,11,14,5,3,13,43,13,62,16,29,44,15,9,55,15,59,17,92,3,20,105,9,31,7,21,17,8,9,27,29,6,3,22,16,14,26,18,9,9,50,80,22,25,24,18,12,59,41,13,11,9,28,49,29,13,15,31,10,2,74,15,14,29,4,21,8,15,25,35,15,9,24,10,110,4,79,25,15,44,12,20,49,9,22,5,23,26,59,28,100,17,28,2,29,7,7,3,7,5,10,5,54,23,9,12,15,17,5,15,5,20,9,5,10,5,33,20,4,5,4,25,18,21,29,7,4,22,7,4,2,18,17,8,10,13,9,16,1,4,14,9,34,8,25,9,10,11,69,12,5,8,13,48,22,42,49,51,8,5,21,25,16,7,33,13,7,8,15,22,7,19,28,8,16,21,6,8,4,9,31,9,9,5,111,53,8,10,17,5,4,25,12,20,11,18,7,4,12,51,14,23,9,12,8,7,13,8,18,24,8,16,5,21,8,16,19,30,10,7,40,10,18,48,15,12,9,12,12,9,65,27,42,34,14,3,4,18,12,26,4,26,22,7,48,12,6,55,7,16,39,14,9,7,47,11,31,5,34,31,22,4,54,40,11,8,20,5,8,17,20,10,23,25,13,13,21,33,17,6,9,14,6,27,25,54,18,4,27,11,6,14,50,25,43,4,12,12,5,39,10,40,14,10,46,21,16,3,47,5,28,3,10,13,25,11,8,42,4,9,15,22,11,45,30,39,37,37,15,5,23,12,9,22,15,5,22,22,10,36,6,6,6,190,19,14,24,7,9,17,31,21,7,23,10,10,35,25,16,11,9,6,20,15,16,14,35,31,27,5,5,15,2,6,25,44,25,11,14,10,14,12,4,13,28,19,27,13,10,11,13,11,18,17,9,6,9,11,18,11,28,16,3,6,2,3,9,40,23,25,7,11,12,15,14,5,5,40,3,8,17,6,12,18,11,18,12,14,8,6,29,3,31,8,13,11,8,24,24,9,18,9,11,10,15,7,2,14,9,15,10,18,5,14,24,18,6,14,25,24,19,12,8,15,7,4,7,24,3,24,20,3,14,17,14,7,19,9,13,11,13,12,15,19,12,23,5,6,18,46,4,5,7,5,9,8,10,11,21,13,13,12,28,11,15,3,14,10,8,10,3,28,7,12,5,9,6,12,14,14,10,9,26,6,12,15,23,7,11,12,26,50,15,15,11,11,8,13,11,13,17,11,23,16,49,32,16,10,2,2,7,9,3,4,33,6,4,5,5,18,7,9,13,13,3,7,17,33,3,6,10,20,20,4,3,12,5,6,10,7,10,4,12,11,4,20,5,6,4,5,7,9,9,23,18,9,3,9,12,3,1,27,5,31,2,8,8,13,22,4,2,7,13,5,18,6,4,17,3,12,9,19,8,19,12,9,12,9,6,6,6,9,5,19,6,16,4,9,16,25,35,15,65,11,4,10,5,5,12,1,3,6,29,7,5,7,4,5,6,18,8,6,3,4,7,11,7,3,12,10,3,18,17,1,4,9,6,34,10,6,18,7,12,7,4,4,5,7,0,10,17,13,5,14
occur,2,26,7,142,6,3,4,39,1,5,32,5,3,40,4,11,8,8,4,5,7,48,4,18,22,11,9,8,4,16,13,144,124,9,37,30,55,5,13,6,0,6,4,1,36,18,22,10,276,12,41,2,13,23,4,6,58,26,0,16,32,10,5,5,27,6,75,6,9,17,14,6,7,3,58,2,15,10,76,17,47,6,14,4,227,18,16,0,36,1,4,6,3,25,42,12,7,10,42,13,7,27,47,7,10,40,5,4,15,6,21,4,7,11,2,29,10,4,76,139,36,15,8,63,6,0,1,9,3,1,7,4,12,33,20,15,11,8,5,7,1,29,45,6,2,64,2,15,12,11,61,0,10,10,5,22,20,5,13,3,7,3,8,3,5,3,5,20,30,14,22,67,14,0,2,25,148,1,10,27,17,20,1,15,0,14,28,15,39,56,3,4,1,0,1,4,14,3,9,12,29,4,9,8,34,6,4,35,9,17,54,3,18,5,4,0,3,3,12,0,1,14,7,12,47,84,23,19,5,5,11,14,9,21,28,27,36,4,3,8,62,20,3,3,12,5,5,15,32,6,15,17,15,13,9,13,1,6,10,21,3,26,26,6,4,44,2,4,8,8,146,8,30,5,6,0,23,8,20,2,51,3,8,25,11,2,6,11,38,1,9,4,19,5,4,7,56,7,5,20,31,17,1,4,20,0,9,5,1,2,5,7,31,3,30,17,7,42,10,4,59,9,23,3,55,7,2,15,6,23,6,16,9,3,8,18,14,15,2,15,17,13,9,10,6,1,46,48,12,2,8,13,2,36,21,2,5,5,11,26,6,2,8,15,4,2,41,11,1,8,2,6,4,5,14,31,10,4,14,10,46,1,28,10,2,25,5,29,30,3,21,4,16,7,30,14,64,6,30,6,16,2,4,0,14,5,8,4,19,12,4,8,2,24,13,8,4,11,2,2,0,5,17,15,1,7,4,18,31,22,27,13,4,21,0,6,0,11,6,6,11,17,4,7,0,2,1,12,36,8,7,7,2,3,38,3,0,6,11,33,9,21,29,30,5,4,11,14,4,2,19,7,0,0,1,7,2,21,16,1,9,16,4,5,9,8,9,6,5,3,88,45,2,6,8,4,2,20,8,8,5,6,2,0,9,41,1,13,7,4,3,6,6,3,14,15,2,8,0,6,4,25,6,20,10,5,29,4,26,27,13,6,6,7,12,5,14,5,32,16,2,3,2,1,7,8,24,32,17,10,35,8,1,32,7,9,25,2,6,9,30,5,15,3,16,22,19,6,24,27,14,11,14,4,7,8,6,7,4,11,6,16,10,13,11,7,6,9,2,5,19,37,8,3,11,5,3,2,48,17,15,0,4,8,10,18,6,44,4,7,32,14,16,6,43,8,15,2,12,3,18,5,3,18,2,5,7,9,17,19,10,38,15,23,8,6,3,5,5,14,4,1,7,19,13,28,9,6,3,141,16,4,9,0,6,13,48,9,5,16,8,5,12,15,6,9,2,15,20,11,24,10,81,24,20,5,4,8,11,6,4,17,35,8,11,12,12,6,2,9,11,7,22,9,12,6,18,2,11,8,7,4,8,16,8,6,25,7,1,6,4,15,6,22,14,34,19,12,3,8,16,6,9,27,8,5,7,6,5,15,5,17,7,2,3,3,16,11,43,8,15,3,2,11,6,3,21,6,6,13,13,10,5,17,7,10,9,11,2,11,10,13,7,2,13,19,13,12,3,15,2,4,0,13,3,14,8,3,24,13,9,4,14,7,6,7,8,27,6,17,7,7,1,9,17,9,2,4,9,5,3,8,11,1,2,3,14,8,14,14,8,4,11,6,4,3,4,5,3,5,11,7,4,9,6,9,4,3,12,0,7,7,14,5,13,10,14,34,7,7,11,12,8,2,20,5,3,4,3,13,21,29,7,4,1,6,11,10,8,3,6,4,8,1,9,10,5,6,11,18,2,2,4,13,14,10,1,20,15,3,4,6,6,6,7,5,5,7,16,7,7,4,0,12,14,15,6,10,8,2,11,5,5,19,16,13,6,20,7,13,11,12,7,7,8,8,2,6,2,3,7,8,6,7,5,6,7,31,9,17,4,2,9,13,5,4,3,4,3,13,1,17,5,1,11,22,5,7,40,13,12,3,5,5,7,5,3,6,22,9,3,6,4,2,3,19,6,2,1,4,5,5,3,2,9,7,2,11,7,8,0,6,10,10,6,1,8,0,28,2,1,2,10,1,0,4,0,4,2,1
5,0,10,2,66,1,11,0,4,1,6,3,4,11,18,1,1,2,6,5,0,1,21,8,16,4,10,0,11,3,15,6,88,16,7,20,19,12,5,9,4,5,0,0,7,12,9,26,12,84,24,10,1,2,17,22,0,23,13,9,6,8,5,2,5,15,4,36,17,2,4,84,0,2,1,21,5,11,0,41,7,60,10,2,4,75,11,7,4,32,21,15,5,49,17,50,27,4,1,15,2,5,7,9,3,24,11,29,10,22,8,9,2,6,11,9,16,14,6,48,52,9,25,22,166,9,1,3,1,5,18,1,3,3,26,2,17,2,2,0,10,1,11,17,2,2,30,2,12,2,7,8,2,1,4,3,20,8,9,4,17,12,1,8,29,52,7,1,8,8,2,7,17,6,3,1,1,32,0,4,21,5,3,19,6,1,8,18,3,7,24,1,0,2,3,8,0,17,1,10,3,7,5,7,2,6,5,1,5,5,6,22,3,7,10,1,3,9,23,7,6,6,14,3,4,16,18,4,20,2,24,6,11,29,10,9,11,10,4,10,0,16,13,6,3,8,14,5,13,22,12,4,7,5,15,3,8,6,1,1,15,3,14,11,2,3,31,12,3,4,4,38,23,28,6,0,5,9,13,7,2,13,1,7,4,14,0,17,13,3,0,16,2,14,21,30,3,15,5,0,5,4,27,7,30,3,0,5,0,1,2,1,2,26,6,51,10,5,13,4,0,8,1,10,8,8,1,3,8,1,14,1,6,2,1,1,3,4,1,1,8,1,6,4,5,6,0,12,5,12,7,2,5,1,10,3,5,1,5,4,10,7,5,6,5,0,9,8,5,1,5,2,8,2,4,0,10,0,3,4,0,21,1,14,5,3,12,0,12,10,2,1,2,3,2,4,7,14,4,13,3,4,0,2,1,6,0,0,1,12,2,0,0,1,3,2,1,2,0,0,2,1,3,8,2,1,0,0,4,1,7,14,15,2,19,2,2,2,2,8,2,0,0,7,1,1,1,4,1,5,3,4,1,0,6,11,0,0,2,1,8,5,15,2,6,4,1,9,4,4,0,6,0,1,1,2,0,1,3,6,3,2,3,1,2,3,0,8,1,0,1,34,9,0,2,9,2,0,6,2,1,4,5,2,7,5,17,4,5,3,0,2,1,0,0,4,2,2,1,0,5,2,6,2,3,3,0,4,4,4,12,4,2,1,1,2,2,1,1,13,2,1,0,1,1,3,2,18,5,1,3,5,3,6,17,3,0,5,3,2,1,10,0,21,0,5,4,1,1,4,2,4,2,8,0,3,3,13,5,0,14,2,6,4,1,5,2,2,2,1,3,8,4,3,1,7,1,1,5,7,1,2,1,2,2,0,5,1,7,0,4,8,8,3,3,6,6,1,0,0,1,5,6,2,17,3,1,4,5,2,6,12,4,13,3,1,2,2,7,1,2,0,1,2,6,3,15,2,4,0,52,2,0,3,3,1,5,13,1,1,4,1,0,6,0,1,4,2,0,2,5,2,1,0,2,5,1,2,6,5,0,1,6,3,1,0,6,3,2,2,1,9,6,2,0,5,7,2,1,6,1,2,2,4,4,0,2,6,6,2,0,0,18,0,9,2,6,3,1,0,3,1,0,0,6,0,0,1,0,1,2,2,8,7,1,3,1,6,1,2,3,3,0,2,8,6,2,15,6,3,2,1,6,4,16,11,3,2,3,1,67,87,6,8,28,7,8,3,3,1,3,1,1,5,2,1,2,5,2,2,2,0,1,5,19,5,4,8,6,8,7,3,0,0,3,1,4,1,3,1,0,0,4,1,1,0,2,1,3,2,0,6,0,7,5,0,1,0,3,1,2,1,2,8,9,2,1,0,6,7,2,5,1,1,0,1,0,0,7,2,3,1,1,0,4,3,10,4,2,2,1,2,9,1,2,5,1,0,5,2,3,7,2,2,5,0,2,2,0,2,8,3,9,23,10,1,0,3,1,1,0,5,3,3,0,2,0,0,0,0,2,3,1,3,0,0,12,0,0,5,9,4,0,2,0,0,10,1,13,2,2,6,21,5,16,2,10,0,0,4,4,2,4,1,1,0,1,0,0,0,4,3,6,2,2,2,0,0,3,0,2,3,20,4,13,7,14,15,14,41,0,4,1,2,6,3,12,3,0,22,1,2,2,2,0,16,13,0,1,0,0,4,1,7,6,3,0,2,2,0,0,2,3,0,9,1,3,3,4,5,2,1,6,1,5,1,8,3,1,0,1
anticipate,2,12,3,57,5,1,2,13,0,1,8,5,2,16,2,1,4,6,0,4,4,17,2,9,5,7,4,3,0,4,2,79,61,4,12,20,16,5,7,1,1,4,5,2,11,10,11,4,130,2,25,1,6,8,0,0,40,13,0,6,14,3,1,2,8,0,29,2,3,1,36,1,2,0,32,5,5,1,24,7,38,2,10,1,89,9,2,1,23,2,8,0,0,17,29,6,5,1,15,5,3,17,24,2,4,11,12,1,5,3,6,5,4,4,0,23,4,3,37,56,15,2,0,46,7,0,1,1,1,1,6,0,0,18,4,7,3,2,3,2,0,10,9,3,1,20,3,7,12,7,30,0,11,5,1,14,13,0,1,1,6,0,2,0,2,1,2,7,11,5,6,20,4,0,0,9,67,3,4,15,5,3,2,8,1,7,14,10,14,30,0,0,3,0,0,1,9,3,3,4,11,0,1,7,8,6,2,13,2,11,21,4,10,3,1,0,1,5,6,0,4,11,3,5,20,34,9,13,0,26,5,14,13,7,12,28,22,1,3,4,22,12,1,2,3,4,4,8,18,3,1,11,7,12,10,8,10,1,1,8,1,9,9,0,7,15,0,0,5,1,61,14,31,3,1,0,5,26,7,2,22,1,0,5,4,1,2,1,5,1,5,1,2,5,7,3,22,2,4,5,10,10,3,4,5,1,5,1,0,0,3,5,17,0,12,14,6,27,4,0,22,3,12,0,18,2,5,13,0,5,0,2,5,2,2,5,6,7,9,13,2,2,9,3,2,1,21,29,5,1,10,8,2,17,7,7,0,2,7,13,6,2,0,8,2,0,21,1,1,5,2,5,3,2,0,17,5,1,9,3,25,0,10,5,0,9,1,7,16,1,8,4,4,7,18,1,26,3,5,2,10,0,2,0,4,1,5,2,11,2,2,2,1,5,4,5,4,0,1,0,4,3,8,7,0,3,1,11,7,4,17,13,5,5,0,4,2,7,0,2,5,7,3,6,0,1,1,2,15,6,4,2,2,1,32,3,0,3,2,15,1,6,12,9,8,3,7,1,2,0,6,0,0,0,1,1,0,7,5,0,2,2,1,2,8,6,4,1,3,2,29,11,0,2,4,1,2,7,5,1,3,0,1,0,3,22,0,3,2,1,3,2,2,1,6,10,3,6,0,5,1,7,6,5,8,1,14,4,14,13,6,0,1,1,4,2,4,0,10,7,1,0,0,2,5,5,1,7,11,8,20,2,5,14,1,4,18,1,2,2,12,3,7,3,11,8,9,3,14,16,7,7,9,0,1,4,6,3,3,10,3,5,4,11,5,1,3,5,2,1,12,17,5,4,11,0,2,3,36,6,9,0,2,3,0,10,1,6,1,6,13,7,2,3,15,1,20,0,6,4,9,7,2,11,0,5,2,4,6,12,10,10,10,6,4,1,0,7,2,7,2,1,0,11,6,13,5,4,2,71,18,1,2,1,3,8,12,1,0,3,2,4,3,14,3,5,6,7,10,9,8,4,32,7,11,4,2,10,1,6,1,11,12,4,8,8,6,1,3,8,10,2,6,2,2,4,8,2,8,9,3,4,2,2,6,2,14,0,1,3,4,9,2,8,5,10,5,4,8,2,4,2,7,12,1,1,4,1,1,2,3,7,0,1,3,3,3,6,13,3,3,1,0,3,6,2,5,6,3,3,4,15,15,11,6,10,3,5,4,10,10,7,4,3,6,7,2,4,8,2,0,1,0,10,1,6,8,3,5,5,1,0,3,7,3,5,1,3,2,9,5,2,1,0,1,9,0,1,4,1,2,2,4,1,5,0,5,2,18,2,6,0,2,4,4,6,2,2,1,5,4,5,4,1,3,5,1,5,1,4,4,6,6,0,2,7,4,9,3,3,8,2,1,12,6,4,5,5,1,5,9,13,2,6,0,3,3,7,3,1,7,0,2,2,2,5,1,2,3,5,0,0,14,4,3,5,1,9,8,0,2,4,1,1,6,5,5,2,4,9,2,3,0,2,1,2,3,0,2,0,4,2,1,1,6,5,1,4,7,5,1,11,3,9,6,5,2,4,3,4,3,4,1,4,3,2,6,9,4,3,2,0,6,2,1,1,3,4,2,5,1,1,11,8,7,12,8,27,36,5,0,2,0,3,3,10,0,0,9,5,0,2,5,3,0,6,2,0,0,2,1,1,3,0,4,3,2,6,7,1,6,4,5,7,4,0,4,3,15,1,1,1,5,0,0,2,0,1,1,0
number,4,42,23,227,10,18,12,55,6,18,11,26,19,90,6,9,7,33,16,9,4,67,27,49,32,34,20,31,9,46,44,332,231,32,103,80,67,17,26,18,7,22,8,16,60,17,33,36,411,31,61,11,17,50,27,9,90,112,8,38,16,7,4,19,36,7,148,25,8,45,58,9,10,4,151,19,38,3,179,38,356,6,26,18,249,50,29,5,107,7,26,11,19,47,54,31,41,27,83,36,35,51,49,18,35,55,30,20,70,35,33,11,30,23,19,63,14,8,117,245,79,54,30,384,19,2,6,5,20,11,16,8,24,104,35,98,6,27,1,26,6,74,73,13,5,115,9,52,40,46,79,4,40,9,20,40,84,12,10,35,59,2,37,14,15,26,26,40,59,15,53,167,46,5,7,11,251,13,18,105,39,14,20,45,9,45,75,33,46,89,10,7,15,8,14,2,28,12,50,12,41,25,7,18,48,3,14,54,9,43,130,25,45,17,10,15,3,11,54,8,8,29,15,45,80,227,98,89,28,22,31,55,86,28,46,48,59,16,13,10,104,56,28,11,16,28,17,61,145,23,13,53,21,28,25,25,21,15,8,1,30,58,32,9,9,117,26,9,20,8,220,20,107,15,4,6,30,37,14,5,94,11,9,34,34,12,23,37,21,5,23,7,29,32,17,11,72,6,8,31,25,64,25,18,22,2,27,13,4,5,5,30,46,19,103,67,31,73,23,7,53,13,47,45,55,3,26,37,3,55,24,32,8,11,12,30,22,11,7,18,11,27,31,12,18,8,64,62,23,32,18,21,8,80,21,11,12,9,21,89,48,25,13,31,10,8,37,30,17,27,9,42,6,22,24,142,22,11,17,8,96,5,83,13,25,73,11,27,42,6,22,10,30,19,44,15,60,9,60,16,15,4,16,6,17,18,15,4,20,20,7,21,14,48,11,14,10,11,3,7,11,21,36,20,10,13,12,15,23,32,10,28,15,42,11,4,5,18,19,19,47,34,10,12,1,9,35,9,55,27,11,20,5,1,86,18,1,10,19,32,21,45,63,160,28,18,42,22,12,3,51,10,10,8,8,38,6,15,59,22,10,19,3,2,15,13,29,9,8,11,217,68,5,5,22,13,14,31,11,20,18,29,14,3,36,26,17,14,27,3,26,7,16,9,24,14,7,16,7,15,11,54,9,33,13,22,22,12,21,33,15,14,19,14,23,22,8,11,75,23,10,7,9,37,21,8,20,27,19,18,57,10,17,101,14,20,37,8,10,14,22,9,56,12,9,33,24,11,62,53,21,15,36,7,14,2,13,15,12,68,29,13,23,29,6,12,28,10,5,31,25,42,35,18,57,11,15,17,41,18,32,14,10,2,17,39,22,27,16,12,54,47,19,13,70,14,28,7,9,6,15,2,12,36,4,16,3,19,16,65,13,61,38,37,31,1,26,19,16,66,32,13,25,38,15,84,28,9,13,228,29,10,13,7,8,46,58,16,8,36,5,14,13,14,7,3,11,22,18,12,44,7,33,39,54,10,7,14,12,9,12,45,9,16,16,14,16,8,14,26,20,17,29,16,5,22,6,3,14,16,6,9,8,25,17,13,15,11,7,3,9,49,4,38,41,160,35,9,11,36,20,14,17,122,13,20,20,10,13,22,15,35,13,21,11,30,122,18,73,53,19,13,21,48,40,12,72,20,11,14,17,7,38,74,53,20,17,23,13,85,85,25,12,37,34,62,39,12,32,23,17,5,13,73,12,22,10,5,47,14,18,13,26,16,38,18,6,19,23,25,9,42,11,12,33,21,6,24,10,11,6,19,20,15,2,5,9,12,36,13,8,3,20,11,9,3,12,14,6,16,5,28,16,30,19,2,4,13,6,12,24,13,9,7,17,13,13,35,10,7,6,10,9,10,9,16,8,9,8,10,19,39,16,7,7,14,12,18,18,7,11,4,14,9,12,15,6,6,9,33,19,6,12,11,10,9,0,6,11,26,7,25,10,6,24,8,8,6,19,11,11,21,8,8,8,18,13,5,39,23,18,7,8,11,24,25,6,6,6,26,8,8,10,21,24,14,19,9,13,13,8,12,21,15,6,8,7,5,4,16,7,2,7,15,12,17,11,14,4,24,10,21,49,5,16,22,15,62,37,5,50,11,28,19,13,25,34,9,45,4,16,9,9,15,17,90,17,74,11,16,24,2,9,11,11,6,16,4,14,18,32,18,11,8,13,15,8,12,17,5,9,10,21,1,16,19,9,7,3,3
employee,0,15,5,97,0,6,2,16,0,5,1,3,1,21,0,9,2,9,3,1,0,27,3,23,41,13,5,10,3,7,0,125,44,18,45,21,5,5,7,2,5,2,0,8,9,11,20,14,64,6,22,3,2,2,6,0,22,19,7,5,11,0,2,5,16,4,24,18,4,13,18,3,7,1,71,1,11,4,14,26,56,0,4,1,120,15,4,0,11,2,6,2,10,5,46,21,12,11,13,35,6,10,10,7,12,24,5,8,18,3,10,4,9,11,7,11,4,3,48,81,37,10,4,59,8,2,3,0,4,5,1,1,2,36,8,90,8,5,2,3,7,13,10,1,1,30,1,9,19,6,42,4,7,1,2,37,16,2,0,8,20,0,9,1,2,16,5,21,18,2,3,55,14,4,5,6,112,0,5,48,30,2,3,14,7,26,25,22,20,16,2,3,4,0,5,1,17,6,3,9,33,6,2,8,8,8,0,29,3,7,53,2,26,9,2,7,0,0,15,0,3,14,1,11,28,105,25,11,2,6,7,10,31,16,14,9,11,7,6,2,31,19,4,7,5,2,2,13,50,3,7,9,11,0,4,6,3,3,1,30,1,9,3,1,1,45,6,1,3,4,42,3,5,11,0,2,15,12,6,4,45,8,0,13,8,0,16,17,10,7,2,1,11,4,1,3,24,4,6,22,10,19,6,0,15,4,8,8,3,2,3,23,7,7,41,16,17,27,9,4,5,0,18,0,37,6,7,12,0,13,0,18,8,6,5,5,15,6,1,0,2,2,5,3,3,1,15,16,6,18,15,1,0,29,7,7,1,3,7,16,48,10,1,12,0,3,6,7,10,13,1,8,2,11,17,78,3,3,5,1,30,4,29,9,10,9,4,11,8,4,20,5,4,5,4,0,25,7,17,2,15,1,1,1,2,1,9,0,4,3,3,0,1,11,0,2,1,2,2,0,12,13,20,3,5,6,3,14,6,12,2,7,0,5,3,0,0,0,1,2,27,18,6,5,0,0,2,2,20,6,18,5,3,0,27,6,0,4,19,14,12,11,23,36,6,4,4,5,4,4,26,4,2,2,4,30,0,14,12,7,1,7,0,7,1,3,11,0,2,13,11,17,0,0,0,7,1,9,3,4,3,6,6,13,17,3,2,7,2,7,5,5,1,4,8,2,5,4,16,2,3,7,3,20,8,0,25,17,10,7,3,5,2,8,11,5,6,6,14,53,3,0,17,8,4,0,0,6,6,11,1,0,13,13,6,16,26,4,7,7,5,8,18,5,2,9,7,6,14,29,6,0,14,4,4,0,6,3,2,20,5,4,8,4,3,3,6,2,2,5,19,13,14,6,68,0,8,27,1,4,13,1,1,0,7,14,1,21,13,3,16,40,9,0,24,0,5,2,5,3,6,0,6,8,0,7,1,2,4,10,0,20,20,9,11,7,15,8,6,19,7,2,6,4,3,4,23,5,17,37,19,1,1,7,4,1,9,7,3,2,9,0,0,2,1,0,2,1,0,0,8,1,0,16,5,2,1,8,5,1,6,11,1,3,4,5,5,5,0,0,10,6,3,0,3,4,1,1,5,0,4,6,5,8,17,0,6,2,2,0,2,5,1,12,11,4,1,2,1,13,0,3,0,23,15,2,5,4,4,8,12,13,0,4,0,2,0,5,0,1,11,0,2,5,0,2,6,1,5,4,5,1,4,9,15,7,2,12,4,26,26,9,1,16,10,6,4,7,0,4,8,0,2,9,4,20,6,3,3,4,0,1,3,8,3,5,2,1,0,3,6,18,12,2,95,7,26,3,4,10,1,1,2,2,0,4,2,3,4,3,4,0,0,0,3,1,2,4,0,7,1,4,2,21,0,0,4,2,0,0,11,2,0,1,5,0,5,23,2,4,0,0,1,9,24,14,6,13,2,2,3,5,8,0,2,4,5,2,5,0,0,1,10,2,8,1,2,3,2,10,9,2,0,0,2,3,0,0,3,4,1,1,0,0,5,8,1,4,0,4,0,0,1,1,5,3,0,1,4,0,6,0,1,3,0,1,0,0,8,13,8,1,3,1,2,3,3,0,11,1,0,6,1,3,2,0,0,2,4,2,4,1,1,5,1,1,2,1,3,11,2,5,5,0,0,12,0,8,10,0,0,0,3,3,3,0,0,0,5,0,0,0,2,38,4,7,0,8,5,0,0,1,4,10,3,0,7,1,10,1,5,2,2,0,2,2,1,2,0,1,3,0,0,0,0,1,12,0,0,0
force,25,55,20,284,32,37,3,71,14,10,44,19,53,270,10,21,31,28,19,19,12,105,78,75,30,42,81,63,42,82,88,414,313,79,122,294,217,13,24,39,24,59,16,30,95,45,55,31,635,172,154,41,32,222,15,28,121,55,48,58,38,33,5,30,53,32,202,8,20,51,36,18,21,13,287,33,77,20,211,83,158,6,49,35,394,28,45,9,97,8,52,32,12,129,96,12,56,10,146,17,16,72,54,44,27,103,22,18,49,11,59,14,25,44,17,93,24,12,175,402,97,118,17,198,22,34,25,8,27,7,55,18,24,119,88,177,18,11,43,24,21,105,68,8,14,259,23,42,47,25,168,7,42,22,15,38,110,20,37,90,19,7,23,21,12,42,35,69,49,25,54,261,47,12,38,26,302,13,20,119,61,39,38,85,11,50,88,55,62,142,18,13,9,13,8,9,45,28,22,29,40,5,6,28,102,28,18,57,30,71,186,47,56,44,18,24,6,37,48,5,17,47,11,46,121,235,59,71,34,14,24,45,69,35,95,18,68,28,16,31,178,76,21,22,51,13,16,117,113,14,18,45,57,10,31,33,26,14,9,58,9,1,35,9,14,77,16,73,51,17,317,10,41,17,7,12,91,11,19,7,154,11,9,36,20,9,29,39,42,8,29,23,28,14,13,26,77,19,23,43,79,56,4,17,17,13,68,6,13,11,10,32,98,42,61,56,33,78,29,16,109,20,94,21,180,16,17,120,10,69,28,32,20,11,18,20,79,23,1,41,30,54,51,31,26,26,75,115,46,43,33,15,15,104,55,15,10,16,37,103,28,21,20,47,4,15,96,36,34,79,15,119,13,45,18,106,24,4,40,9,143,13,142,32,54,109,21,65,82,10,85,25,20,17,51,34,97,16,137,14,40,38,16,27,16,11,25,6,65,37,5,22,27,44,32,58,27,38,18,69,12,50,52,47,14,13,16,17,51,43,19,30,8,59,25,21,25,44,86,16,46,44,18,62,13,15,67,31,60,25,101,21,52,12,97,43,22,33,16,55,42,77,73,179,35,38,94,30,16,5,82,35,9,3,10,34,21,19,43,24,26,50,14,26,32,15,24,36,14,10,404,68,15,30,44,13,10,40,17,28,24,14,7,11,24,27,8,23,13,9,15,15,18,7,25,40,19,19,5,36,19,47,11,66,18,16,69,3,37,62,42,18,54,26,17,26,30,35,96,21,16,9,22,18,14,19,86,39,28,16,57,13,23,95,26,31,53,14,8,18,40,14,43,16,36,40,37,26,99,76,18,13,22,10,18,12,15,12,15,44,8,34,33,51,19,13,21,14,10,41,61,68,34,16,39,12,7,10,82,39,42,12,12,4,13,30,13,45,22,18,55,36,24,12,70,21,40,3,18,14,17,18,15,62,11,15,12,13,20,94,34,44,52,60,33,8,31,18,22,53,31,14,15,76,22,74,24,18,9,426,62,12,17,11,19,27,76,42,28,27,10,22,51,29,21,5,8,23,29,23,50,18,102,56,43,23,7,12,39,14,15,64,40,18,24,19,41,19,7,40,24,51,35,24,17,27,33,13,35,29,26,19,14,12,27,30,26,56,15,9,13,42,18,66,35,158,110,16,13,19,52,20,31,97,31,17,22,4,11,44,36,34,9,22,11,19,116,17,106,18,28,19,9,40,51,15,38,17,17,20,36,9,5,54,5,20,18,28,7,13,12,28,17,11,52,27,39,9,11,11,31,12,10,31,24,31,14,5,38,32,17,8,36,4,15,20,18,26,15,29,15,18,3,12,17,33,6,18,12,15,11,18,18,10,41,27,19,16,50,13,9,10,47,13,9,10,5,30,26,28,13,5,20,16,7,6,25,23,27,14,15,29,26,46,23,21,27,61,30,6,15,21,7,19,16,11,12,37,13,45,73,66,25,9,13,19,22,7,22,7,29,18,9,15,19,24,23,6,33,26,5,7,9,15,16,17,3,40,39,11,2,14,8,26,7,3,17,12,23,13,28,17,5,5,13,52,18,24,16,65,17,16,41,31,9,41,22,11,16,50,12,6,7,6,26,20,6,12,12,1,14,12,18,10,16,18,12,27,8,8,7,7,11,9,15,7,20,24,16,18,10,27,7,0,6,23,18,28,28,11,23,17,7,17,8,13,12,13,47,15,1,8,5,4,8,71,16,2,8,21,96,13,20,26,9,11,32,27,8,17,5,16,9,21,8,5,21,29,45,10,8,17,8,14,2,4,5,16,7,26
submit,7,46,22,486,21,4,14,67,12,1,58,17,13,85,11,17,23,14,11,5,5,82,10,35,50,20,8,24,4,31,19,365,168,13,79,54,49,14,11,13,5,7,5,12,49,39,90,31,661,19,82,6,15,26,12,8,92,153,3,26,45,15,8,21,23,4,144,7,17,23,14,19,5,6,79,37,13,4,111,29,61,7,35,5,407,13,19,6,102,1,20,11,9,54,82,14,25,8,42,25,27,42,79,11,13,73,19,9,20,5,54,18,16,27,5,48,13,13,161,277,62,10,17,123,11,3,6,12,6,6,16,2,3,107,26,67,15,2,17,8,4,48,65,6,3,91,3,27,17,27,102,1,21,17,7,55,27,12,25,8,16,7,8,6,6,9,7,30,31,19,37,92,27,2,3,16,301,7,21,53,50,20,24,15,11,21,52,30,122,120,2,6,5,0,3,6,59,11,19,19,31,8,0,34,43,15,6,40,34,58,97,10,46,10,1,5,19,58,34,11,11,26,10,22,87,162,37,61,6,10,18,32,24,47,42,29,65,9,8,5,126,45,14,7,17,21,17,30,107,9,35,24,24,26,21,43,26,11,9,32,3,35,1,15,14,104,13,6,29,5,312,20,83,8,8,5,23,43,39,19,61,14,3,33,4,9,13,18,29,1,30,20,35,28,9,27,105,20,18,37,32,73,5,11,23,2,13,20,9,7,8,13,59,5,47,43,21,89,8,11,71,13,22,7,111,17,8,27,10,44,23,14,12,12,7,28,32,17,11,16,22,15,25,15,11,13,92,80,29,7,22,24,15,42,41,3,12,9,28,53,47,14,12,25,11,2,82,11,16,9,12,22,22,7,15,44,15,5,19,14,159,3,96,31,2,54,12,23,51,11,36,6,21,99,94,26,173,24,61,3,45,8,9,1,14,11,11,2,32,18,3,21,2,18,14,17,34,11,3,4,7,14,47,23,2,7,6,28,22,29,32,22,17,38,6,10,2,66,18,9,35,43,15,26,1,7,7,13,57,11,23,14,1,19,123,14,0,19,12,60,30,24,40,21,7,7,13,26,16,0,14,2,8,0,4,4,8,34,20,4,9,13,9,6,5,41,15,3,6,6,107,86,4,5,13,12,4,44,21,11,18,8,7,0,15,32,3,30,21,5,9,16,18,12,28,49,8,13,8,11,4,25,21,31,11,13,22,10,34,41,8,8,6,15,26,9,45,10,66,31,14,12,4,2,9,25,1,49,36,17,111,16,18,65,18,13,43,7,18,12,134,7,59,7,32,36,24,7,70,59,21,29,59,3,9,59,9,15,3,40,1,38,19,15,30,10,7,19,11,17,61,68,25,16,21,8,6,1,174,36,50,2,8,28,26,56,9,91,11,12,41,67,36,11,72,18,35,2,23,10,34,12,11,63,9,7,19,29,14,47,25,71,78,44,12,7,13,12,6,16,13,2,19,38,27,106,10,27,13,370,40,10,19,16,16,27,71,20,10,30,13,14,107,77,36,53,41,30,17,23,38,8,68,82,106,11,8,35,9,5,18,60,33,32,32,18,23,13,5,24,59,13,43,23,26,20,16,25,28,54,4,20,17,11,17,25,35,14,7,21,10,32,8,52,30,36,2,13,27,11,10,9,7,53,0,16,14,4,9,17,10,19,11,11,12,18,37,4,85,7,13,9,7,18,24,11,25,11,2,15,16,21,19,33,25,34,12,25,6,13,12,21,15,13,38,14,14,10,6,32,3,3,3,21,13,39,9,6,48,20,18,13,24,5,19,10,18,56,16,33,16,16,19,11,15,30,16,33,5,11,18,9,24,21,12,6,16,5,19,15,7,4,19,22,7,13,18,29,11,23,9,11,23,44,19,13,5,31,20,15,21,12,26,11,8,18,22,37,12,16,16,32,11,52,17,8,8,42,29,12,39,62,12,11,18,10,7,14,12,5,16,9,16,4,10,16,6,35,12,61,6,13,12,12,10,5,22,24,35,13,26,18,13,13,61,13,15,13,4,15,8,43,0,5,18,34,8,31,5,2,16,24,8,15,39,8,7,39,6,34,17,4,13,28,26,13,9,11,11,13,26,22,9,37,11,22,14,36,11,19,22,17,18,13,6,7,14,9,17,24,9,14,30,3,13,35,17,68,99,10,14,6,5,8,16,15,9,6,54,6,9,20,16,11,5,19,11,4,16,7,10,17,7,7,26,13,6,22,28,14,18,15,11,24,16,6,19,6,24,0,6,2,10,6,1,7,1,15,3,3
february,22,43,8,109,3,1,5,10,7,3,17,19,3,16,1,0,6,8,1,1,2,23,2,21,9,3,5,4,2,27,5,100,43,3,18,9,8,12,3,2,1,2,1,3,13,6,11,5,225,10,7,4,1,7,1,1,24,21,3,3,6,2,0,6,5,0,11,2,4,11,9,2,2,1,14,4,3,4,48,4,13,0,1,2,115,8,8,0,59,3,11,0,1,12,14,3,11,3,12,1,13,6,17,2,3,19,2,1,7,2,17,5,2,7,1,17,14,1,89,46,9,11,2,54,3,1,1,0,4,6,0,2,1,19,4,9,1,3,0,1,0,11,26,2,2,38,5,3,3,14,33,1,12,1,0,9,3,1,10,1,2,2,3,16,3,0,2,9,5,1,12,30,5,0,0,4,79,1,0,14,4,4,1,6,0,5,9,3,21,39,1,5,3,0,0,2,10,2,3,2,4,0,0,7,10,3,17,12,13,5,34,2,27,2,1,1,2,3,4,0,2,12,4,6,25,54,9,12,4,12,4,13,13,7,10,3,11,5,2,2,23,14,4,0,2,2,4,3,37,1,8,1,6,2,2,5,6,2,0,9,1,9,15,1,7,33,1,2,3,2,41,4,36,0,3,0,5,7,9,3,9,0,0,3,4,1,0,0,1,0,13,16,32,5,8,3,28,15,6,5,5,18,5,8,5,0,5,3,0,1,0,3,10,1,27,10,3,22,7,1,28,2,7,0,19,4,2,15,5,14,7,0,3,4,2,11,2,8,6,16,5,10,6,3,2,3,22,24,8,3,10,1,1,13,8,0,3,3,7,17,4,0,5,9,2,0,20,4,2,2,0,2,0,2,0,11,6,1,0,1,24,0,18,7,1,14,2,8,18,0,12,2,18,20,18,0,35,3,18,0,11,0,2,0,3,0,2,3,5,3,0,2,4,5,4,2,5,1,1,2,0,3,12,5,0,2,2,4,8,11,16,14,5,30,1,4,0,13,2,3,6,3,3,6,0,2,1,3,14,5,3,6,4,1,26,5,0,13,2,14,7,11,11,7,2,1,2,6,5,0,4,2,2,0,2,2,0,10,10,0,1,4,1,1,3,9,4,2,3,4,22,28,2,0,2,1,2,9,1,2,2,1,2,0,8,15,3,11,6,0,2,1,6,1,2,16,1,3,1,5,0,9,2,12,6,9,11,4,12,10,4,0,2,4,6,2,6,2,21,7,3,8,2,1,2,3,17,9,14,5,21,6,4,22,2,0,10,1,2,1,13,6,23,3,8,5,3,4,19,14,1,3,18,2,8,3,7,0,3,7,2,11,5,3,2,3,2,1,0,1,6,11,9,1,6,0,1,0,64,4,15,0,2,11,11,7,4,9,0,2,12,23,13,1,21,5,7,2,3,2,2,2,0,32,2,3,3,3,4,14,19,8,1,9,7,0,3,2,0,4,4,0,6,16,5,22,2,16,6,165,13,1,0,1,7,8,15,9,2,10,1,6,31,16,24,16,8,5,6,6,7,2,32,55,20,3,1,9,11,3,5,15,5,6,3,1,2,1,3,6,14,4,10,7,11,11,6,2,1,15,6,6,6,1,6,7,7,1,6,8,1,22,5,13,7,16,4,3,6,2,11,3,2,14,1,4,2,0,0,1,0,9,3,0,5,0,17,0,23,0,7,9,1,5,10,0,11,0,4,6,5,1,2,27,13,6,6,5,2,9,8,4,13,25,13,5,14,3,3,15,0,1,0,14,1,5,0,1,3,3,0,3,4,4,2,1,2,17,1,6,4,17,2,0,4,4,1,7,4,1,6,1,7,6,1,2,2,3,7,4,3,2,5,9,1,6,2,3,4,1,4,7,15,10,4,0,3,20,10,5,7,1,1,5,2,2,3,7,4,4,5,4,3,8,0,5,5,17,3,4,11,19,7,0,1,5,0,8,5,2,2,0,5,2,0,4,4,6,5,10,1,1,21,2,1,3,8,17,10,1,5,14,4,3,11,4,2,4,0,3,1,12,0,1,4,30,1,8,10,0,1,4,2,8,8,13,8,15,4,7,0,4,2,16,5,10,5,3,4,4,4,5,3,6,13,8,4,9,5,3,6,3,3,9,0,1,1,2,5,3,2,7,8,4,1,12,4,3,26,2,6,4,1,0,5,5,1,0,19,2,10,6,4,1,10,14,0,4,2,2,1,2,5,1,10,2,2,2,1,0,0,0,5,5,5,0,1,1,22,0,1,1,1,0,3,0,0,2,0,0
realize,1,8,1,87,2,9,5,18,6,2,9,7,11,55,3,9,1,14,4,3,4,22,13,19,18,5,4,11,3,19,3,98,60,6,32,40,30,7,7,11,4,6,3,4,32,22,27,6,138,28,28,4,5,41,15,4,42,14,3,13,11,2,4,9,13,10,74,6,6,12,13,1,1,4,114,16,14,5,55,29,24,6,5,12,158,17,7,2,30,1,8,5,3,12,34,12,12,2,33,14,15,22,15,10,15,18,6,1,12,1,11,4,8,6,8,21,5,7,43,102,32,15,11,42,6,5,3,6,4,1,15,4,5,21,10,47,6,3,5,10,3,20,13,4,4,34,3,9,12,12,37,4,16,7,12,11,24,7,14,16,13,2,9,3,7,6,4,10,24,8,6,56,10,1,6,8,116,3,1,32,6,4,13,15,10,21,17,11,10,23,3,3,11,3,0,1,17,8,7,14,32,3,5,3,18,11,7,29,9,23,54,2,10,2,3,7,3,4,4,2,5,13,7,5,26,60,28,17,7,16,10,12,18,20,15,25,19,13,6,6,37,22,11,4,15,3,13,25,19,6,10,22,30,9,5,11,4,3,7,9,1,14,14,7,1,30,11,8,7,5,64,6,31,4,2,3,5,22,2,3,36,6,3,14,11,2,7,8,7,3,4,10,14,9,3,7,24,6,2,20,14,10,1,2,10,3,13,4,15,3,1,18,25,5,24,18,17,34,12,4,12,3,16,6,19,1,17,19,1,13,0,13,7,3,7,18,8,2,6,3,7,4,10,4,6,4,24,23,16,4,9,9,2,20,16,7,2,6,13,26,10,3,16,8,2,5,18,6,14,10,1,15,6,6,7,16,7,4,18,6,52,1,29,4,3,29,2,6,16,3,16,4,11,4,20,11,34,7,21,4,8,1,6,3,5,6,7,3,22,7,5,5,6,8,13,7,6,6,5,2,6,4,17,8,2,3,4,13,9,17,11,8,8,2,7,6,5,4,4,8,4,14,10,6,3,0,9,9,19,5,9,2,2,3,24,3,0,5,8,13,10,22,21,22,5,6,18,11,5,5,19,2,2,4,4,19,1,9,15,5,5,7,3,7,6,5,3,4,3,2,27,34,0,8,8,3,2,13,8,8,6,2,5,1,5,26,5,13,6,7,7,5,4,2,9,12,4,16,22,8,3,8,9,15,3,5,15,1,11,13,5,4,3,10,5,0,6,10,33,18,3,2,2,24,15,2,2,15,4,7,14,3,2,20,4,6,22,6,1,3,11,2,4,3,15,14,9,5,26,30,15,8,12,0,9,3,9,3,2,9,13,16,15,12,5,7,1,6,1,3,23,23,5,2,24,2,11,3,11,14,12,2,7,0,2,11,10,10,3,6,23,12,5,7,11,2,3,4,4,3,13,7,3,10,2,5,6,4,12,15,10,6,12,12,6,4,12,6,2,2,17,4,4,11,6,13,0,4,6,80,19,6,7,1,3,11,23,10,1,12,5,0,7,6,2,4,0,3,4,4,10,10,3,8,3,4,1,13,3,2,4,11,6,7,5,4,6,3,1,3,7,12,12,7,3,7,5,1,13,3,9,2,4,2,10,6,14,4,6,3,6,9,1,12,12,4,4,6,12,1,10,5,0,11,3,3,9,5,2,6,3,9,2,6,4,4,2,6,7,5,9,7,1,9,4,1,13,7,7,6,15,17,6,10,7,18,4,9,3,8,6,5,1,1,9,20,9,4,8,4,5,2,6,7,2,5,11,7,3,2,5,1,7,4,9,5,5,1,4,6,2,2,1,5,17,7,14,11,2,1,6,2,4,2,4,3,4,4,12,5,1,4,1,4,4,1,8,4,4,6,2,6,6,8,3,3,5,6,5,8,4,5,10,0,5,9,5,10,1,1,2,4,2,7,2,1,6,12,10,5,13,16,4,6,1,2,9,15,2,2,5,1,3,2,5,6,0,2,2,6,1,7,11,7,8,7,1,5,9,3,0,5,0,0,7,1,7,3,2,10,2,1,1,4,6,2,1,2,1,1,4,4,1,6,3,0,2,16,5,8,6,5,4,10,3,4,1,2,6,4,13,3,2,5,4,4,4,4,1,12,1,4,4,1,3,8,7,1,2,16,4,8,19,4,12,7,8,19,42,3,1,2,4,2,2,7,7,2,9,3,7,3,4,1,4,1,2,2,4,2,7,4,6,7,3,1,0,2,3,2,5,3,3,9,1,2,3,10,18,3,4,4,3,0,0,3,5,4,2,8
department,21,80,67,696,10,11,16,80,12,19,33,54,33,135,16,10,13,53,4,3,8,147,7,52,98,55,24,44,6,68,27,764,352,48,135,53,62,30,30,27,9,8,18,25,94,41,86,153,964,16,118,7,32,70,24,2,204,433,8,50,66,6,7,32,88,18,176,10,20,62,87,29,4,11,217,22,39,7,203,46,377,8,43,13,773,81,89,2,241,6,46,10,10,81,160,66,44,51,100,52,99,124,94,20,62,140,63,29,71,17,62,30,83,84,8,95,29,16,230,363,124,44,19,547,42,5,14,8,25,16,37,23,10,193,42,277,4,29,13,17,8,127,103,28,5,196,13,57,68,150,116,5,45,31,61,124,81,22,17,29,100,18,24,27,31,17,13,80,86,24,52,264,45,1,14,16,521,19,19,187,126,23,26,72,22,57,127,81,113,159,7,10,30,2,10,12,101,35,49,31,214,4,13,37,74,41,38,158,37,72,248,13,89,16,8,6,25,8,226,20,53,51,36,34,187,463,177,106,36,96,46,126,133,92,114,196,79,32,34,12,182,134,25,8,41,28,25,110,244,12,51,69,32,73,42,45,44,31,15,117,45,77,104,33,30,1,65,5,23,20,401,53,274,12,21,0,46,291,73,30,172,52,22,50,36,8,44,59,30,8,30,13,47,58,26,33,141,25,24,43,57,196,22,28,46,1,54,103,32,14,20,105,124,34,159,160,46,200,37,35,89,24,54,34,71,31,48,71,15,57,9,54,24,46,16,34,51,39,20,49,26,43,39,23,40,16,163,142,72,35,63,16,30,155,80,82,9,17,60,231,87,70,31,67,10,3,93,19,43,52,11,64,10,35,20,333,53,17,21,40,171,4,182,52,13,123,27,64,106,3,135,9,54,30,100,31,233,66,149,62,83,3,13,5,21,15,36,1,79,53,0,23,12,102,8,23,9,17,4,3,16,67,43,18,13,23,23,61,21,31,52,35,49,70,9,12,0,28,43,13,56,54,29,21,4,7,26,8,188,19,39,31,8,9,132,48,0,15,33,93,19,38,81,106,35,8,53,46,31,3,45,5,16,3,18,45,10,56,64,19,18,38,8,16,22,26,80,8,12,25,394,186,0,3,40,35,22,66,31,21,28,21,50,8,43,80,51,53,27,20,24,29,31,27,41,62,12,29,9,17,6,34,27,94,21,10,79,28,75,102,36,12,7,50,63,31,34,18,132,84,2,10,7,124,24,34,9,66,60,40,74,17,19,155,80,50,195,23,27,28,87,18,81,25,34,62,41,20,148,170,26,41,200,47,64,15,48,25,10,140,31,84,52,33,24,10,23,37,28,37,52,79,33,32,155,41,5,11,70,39,75,29,10,16,27,99,28,189,84,32,100,133,72,25,108,22,44,18,27,21,53,29,26,76,33,26,30,48,45,113,21,173,73,39,51,11,70,52,21,59,31,1,15,147,29,329,16,35,41,381,31,10,21,37,20,51,96,38,19,52,24,6,21,25,16,12,5,23,29,36,84,23,61,78,84,29,60,30,20,15,19,151,41,59,71,59,27,19,15,64,32,46,79,32,38,53,30,11,36,52,15,21,23,32,92,52,60,13,19,48,12,84,9,58,31,163,29,16,18,95,33,17,8,195,19,45,29,9,28,48,40,91,12,15,15,133,290,28,54,24,44,14,75,31,34,21,61,37,24,49,22,107,104,178,135,75,42,87,53,95,98,50,19,50,83,34,54,41,207,32,23,28,3,57,30,56,35,29,32,41,8,12,37,29,39,31,15,29,42,118,28,32,10,24,49,60,47,67,36,54,34,28,29,13,13,12,9,18,84,27,19,5,18,31,22,17,20,20,15,49,11,57,31,101,51,7,28,59,38,17,85,27,27,9,12,32,26,75,16,65,25,14,7,44,43,77,18,14,55,33,19,89,39,22,38,86,38,29,16,16,14,15,37,20,17,25,28,18,16,114,155,23,27,17,21,11,5,14,39,4,9,29,30,23,45,28,27,47,17,24,11,35,4,8,12,20,14,11,44,4,30,18,20,36,12,16,7,25,27,47,51,25,37,104,28,40,17,9,22,34,21,10,27,19,17,36,9,39,15,48,68,12,24,32,17,36,45,31,11,84,27,15,132,17,60,96,24,227,358,2,59,13,18,25,66,67,67,10,75,13,28,13,33,54,16,96,112,42,3,11,10,5,14,7,30,21,18,16,43,9,218,18,28,15,14,6,24,24,17,1,28,20,83,2,6,40,1,22,20,1
education,0,12,15,99,2,15,6,13,3,2,9,11,18,89,6,5,5,11,7,0,7,13,21,30,28,20,9,27,4,11,2,187,100,19,61,64,17,2,2,7,5,13,3,17,24,3,27,38,156,72,11,14,18,38,105,3,29,31,18,32,10,2,23,10,24,4,115,11,3,13,46,0,7,3,156,16,38,1,30,22,66,1,5,25,143,35,5,4,15,4,6,4,12,12,35,15,16,4,48,20,1,22,11,17,10,21,2,32,26,12,19,12,18,32,35,23,0,1,48,61,25,28,41,121,21,4,2,7,3,6,30,12,29,41,19,101,3,13,4,12,7,36,12,4,2,64,7,13,8,4,24,13,4,24,19,81,28,20,9,81,16,8,12,7,31,35,10,26,19,5,15,99,23,7,5,6,77,7,13,101,13,7,49,23,4,47,35,19,27,31,1,6,0,4,18,2,20,6,13,14,37,12,24,8,11,23,6,19,18,21,107,27,16,13,1,29,10,32,13,3,6,29,7,17,30,42,28,20,13,44,23,7,18,14,25,12,31,36,3,4,19,23,6,8,22,5,7,28,67,16,17,16,17,0,3,20,2,12,0,26,6,16,13,1,11,65,1,6,28,6,45,22,13,6,2,11,8,8,3,4,102,12,2,13,11,16,57,32,1,3,1,3,10,20,8,14,28,5,1,9,22,29,3,2,5,12,15,4,31,25,9,35,21,23,32,14,49,26,3,11,37,3,35,161,40,1,22,25,3,20,5,13,2,6,5,33,16,2,5,7,1,14,29,4,5,2,9,32,35,33,4,6,10,28,18,12,7,15,16,26,26,39,39,12,3,3,10,23,24,42,4,41,2,34,5,27,8,6,4,2,28,1,28,5,15,28,26,12,12,8,6,13,8,4,11,9,12,1,14,3,15,5,5,8,10,11,4,1,11,28,6,1,3,17,1,5,0,0,9,2,3,6,33,2,10,0,1,5,0,8,0,0,0,2,6,3,2,4,10,3,5,10,11,2,0,4,14,8,19,11,11,1,6,2,31,1,6,0,11,10,9,22,33,17,17,2,27,14,3,4,41,10,1,11,10,40,3,3,16,6,2,24,0,8,8,3,2,6,2,5,16,15,0,3,8,3,5,2,4,5,31,5,5,0,4,8,15,4,3,3,1,4,3,5,6,10,3,14,0,9,8,14,0,6,13,0,14,6,17,8,4,8,5,18,15,7,3,6,33,4,2,1,1,34,6,2,3,7,4,0,11,0,0,23,8,5,9,3,10,11,6,8,11,1,3,1,5,5,22,24,10,9,10,4,6,1,2,3,3,34,4,16,15,6,3,2,3,2,0,17,12,12,8,2,25,8,14,5,4,17,6,7,4,0,1,3,3,5,4,6,12,10,6,6,18,4,4,6,0,2,13,0,6,4,9,6,4,7,10,35,0,14,20,37,3,4,16,10,8,6,24,19,1,17,4,18,12,5,5,41,7,15,3,9,2,4,17,10,3,8,4,1,3,1,4,4,0,10,3,4,13,3,0,4,2,9,10,0,0,10,2,23,3,7,8,3,5,4,1,0,8,40,3,1,0,14,0,2,3,0,1,3,2,10,7,18,13,9,0,1,3,0,2,7,6,9,1,0,2,17,2,3,1,14,17,8,1,17,6,20,3,14,1,8,2,1,3,5,15,13,2,2,6,2,0,4,9,21,7,5,11,3,2,1,1,3,4,16,8,9,10,18,1,13,20,10,9,4,21,3,9,0,7,5,8,10,10,3,43,13,12,3,10,5,9,9,11,0,4,5,7,24,6,0,4,7,1,9,5,1,5,10,2,3,5,7,3,1,2,3,0,0,0,1,0,1,7,4,3,1,2,0,7,10,16,0,12,8,1,1,9,5,25,0,4,5,1,21,7,17,2,7,1,3,0,3,4,0,8,12,9,8,7,5,20,0,2,3,1,2,5,9,3,7,0,6,1,2,5,14,41,5,1,0,4,3,0,0,3,4,2,1,2,2,12,0,5,9,3,1,8,2,52,0,1,1,3,20,13,6,8,5,7,6,0,1,0,0,1,5,6,12,6,3,6,0,1,0,8,2,0,0,2,2,0,0,0,3,0,0,7,19,1,4,0,0,19,4,5,22,4,7,2,2,5,3,5,8,5,3,9,4,14,2,6,0,0,0,5,3,5,3,4,1,3,0,21,5,0,1,0,1,23,6,0,2,8,0,6,3,8,12,4,0,5,3,2,25,0,38,12,10,5,7,12,7,15,1,43,4
strong,2,19,6,90,18,43,5,61,3,8,11,2,23,130,0,11,21,21,34,15,4,31,83,41,18,29,56,67,31,49,8,163,116,48,52,192,97,2,4,27,14,52,7,21,56,13,12,6,159,210,59,25,29,162,18,7,21,16,70,30,11,10,3,15,37,23,107,13,14,6,22,1,14,3,154,25,29,1,77,46,26,6,9,17,128,7,6,5,12,3,8,18,10,69,18,9,18,0,56,9,7,11,7,30,22,21,4,11,22,3,30,3,64,23,18,45,1,4,43,85,25,63,20,129,15,20,6,3,3,2,57,10,15,50,75,104,17,7,13,19,17,44,18,5,6,86,9,52,10,2,69,9,17,8,10,16,78,15,13,85,17,2,10,4,6,39,4,27,24,9,10,116,29,5,34,7,84,9,12,85,17,20,30,32,3,53,24,15,20,49,7,1,2,14,3,7,9,19,12,15,20,5,9,1,32,22,1,21,12,29,77,42,26,5,29,30,12,19,21,1,8,19,5,8,21,51,18,21,9,8,17,9,17,13,38,2,27,8,10,13,51,24,5,14,11,6,12,97,28,8,11,13,25,1,2,12,4,3,0,9,1,73,6,2,8,5,6,1,45,4,80,7,7,4,2,16,33,3,3,1,81,8,2,17,22,5,35,30,17,4,0,15,9,11,2,5,18,3,9,19,41,5,2,1,12,19,29,2,4,6,1,8,46,25,16,13,20,10,5,11,34,5,46,11,71,5,9,79,4,35,22,3,7,2,7,6,30,3,1,9,4,20,32,3,4,13,16,36,20,39,1,16,1,41,8,0,4,4,10,45,15,11,13,8,1,19,15,17,26,65,9,77,13,49,8,13,1,6,30,4,33,4,28,9,32,14,5,21,19,6,27,20,12,6,10,28,22,4,15,4,24,28,4,22,3,10,4,2,26,26,7,4,13,14,8,38,19,12,8,46,5,11,24,8,7,4,5,11,4,12,3,0,0,21,14,3,13,23,50,10,18,17,2,23,9,3,85,24,14,11,76,1,41,8,51,6,28,7,8,14,24,47,24,44,4,11,64,6,4,8,32,8,1,11,3,7,7,6,22,28,10,16,3,17,6,5,5,22,3,3,87,17,11,11,26,2,6,4,11,3,6,10,4,8,5,12,4,10,2,7,1,4,6,3,8,11,5,7,6,14,4,2,1,16,1,2,19,6,17,16,13,12,12,9,7,9,7,15,33,8,6,8,9,4,5,1,8,11,6,4,29,3,0,41,4,3,14,2,1,4,8,2,2,10,9,10,12,2,19,29,9,4,2,2,6,3,2,1,1,24,3,7,15,42,13,2,8,3,1,17,10,22,24,8,12,5,8,6,2,15,9,2,9,1,1,9,8,9,5,1,21,7,9,3,8,4,8,6,3,0,2,0,6,17,4,0,3,2,10,12,10,6,14,10,4,3,6,2,8,1,9,15,6,6,3,4,3,1,6,84,3,4,6,4,7,21,24,28,6,5,4,7,1,8,2,0,2,3,1,6,11,3,19,12,8,4,0,1,0,1,8,15,2,3,6,5,13,15,2,8,2,46,4,7,0,10,13,2,10,11,1,2,2,4,1,11,7,11,3,1,7,1,3,8,7,15,27,1,3,5,5,3,3,15,1,2,0,4,2,9,3,3,2,4,1,1,25,2,12,3,7,5,3,6,8,2,9,12,10,4,15,0,0,0,3,6,3,2,0,2,1,14,0,1,20,19,11,0,7,10,25,6,7,6,7,7,10,2,9,6,2,1,6,5,7,6,5,7,3,4,5,1,0,0,5,10,1,2,4,1,4,6,4,2,28,5,18,5,11,4,0,2,2,4,0,2,3,22,1,8,2,2,2,0,6,1,15,3,8,1,10,2,8,17,14,14,2,21,5,3,0,4,1,2,3,2,1,8,0,4,8,11,8,2,6,6,5,0,1,7,2,2,5,1,1,3,3,1,13,3,1,2,1,2,6,3,2,0,13,7,0,1,4,2,2,1,2,2,5,2,17,3,4,1,1,3,4,1,4,29,2,1,23,4,5,0,0,0,2,6,1,6,6,3,7,0,0,0,3,0,1,2,5,0,0,2,1,0,0,0,2,1,0,1,5,2,2,3,1,4,1,13,0,0,0,2,14,1,2,2,3,4,6,1,2,0,1,1,2,0,0,3,1,0,0,2,0,1,8,1,8,5,16,21,0,2,18,4,1,2,0,4,0,2,3,2,5,27,7,8,4,7,0,17,1,6,7,1,3,27
free,9,20,8,152,24,19,9,63,4,4,24,6,24,160,8,25,21,23,16,15,2,56,49,58,21,24,37,37,33,37,15,256,180,25,79,160,100,5,18,13,21,56,8,9,67,25,29,21,371,117,94,17,33,155,21,12,118,22,29,32,26,16,8,18,23,11,217,4,12,22,12,8,17,6,137,29,30,4,130,58,62,4,19,23,245,17,20,4,38,4,12,10,6,64,55,20,23,9,54,31,4,48,23,25,16,31,12,12,25,12,46,6,30,30,12,72,5,7,79,259,41,55,35,127,23,14,7,8,10,4,34,6,26,70,53,85,11,11,16,35,13,55,41,5,7,88,9,35,19,5,102,4,24,10,8,20,74,10,28,67,30,6,18,5,6,19,8,30,25,9,20,149,31,8,22,15,225,8,18,64,33,22,16,32,12,49,45,28,44,63,8,9,15,3,8,7,17,17,12,15,30,2,7,23,38,24,8,56,37,39,114,25,26,6,9,16,6,17,22,0,4,26,10,18,39,106,27,36,9,7,11,12,34,39,49,19,48,10,20,20,101,61,17,15,44,5,10,57,28,11,22,53,35,15,11,32,8,4,5,20,3,51,29,3,7,23,28,45,1,10,146,9,37,8,5,8,29,9,8,2,103,18,5,13,31,4,11,15,24,7,4,10,6,9,2,16,37,5,14,27,29,22,2,5,24,5,35,1,15,3,7,15,25,22,29,18,34,44,19,8,64,16,58,29,132,4,12,61,2,27,20,14,24,10,16,18,47,11,0,12,13,30,51,21,10,21,45,90,29,14,16,23,7,55,36,6,14,8,19,53,40,9,22,30,10,11,42,23,28,40,7,68,3,35,5,10,9,9,37,14,86,5,35,13,28,45,16,26,59,12,37,13,20,16,28,25,76,4,22,7,36,15,9,12,10,17,10,7,44,22,14,29,20,12,22,28,17,22,13,18,5,16,15,15,7,9,4,20,17,19,10,1,1,16,11,4,5,29,27,6,23,19,9,28,5,8,46,24,39,17,36,8,23,9,77,17,20,28,10,21,37,33,48,58,8,9,47,47,26,2,48,11,7,4,8,31,15,11,29,11,12,28,11,15,16,11,22,16,6,2,110,34,5,18,19,6,6,10,8,16,32,7,6,5,4,32,5,18,10,5,4,7,8,13,10,20,11,16,3,14,6,30,19,41,14,5,30,7,17,38,18,10,4,12,10,12,12,20,61,21,10,5,6,5,18,6,13,26,5,7,43,3,3,60,2,18,47,2,10,10,22,6,10,7,20,17,12,11,37,68,17,14,13,5,18,27,14,11,8,24,27,19,27,39,12,15,12,12,10,32,42,49,16,10,45,13,10,22,72,37,37,4,7,5,7,35,4,39,13,4,36,11,14,18,19,15,17,6,12,5,9,3,8,26,1,4,16,12,17,35,24,21,36,46,8,10,13,8,6,4,28,15,15,24,11,18,1,12,11,206,37,11,6,4,14,26,47,28,11,32,2,23,19,32,10,9,1,11,11,11,16,9,50,9,26,14,1,4,5,10,8,34,13,11,13,12,27,5,1,10,18,31,10,11,4,14,14,3,26,11,4,10,2,12,4,6,15,13,3,6,7,0,8,29,25,18,16,9,10,12,13,10,6,22,6,15,6,9,2,22,7,14,9,10,5,1,6,6,46,18,13,9,2,10,19,8,14,12,10,11,20,6,6,4,10,14,10,9,7,39,40,14,0,4,26,56,16,10,11,14,16,5,4,22,7,25,5,7,19,11,7,12,22,4,6,4,8,41,14,14,8,19,15,3,15,31,9,6,6,3,10,7,18,2,27,4,8,10,12,14,33,3,21,4,10,8,5,18,5,18,7,19,3,7,1,9,15,6,10,11,9,7,22,3,16,22,10,42,29,4,5,6,2,9,7,11,12,11,4,9,49,20,16,9,6,7,8,7,5,6,8,15,6,6,8,5,4,3,14,6,2,7,10,19,5,5,2,9,19,0,0,3,2,1,5,5,6,6,11,5,11,33,3,8,2,4,8,4,4,15,12,5,8,13,19,1,7,15,12,32,4,3,9,1,39,8,4,23,9,3,9,9,13,30,10,4,1,10,3,6,4,7,7,9,7,6,6,5,9,12,2,27,9,5,8,9,24,7,24,2,1,16,9,1,5,0,0,11,4,9,10,22,10,3,3,24,2,2,4,6,7,15,16,14,5,6,9,6,7,7,10,15,8,17,7,21,25,19,21,7,5,8,8,9,2,3,7,7,6,17
contribute,0,13,16,68,6,3,0,24,2,4,21,7,6,45,7,4,6,3,1,5,2,19,7,7,13,11,4,4,3,5,7,82,101,3,31,35,36,4,20,4,10,6,3,4,20,10,15,11,129,18,30,7,16,33,5,3,37,7,1,14,13,8,5,8,10,5,61,5,4,5,10,4,8,4,46,10,9,4,42,14,46,7,6,3,124,13,10,1,12,1,6,7,2,7,33,13,9,18,26,10,6,23,12,3,7,13,4,5,5,1,6,4,10,8,4,12,6,0,38,106,16,22,21,42,5,3,3,2,2,1,4,2,4,33,5,41,2,2,1,13,2,28,19,3,1,35,2,7,10,15,28,1,12,11,2,17,12,12,15,15,17,2,1,2,3,11,1,12,16,10,15,51,13,3,4,5,77,1,12,16,6,7,13,10,7,14,33,12,9,30,1,2,6,1,0,3,12,3,5,9,22,1,2,4,12,3,2,36,4,14,33,6,8,8,0,8,2,6,9,5,2,6,6,7,22,43,14,14,1,9,6,9,13,10,13,18,15,3,12,9,32,10,3,12,9,5,3,6,25,2,6,16,15,2,4,11,8,4,1,8,4,17,5,2,5,20,6,4,10,1,69,11,10,6,4,1,8,9,6,1,34,12,8,12,5,4,18,14,9,9,7,3,3,4,2,5,22,6,4,18,18,25,0,1,7,7,24,1,5,4,8,11,19,10,26,11,11,18,6,3,32,2,8,2,21,0,5,12,1,16,6,5,2,4,3,10,5,3,5,14,6,4,16,3,6,6,22,27,12,4,11,4,1,27,8,1,4,2,5,19,13,3,6,14,4,2,10,3,9,11,1,27,4,8,5,18,4,5,8,3,24,2,20,12,5,20,3,11,14,4,13,3,13,3,16,6,20,4,18,2,8,0,3,6,7,7,4,4,20,13,5,9,5,11,7,0,2,6,3,1,4,3,9,7,2,2,6,6,4,9,3,2,0,3,7,3,2,12,2,5,12,14,4,7,4,4,7,5,12,6,23,9,3,0,29,6,1,6,9,15,4,14,22,15,2,0,18,10,6,1,17,3,0,4,1,8,5,12,4,6,5,12,1,3,6,3,16,4,2,2,44,14,0,3,6,3,1,8,11,5,3,1,1,9,0,7,3,7,4,2,7,3,3,4,7,9,3,6,0,5,2,12,1,5,2,2,7,8,7,14,2,3,3,5,3,4,7,3,30,11,3,3,1,5,7,6,5,9,11,7,19,2,2,9,5,5,26,4,9,2,13,3,12,3,6,9,7,4,14,15,6,6,6,5,5,1,3,1,2,9,8,8,10,9,7,2,3,7,4,5,13,9,1,0,17,0,0,4,18,11,10,6,2,6,2,10,6,15,5,9,14,8,6,8,10,2,5,4,2,2,3,2,0,8,1,4,5,8,9,14,6,15,11,7,5,1,6,6,3,7,3,1,3,7,4,8,5,1,3,88,7,4,3,4,0,3,19,11,3,4,3,1,3,9,2,1,2,2,7,3,10,1,29,4,17,4,7,1,1,1,5,9,6,8,3,8,8,2,2,6,4,8,6,8,2,8,3,1,12,8,4,0,2,4,11,3,9,4,1,1,0,5,4,9,2,5,3,2,9,3,6,5,2,14,3,5,2,4,2,6,6,7,1,8,2,2,10,2,12,7,5,2,4,6,10,2,8,10,2,1,7,6,1,2,1,8,4,12,4,5,3,8,1,3,6,13,14,4,18,6,2,4,7,7,4,9,7,2,3,8,0,4,3,1,6,7,5,9,3,9,8,9,3,1,5,9,5,3,4,4,4,3,0,2,2,2,9,3,9,5,11,9,5,5,3,3,3,3,3,5,4,2,6,6,5,0,0,2,3,1,2,3,5,2,6,4,5,12,1,4,3,11,0,2,6,8,2,4,4,3,7,5,5,2,4,3,7,3,3,2,6,1,2,6,5,4,1,0,3,6,3,4,3,4,2,3,1,4,8,4,0,0,2,4,1,3,3,1,7,3,2,5,2,4,1,1,2,8,4,5,6,2,4,3,3,0,1,3,1,11,7,4,0,1,7,2,5,8,4,2,2,4,3,15,2,3,4,1,5,3,0,4,4,2,2,1,3,2,1,13,1,14,4,2,6,5,8,5,18,6,0,3,6,4,2,0,1,3,4,0,1,3,2,0,1,5,5,0,1,4,3,5,6,15,2,1,2,4,4,2,2,3,2,7,4,10,7,3,4,2,5,7,3,0,3,2,1,2,7,0
may,77,293,104,1635,102,33,54,438,33,39,189,76,70,735,62,96,55,170,58,49,47,466,91,314,274,108,116,110,88,184,122,1815,1232,125,606,619,492,104,132,43,125,88,43,31,353,194,314,127,2950,200,367,47,159,333,72,83,799,295,23,179,217,126,58,189,201,67,1022,62,135,197,162,64,62,43,807,156,181,72,849,232,521,14,193,82,2279,261,160,3,356,39,65,67,7,284,645,124,204,45,323,186,119,329,430,130,130,293,99,35,132,55,176,70,91,184,17,312,67,64,817,1536,444,175,174,625,78,47,41,38,44,23,137,42,77,529,234,384,76,45,62,81,34,361,302,36,45,699,54,119,134,180,785,20,191,117,37,255,292,56,129,99,120,46,106,38,14,57,47,174,225,92,180,818,230,10,54,99,1832,44,219,330,255,187,30,155,64,231,399,273,419,430,81,64,74,16,17,32,195,61,86,163,226,23,29,143,283,96,79,365,111,311,840,64,310,131,31,33,12,28,181,33,43,181,51,193,631,1278,258,299,60,91,170,129,228,216,395,405,401,103,84,60,777,380,78,68,193,79,56,207,476,70,156,258,284,140,127,206,146,38,61,220,42,317,312,41,64,401,45,80,146,69,1,96,339,127,75,10,234,180,182,30,598,91,21,195,103,29,32,127,160,38,71,39,166,74,48,104,439,61,74,250,270,461,16,63,177,27,236,52,61,20,21,108,300,69,415,189,213,411,126,64,488,127,312,38,628,95,73,255,36,308,105,130,115,76,86,193,209,78,54,157,164,91,178,120,76,87,532,564,203,74,202,146,64,360,250,70,67,83,182,285,238,82,92,207,58,23,382,96,72,148,41,223,66,116,122,310,105,60,166,93,960,29,629,103,30,438,76,234,328,46,314,49,171,161,421,138,771,79,377,42,219,39,73,14,66,70,67,41,272,168,41,101,78,189,114,104,52,108,29,29,54,83,204,175,24,62,44,147,154,185,167,80,52,158,45,51,9,145,106,54,179,307,83,139,19,34,110,65,336,117,180,93,32,44,513,134,43,92,78,360,123,271,340,259,75,63,195,142,127,14,162,36,35,25,32,170,70,210,203,74,79,137,55,65,82,109,139,55,72,60,772,447,36,41,138,71,49,177,105,126,143,58,62,16,55,240,30,126,95,56,89,85,90,90,215,213,63,149,48,93,61,221,105,284,99,83,260,65,192,320,100,100,62,103,106,69,198,116,485,269,73,36,44,59,117,104,142,219,228,101,471,95,75,527,92,117,346,65,57,126,344,58,298,52,197,220,183,96,424,390,158,107,179,49,91,52,134,67,88,139,113,176,156,146,163,59,91,105,55,150,239,387,104,50,233,58,74,49,437,276,247,30,63,34,85,273,63,301,84,96,257,207,115,80,356,100,316,52,116,99,162,127,58,230,72,117,77,174,164,353,195,265,375,252,92,41,106,68,51,150,154,33,123,187,167,291,68,65,77,1665,225,80,78,86,67,140,430,161,79,152,87,64,172,174,94,53,34,112,126,142,216,108,423,312,278,94,53,89,56,76,99,280,173,97,135,141,174,69,59,122,166,131,158,142,94,117,97,59,198,251,87,50,65,76,98,103,260,98,52,50,94,124,87,331,245,206,100,102,104,66,97,67,70,246,33,93,124,26,59,118,77,192,78,61,87,59,221,98,399,117,109,83,50,125,185,65,168,88,70,121,139,82,50,156,57,158,92,151,47,176,175,163,33,40,233,222,109,75,94,121,90,40,30,159,75,166,99,30,186,129,67,70,144,52,98,79,93,143,108,111,90,115,33,75,59,254,59,81,59,73,65,68,121,87,77,43,122,51,208,72,82,34,123,94,57,56,56,104,52,138,52,34,82,101,80,85,66,99,115,52,78,80,160,68,108,130,122,301,159,69,88,97,77,148,57,139,107,51,95,122,205,332,122,103,39,61,78,98,70,24,84,90,93,33,68,102,51,64,119,131,35,59,115,153,44,69,52,80,149,59,36,63,60,67,109,57,57,48,70,84,42,111,11,45,88,120,60,56,62,46,93,66,44,89,129,73,29,108,44,271,64,130,84,153,132,65,41,138,45,38,113,101,72,146,12,103,47,115,49,90,92,34,98,95,66,45,72,90,52,142,49,199,64,97,87,194,185,205,404,44,35,48,45,75,60,61,57,60,259,72,42,45,75,49,31,266,65,24,91,81,116,78,53,58,39,88,19,91,115,75,72,88,101,129,66,94,133,27,151,14,43,47,69,6,2,50,8,63,18,13
fund,2,11,4,147,8,3,2,11,1,3,7,3,14,51,4,3,10,27,6,1,6,53,19,18,14,43,10,18,2,20,7,218,84,8,38,34,21,44,15,2,5,5,2,12,19,12,50,19,189,32,33,4,16,31,28,2,74,29,10,16,9,2,2,10,16,3,64,10,2,13,92,2,5,1,82,8,18,5,75,10,104,3,17,12,191,70,23,5,57,9,16,2,22,42,90,24,17,16,63,8,27,43,32,7,12,41,12,9,16,16,21,8,21,34,15,31,3,5,78,118,19,21,33,158,10,3,4,2,11,14,24,3,8,67,9,75,0,6,7,6,3,15,41,2,0,80,4,15,27,22,27,7,23,11,7,60,25,17,2,38,13,5,14,6,46,13,3,18,14,4,23,47,22,2,1,9,114,5,8,64,12,5,43,17,5,30,38,12,17,30,2,3,4,2,17,9,39,11,7,13,36,14,18,9,32,4,23,44,15,18,64,6,22,15,2,10,9,37,24,14,25,10,4,10,74,69,21,34,3,52,18,20,42,14,35,74,19,11,8,2,49,18,7,3,2,15,5,18,112,13,16,19,12,35,22,12,8,23,14,20,3,10,20,4,6,53,22,7,9,11,96,1,133,14,2,6,37,83,7,5,45,3,12,9,17,4,12,11,5,4,4,3,23,19,19,10,59,8,9,6,12,52,10,16,8,26,12,10,7,3,6,18,55,16,112,36,30,21,20,5,15,3,16,22,21,1,2,12,4,29,2,8,0,2,2,38,17,9,17,17,7,8,16,4,5,2,39,45,27,15,52,67,16,67,17,10,9,4,13,49,26,17,15,17,5,12,30,2,14,9,5,39,8,16,2,30,3,8,5,21,25,7,48,11,5,48,6,13,36,2,7,6,4,2,22,10,45,7,18,3,9,5,2,3,2,7,6,0,22,12,2,4,5,14,2,4,5,9,4,1,5,2,22,4,5,2,5,7,6,12,54,25,11,13,6,2,0,7,7,4,7,10,11,5,1,5,7,8,27,21,48,3,6,6,21,3,1,0,5,18,11,10,27,12,3,0,24,4,7,1,19,7,2,2,1,6,0,5,21,10,2,15,3,2,9,1,8,2,0,0,39,30,1,7,13,2,4,20,5,2,14,17,4,15,14,96,10,6,9,7,7,2,7,5,6,12,10,7,0,10,1,12,6,4,5,2,11,14,11,24,7,4,3,4,7,17,13,5,28,22,4,26,3,8,15,5,3,17,6,13,9,5,9,40,8,7,13,5,10,5,17,5,33,6,11,13,12,0,44,26,19,7,32,2,8,3,4,6,1,65,6,15,4,9,3,6,3,11,2,12,4,16,11,9,10,2,6,7,19,13,12,6,7,0,4,15,15,14,7,27,13,5,11,1,14,15,32,2,5,3,9,33,5,45,20,3,1,8,10,27,47,19,20,31,8,2,3,30,0,9,2,1,1,17,4,67,10,19,9,83,0,2,7,3,7,9,44,4,1,12,7,4,11,2,4,1,0,8,5,10,13,4,8,1,23,5,3,8,0,2,2,21,9,6,9,9,24,9,0,1,9,13,10,11,13,16,6,0,11,10,21,4,7,3,9,10,22,3,7,1,2,15,4,25,17,6,4,7,1,6,4,4,5,7,1,5,6,4,3,3,3,19,10,4,7,4,19,10,4,6,6,2,10,2,0,3,20,25,6,3,11,48,46,37,34,22,4,10,4,63,52,10,8,30,25,7,9,1,11,4,5,4,3,7,6,2,32,4,26,20,3,5,10,35,5,7,12,1,9,14,11,1,0,4,7,9,9,16,0,2,6,6,9,2,5,1,4,2,5,1,11,4,6,15,2,3,2,6,5,7,2,5,3,13,16,2,17,10,14,5,34,9,20,2,4,7,3,20,3,5,1,4,0,4,7,12,12,15,2,6,9,24,1,16,7,11,5,23,1,4,4,0,8,2,1,7,0,1,1,12,13,7,65,20,8,8,0,2,5,15,6,15,2,2,17,3,4,1,5,12,3,5,4,5,2,8,2,6,7,12,9,1,4,3,6,7,5,16,16,13,9,55,2,53,3,4,8,1,1,2,6,3,4,14,1,4,1,4,2,22,6,11,4,4,11,18,4,25,2,11,1,9,41,37,59,48,47,65,170,5,7,7,4,11,28,23,0,0,28,12,6,2,9,4,5,12,7,19,0,5,0,2,11,10,2,4,7,9,11,0,1,9,1,6,4,11,1,12,5,3,6,6,7,8,13,13,9,5,5,6
amount,18,21,13,427,9,2,17,55,2,7,31,23,24,64,4,11,15,61,3,6,7,88,8,55,51,27,6,38,9,104,18,649,306,15,117,83,40,80,59,11,26,3,5,16,70,30,75,48,698,23,99,7,33,41,14,4,264,208,0,31,30,9,4,28,48,11,174,33,22,31,283,25,5,10,129,27,56,4,283,26,452,6,26,7,683,176,79,4,341,46,92,14,27,184,358,133,62,43,100,28,58,78,139,13,19,75,86,14,98,57,94,15,26,41,10,117,42,22,259,499,87,19,133,820,23,4,8,9,36,20,16,1,6,154,28,120,15,15,17,36,2,76,155,18,4,126,9,28,115,124,69,4,71,21,6,51,61,25,10,8,101,5,27,27,56,7,22,24,47,21,47,187,36,4,9,21,436,5,15,67,72,21,15,28,24,41,99,51,62,125,8,15,33,2,12,13,34,17,61,32,113,29,13,18,69,10,29,111,26,53,131,5,68,55,5,4,28,15,54,11,210,36,20,28,199,241,155,170,51,178,31,109,169,40,80,326,110,21,39,12,186,87,16,9,18,26,13,50,145,12,31,97,15,237,49,27,30,28,31,107,5,41,83,36,31,274,13,7,37,10,339,133,1,13,14,0,25,370,58,12,99,18,9,24,43,9,8,13,22,6,19,8,50,91,56,40,200,19,16,51,55,105,62,47,35,3,24,22,6,4,1,41,91,11,421,104,34,133,77,16,118,11,49,3,55,11,10,50,19,78,4,52,10,17,26,56,20,18,51,91,17,28,42,12,25,4,106,130,49,12,94,27,9,89,49,38,2,4,25,392,35,15,10,61,12,0,93,12,5,18,5,52,19,16,20,109,28,23,20,98,151,1,104,16,2,126,13,76,239,10,35,4,35,13,86,26,150,22,69,22,36,5,4,0,31,17,27,1,56,18,0,17,103,31,12,16,23,9,7,1,9,7,27,14,7,5,6,14,38,66,202,137,150,79,3,10,2,14,20,11,41,47,8,29,4,4,18,6,91,54,72,17,5,30,168,13,1,25,28,107,25,60,57,26,15,8,47,18,8,1,21,5,8,8,1,25,5,17,51,12,17,32,5,10,15,45,61,3,8,14,179,207,0,11,42,8,22,134,29,15,59,23,80,3,41,279,14,64,29,15,49,5,22,7,39,62,3,25,10,12,4,61,27,24,7,29,40,23,58,94,15,13,2,23,39,35,17,11,76,88,7,5,1,14,56,25,8,59,43,14,38,8,15,182,9,15,52,12,18,10,64,24,72,10,31,39,33,20,117,100,42,20,174,3,14,13,58,21,20,235,40,57,38,35,14,12,12,24,27,22,42,53,47,31,36,7,22,27,81,41,57,7,1,7,17,54,22,32,13,75,104,53,24,13,107,34,63,13,19,20,49,176,12,204,21,26,8,25,16,69,158,66,54,55,30,7,6,70,15,36,28,5,18,48,22,235,10,19,9,433,25,9,18,8,8,72,124,25,5,51,11,11,81,40,24,12,10,32,36,50,54,39,147,68,187,19,13,43,26,10,38,93,37,11,21,49,39,12,17,22,51,10,92,56,18,37,34,8,92,36,20,19,21,13,50,22,55,11,19,25,3,125,39,42,63,44,7,17,17,23,20,6,8,32,6,19,60,6,6,37,28,66,56,10,27,23,70,31,37,24,36,12,5,19,16,13,100,4,13,32,13,305,222,383,291,35,12,31,18,346,316,52,86,111,40,149,26,18,25,52,15,4,3,35,10,24,62,10,16,39,5,8,41,64,35,12,37,10,99,42,19,20,8,22,56,40,35,27,29,4,22,31,52,18,10,13,21,21,46,12,122,13,31,43,11,14,17,25,18,35,12,119,0,44,33,10,4,32,82,24,145,43,17,0,11,17,20,69,9,8,19,11,11,14,35,61,18,30,21,19,21,60,12,69,5,31,6,110,8,4,17,8,22,15,19,17,10,7,12,34,18,12,190,83,18,25,9,13,18,15,65,60,11,13,53,22,21,21,3,19,2,56,1,6,21,41,4,3,35,2,20,7,7,14,1,44,4,44,84,33,15,127,20,336,16,81,14,7,10,20,19,15,41,65,9,12,3,23,19,148,11,9,27,36,2,83,22,45,11,62,12,70,295,197,95,266,133,395,714,11,11,10,4,21,58,189,27,2,102,17,134,18,12,31,20,52,27,97,1,6,7,4,20,6,18,4,10,13,25,12,90,16,60,106,7,52,10,7,22,0,2,7,40,1,1,37,6,38,1,0
safety,3,15,7,75,12,5,2,36,2,3,12,5,8,57,11,7,3,9,8,5,3,15,10,17,8,12,10,6,4,9,8,100,60,11,43,40,35,5,2,8,3,10,4,3,26,9,17,16,124,19,8,2,8,23,11,7,30,8,7,12,7,6,3,15,10,2,72,1,4,4,7,13,6,4,41,3,11,8,51,22,41,1,10,7,128,18,7,0,12,0,2,3,3,17,30,4,4,4,24,12,9,15,12,11,5,16,2,4,6,2,10,6,4,14,1,17,2,4,34,91,24,9,5,28,6,3,1,0,2,0,11,2,6,30,11,35,6,5,3,3,0,22,12,2,1,20,3,11,9,9,45,3,12,12,1,24,9,9,5,14,11,4,15,2,3,6,1,13,15,7,12,51,15,2,1,3,88,3,9,24,8,20,9,11,4,12,22,8,12,12,1,3,2,3,3,2,17,3,7,11,12,2,0,7,21,9,4,18,8,27,30,4,8,5,0,0,0,1,4,1,0,14,4,6,41,70,7,18,3,3,11,7,15,10,27,9,14,15,2,3,34,26,5,5,19,1,7,19,30,6,12,12,13,3,6,16,5,6,3,15,11,17,8,0,4,12,6,4,8,6,127,14,13,1,3,4,26,12,5,4,45,3,2,19,6,3,24,16,10,1,3,5,8,2,2,4,15,4,4,11,11,25,0,3,13,1,12,1,11,3,1,15,9,8,16,13,17,18,4,8,27,5,12,7,41,3,6,13,0,11,3,5,8,3,8,5,13,2,3,9,11,8,4,5,4,6,32,29,10,13,15,9,3,28,11,3,2,2,8,19,21,16,8,11,2,3,18,4,8,14,3,11,2,11,5,24,5,0,10,2,56,7,26,3,7,9,7,18,19,2,10,0,10,6,20,4,24,3,19,4,20,5,2,0,6,3,4,1,4,6,3,3,1,11,4,7,0,4,0,3,2,5,19,13,0,6,3,3,4,9,16,2,3,0,2,3,0,6,9,3,13,38,6,6,1,3,5,8,22,9,27,3,7,2,29,9,2,4,4,13,8,15,26,24,1,1,9,3,16,1,23,2,5,5,3,7,1,6,19,4,8,8,4,1,12,5,9,3,2,1,33,25,2,1,5,6,3,7,5,3,5,7,1,3,5,21,4,10,11,5,4,4,1,10,16,12,1,7,3,9,5,19,4,12,1,5,14,5,7,24,4,8,3,7,4,6,10,5,16,23,7,0,4,3,5,4,1,13,10,5,38,2,1,33,3,8,43,3,5,8,9,2,15,3,11,18,8,4,19,25,9,5,13,1,3,2,2,2,4,10,5,13,7,13,8,2,4,10,0,8,16,24,5,3,15,0,13,6,8,10,12,3,2,1,3,13,3,17,3,7,10,13,2,2,19,10,16,2,3,2,11,3,4,9,2,4,4,7,2,26,14,22,13,19,9,0,4,5,4,18,3,3,3,12,5,11,7,2,4,64,13,5,4,3,4,6,22,4,0,6,6,5,10,6,2,1,1,4,8,5,13,6,19,4,6,3,4,5,0,2,1,15,12,5,6,6,4,9,3,13,6,7,7,9,5,5,2,1,11,7,3,2,3,2,5,5,3,12,1,1,2,4,3,16,17,5,1,2,2,2,5,3,4,12,5,3,3,1,6,1,8,9,3,5,2,3,18,6,16,7,4,5,7,13,16,8,9,4,4,1,15,3,3,4,0,5,5,10,6,7,6,5,2,4,13,9,4,4,1,7,6,2,0,9,6,9,3,2,7,4,5,6,4,3,6,4,6,2,1,8,5,7,3,3,19,18,3,4,4,2,1,0,4,4,6,3,3,2,12,3,1,2,3,4,2,4,1,1,1,6,1,3,1,2,1,2,4,2,4,1,5,7,8,6,4,6,11,11,8,8,4,8,3,4,5,3,2,4,4,4,5,16,4,5,0,1,6,2,0,1,0,1,6,2,6,6,4,3,4,10,1,2,6,11,1,2,2,1,4,0,3,3,1,3,2,2,2,1,3,8,5,5,0,0,1,0,6,0,1,3,3,2,1,3,2,3,4,5,1,13,3,4,0,4,4,3,2,12,3,2,6,1,6,4,0,4,0,7,1,5,2,1,3,1,7,0,2,3,4,8,0,19,2,2,1,9,7,7,12,3,2,0,0,10,2,2,6,4,7,4,0,6,7,3,2,23,8,1,1,14,6,2,4,6,1,1,0,7,7,0,2,3,1,4,6,6,12,5,1,1,3,3,3,2,0,0,6,4,0,4
worthy,1,7,3,67,7,2,2,11,0,3,9,6,1,33,3,7,2,10,3,7,3,18,13,9,6,4,7,9,2,6,3,63,51,7,41,28,19,6,5,5,3,5,2,1,17,10,12,3,91,13,17,5,1,19,5,3,15,23,2,9,6,3,0,5,2,2,31,2,2,3,5,0,5,2,31,6,9,3,25,7,17,0,4,3,74,10,4,0,14,1,0,3,0,10,24,5,9,3,5,3,3,14,12,0,5,17,2,1,6,1,10,4,3,7,0,12,3,2,18,43,9,5,1,27,3,2,1,1,5,0,6,0,4,18,10,21,2,5,2,5,3,14,14,4,1,27,4,6,3,4,17,0,4,4,2,9,13,1,4,5,6,2,5,0,1,1,1,7,12,0,12,29,13,1,1,4,66,3,6,17,11,6,3,4,2,8,16,4,6,14,0,3,4,1,0,2,9,7,7,2,3,0,1,4,10,5,2,21,9,10,37,3,6,4,2,0,1,0,6,3,1,5,2,8,14,51,7,7,5,2,3,7,9,11,13,7,10,1,0,2,30,10,3,7,4,5,2,6,19,0,12,5,11,3,2,6,6,0,1,4,0,7,8,3,2,21,2,2,5,4,75,2,14,3,1,2,14,5,8,3,31,6,0,6,4,0,2,12,5,1,2,1,6,2,4,1,14,3,3,12,5,22,0,0,4,0,4,1,2,0,2,6,11,3,14,10,4,12,14,2,17,5,16,1,23,4,1,10,2,10,1,1,10,3,3,7,7,2,0,2,3,4,7,6,3,1,17,18,5,2,2,7,2,8,5,6,2,3,5,5,3,3,2,3,4,5,15,5,5,5,2,8,1,5,5,17,4,0,7,3,21,0,19,1,6,21,9,6,7,1,16,7,8,6,13,4,28,2,10,2,9,1,6,0,4,2,3,1,6,8,1,2,0,12,2,3,1,1,1,0,1,2,10,2,1,2,1,4,7,7,6,1,1,5,0,1,0,1,8,1,4,16,5,1,1,1,6,3,13,3,9,1,1,2,14,8,5,7,1,9,6,11,10,23,3,1,4,6,5,0,12,1,2,4,3,5,1,9,3,0,0,2,4,0,2,1,7,1,3,1,27,25,1,4,5,2,2,9,3,1,1,4,0,0,2,8,2,7,3,0,3,0,0,4,7,7,5,6,0,0,1,8,4,7,4,7,7,0,10,11,4,5,5,4,4,5,3,5,15,8,3,1,0,2,2,2,4,7,6,6,17,3,4,22,2,2,12,3,1,7,32,5,11,2,8,7,10,4,14,16,7,3,8,2,10,4,1,4,2,6,0,5,6,6,8,1,3,5,0,3,13,12,2,3,17,4,1,1,9,6,8,0,3,0,4,13,2,6,6,3,6,4,6,4,15,4,11,1,6,3,2,3,1,11,3,2,3,8,6,10,0,35,25,6,4,2,5,3,4,5,9,3,3,8,2,25,0,0,2,51,4,4,3,6,7,5,15,4,2,5,0,2,7,2,2,1,0,2,7,3,8,3,9,14,5,4,5,2,2,2,4,15,8,8,6,3,6,1,1,7,4,5,7,6,3,8,2,1,4,10,2,3,2,1,6,3,10,3,1,1,0,3,3,8,10,15,2,1,0,8,5,3,1,18,2,2,4,1,2,9,4,10,1,1,4,6,28,1,9,3,5,1,4,11,10,3,8,1,1,5,3,0,1,2,1,5,2,8,2,3,2,3,0,4,9,6,9,2,5,9,4,3,2,16,5,6,4,1,4,4,3,2,4,3,4,7,4,1,2,3,6,13,7,2,4,10,1,7,3,0,5,6,6,1,5,6,4,0,5,1,1,0,2,2,6,0,2,7,0,2,3,1,3,10,4,0,5,8,1,2,2,2,7,2,6,3,3,14,1,0,1,4,4,1,5,4,3,1,15,3,6,6,1,3,5,1,2,3,1,2,1,2,2,3,1,3,1,4,4,8,2,2,0,0,4,2,1,2,5,1,1,3,3,2,5,4,1,5,6,1,4,5,0,3,5,1,2,0,5,4,4,2,2,2,4,1,2,2,3,9,1,1,3,3,7,1,2,4,2,1,6,2,6,2,0,4,1,0,1,3,4,1,4,2,1,2,4,3,0,14,1,9,3,0,3,6,2,8,15,4,5,1,3,3,2,1,2,3,6,1,5,3,2,4,3,9,7,9,5,3,4,1,1,2,3,5,1,2,5,2,7,3,4,0,0,1,3,0,3,1,3,1,4,1,1,0,0,4,3,0
goal,0,10,0,52,2,17,0,10,4,1,0,8,9,48,0,4,4,7,7,6,2,5,36,26,11,19,11,25,8,20,2,89,27,11,17,71,48,0,5,4,3,23,1,7,18,2,7,10,39,46,17,41,6,50,11,2,5,3,17,18,2,4,5,3,5,6,37,6,1,0,20,0,5,5,83,3,20,0,17,17,22,9,7,5,43,7,2,8,6,1,5,4,8,10,4,5,34,2,23,7,1,8,4,4,14,12,3,13,6,11,10,3,7,12,13,11,1,2,11,24,17,25,9,78,12,3,7,0,0,10,17,5,4,21,12,45,3,4,3,3,4,13,5,4,4,41,4,10,2,0,15,5,1,3,1,18,17,12,6,47,12,2,5,4,8,19,3,7,5,4,8,35,17,13,8,1,4,2,4,44,5,1,26,6,0,13,14,3,2,19,3,4,2,5,4,2,16,4,6,2,8,2,4,0,9,7,0,3,5,3,24,7,19,8,8,15,10,16,6,2,8,2,2,1,14,9,8,6,5,8,9,2,12,9,13,4,8,2,9,5,15,8,2,5,9,3,3,18,19,3,6,6,11,0,0,4,0,5,0,6,2,12,5,0,3,0,11,16,8,1,10,6,0,4,2,1,10,2,0,1,36,0,1,2,4,4,26,8,2,1,0,5,2,6,6,1,2,0,5,7,12,3,1,5,1,3,40,1,10,7,0,5,30,8,4,3,7,4,1,3,13,2,7,15,16,0,10,16,0,9,6,4,3,0,1,1,10,3,2,2,1,7,11,1,5,1,1,10,1,11,1,5,0,12,0,1,7,1,3,18,5,9,11,4,0,7,3,1,19,17,2,25,0,17,3,3,2,0,9,2,16,0,5,4,8,3,1,2,2,2,8,7,2,1,2,3,4,2,8,1,8,6,3,11,1,1,3,0,4,7,2,7,11,2,0,8,5,5,1,9,2,3,8,0,0,2,2,1,1,0,0,0,0,2,5,3,3,3,10,3,2,1,0,8,1,3,19,4,1,2,17,1,20,5,7,4,5,1,3,1,34,10,2,6,3,1,13,1,0,5,9,5,2,2,0,4,1,0,6,5,1,5,0,1,2,1,0,6,1,1,22,1,1,2,9,0,0,0,1,0,4,1,0,9,2,4,4,1,2,1,1,2,1,2,1,0,7,0,0,5,1,0,0,7,0,1,3,0,2,0,1,2,2,8,4,2,0,4,6,0,0,3,1,4,4,1,0,2,0,1,0,1,1,16,1,0,1,0,0,0,1,1,1,5,1,2,1,1,1,5,2,0,2,0,1,0,0,0,3,10,1,2,1,6,0,2,0,1,1,5,5,3,5,4,10,0,7,3,0,2,4,2,1,2,0,2,1,5,2,0,2,0,1,0,8,1,1,0,0,1,0,1,0,4,4,2,2,0,0,11,6,1,4,3,1,5,1,2,3,1,1,4,1,1,0,2,3,2,2,18,0,0,0,3,1,3,2,4,1,1,1,4,0,0,0,0,0,0,1,3,0,0,1,1,0,0,0,0,3,0,1,4,0,1,3,0,3,4,1,0,0,9,0,0,0,5,1,0,3,0,2,0,0,1,4,1,3,4,0,0,0,0,0,6,5,3,6,0,0,0,3,1,0,2,1,3,0,0,0,6,4,3,5,3,0,0,0,0,0,1,1,0,0,0,0,1,3,5,5,1,1,0,0,0,0,5,1,1,1,1,0,9,1,4,3,2,6,2,1,0,6,1,2,1,0,0,0,3,0,1,0,0,3,2,0,0,0,0,1,0,0,1,1,1,1,2,0,0,0,0,1,4,0,2,4,0,1,0,1,3,5,0,0,0,0,0,0,6,0,0,0,0,0,0,0,0,10,1,1,1,3,0,2,2,2,0,0,6,1,3,0,1,1,3,2,1,1,5,0,4,6,0,1,0,1,1,1,0,0,3,0,1,0,12,1,0,2,0,4,2,1,0,2,0,3,2,0,1,2,1,0,0,0,0,0,0,1,0,3,0,2,0,7,1,0,0,0,13,7,7,0,0,4,0,0,1,0,2,0,4,4,0,0,0,0,2,0,0,5,0,0,0,0,0,4,0,0,2,0,0,1,5,0,2,0,0,0,0,0,1,4,3,1,0,4,3,0,1,0,0,0,3,2,2,1,0,1,1,0,0,1,0,0,0,0,0,0,1,1,0,2,0,3,17,0,0,3,1,1,0,0,1,0,9,3,0,3,9,0,4,1,3,0,8,3,3,4,0,4,10
protect,13,47,16,253,41,30,6,53,9,8,36,11,25,195,11,29,22,24,23,13,7,69,35,60,33,51,38,32,14,33,37,349,227,34,131,132,128,16,37,8,10,36,17,19,63,35,39,26,562,95,73,19,16,86,50,16,99,33,30,33,31,16,4,18,33,22,212,15,6,34,44,17,21,10,281,20,42,17,133,48,83,10,21,16,419,36,37,5,61,1,19,8,13,51,92,18,40,8,69,37,29,51,48,21,31,53,4,25,37,7,34,18,38,41,32,66,15,7,154,317,66,96,21,124,20,11,10,8,8,7,29,9,21,143,49,132,23,14,17,13,10,75,46,6,10,166,17,30,27,15,148,8,19,20,13,67,54,21,25,86,25,9,30,14,12,32,9,51,38,22,48,152,47,7,13,16,250,4,19,108,59,62,33,38,16,38,51,33,45,58,9,15,8,5,2,7,35,15,13,33,44,12,13,21,73,22,20,63,24,45,141,16,76,30,6,26,7,30,26,6,13,34,10,25,93,215,31,46,6,15,24,20,28,45,71,19,54,25,15,8,110,65,11,12,33,14,12,68,104,22,26,33,35,1,15,21,23,9,5,30,15,91,23,5,5,46,8,33,29,8,234,37,25,26,14,10,1,15,14,7,130,22,21,31,26,10,33,35,24,12,14,6,26,11,12,28,69,16,24,39,51,62,2,14,15,18,36,5,17,11,10,49,63,39,53,28,44,47,25,18,161,20,60,11,218,17,12,83,5,47,17,21,19,18,8,18,33,10,7,21,20,42,42,30,16,17,62,100,39,34,15,17,13,95,40,15,17,5,24,57,54,38,24,37,22,15,67,17,27,42,5,76,15,41,15,46,10,11,22,12,105,19,104,22,28,95,35,50,67,13,63,6,17,10,43,17,77,15,108,9,41,13,17,9,6,13,15,3,51,50,5,20,13,28,13,24,9,16,14,14,7,32,34,31,8,12,6,21,25,33,17,11,4,32,13,13,5,22,48,14,37,85,19,26,10,8,45,24,59,12,87,8,21,13,68,24,5,20,22,42,31,45,74,60,14,4,66,18,39,5,91,19,9,8,4,20,11,10,44,11,24,26,6,20,12,16,10,12,8,10,164,53,5,6,31,19,5,29,16,23,16,8,3,19,36,32,16,22,15,12,6,7,11,20,22,19,16,15,12,26,12,107,23,53,21,21,77,16,23,45,33,12,37,16,15,12,18,15,75,33,14,4,11,38,26,12,44,40,15,15,94,16,15,73,10,24,70,11,7,18,24,9,41,15,25,28,27,15,55,86,19,9,28,21,15,11,21,16,9,43,17,32,23,38,9,7,10,12,14,27,37,37,26,11,47,18,17,13,72,30,29,6,11,9,9,33,4,35,9,10,37,31,15,13,61,9,29,12,12,8,19,3,8,52,8,7,15,13,15,67,45,29,38,37,26,11,13,13,15,30,30,8,17,45,6,52,21,10,27,300,24,13,19,18,16,18,58,30,12,31,7,14,20,22,8,7,6,11,11,21,39,13,117,50,39,10,12,2,27,9,12,52,22,12,16,19,33,21,17,26,16,28,17,26,14,15,20,15,29,28,21,3,13,23,15,13,16,28,4,6,10,18,11,45,42,68,45,10,16,11,18,6,20,43,6,22,5,4,8,25,21,37,10,11,8,14,57,12,93,25,28,18,11,35,40,13,20,15,20,14,36,3,2,20,6,23,16,22,10,14,13,24,5,13,46,33,31,9,20,12,24,13,13,38,6,21,23,9,61,17,13,12,21,5,23,6,11,63,14,16,8,10,4,7,20,31,13,24,6,3,5,9,20,8,19,6,11,20,35,14,17,6,21,16,9,4,16,13,9,23,13,5,15,15,4,11,26,11,11,6,19,17,24,54,23,14,11,47,22,14,3,9,11,12,21,22,26,28,7,32,36,53,33,11,5,7,11,13,13,5,15,17,14,4,12,8,23,4,17,19,6,11,17,19,4,13,12,6,21,5,3,12,7,5,11,4,9,12,39,13,31,24,2,12,17,31,15,16,10,37,16,7,21,16,14,17,26,11,7,24,9,11,16,6,16,16,8,15,5,2,16,7,7,27,2,11,5,29,5,5,10,13,14,11,1,2,8,13,7,20,7,26,1,1,11,24,15,7,33,5,4,15,12,16,4,2,9,13,26,3,19,7,2,3,7,58,15,16,9,29,35,17,9,12,8,8,11,14,11,23,5,9,3,17,9,10,17,21,23,12,11,6,4,6,5,12,16,9,3,7
expenditure,0,10,10,281,5,6,2,17,0,3,5,4,30,59,8,5,6,15,1,1,4,31,7,15,21,16,10,14,4,27,6,342,115,8,60,51,29,25,31,10,18,3,2,18,39,12,31,50,175,15,33,5,15,35,8,2,58,150,3,17,17,6,2,23,37,9,90,11,8,24,199,28,2,2,101,9,27,6,107,21,361,7,14,5,333,62,29,14,163,12,28,9,13,58,111,56,32,21,73,15,37,49,69,6,21,40,98,14,61,25,47,7,83,17,5,55,3,5,95,165,48,10,82,527,22,4,7,3,20,16,14,1,2,84,15,70,2,2,16,5,1,35,39,17,3,72,3,37,41,94,54,2,15,21,14,69,25,5,2,6,61,6,13,15,128,7,3,28,22,10,29,78,19,2,4,6,207,4,9,57,26,4,44,14,8,16,54,19,18,60,2,4,5,1,19,7,20,14,20,7,64,9,11,6,28,9,3,43,7,30,57,7,32,11,1,4,42,89,49,17,84,14,9,14,115,117,135,89,20,212,18,67,144,23,55,304,48,4,17,7,73,24,9,0,9,25,8,23,100,3,11,34,17,112,26,28,8,13,26,37,12,11,43,7,22,291,8,3,9,9,180,83,370,12,5,2,15,1,24,9,40,7,10,9,13,5,4,14,8,4,3,1,23,71,25,19,58,12,8,16,15,85,43,11,24,3,18,18,8,11,5,24,76,11,113,72,28,54,15,19,21,13,25,5,16,4,6,14,3,31,2,20,7,17,9,17,17,5,36,59,11,3,16,9,19,3,64,48,37,1,57,18,8,34,34,31,1,3,28,303,49,26,5,11,5,0,27,5,8,18,12,34,4,3,5,121,5,9,2,56,99,3,104,7,0,34,3,29,118,0,7,2,13,4,41,5,54,14,26,13,22,4,9,0,13,9,14,0,16,10,0,5,20,10,0,2,8,11,3,0,4,7,19,8,0,10,4,8,5,29,35,62,71,33,4,2,0,2,27,9,9,15,18,4,1,0,14,2,68,34,23,13,2,2,64,10,0,6,11,53,13,15,30,17,1,7,8,11,11,3,9,1,10,0,0,5,1,7,34,6,3,19,2,3,14,1,45,6,5,7,196,116,2,3,10,4,6,57,18,5,22,14,56,3,4,31,7,20,11,5,31,2,4,7,10,30,2,18,3,15,2,8,12,22,10,10,14,11,16,48,18,6,1,8,14,8,15,2,32,31,2,7,1,8,11,5,1,23,17,15,17,2,7,90,8,6,30,5,14,6,25,10,35,5,15,32,11,2,72,35,26,13,130,4,14,8,16,7,12,165,5,30,7,19,8,6,4,7,21,6,20,22,13,24,12,2,8,7,11,21,30,19,2,3,4,28,16,33,19,29,50,18,2,5,14,14,44,2,13,5,15,4,11,17,7,9,8,19,14,42,13,47,26,25,4,2,7,36,11,11,14,2,1,42,7,148,7,11,9,88,12,3,4,6,4,27,59,11,3,12,12,9,4,17,6,1,0,5,9,19,20,18,33,11,16,1,15,14,19,4,21,47,8,22,24,25,18,19,2,9,11,6,31,6,4,13,14,0,24,17,11,9,7,6,26,13,52,8,3,9,2,63,5,33,51,34,4,4,9,39,7,2,2,20,2,2,19,1,5,15,6,28,8,9,2,24,74,20,12,30,14,2,10,26,12,4,49,25,8,6,14,311,240,297,235,23,16,37,25,86,72,24,13,47,27,9,10,14,38,3,8,1,5,6,14,27,27,5,13,11,1,5,16,6,13,4,8,2,27,35,0,14,7,9,19,21,5,14,18,2,12,8,10,6,6,7,13,13,19,8,19,0,9,20,6,5,11,13,2,32,0,62,3,13,11,4,8,24,4,12,76,37,13,4,15,19,7,33,2,5,9,8,5,9,4,22,7,1,20,8,4,31,2,23,8,8,5,23,1,5,6,0,0,10,3,8,1,6,3,28,18,6,39,5,7,5,0,2,10,7,1,13,0,6,7,10,11,6,4,22,0,32,4,1,4,2,4,6,16,7,10,0,7,6,20,19,1,4,39,18,6,66,10,112,9,23,1,8,3,38,11,8,10,10,6,9,4,0,8,7,14,9,4,15,11,95,23,25,3,40,21,11,237,89,120,68,53,404,324,2,5,2,1,12,30,73,42,3,43,3,1,10,13,11,16,18,7,35,0,12,5,1,24,10,8,2,33,8,10,6,102,5,15,2,2,29,11,10,3,0,1,10,22,4,1,52,2,13,1,0
refer,18,54,11,203,7,4,3,25,6,3,36,10,3,34,7,2,9,6,2,3,12,41,1,22,21,2,8,8,1,17,10,195,99,6,53,27,28,10,17,1,2,3,2,2,26,18,24,11,396,9,32,3,5,9,0,3,70,126,0,17,46,3,2,16,18,5,52,3,16,14,14,11,2,0,46,6,12,2,72,22,49,1,10,5,232,18,9,0,74,2,11,5,0,38,55,7,17,3,21,9,17,29,38,11,9,33,10,4,11,3,14,4,5,11,0,29,6,2,90,127,28,13,9,58,6,1,1,9,2,3,6,2,2,52,8,28,10,2,7,10,1,38,28,0,0,60,6,8,17,17,90,0,12,2,1,19,17,5,3,4,7,2,3,6,0,3,3,23,25,7,14,68,11,0,1,6,196,1,9,27,18,10,2,10,9,12,23,19,81,59,2,11,5,1,1,1,10,0,11,7,20,0,2,16,16,7,1,36,12,23,61,7,37,8,2,1,0,2,17,5,8,23,9,14,49,78,30,17,1,2,14,12,8,10,28,27,28,7,4,5,92,32,7,3,6,2,3,12,45,10,25,26,20,13,14,16,20,7,7,14,6,19,39,9,2,73,3,3,8,6,182,7,58,5,8,0,14,24,1,16,40,4,1,19,7,2,3,10,2,1,7,4,23,9,1,7,48,15,5,18,22,50,2,3,15,0,25,3,5,0,0,9,20,2,38,34,15,38,12,6,53,4,19,3,62,13,3,21,11,16,7,9,5,4,6,18,17,5,3,11,13,17,14,14,3,6,58,60,11,3,12,10,8,21,28,8,0,6,8,33,24,8,4,20,5,1,36,3,7,7,5,8,2,5,3,35,7,3,12,8,78,1,45,18,0,42,4,21,28,1,27,2,32,23,52,7,113,18,33,13,34,3,6,0,4,1,6,3,23,4,0,16,9,15,32,6,8,7,0,2,4,13,22,6,0,6,4,10,19,12,10,9,7,22,4,6,0,28,10,1,11,22,8,10,2,4,3,6,42,5,13,10,1,1,52,7,1,19,5,33,12,15,26,18,10,0,6,7,12,0,9,0,4,0,5,3,2,20,10,2,1,14,1,8,9,20,10,3,4,0,84,61,2,3,3,12,5,15,11,7,12,4,4,0,11,12,3,23,3,5,3,6,11,5,7,25,2,11,2,9,5,14,9,24,18,7,24,8,21,25,7,5,7,7,14,9,22,9,33,15,3,4,1,3,9,10,3,15,30,22,48,7,9,63,5,9,48,5,7,9,41,5,30,2,15,19,18,5,46,25,13,9,25,1,5,16,12,7,5,18,10,15,9,14,13,3,10,4,5,4,17,44,6,5,14,9,2,0,78,26,26,1,3,8,19,26,5,27,4,8,36,21,14,6,48,3,28,1,13,5,21,4,5,19,2,9,10,9,14,27,12,39,23,24,8,1,6,10,5,18,7,0,13,25,15,98,2,4,7,234,32,4,6,5,15,15,43,13,5,22,10,11,30,27,16,10,21,31,18,19,23,12,38,51,86,11,10,19,7,5,3,28,18,14,20,8,11,7,0,14,18,10,25,12,9,9,8,5,7,24,16,11,24,6,15,9,22,4,3,13,3,14,5,36,18,31,13,8,12,7,14,7,11,25,0,11,4,2,7,16,6,21,1,5,13,5,26,3,56,7,10,7,5,12,13,5,16,3,3,7,15,12,1,20,7,17,9,15,4,9,8,13,2,5,15,24,7,10,11,22,5,2,3,13,2,11,3,2,17,17,9,6,7,9,5,17,1,26,10,18,8,13,4,5,8,9,5,17,7,3,6,6,14,9,0,3,3,3,21,7,13,2,17,13,6,12,6,14,3,14,11,13,4,18,8,5,0,13,12,2,10,5,5,6,8,5,10,22,11,17,17,7,5,30,7,11,7,10,17,15,39,36,8,7,5,5,3,3,8,1,11,5,12,3,5,6,2,7,14,27,5,5,2,7,6,8,15,20,21,7,24,10,4,9,28,5,4,28,7,8,7,13,0,1,8,21,6,5,6,0,8,12,1,13,18,2,5,8,7,24,6,9,9,26,14,16,5,12,0,3,8,17,7,20,0,9,4,31,16,4,12,7,7,13,4,1,9,5,9,21,4,10,10,9,5,24,7,16,54,13,4,3,6,8,9,6,6,5,41,5,6,9,8,5,1,27,15,2,6,11,5,7,8,6,10,3,0,7,18,4,8,4,9,3,6,3,3,4,45,2,4,1,8,0,1,4,0,4,3,0
committee,3,27,14,139,11,2,2,9,3,0,3,5,5,12,1,1,0,3,2,1,1,18,5,17,11,8,7,5,1,2,2,103,32,3,22,11,1,3,2,2,0,2,4,8,12,6,16,12,77,4,11,1,4,5,0,0,14,61,1,8,6,0,4,10,9,1,14,3,0,3,8,2,2,1,9,5,9,2,38,8,12,0,2,6,65,7,4,0,8,2,3,9,3,7,9,7,6,2,9,4,7,12,9,1,5,17,10,8,8,5,7,1,7,5,1,8,5,0,28,58,6,6,17,30,1,0,0,1,0,2,3,0,1,32,4,25,5,0,3,3,0,7,8,1,0,21,1,7,7,3,17,0,3,1,5,35,8,1,0,2,12,5,2,0,8,3,0,7,14,2,4,32,15,0,1,5,51,0,5,29,11,3,10,12,10,2,15,8,15,33,3,1,2,0,0,2,29,0,1,4,18,0,2,1,7,6,5,20,4,14,25,3,11,2,0,0,0,5,19,3,0,6,0,7,19,32,13,5,3,4,6,8,9,8,20,9,11,2,5,3,18,16,1,1,4,7,3,6,26,1,6,9,7,2,1,3,2,2,2,5,4,7,19,3,3,30,4,1,2,1,30,5,12,4,3,1,7,9,16,1,21,5,4,7,3,5,3,9,5,1,4,4,42,8,2,2,15,7,0,8,7,37,4,1,2,1,11,5,2,2,3,10,12,4,8,2,5,14,10,0,19,3,5,0,18,3,10,15,0,13,8,4,3,2,4,9,4,4,3,4,3,6,4,4,1,2,10,18,4,1,5,6,4,10,5,8,2,5,5,7,14,5,4,7,1,0,38,1,8,2,1,5,1,0,3,12,2,0,2,0,17,3,19,9,6,21,1,9,10,2,10,0,58,26,19,2,38,2,9,2,10,0,0,0,1,1,2,0,0,0,0,2,0,7,0,3,2,1,3,1,0,3,12,2,1,2,1,7,1,3,2,5,2,10,4,2,5,1,2,1,6,3,8,2,0,0,3,0,5,0,4,0,1,1,5,0,0,7,4,10,7,4,4,6,3,1,2,3,2,0,5,3,7,0,1,1,0,34,7,1,1,5,2,2,3,8,3,0,0,5,11,23,0,0,2,4,1,9,2,1,0,3,0,6,2,4,5,11,3,0,2,4,6,0,1,6,0,2,0,1,0,10,0,3,1,2,2,3,5,9,5,1,2,0,5,1,8,3,6,7,1,1,1,4,1,6,0,5,2,2,8,4,4,4,12,5,11,2,6,7,9,4,11,5,4,10,2,4,19,19,0,3,12,0,2,4,0,3,1,7,2,13,5,7,3,3,2,5,0,5,6,6,3,2,19,2,2,1,8,16,16,2,1,1,5,5,4,22,5,0,8,20,33,0,9,2,4,0,2,0,1,0,1,8,7,3,0,2,4,15,2,16,14,6,7,1,4,10,1,5,4,1,4,4,3,18,10,6,6,33,6,4,2,5,2,4,7,2,4,1,8,0,2,0,7,1,0,0,1,2,2,1,8,30,17,0,5,6,0,1,1,14,5,2,1,2,1,2,0,1,3,5,11,7,6,11,0,2,6,10,2,2,3,3,7,11,3,1,2,3,0,1,0,8,3,5,1,0,0,8,0,2,0,14,0,1,3,0,2,6,2,4,1,1,7,3,11,1,8,1,9,4,3,2,1,2,7,6,1,1,1,0,1,5,2,2,4,8,3,2,6,3,2,1,3,2,4,6,7,4,1,1,1,3,0,4,4,2,4,3,0,1,0,6,6,4,2,0,0,6,0,13,14,1,2,6,3,6,1,6,5,1,3,13,2,1,0,0,2,2,1,1,4,2,0,3,3,6,3,2,4,0,6,10,0,1,1,5,0,0,7,0,2,0,3,1,3,2,1,6,3,5,5,6,3,5,5,7,2,4,5,16,1,2,20,1,0,7,1,1,4,2,0,5,3,0,1,5,1,14,2,3,1,6,0,3,0,4,8,2,3,4,1,2,1,2,3,0,0,2,1,0,0,1,1,9,0,13,2,0,2,0,1,10,3,0,0,1,1,10,7,2,2,6,1,0,3,1,0,3,0,2,1,0,2,4,0,0,4,1,5,8,0,2,3,1,3,2,1,11,0,0,1,0,5,3,4,3,12,0,0,1,0,1,13,0,1,0,16,4,5,0,0,2,0,0,6,0,2,1,0,0,0,2,2,0,3,0,3,4,1,1,1,2,3,1,2,1,0,0,0,5,1,0,0,4,1,2,0,0
every,19,138,73,512,80,85,42,246,19,28,71,47,89,511,38,82,55,119,71,31,28,183,171,163,128,117,131,105,73,206,60,996,759,108,313,544,249,36,66,46,53,117,34,34,171,83,98,94,1282,356,236,50,111,355,203,48,274,84,110,124,69,39,28,65,108,55,676,57,46,69,105,23,44,30,651,95,194,32,386,199,240,16,54,68,998,122,84,15,126,10,38,46,33,120,295,42,100,33,170,127,49,147,124,79,74,150,44,52,92,43,114,29,94,109,85,164,16,34,233,656,239,336,139,452,50,44,31,25,17,18,133,62,87,257,144,381,63,22,35,83,49,206,149,28,30,401,47,111,64,47,322,41,78,52,36,119,251,35,58,171,85,48,94,14,37,128,42,166,137,48,79,604,181,34,59,46,691,27,86,288,145,97,75,126,25,172,192,117,168,197,21,39,61,19,47,27,86,42,51,104,193,30,25,60,133,90,32,181,72,153,432,74,123,54,56,93,18,40,72,17,23,112,28,96,195,477,146,131,31,97,61,93,101,122,276,102,161,60,65,43,328,191,47,46,115,28,20,221,226,51,60,108,120,42,54,111,51,13,22,94,45,154,61,9,36,172,102,81,103,34,598,45,99,45,31,36,130,40,40,21,1,44,17,114,107,23,92,118,102,37,11,32,74,36,14,31,161,23,43,112,141,98,8,14,68,34,129,28,67,23,15,116,167,69,188,68,107,182,65,29,302,70,183,132,428,31,79,271,27,139,46,74,46,19,53,54,140,22,17,51,54,74,132,50,40,45,164,328,99,130,55,76,32,214,92,22,39,37,76,149,94,56,62,92,50,78,147,63,81,165,18,186,36,171,59,137,57,26,111,37,333,34,210,63,96,173,55,102,143,51,153,31,67,49,142,73,201,32,125,11,130,40,32,29,36,42,33,26,110,101,33,32,25,72,57,66,36,40,34,44,58,51,86,46,26,22,17,76,64,72,56,20,14,39,41,24,11,42,64,28,87,111,33,84,17,25,134,63,135,38,142,32,70,30,282,35,38,41,83,110,83,151,166,210,68,41,175,69,36,21,184,47,29,45,40,191,41,64,108,65,35,93,29,36,64,41,45,79,35,21,370,175,25,45,89,26,28,71,55,40,95,47,23,32,21,114,52,55,26,31,27,39,43,28,70,79,47,62,25,69,34,90,29,129,38,16,134,35,83,140,59,35,28,59,44,60,41,69,234,100,21,10,19,44,65,27,30,92,44,24,172,19,29,234,41,57,151,16,35,39,119,15,74,26,68,69,63,47,132,176,67,37,50,28,54,21,44,30,44,75,47,60,73,127,64,63,34,50,24,72,135,167,72,37,125,33,46,28,122,115,84,30,38,17,22,92,27,118,52,31,103,57,46,44,156,31,89,24,50,20,76,44,25,91,15,23,33,37,72,114,77,97,144,157,51,22,66,31,63,57,70,47,60,98,37,87,36,23,36,610,130,43,56,20,32,69,169,76,30,66,31,16,23,60,11,15,14,36,49,38,96,42,128,85,87,32,13,20,11,48,33,151,77,37,53,39,95,39,23,43,49,130,60,42,26,58,55,12,60,56,18,12,14,60,79,46,89,53,15,17,18,19,25,123,78,119,71,47,39,54,56,29,35,150,50,47,32,33,38,79,41,55,31,30,24,14,120,34,126,54,38,34,24,81,70,28,71,56,43,53,72,15,6,23,17,56,44,50,20,45,45,97,3,20,106,97,66,38,62,38,66,40,36,106,29,52,59,17,54,66,18,31,53,35,58,35,50,58,64,50,45,50,21,27,43,113,20,26,19,26,28,21,65,19,59,37,61,48,95,14,30,11,46,37,33,21,36,56,10,48,20,10,17,43,15,35,68,29,53,23,45,56,70,28,54,67,45,143,57,46,22,33,27,44,40,38,44,26,21,70,77,98,32,39,25,34,40,21,32,12,26,27,28,28,23,28,26,15,45,35,20,35,36,66,28,32,19,47,62,49,10,16,29,21,15,13,25,20,32,15,51,36,72,17,28,18,24,25,36,59,41,21,35,45,51,4,10,40,18,78,31,22,35,38,47,9,16,29,27,15,36,18,20,51,16,26,14,34,15,24,18,26,36,29,28,16,39,27,35,62,30,78,15,14,41,68,58,39,114,11,21,37,40,34,19,19,16,24,45,16,8,34,31,16,4,76,19,38,15,38,61,47,59,64,25,27,44,40,71,21,21,38,27,38,31,50,53,54,50,47,28,19,37,19,14,19,33,23,39,45
abuse,2,9,4,85,7,7,4,16,0,1,10,1,8,65,2,10,6,16,6,6,2,25,6,11,33,13,9,8,7,11,5,82,64,5,31,26,20,3,7,1,7,6,4,9,28,19,20,17,127,8,27,6,7,16,7,7,23,14,1,11,16,9,1,3,34,5,84,2,3,2,5,0,4,2,89,21,14,5,55,24,41,2,11,10,148,7,15,0,23,0,0,2,2,12,33,30,9,3,24,2,2,15,16,9,9,19,0,3,4,2,16,6,4,13,2,26,0,4,45,136,34,20,12,32,3,1,1,2,0,1,5,3,6,25,19,35,14,1,4,7,8,22,14,0,0,43,12,23,7,8,55,3,7,3,4,10,21,4,1,15,21,9,4,0,6,7,4,27,19,10,12,53,16,6,5,3,122,4,10,27,23,6,10,16,2,37,45,18,26,14,2,4,1,0,1,9,10,5,9,16,52,4,0,10,13,6,1,37,6,12,52,3,11,7,3,9,4,4,12,1,2,15,2,9,31,142,14,17,6,0,8,6,16,19,34,20,16,6,5,6,44,29,4,12,34,6,5,13,33,6,7,20,18,1,11,15,3,1,1,11,8,11,14,0,6,52,12,8,18,12,91,3,18,3,6,0,22,7,4,5,44,1,4,11,5,2,12,13,11,6,1,1,12,0,0,12,17,2,6,19,21,16,0,0,16,2,15,4,8,0,3,30,22,8,21,6,12,35,10,11,31,11,32,0,85,4,10,16,4,15,1,8,6,10,6,13,24,5,3,10,7,11,11,13,1,8,33,28,18,2,8,11,4,39,16,6,3,4,15,28,24,10,11,24,5,8,34,6,30,15,3,15,5,8,20,28,2,3,22,10,29,6,32,12,3,21,10,16,18,7,23,3,15,1,26,4,37,0,17,3,14,2,4,3,1,22,14,1,17,7,2,1,0,14,21,7,0,2,2,0,6,5,21,9,2,5,6,10,2,10,8,0,0,3,5,2,0,0,5,10,15,14,9,3,0,0,4,4,20,2,6,6,2,0,28,8,0,4,11,16,10,17,22,33,4,2,10,6,5,2,20,9,8,2,5,29,2,6,16,6,14,8,0,15,8,7,7,0,7,2,32,20,0,5,1,1,5,4,3,20,14,3,1,4,6,7,2,14,11,12,3,16,6,17,16,17,6,11,8,14,3,22,6,26,15,7,39,31,19,13,18,11,11,20,9,6,7,10,42,20,5,0,3,3,8,4,2,12,11,9,18,5,2,31,3,13,18,8,5,6,11,2,16,5,8,18,8,7,30,35,5,9,1,16,8,2,5,10,5,11,1,2,6,16,10,7,13,4,3,6,14,31,7,7,39,2,3,3,10,19,24,3,2,1,5,15,1,12,10,4,21,21,3,3,24,6,14,7,8,1,11,2,0,13,1,4,3,11,11,12,1,19,40,25,7,3,31,2,3,6,17,0,22,7,5,8,2,1,9,55,18,10,4,12,8,7,25,20,4,4,3,1,0,5,0,0,0,5,5,8,12,5,5,38,9,12,3,2,0,5,0,36,8,3,15,5,6,2,1,7,6,10,10,5,3,2,7,4,11,3,0,5,4,9,8,2,6,6,7,5,3,3,8,22,14,3,0,11,6,3,4,12,6,9,2,5,3,3,6,9,17,6,3,9,3,2,8,3,15,2,12,1,0,3,6,8,6,2,4,7,12,3,0,1,1,9,6,6,8,13,16,4,0,10,12,14,6,5,5,4,5,4,0,20,3,13,2,6,1,6,0,2,10,6,9,6,4,1,6,9,4,5,2,2,16,22,6,8,2,9,0,2,9,0,3,1,5,0,10,5,6,0,4,7,3,5,4,2,3,8,2,5,2,5,2,3,3,3,7,3,8,2,9,6,4,8,6,23,10,9,2,12,5,8,6,0,14,1,5,7,33,19,10,4,3,1,14,2,6,7,2,7,6,2,4,3,5,1,13,12,4,2,4,11,6,4,3,1,6,1,0,2,3,2,0,4,2,3,7,4,6,4,0,3,7,0,1,1,3,8,2,0,0,5,7,2,0,1,12,18,12,1,17,1,9,0,4,2,8,3,10,0,6,3,5,4,1,4,4,2,4,1,5,1,0,6,11,3,5,7,2,2,5,2,4,5,2,5,23,5,0,3,0,3,1,3,0,3,7,4,3,1,3,1,0,19,3,10,1,4,0,4,10,3,3,1,0,5,7,4,27,5,3,1,3,5,6,4,16,7,2,1,4,0,1,2,3,0,1,2
food,1,3,1,44,1,7,1,2,0,3,3,1,10,32,2,2,5,1,1,2,5,10,9,8,11,8,8,4,0,4,1,61,70,4,22,23,9,12,50,3,2,5,1,6,7,9,12,19,46,16,17,5,2,23,12,1,10,5,7,9,3,1,2,1,7,10,33,13,1,15,30,3,7,1,49,6,14,2,17,12,52,4,3,7,43,6,33,0,7,0,11,6,16,6,10,6,9,5,28,8,1,19,8,6,3,6,5,11,5,3,7,3,5,8,4,23,0,1,27,46,8,15,8,36,4,1,3,7,2,1,7,0,6,19,6,31,1,7,7,3,2,20,16,2,1,23,2,10,9,2,10,1,3,1,3,7,11,8,0,26,25,3,1,2,12,7,5,10,12,4,9,22,14,4,3,2,35,2,1,34,7,6,29,17,2,7,8,5,9,12,0,1,28,0,4,3,10,1,2,2,12,1,4,9,4,8,10,17,5,15,24,3,8,11,4,9,5,3,4,0,1,4,4,5,20,27,9,9,2,13,4,3,10,13,15,5,13,7,47,4,19,11,2,2,6,7,3,10,29,7,7,23,3,2,2,7,8,7,0,9,0,9,3,0,3,22,2,2,5,8,21,12,9,2,0,1,21,10,1,4,17,4,1,6,9,4,11,7,2,0,2,1,4,9,7,4,18,0,3,7,10,5,0,6,8,5,5,1,6,1,6,3,13,5,12,3,7,24,7,8,2,1,11,5,3,0,11,9,1,8,1,5,1,0,3,1,8,3,2,7,3,7,6,3,4,9,8,12,16,11,8,3,0,15,5,0,6,2,6,11,8,12,12,2,2,3,20,0,1,9,3,19,1,2,7,3,4,2,2,2,6,2,14,5,6,12,1,13,7,0,4,1,3,1,4,0,5,1,12,8,4,0,2,0,1,1,4,0,23,9,3,10,10,9,1,2,0,4,1,4,2,1,2,1,7,2,1,5,1,5,2,1,0,3,1,0,0,8,2,6,5,6,3,11,3,4,7,9,8,1,9,4,6,2,22,5,1,1,5,13,4,3,12,8,12,0,15,16,7,6,15,2,1,2,0,1,2,3,8,6,5,2,1,0,2,0,5,0,3,0,33,5,1,3,13,2,2,5,2,4,0,0,2,2,3,5,20,1,2,3,6,4,0,5,3,6,0,2,1,10,1,4,2,0,1,2,16,5,3,4,3,0,3,0,5,4,0,1,14,5,6,10,1,37,30,1,2,10,6,5,2,3,0,5,6,3,7,0,5,0,3,5,12,4,8,7,8,1,6,7,7,3,7,5,4,1,5,1,2,11,4,4,8,0,2,0,6,0,2,4,1,0,8,0,21,4,4,12,8,9,7,9,0,0,2,6,1,4,2,0,6,8,5,0,15,1,1,1,1,1,5,0,4,3,8,1,1,0,5,4,0,3,5,7,1,1,2,4,0,3,3,2,0,4,2,7,4,2,3,35,2,3,6,0,3,1,10,3,0,3,3,4,3,11,4,0,0,1,2,1,6,3,0,3,3,3,1,2,0,0,1,8,3,4,3,1,0,5,0,4,7,6,5,0,0,5,0,0,2,2,1,0,1,4,4,2,3,2,1,0,1,2,1,8,5,2,3,4,3,2,2,2,1,1,2,3,0,0,1,3,2,14,6,3,3,0,2,3,4,9,10,1,8,0,0,2,3,4,5,1,5,0,5,9,8,7,4,6,2,4,11,6,1,5,9,4,3,4,35,0,3,2,13,2,3,5,8,5,6,2,5,3,1,3,9,7,1,1,4,9,1,0,0,0,6,4,2,6,3,0,1,0,3,2,2,1,0,2,4,4,3,1,4,3,2,2,1,4,3,1,1,2,2,11,5,1,5,0,0,1,4,3,1,0,4,1,2,5,0,1,0,0,0,5,1,0,1,3,0,1,2,7,2,5,7,0,1,2,0,1,3,1,4,1,4,1,5,2,0,2,3,0,1,0,1,1,0,0,0,2,0,1,2,0,3,2,3,0,0,2,3,4,1,1,0,2,0,1,5,4,2,0,0,3,1,0,6,3,3,7,3,2,0,0,3,2,1,4,3,3,1,2,4,6,7,3,0,2,2,1,4,1,0,1,2,2,2,2,0,3,2,3,2,0,9,2,1,16,5,0,2,2,4,5,1,0,0,1,10,0,1,3,4,0,1,5,3,0,2,0,4,0,3,3,0,0,0,1,2,0,0,4,1,0,1,0,5,2,0,2,1,6,0,4,4,5,4,0,0,2
whose,16,42,22,169,25,12,13,66,8,12,45,18,15,115,9,20,2,28,3,9,9,67,28,64,32,16,39,21,16,22,19,259,235,18,85,117,69,8,10,12,12,32,5,3,52,19,33,23,407,60,67,7,31,70,18,10,84,41,14,20,40,12,4,17,38,22,178,10,9,23,32,5,15,7,129,23,23,11,120,41,89,4,18,11,338,22,24,1,42,2,19,22,7,41,95,14,15,17,40,25,19,38,55,18,15,39,7,11,35,5,24,12,15,30,19,48,9,7,99,243,50,46,15,84,16,10,8,7,4,6,18,15,19,67,40,90,18,6,10,19,14,46,25,6,14,109,19,22,27,18,135,3,24,12,7,36,52,11,26,15,21,4,7,2,4,12,9,27,42,26,17,168,42,0,6,15,256,8,23,57,35,18,11,32,8,43,60,29,67,76,3,7,16,1,3,8,33,14,23,26,64,9,4,14,62,18,10,60,11,39,125,16,35,9,5,7,0,0,23,3,14,27,13,23,54,138,42,43,9,10,21,35,18,37,48,25,52,12,7,22,99,71,16,15,44,13,7,24,63,12,17,36,25,7,13,28,25,4,5,34,13,36,33,3,14,50,13,17,13,12,195,9,24,19,6,2,31,9,19,7,114,11,6,1,19,4,19,17,40,5,6,10,18,7,5,11,58,9,8,40,40,44,3,8,19,5,38,20,25,5,8,32,47,9,36,18,32,58,30,20,89,22,60,16,86,14,10,49,7,47,9,20,10,8,16,20,31,15,4,17,14,8,34,22,5,15,58,76,36,24,27,28,14,44,28,8,13,12,25,24,30,13,6,35,17,3,48,26,13,25,3,37,9,39,26,61,12,10,49,14,91,10,53,24,11,41,21,24,41,8,53,6,22,27,36,14,91,12,71,10,50,4,9,4,11,17,17,20,55,31,9,42,13,34,8,15,7,13,7,4,9,20,40,30,6,13,3,23,20,20,16,9,4,17,6,6,5,16,13,2,27,40,18,43,7,12,12,9,58,7,23,10,10,2,94,12,5,14,22,44,28,55,61,102,39,4,23,16,19,5,43,7,10,9,9,63,6,29,30,4,15,11,11,13,22,16,24,15,21,7,81,63,11,13,16,10,8,34,18,18,25,9,8,8,19,50,15,29,10,5,5,17,15,19,35,27,16,25,16,13,8,41,11,46,8,19,38,26,30,38,7,21,9,35,13,25,24,23,55,39,8,9,9,13,23,6,13,32,26,15,68,10,13,69,16,10,52,5,7,14,24,10,34,9,21,27,29,15,55,52,17,9,17,7,9,8,10,15,6,22,16,26,24,30,21,8,12,8,9,17,20,53,17,6,54,10,11,15,59,31,25,10,9,3,12,31,16,38,11,7,44,28,18,10,72,11,36,11,16,3,29,5,12,25,5,12,9,13,35,61,14,32,43,38,14,7,24,7,8,25,31,7,22,28,10,28,18,13,10,228,14,20,17,11,12,18,54,30,10,26,17,17,42,35,8,7,9,8,20,18,31,17,57,59,67,7,9,7,4,13,4,46,15,10,15,13,27,12,2,25,20,29,21,25,11,9,10,10,18,28,22,12,6,12,21,20,35,16,4,2,8,12,11,34,28,28,10,15,9,11,18,16,8,43,6,30,7,10,8,33,13,18,2,10,10,11,21,13,41,12,18,10,5,22,18,5,27,22,6,21,16,6,0,8,2,17,20,19,6,16,15,16,9,7,40,26,24,13,16,18,15,5,13,35,5,24,6,5,10,21,2,4,17,10,18,11,19,20,5,24,16,21,8,18,16,30,4,13,6,12,6,4,17,5,14,12,23,14,28,12,10,13,18,6,4,7,9,8,9,12,15,6,5,23,4,7,12,12,4,6,14,11,32,7,12,18,25,45,10,14,10,17,2,22,13,13,14,6,14,33,23,51,17,12,6,6,22,8,11,1,6,10,11,11,9,9,5,5,9,19,11,7,2,15,10,12,12,19,16,16,12,12,6,13,14,5,11,5,10,4,12,14,1,9,14,15,7,5,8,13,14,7,4,18,18,9,5,15,14,26,5,14,14,13,23,10,3,19,11,5,14,11,10,13,12,5,5,19,4,9,9,9,13,10,8,1,6,9,17,22,2,40,3,1,15,31,8,5,20,9,4,6,12,6,6,7,4,10,13,5,8,7,5,21,1,23,9,11,4,13,10,13,12,24,9,11,13,11,12,12,7,22,9,11,8,5,26,13,22,19,8,11,12,2,1,14,8,9,5,3
almost,6,27,10,106,4,13,5,36,3,6,22,8,20,85,3,7,9,29,9,4,5,36,13,34,32,14,16,14,8,17,7,161,165,13,56,66,41,13,21,6,9,9,5,13,30,20,17,19,246,36,59,9,21,49,9,6,54,23,17,18,21,6,4,8,32,14,109,16,4,20,70,6,2,6,91,20,52,8,92,22,81,10,19,18,203,28,26,9,39,9,14,12,33,31,43,24,23,3,30,20,16,30,25,15,14,34,13,23,26,25,17,8,25,21,30,48,4,7,53,208,41,30,40,158,40,6,3,8,8,18,8,11,16,48,26,68,10,6,1,17,8,57,61,5,8,60,10,33,13,11,49,9,14,6,17,42,49,7,11,25,24,9,17,3,45,13,11,24,42,10,21,114,25,8,5,19,147,4,9,46,27,10,17,29,4,26,46,22,45,58,7,12,20,5,10,7,12,10,18,19,40,5,11,8,34,6,2,55,7,25,51,15,45,9,10,14,12,13,13,6,4,25,7,12,34,64,29,32,14,44,21,28,21,40,43,30,34,13,18,6,91,52,15,3,30,9,8,30,52,6,17,38,22,12,10,12,11,14,4,34,8,20,4,4,11,36,11,22,31,5,103,17,43,6,4,4,26,13,7,3,107,5,9,19,1,8,12,13,20,3,0,6,15,7,7,7,38,9,10,18,32,21,4,9,13,4,16,3,4,5,3,39,33,7,55,12,23,53,23,3,32,9,47,16,39,10,16,31,7,29,5,12,7,3,11,6,17,8,1,19,9,17,12,12,6,9,46,51,24,12,8,4,8,51,34,9,7,7,24,30,19,17,19,14,8,1,37,10,13,24,5,17,5,15,10,25,7,12,14,7,38,9,27,12,8,50,7,28,33,4,18,5,21,11,22,9,38,3,15,7,17,6,5,7,10,5,11,4,29,10,3,22,13,16,20,6,3,12,4,8,6,9,28,16,6,3,5,14,13,19,27,5,2,7,9,6,2,7,12,3,16,20,6,19,1,5,17,7,39,15,19,5,3,3,81,9,0,9,11,27,16,34,34,31,9,2,28,15,17,3,30,5,3,2,3,16,10,11,18,9,15,14,10,2,12,1,10,8,6,4,63,37,2,2,15,10,2,7,9,7,23,10,17,2,5,72,10,18,5,4,5,5,7,4,16,12,5,4,5,17,9,19,8,15,6,2,18,4,19,21,13,8,1,6,4,9,4,3,41,22,2,0,6,18,24,5,7,25,12,9,40,2,6,52,5,12,43,5,13,9,17,3,10,4,9,12,13,16,19,37,12,11,15,4,10,3,8,22,14,15,18,4,20,15,10,7,9,22,3,13,11,23,12,6,25,21,13,7,30,8,19,8,9,5,5,27,5,9,3,8,36,22,5,6,32,7,15,5,9,6,20,34,4,16,2,12,4,6,7,29,22,14,17,32,6,3,14,14,4,14,14,4,1,27,4,22,9,5,8,134,24,14,5,7,1,18,44,13,8,19,7,4,7,21,3,3,1,18,13,17,16,7,42,27,13,10,3,8,2,10,7,33,13,9,11,5,5,3,9,12,7,10,10,9,6,14,12,4,11,11,11,2,5,8,9,17,11,5,7,3,3,2,11,26,18,20,1,4,5,10,13,5,7,22,6,7,6,3,6,30,8,18,4,6,4,1,28,9,37,15,9,13,5,21,18,6,22,12,7,1,7,6,11,6,12,13,11,5,7,14,17,18,3,11,26,30,29,13,13,6,8,9,10,6,6,11,19,1,21,13,6,6,11,5,13,10,10,19,20,9,10,11,4,5,13,19,5,8,4,7,1,4,12,4,3,5,11,8,16,8,8,8,9,10,3,3,9,7,5,9,4,5,12,8,7,9,2,8,22,6,9,6,10,1,5,12,7,27,7,5,2,4,4,7,11,17,7,5,5,11,14,26,14,7,6,9,7,4,4,6,4,2,3,4,4,9,6,4,6,12,3,5,3,24,10,12,1,11,7,19,4,4,5,7,6,4,6,3,4,4,8,18,9,7,4,4,4,4,15,10,4,5,4,11,10,2,2,14,4,13,8,19,5,3,3,5,5,5,7,1,4,7,7,11,1,4,3,3,4,16,5,5,9,6,5,1,4,15,2,10,6,10,11,5,6,18,21,13,22,2,1,4,6,8,7,6,10,8,9,6,6,18,2,7,9,4,4,9,7,3,6,12,19,8,1,6,8,5,7,11,9,7,6,21,7,4,11,10,14,1,4,1,10,1,4,13,6,5,7,3
area,0,4,3,31,4,12,1,11,9,2,2,8,10,28,1,3,1,8,2,4,1,11,6,3,1,5,3,5,3,3,1,61,48,9,15,26,23,6,13,3,2,14,1,12,5,3,16,13,72,18,12,14,9,35,15,1,9,10,9,10,4,0,3,3,6,5,42,2,3,4,12,2,1,1,32,6,16,6,22,7,51,2,2,5,38,3,14,0,10,1,1,3,7,15,16,8,10,2,22,12,5,14,7,1,10,9,5,9,13,4,3,6,12,19,6,11,0,3,13,41,10,12,10,52,8,1,3,3,3,5,7,1,4,34,1,30,2,4,4,2,2,14,7,2,0,24,3,17,9,0,11,6,6,9,3,25,9,14,2,36,8,2,4,3,8,5,4,11,22,3,18,28,10,4,1,2,24,1,0,31,8,9,21,7,1,5,13,4,9,14,2,1,9,2,0,1,9,10,13,6,12,2,12,5,8,6,16,7,2,13,25,6,9,5,1,3,4,9,7,5,4,2,2,7,13,19,6,5,2,7,7,15,13,24,4,4,10,9,10,2,12,16,2,1,16,7,2,8,24,8,6,8,12,5,14,4,2,0,1,12,0,9,9,1,2,8,16,5,4,4,29,4,9,3,0,4,10,5,2,5,23,2,4,4,8,1,17,12,2,1,1,3,3,4,4,4,7,1,4,4,5,14,0,3,4,1,6,2,3,3,5,10,9,9,4,6,11,11,4,7,4,0,8,5,9,0,13,3,2,8,0,4,1,3,3,7,12,6,2,3,2,2,8,0,8,3,6,9,11,12,3,4,0,19,2,2,4,1,2,4,15,15,13,6,5,1,6,1,3,7,7,16,5,11,8,13,0,2,2,2,17,1,6,9,8,37,4,8,14,2,3,3,4,0,5,2,17,1,10,6,2,3,1,2,0,3,0,0,12,15,1,9,6,5,5,5,1,4,2,5,0,1,14,4,3,3,2,0,2,1,0,1,1,2,7,3,9,1,6,2,2,8,3,14,10,18,6,6,8,4,11,1,5,2,26,2,0,2,3,2,3,7,11,9,6,1,17,5,13,1,5,0,0,4,0,2,4,2,6,2,2,4,2,1,1,1,2,3,0,2,21,11,2,2,8,3,2,1,3,1,7,4,4,7,2,8,13,2,1,2,1,2,0,4,1,2,3,1,0,5,0,1,0,1,0,0,10,0,6,5,3,2,1,2,3,2,0,2,11,7,0,5,1,13,7,0,0,5,3,0,3,0,0,20,2,2,5,1,3,1,3,5,1,2,2,1,3,3,8,9,3,1,4,3,4,1,3,0,1,25,2,2,3,4,2,0,2,1,4,3,8,3,5,4,7,5,3,3,7,4,7,2,2,0,2,6,0,3,4,2,2,6,2,4,5,4,1,8,1,0,5,0,1,3,6,6,7,0,4,11,0,2,7,3,3,3,6,11,1,1,4,7,1,13,2,7,6,2,2,47,11,2,0,0,4,3,8,4,0,2,0,9,0,5,3,0,1,6,1,2,2,0,14,0,2,0,1,1,0,6,2,8,0,7,4,0,0,7,10,13,0,7,3,18,1,3,3,1,3,1,3,1,0,1,3,5,7,3,0,2,1,1,0,4,9,2,2,0,2,1,0,1,0,0,3,3,4,1,0,4,1,4,3,4,7,0,2,1,19,6,4,4,2,2,6,5,9,14,4,0,3,2,4,4,1,1,0,2,7,3,3,4,0,2,20,11,12,1,14,3,2,7,4,3,0,4,9,1,8,3,0,0,4,0,5,10,1,10,6,2,2,6,3,2,3,8,1,5,0,1,0,2,2,1,1,3,6,1,3,1,14,1,3,3,0,2,3,3,1,6,2,0,1,6,13,1,7,3,0,2,0,3,3,3,3,1,1,10,5,1,0,2,0,3,5,0,2,3,2,3,4,3,0,0,1,2,1,3,0,3,0,3,1,5,1,0,0,0,8,4,4,5,0,0,5,5,0,0,4,5,0,3,2,0,5,1,4,3,5,1,1,10,0,0,0,0,2,3,2,3,3,0,2,3,0,2,0,1,1,4,3,3,1,1,0,1,2,3,1,2,0,5,1,1,3,1,8,0,0,4,2,4,1,11,0,1,7,5,3,4,0,3,1,0,2,2,2,16,3,0,3,1,0,4,3,0,21,9,4,0,56,8,0,0,2,6,2,1,2,1,3,2,3,4,0,1,2,2,3,0,1,0,1,0,1,0,2,11,2,1,0,7,1,5,5,0,3,1,4,1
health,3,43,16,167,8,24,6,10,25,7,4,9,21,74,3,1,15,8,11,3,3,26,56,38,26,39,19,43,9,29,0,241,80,34,35,88,22,9,14,12,9,10,4,34,22,7,49,46,89,70,31,26,13,69,91,0,15,17,32,13,4,4,4,12,31,10,162,10,5,11,106,1,10,3,180,22,61,4,53,41,48,28,7,7,114,6,9,14,25,4,8,7,34,25,19,2,26,1,51,8,9,26,10,17,12,36,6,35,33,5,36,11,35,23,75,50,2,0,54,96,20,132,55,175,14,2,3,8,8,6,21,3,17,67,33,160,3,10,9,17,10,51,30,4,5,69,19,28,7,2,17,7,11,7,21,53,43,9,3,137,170,3,21,4,22,115,9,17,36,5,8,110,55,2,21,12,50,2,6,122,28,23,63,50,0,25,27,6,13,30,3,2,11,20,17,5,70,16,16,7,33,28,13,1,11,30,0,88,19,15,81,34,55,13,19,71,28,44,18,4,4,19,9,12,26,42,13,20,11,35,8,5,56,50,41,5,35,17,6,12,60,49,50,40,11,4,7,54,107,13,27,8,21,2,2,24,6,17,2,23,16,29,13,0,7,44,57,35,11,18,32,12,8,24,2,26,33,4,3,3,92,12,11,19,12,17,1,456,13,31,0,8,26,12,1,12,29,4,3,17,18,30,3,2,9,12,23,6,76,8,10,36,40,28,75,4,50,12,5,13,35,7,28,21,36,6,27,58,3,5,10,12,4,9,3,8,25,3,2,6,5,11,39,2,9,11,24,36,18,79,7,13,1,39,10,7,37,6,7,37,37,50,16,11,1,12,14,3,116,42,7,47,9,43,1,72,4,0,9,7,30,13,14,26,30,6,6,18,29,11,7,13,10,2,8,7,19,8,10,5,11,9,10,5,2,7,4,3,5,32,0,2,2,17,4,9,10,5,6,10,2,5,6,3,8,2,6,3,0,3,0,7,0,7,12,4,2,8,12,0,9,21,1,2,1,2,31,10,17,6,59,2,29,6,13,5,11,1,5,5,13,24,15,28,10,2,35,7,10,9,50,18,1,4,5,5,8,9,10,14,3,17,1,3,6,2,3,14,2,4,21,13,2,7,9,2,3,6,5,4,7,4,3,182,21,4,6,9,5,1,3,3,4,12,5,3,23,5,3,8,2,0,4,13,2,1,28,1,7,22,9,11,2,1,3,5,3,4,21,33,3,3,3,9,13,3,4,39,2,2,2,2,2,35,10,12,15,6,4,5,6,9,17,10,7,3,2,3,13,22,6,2,14,8,6,1,0,1,1,41,3,7,14,10,6,3,3,5,0,14,10,13,14,27,27,7,7,7,2,6,10,1,8,0,2,8,2,4,3,0,17,10,8,4,14,2,0,3,1,2,6,0,6,11,12,2,0,7,3,22,2,13,13,14,11,7,9,6,14,4,4,2,2,10,3,12,5,6,18,34,7,4,4,3,3,7,4,9,1,10,6,1,2,0,4,3,0,1,3,7,8,1,0,20,5,1,3,1,3,2,7,8,3,4,6,5,14,10,1,1,5,32,6,1,5,10,3,0,5,4,4,0,1,3,3,4,11,7,5,3,0,1,1,20,8,8,11,3,2,6,4,5,1,29,3,3,0,8,4,14,4,8,8,0,0,0,4,2,0,13,5,0,2,3,1,0,8,14,4,1,9,0,6,4,11,10,3,14,6,2,4,30,3,5,29,6,25,8,13,2,11,1,4,4,3,11,16,3,6,4,1,1,8,7,4,5,3,0,1,19,10,8,3,3,2,24,0,2,4,3,5,2,1,10,14,4,3,4,17,6,4,0,5,0,1,2,1,12,1,3,1,1,6,12,2,0,21,6,5,4,28,9,5,1,11,0,7,14,3,17,2,6,4,17,6,2,5,2,2,12,7,3,6,1,5,5,4,0,0,5,1,8,1,0,1,0,2,0,2,26,20,1,0,0,1,6,0,3,5,0,1,0,1,2,12,0,5,2,6,2,6,3,8,3,0,0,1,5,3,9,3,2,8,6,1,4,0,5,1,15,10,3,1,3,8,1,0,1,4,3,2,0,1,0,2,1,0,1,0,1,4,12,0,1,1,0,6,3,1,9,0,13,6,1,2,10,6,20,4,0,7,5,11,15,1,2,1,0,8,2,0,3,3,6,3,4,2,6,0,0,1,2,22,20,0,2,17,0,3,3,0,6,3,0,4,1,1,46,0,20,7,6,2,13,14,26,16,0,7,9
care,14,34,13,157,18,27,7,18,19,9,6,16,24,101,14,2,7,17,10,2,2,41,59,57,29,44,25,37,11,35,9,279,121,42,70,87,20,2,18,6,20,11,7,27,42,11,50,30,154,79,52,22,13,52,152,7,67,25,24,24,3,3,7,20,42,12,184,13,4,17,73,3,12,5,192,23,74,10,86,45,64,30,18,19,199,40,13,8,24,3,7,6,30,23,43,14,35,5,44,20,10,48,24,18,23,25,4,44,28,7,29,11,30,24,62,45,3,3,61,154,41,98,60,164,16,6,4,5,8,7,44,4,15,82,43,200,6,9,9,14,7,51,28,16,6,164,21,26,22,14,28,9,16,13,25,23,59,11,6,121,134,26,20,7,24,102,11,23,39,9,13,125,48,15,14,9,113,6,12,123,33,20,32,39,3,26,47,20,15,46,5,14,5,15,26,5,60,17,8,16,41,15,14,5,25,45,10,104,16,31,87,26,47,27,20,61,32,34,25,7,2,29,3,21,46,96,37,31,13,23,16,26,50,40,54,24,51,11,3,12,72,55,36,27,13,10,14,73,104,12,21,15,22,5,8,26,11,13,1,37,17,39,18,0,8,59,32,30,15,14,127,11,13,16,12,8,35,14,10,9,118,13,7,17,13,12,456,1,17,25,3,8,22,14,3,15,37,8,4,24,35,30,3,2,6,11,31,4,77,3,4,42,35,29,71,10,56,26,8,17,35,9,42,17,67,2,20,62,1,17,6,15,5,9,6,12,24,1,4,9,18,12,45,19,18,15,25,45,16,86,9,14,6,77,19,10,31,5,14,35,34,34,11,31,7,15,26,4,98,49,3,52,5,34,13,44,4,3,6,8,57,18,47,17,34,47,6,21,52,16,15,10,11,1,28,8,30,7,24,5,14,11,10,3,7,11,12,1,26,25,6,8,7,19,3,12,5,8,10,5,1,12,20,6,3,5,4,13,11,10,4,3,0,8,8,3,1,5,9,4,18,38,10,5,6,1,35,7,44,11,38,8,34,2,40,6,7,5,5,16,11,31,24,48,12,3,44,16,6,7,42,19,1,18,8,22,2,13,30,29,16,9,1,8,7,3,11,19,10,2,67,38,1,8,14,6,7,11,8,6,13,9,5,71,17,8,17,10,2,14,9,2,8,4,10,9,13,6,6,4,4,7,3,22,6,6,31,4,11,23,13,12,2,11,6,8,11,12,44,31,2,3,2,14,12,11,2,32,12,6,36,14,2,41,5,13,24,10,6,10,14,7,22,6,7,8,12,4,25,37,12,4,16,6,8,5,8,10,6,42,7,9,23,23,8,6,3,10,3,18,15,23,17,15,15,8,4,1,19,8,12,3,7,2,4,19,8,10,2,6,40,11,11,8,22,5,15,2,6,4,13,8,2,27,7,1,3,8,13,14,4,20,20,23,6,3,18,9,20,9,17,8,4,19,7,35,3,6,14,82,4,6,18,5,7,9,18,12,0,10,10,3,9,6,2,1,1,6,6,4,13,6,18,15,13,2,11,3,3,9,1,19,9,2,14,10,15,10,3,13,4,25,14,11,3,20,3,1,15,12,2,3,4,10,7,12,17,16,5,7,3,7,3,12,14,41,17,2,9,12,8,5,4,26,4,8,7,8,4,19,7,7,5,8,3,11,25,8,17,12,20,7,9,13,6,3,15,8,10,15,7,4,6,5,9,16,8,10,4,13,16,23,4,7,25,13,16,11,10,3,15,14,1,30,8,15,19,4,24,8,2,5,9,7,6,7,10,0,5,17,7,16,7,1,10,40,0,8,6,3,1,7,7,4,11,9,9,8,13,2,5,3,4,5,6,6,6,14,5,9,4,3,11,12,3,2,19,6,10,2,18,10,11,3,18,1,10,24,8,16,6,4,0,12,7,4,14,6,6,14,15,12,6,5,9,6,5,5,5,5,7,4,10,3,2,5,12,3,2,18,8,1,1,5,1,7,6,5,9,0,3,3,3,6,12,0,3,3,2,2,10,11,14,1,3,1,3,2,5,11,11,8,14,5,2,1,1,2,2,17,10,2,6,9,10,4,4,7,9,2,4,4,9,7,1,8,3,11,2,3,8,11,7,6,6,4,6,8,2,11,7,27,2,1,8,14,8,12,15,0,6,5,16,14,8,1,2,6,16,2,4,4,2,5,1,10,7,10,4,7,4,8,26,15,1,1,33,1,7,4,2,1,9,4,11,5,8,29,5,41,7,1,6,15,10,22,12,3,2,5
nothing,4,34,21,151,33,12,10,60,3,6,19,15,8,133,11,16,4,43,11,7,6,46,30,48,41,28,38,19,13,34,20,205,166,19,69,108,82,12,13,16,16,19,4,5,48,21,24,11,313,49,98,18,22,63,12,6,66,9,14,21,36,9,5,19,21,20,156,6,18,26,8,2,8,6,150,22,21,6,112,40,58,3,10,16,255,16,16,2,33,2,13,9,0,41,72,7,16,7,55,15,10,32,43,20,14,46,10,7,11,13,24,3,15,17,5,32,3,4,77,284,58,35,23,80,15,8,2,2,3,0,15,17,14,52,34,66,32,4,13,20,20,37,50,5,8,94,17,26,15,21,103,5,32,12,5,22,49,13,14,31,15,4,23,3,1,14,5,29,31,11,17,134,37,0,16,14,231,5,23,54,64,28,9,22,9,34,64,30,50,73,11,19,11,1,2,5,20,17,8,38,51,1,3,13,28,14,7,53,18,45,106,15,34,15,8,21,5,4,10,2,4,25,8,19,66,120,39,54,5,8,18,16,17,36,60,18,49,17,9,10,82,32,15,25,34,9,11,39,63,6,9,20,18,1,7,27,38,3,5,21,10,42,29,1,7,30,1,17,24,9,160,5,22,10,5,2,24,8,2,5,102,11,2,40,20,2,13,17,1,15,7,8,13,7,2,11,41,9,9,36,39,27,1,10,14,5,36,16,15,3,0,28,40,9,56,13,24,42,15,11,69,15,58,6,116,8,12,60,3,35,12,10,18,8,12,22,21,3,6,19,15,17,28,25,6,9,68,71,16,17,15,21,12,33,33,2,11,11,26,35,28,10,11,28,9,3,36,23,18,36,3,27,5,14,20,27,24,7,34,8,120,6,48,15,6,38,7,42,52,17,49,4,17,16,21,16,57,6,47,6,36,10,8,9,12,18,16,8,19,21,13,14,0,14,8,17,7,10,7,8,16,10,19,25,5,18,6,48,15,35,25,5,5,11,10,11,3,15,15,5,26,32,13,24,2,4,18,21,45,19,32,5,5,10,75,8,4,10,25,35,27,45,30,76,10,6,29,13,3,5,37,9,3,5,2,42,12,16,29,12,11,20,5,9,13,12,15,12,9,3,119,44,7,6,14,4,5,11,12,27,10,9,13,5,5,25,2,13,12,9,6,10,15,4,12,19,12,9,9,13,9,28,11,25,17,13,34,25,23,50,22,13,13,21,9,19,17,22,51,23,11,4,9,15,8,15,3,31,12,11,62,8,12,46,5,11,26,2,6,11,21,5,21,11,17,20,12,10,59,28,16,14,9,0,13,7,20,7,14,25,6,23,19,31,13,30,6,6,3,15,38,46,15,8,37,7,6,10,49,33,30,0,6,8,4,28,5,49,9,8,33,13,13,8,35,12,12,5,14,8,16,3,8,36,4,5,4,14,23,28,33,26,50,29,14,8,37,4,10,7,26,2,23,12,10,18,7,4,9,166,20,8,4,2,10,16,45,26,16,19,8,4,12,17,6,8,6,9,13,14,22,14,59,31,31,7,6,2,0,3,2,28,26,12,8,13,23,10,7,8,22,32,17,11,7,7,9,5,12,9,1,2,8,12,9,16,22,15,7,6,7,7,8,35,15,32,6,15,10,16,9,13,13,29,8,4,13,9,10,16,9,14,5,13,3,7,32,7,34,10,17,5,2,15,8,4,20,9,6,13,18,7,3,8,2,11,6,9,11,5,4,29,1,3,13,15,14,10,5,20,11,4,1,20,8,16,16,3,4,11,1,6,15,4,13,5,5,39,7,25,3,9,3,10,27,28,8,11,6,12,3,5,10,7,29,7,14,12,24,7,3,1,7,10,13,5,12,16,7,23,8,3,3,13,2,4,10,12,4,7,6,11,17,9,10,16,12,55,9,10,13,15,6,13,8,7,5,11,8,15,22,34,12,4,8,8,11,5,5,0,5,10,11,4,5,7,7,5,9,9,3,5,6,16,11,8,8,25,13,26,1,12,3,8,2,6,3,7,4,3,5,8,6,6,11,1,4,5,5,22,8,5,8,11,23,7,0,13,2,18,7,5,10,6,20,8,5,2,14,6,13,14,4,6,9,6,8,28,4,7,5,4,9,9,5,7,5,6,8,13,1,25,6,4,8,17,17,7,34,7,0,7,8,5,1,4,5,5,15,13,1,4,5,3,1,4,5,6,7,2,20,3,5,8,5,10,5,9,5,9,3,9,7,13,10,6,11,7,19,6,7,4,9,3,1,6,9,3,4,4
something,6,30,5,33,1,6,1,5,0,3,3,4,9,26,0,2,3,9,4,2,3,3,21,39,7,18,7,18,4,4,1,57,52,8,20,54,19,3,3,4,2,5,5,5,13,3,4,2,60,33,18,8,3,24,18,4,11,3,12,5,2,4,0,3,20,5,68,5,3,3,11,1,3,3,60,9,28,0,46,18,18,4,5,4,44,13,4,2,11,1,6,0,5,6,21,8,12,0,13,6,7,10,7,6,7,9,2,8,5,0,5,1,6,11,13,9,0,4,19,55,12,17,12,56,14,3,1,1,6,3,7,6,5,15,12,39,2,2,2,9,3,14,19,1,2,38,5,8,8,4,12,6,4,4,3,10,31,0,2,18,12,1,8,0,7,26,3,5,15,4,14,46,15,1,11,0,28,1,6,25,23,8,4,8,2,14,20,7,4,11,6,3,6,4,3,3,5,2,3,3,14,1,4,5,6,5,1,24,5,9,41,15,12,7,16,35,6,5,5,1,0,10,2,8,12,26,7,17,4,6,7,3,7,5,26,17,15,1,1,0,28,14,8,25,4,2,3,13,18,2,2,16,17,0,2,7,1,0,1,5,7,8,1,0,3,8,3,4,7,9,38,4,6,1,1,1,12,4,1,1,37,6,0,5,3,1,31,25,15,1,0,2,8,5,2,3,9,2,1,13,9,8,0,1,3,0,8,3,4,0,0,4,10,1,29,1,27,11,3,3,9,1,16,7,23,1,7,28,0,6,2,2,4,0,1,1,9,2,3,4,4,8,21,1,1,6,3,19,2,16,4,1,0,23,2,1,2,0,6,9,4,3,5,3,0,6,12,2,15,13,0,6,2,13,0,5,5,1,8,2,10,5,14,3,3,5,7,6,20,5,5,1,8,5,6,7,5,0,6,1,2,3,5,0,2,1,6,1,10,4,1,1,3,4,4,0,0,3,1,1,2,1,3,5,3,2,2,3,3,5,1,0,0,3,6,2,1,3,5,3,2,3,4,6,2,0,8,0,11,5,9,0,6,0,14,0,3,2,3,2,8,15,6,6,2,1,11,11,0,5,12,12,1,6,2,15,1,4,14,9,2,2,1,1,2,2,1,3,2,1,29,4,1,2,4,2,1,1,3,2,6,1,1,10,3,0,0,4,1,2,2,1,2,0,2,2,3,0,1,3,2,0,0,6,1,1,5,1,5,7,9,6,2,5,3,2,1,1,12,2,2,1,8,3,9,2,0,8,0,2,13,1,1,10,3,5,0,1,3,2,3,0,3,0,4,4,1,0,5,9,7,2,3,0,2,1,4,4,4,8,4,2,10,3,3,2,3,3,1,5,7,7,2,1,5,1,1,5,2,9,6,0,3,0,1,6,0,4,2,1,7,10,0,1,9,2,0,0,3,1,2,1,0,6,1,2,0,2,2,9,0,4,12,6,2,0,1,1,1,2,6,2,1,4,0,4,0,1,1,31,1,3,3,2,2,5,5,2,1,1,2,2,1,3,0,0,0,1,0,0,3,3,2,4,4,0,1,2,3,0,6,9,0,1,0,0,1,0,4,3,1,9,0,3,3,3,2,0,1,1,1,0,2,3,1,4,4,4,0,0,0,1,1,14,4,17,5,1,2,2,2,3,2,7,4,6,3,1,2,3,1,5,0,3,2,2,9,2,4,6,3,1,3,3,1,1,3,8,4,2,1,1,0,0,0,0,0,1,0,1,0,17,0,1,4,3,6,0,1,0,3,1,1,4,2,3,4,1,0,4,2,1,4,0,2,1,3,4,3,0,3,3,1,1,0,3,1,1,0,0,0,3,4,0,2,3,3,7,10,2,1,0,2,1,0,0,1,8,1,2,0,0,3,2,0,1,4,0,0,2,3,1,3,6,2,0,1,6,2,1,0,1,2,5,1,1,3,0,0,2,11,1,2,1,0,0,3,1,1,0,1,2,0,0,3,4,1,1,4,4,1,1,1,2,3,3,0,0,4,3,0,2,0,0,0,1,5,1,1,0,6,3,12,3,0,0,2,4,2,6,2,0,4,3,2,0,0,1,0,7,0,5,1,4,7,1,3,1,1,0,1,0,1,3,0,0,1,0,1,1,0,1,1,1,0,2,1,0,0,1,3,1,1,2,4,2,3,3,4,1,0,3,3,5,1,1,2,1,0,0,0,2,0,1,3,2,0,3,0,0,3,2,1,7,0,1,0,1,0,2,0,1,2,0,1,0,1,3,0,1,2,2,2,2,1,1,7,1,2,3
august,7,30,5,66,4,1,7,17,7,1,15,9,8,11,1,3,5,13,1,4,1,26,2,9,10,8,4,8,4,15,6,110,49,0,14,18,28,3,3,1,0,0,2,0,9,4,17,9,253,4,23,2,1,4,1,1,32,40,0,11,13,1,1,10,4,0,22,1,3,9,9,4,3,0,11,0,10,4,39,5,25,1,9,3,115,5,4,0,84,6,24,0,4,17,21,7,18,5,20,2,3,14,21,0,2,24,2,2,10,5,10,1,3,6,2,16,21,4,87,53,13,22,0,45,6,1,2,4,4,2,2,2,2,15,5,17,4,5,2,0,1,20,26,3,4,42,3,0,1,9,23,2,12,1,1,5,10,1,9,1,7,1,2,15,1,0,6,7,9,2,23,33,4,0,1,7,90,0,2,8,11,8,3,12,1,2,14,3,26,56,4,3,10,0,0,3,4,8,10,3,9,1,0,9,16,1,2,10,11,7,40,2,9,5,0,0,0,1,2,0,3,16,7,16,15,42,17,11,6,3,5,17,8,12,8,4,15,0,5,3,24,8,8,2,9,6,2,12,23,0,1,10,6,5,4,1,9,16,5,23,2,29,30,13,4,30,1,0,4,7,71,4,19,3,2,0,14,3,7,4,11,1,2,6,0,1,0,3,7,0,1,26,6,6,10,4,31,6,5,9,17,14,5,18,4,0,9,3,0,0,1,3,20,3,15,11,2,22,7,0,24,2,3,0,15,1,2,9,1,12,0,0,7,1,2,5,2,2,2,9,8,10,2,5,2,2,16,24,4,0,3,4,1,7,9,2,2,2,9,15,3,1,2,4,0,0,17,3,2,3,1,4,0,1,1,4,1,0,5,1,13,0,17,8,1,25,3,27,18,0,6,2,7,18,13,4,27,5,41,5,8,0,1,2,3,0,2,2,12,3,0,6,14,6,17,3,0,1,4,1,3,9,1,13,0,1,2,8,8,31,11,24,12,46,2,11,0,22,3,3,9,2,6,5,2,0,0,4,5,1,2,3,1,1,31,3,0,6,0,26,6,8,8,12,4,5,8,11,2,0,6,0,1,0,0,1,0,16,9,2,4,8,1,6,2,11,3,0,4,7,47,18,1,6,8,7,1,5,2,5,1,3,4,0,5,7,3,6,3,1,2,2,14,5,12,5,4,2,0,3,0,12,2,12,6,4,7,3,10,4,1,0,9,4,9,1,9,0,18,2,2,4,0,1,5,6,70,6,6,8,8,4,3,16,4,1,20,3,3,2,9,6,27,6,3,6,13,5,22,6,3,2,11,2,9,11,20,7,2,7,3,12,3,3,1,1,6,2,3,5,14,10,4,2,9,1,0,4,54,8,9,0,0,10,4,8,5,11,3,5,14,18,22,1,15,9,8,1,8,3,6,0,2,12,2,1,14,5,3,19,2,14,9,5,8,1,4,5,1,3,2,2,0,14,4,42,0,14,4,182,41,0,2,2,5,5,13,9,6,12,0,4,39,23,12,9,12,6,6,7,14,2,30,5,28,4,1,6,26,1,15,18,3,5,10,4,1,3,7,11,32,2,14,3,4,16,8,1,11,12,4,8,3,6,0,4,4,2,0,5,1,71,4,13,5,26,22,4,15,2,4,11,7,12,0,4,1,1,1,9,2,7,0,3,3,3,8,1,12,3,7,6,0,7,10,1,4,0,1,6,6,6,9,47,13,6,3,3,1,20,20,2,17,21,11,3,9,1,3,5,1,1,6,14,3,4,3,2,4,6,2,3,3,0,9,2,0,18,1,10,2,7,10,4,9,3,3,8,1,8,4,12,13,8,0,1,0,3,4,8,7,2,23,8,1,8,0,10,4,2,1,3,21,28,4,4,0,11,3,4,4,3,2,4,4,1,4,9,2,6,9,1,1,6,4,2,0,9,4,8,17,17,1,1,2,4,4,0,8,2,8,0,5,1,1,2,2,4,8,5,4,5,1,2,3,4,6,2,6,6,10,14,4,8,28,1,12,8,0,3,6,17,0,2,3,58,2,10,5,2,1,2,3,2,8,45,2,10,5,12,3,8,1,10,4,28,7,8,3,4,3,5,1,9,4,8,3,21,6,4,3,3,4,3,1,1,3,1,0,3,4,4,2,1,1,7,0,4,22,0,6,4,1,2,1,10,4,2,19,3,0,2,7,2,13,39,3,0,0,1,3,0,0,1,9,2,0,2,3,4,2,2,5,4,2,1,2,2,17,0,1,5,3,0,0,0,1,9,0,0
sign,13,24,6,71,2,11,7,16,7,1,24,21,9,41,0,0,8,18,3,1,3,10,24,26,10,13,16,16,7,28,8,86,65,14,26,55,38,4,5,4,2,4,2,8,18,12,22,16,184,44,39,8,7,33,5,1,13,14,13,10,13,10,0,22,6,6,34,3,7,6,11,0,2,2,28,7,13,2,45,13,11,0,9,6,106,4,5,1,43,4,9,7,6,27,12,2,15,0,19,7,4,10,10,9,7,14,3,4,8,5,14,5,7,9,12,21,12,3,43,43,12,33,8,53,11,9,3,3,4,6,11,2,0,30,16,41,3,2,6,4,3,25,12,2,4,46,9,15,3,2,29,8,10,3,5,12,23,8,5,22,3,1,1,7,5,9,0,16,9,2,9,58,11,1,12,6,60,2,1,19,5,9,15,22,0,13,9,2,18,42,1,1,3,2,4,3,3,10,7,5,7,1,1,13,6,5,0,4,4,17,36,11,26,5,8,14,0,4,10,1,2,12,2,9,19,35,11,6,6,1,12,9,12,11,14,0,18,1,6,7,31,8,1,4,11,0,7,25,37,6,9,7,12,0,2,5,4,2,1,7,1,23,20,16,10,13,3,15,10,3,39,3,8,5,1,5,6,1,4,4,32,1,1,10,6,3,8,8,8,2,26,1,39,9,9,4,25,10,6,10,13,6,3,3,2,2,26,5,3,1,3,1,23,13,9,5,4,20,3,2,14,0,18,4,29,3,3,26,1,20,14,10,9,2,2,3,8,13,0,4,5,22,8,2,1,6,6,44,8,16,5,8,0,19,5,1,3,0,6,20,15,7,6,5,0,4,13,5,10,20,4,30,2,13,5,9,7,1,9,2,39,2,15,6,10,11,2,13,13,0,11,8,13,57,13,6,25,5,22,3,10,9,3,4,2,0,4,1,10,13,2,6,5,4,5,10,12,7,7,13,2,3,12,5,2,2,0,9,4,16,7,12,5,24,4,14,9,31,10,3,7,12,6,11,3,0,17,10,3,3,18,8,16,1,29,5,7,7,5,22,16,12,13,11,0,6,13,9,7,2,11,5,5,0,3,2,1,17,17,4,1,7,3,11,2,2,1,7,2,1,37,20,3,7,5,0,3,2,4,0,3,0,0,3,3,5,2,4,8,4,2,1,8,4,2,1,5,4,0,6,1,4,6,8,2,4,5,3,12,6,6,2,3,2,7,11,4,3,18,4,2,15,2,2,1,5,2,6,4,1,5,3,1,18,3,3,13,1,1,6,15,3,11,3,2,2,1,0,9,12,3,5,2,0,2,2,6,6,2,16,0,11,8,14,0,4,3,2,0,3,9,16,9,4,7,0,2,2,105,3,17,1,4,35,11,2,3,10,2,1,12,28,13,2,9,2,9,0,2,1,2,0,0,11,1,3,9,2,3,10,2,4,6,2,5,0,2,3,5,3,2,3,2,16,3,16,2,8,2,143,18,5,1,5,2,9,13,12,5,6,3,3,72,22,23,37,11,4,6,7,8,3,24,11,14,1,2,5,6,2,14,9,3,3,7,0,6,3,0,9,33,12,15,6,4,10,3,13,7,6,25,9,0,2,2,7,2,3,0,6,1,29,4,2,10,6,15,1,16,3,3,5,2,10,0,3,5,1,1,3,2,7,3,3,1,1,1,1,9,2,10,2,3,4,3,0,2,5,1,2,2,5,0,8,5,4,0,6,1,2,2,6,8,7,13,1,8,3,0,10,4,2,1,6,1,5,2,1,3,2,0,1,4,2,7,0,1,3,3,2,7,1,0,3,0,0,1,9,5,5,3,2,3,7,9,0,4,3,6,1,2,9,0,6,0,8,1,14,2,3,0,2,34,3,0,0,6,16,12,2,3,1,2,1,5,3,2,5,1,5,8,0,2,5,2,1,0,31,0,6,8,2,4,0,2,4,3,1,1,3,8,4,1,2,1,4,3,8,6,2,0,1,2,0,3,1,8,8,13,7,11,8,4,5,15,3,5,0,5,2,3,2,0,1,3,11,4,1,5,5,1,4,6,2,2,5,7,16,2,7,3,2,3,4,1,12,0,5,4,3,1,7,0,8,6,4,6,15,4,4,8,4,3,3,1,2,2,1,6,2,2,3,0,0,2,6,1,2,4,3,0,4,2,0,4,6,0,0,10,4,2,0,2,1,8,3,0,2,4,0,0,1,4,6,3,2,7,1,3,1,0,2,6,1,1,1,3,16,13,4,1,4,1,3,1,2,1,4,1,7
bill,28,136,37,396,9,12,4,13,8,3,1,31,19,36,8,16,21,28,16,5,18,75,51,52,31,45,17,21,2,56,4,262,105,8,91,55,18,15,10,1,11,7,1,27,59,18,103,19,261,52,54,5,5,23,21,0,95,42,14,7,12,2,5,14,20,13,161,15,9,27,38,9,13,5,113,19,56,0,175,39,66,3,12,8,263,60,22,6,37,8,17,8,14,20,60,29,16,6,37,21,18,36,25,10,11,47,26,26,25,17,33,10,22,45,32,23,12,13,123,281,34,41,86,119,10,4,3,2,17,8,13,5,9,83,28,88,11,9,13,12,4,10,23,2,3,107,7,13,12,28,103,11,49,4,7,56,56,12,7,34,24,10,23,8,35,37,7,13,39,10,11,125,32,6,4,20,211,4,12,66,32,12,18,40,15,20,43,25,30,78,16,10,12,4,11,6,31,5,24,21,43,5,11,11,25,17,14,36,13,22,118,21,219,22,13,47,13,46,41,8,6,31,5,21,92,220,26,33,4,25,23,31,39,32,50,38,43,14,4,12,104,37,11,5,16,16,4,47,109,30,43,36,27,30,10,27,19,14,2,29,11,28,35,32,14,47,10,9,6,3,166,23,50,8,6,2,26,23,23,42,74,12,4,18,15,3,26,22,13,8,6,39,1,18,10,12,54,20,8,4,26,52,5,4,8,5,7,3,9,2,6,16,50,10,88,30,31,36,20,12,18,6,43,5,125,14,13,70,9,26,45,19,8,7,15,45,21,8,12,8,17,36,30,12,4,11,64,48,29,26,19,13,4,36,26,7,10,16,14,42,46,27,5,40,4,10,67,6,37,14,10,30,8,21,15,40,16,8,12,4,143,8,60,10,4,17,25,20,27,4,22,4,160,66,39,27,105,15,76,1,22,3,5,3,6,4,14,0,35,15,1,9,3,10,1,4,3,3,1,0,2,6,53,16,4,4,4,2,7,30,44,7,3,21,9,12,0,9,8,16,16,22,12,5,0,1,16,2,21,7,22,5,10,10,47,16,3,18,6,45,30,24,28,22,10,16,14,17,13,5,25,10,14,7,10,8,5,64,20,14,9,8,0,2,3,15,17,3,4,2,48,94,2,4,8,3,2,40,5,9,10,16,7,7,16,53,7,23,8,13,8,7,11,9,24,57,9,7,5,12,1,27,11,49,16,6,20,16,31,39,29,12,8,10,14,7,5,21,70,24,9,1,9,9,6,23,3,27,20,13,125,24,12,42,1,23,19,5,10,27,49,48,56,8,21,26,6,13,42,50,17,5,75,2,22,12,22,3,5,30,3,15,15,18,12,5,7,10,2,16,31,43,41,5,23,0,3,6,33,19,34,2,7,6,36,30,5,34,13,6,39,29,7,5,55,19,20,6,24,6,30,30,3,63,9,7,5,10,20,29,35,28,28,29,14,14,22,15,13,3,18,4,12,26,7,42,5,20,30,113,19,7,15,28,9,15,59,0,16,27,25,1,8,3,6,3,0,4,10,15,17,7,7,45,13,4,8,33,2,1,14,56,10,13,7,13,22,1,1,7,10,20,17,5,9,11,9,3,19,17,5,9,9,13,11,17,9,6,7,3,2,4,4,52,13,28,0,12,8,10,23,6,1,26,4,2,12,5,11,7,16,16,14,5,7,4,13,6,14,2,24,6,7,5,3,10,25,16,3,15,8,5,12,20,16,8,12,18,5,35,23,16,5,10,15,19,3,9,3,8,8,1,2,15,2,13,27,13,0,14,0,12,10,23,14,3,32,2,10,21,11,15,4,13,14,22,7,32,1,1,5,3,20,50,5,1,12,4,17,4,7,1,10,9,2,3,9,8,8,18,7,8,10,37,7,6,7,60,47,15,8,5,16,6,11,7,8,36,6,3,1,8,9,17,4,9,7,13,14,10,19,51,3,6,6,2,3,5,12,4,2,14,13,6,8,4,4,46,10,19,3,5,17,22,13,5,2,16,16,3,1,7,2,2,18,3,7,5,0,7,6,11,24,3,4,9,0,8,15,2,12,11,2,7,19,4,0,52,4,21,14,14,15,14,6,1,1,19,7,4,19,4,19,12,3,8,0,5,2,24,6,16,6,7,10,5,5,6,4,21,11,11,8,6,9,42,17,17,65,7,18,6,11,7,20,7,4,5,46,8,7,4,15,8,9,12,6,8,20,2,0,27,7,8,6,1,2,9,8,3,6,4,8,34,3,13,3,9,5,1,7,1,1,3,3,7,14,7,0,1
next,2,20,7,135,3,14,0,14,2,3,4,9,19,36,1,2,7,11,10,3,5,26,27,15,18,29,5,19,4,26,4,152,75,9,32,51,19,4,10,5,10,6,1,12,27,11,38,15,103,32,28,8,9,40,25,1,37,38,21,14,3,7,2,7,18,10,51,9,9,10,85,3,5,3,75,16,29,2,56,18,68,2,12,7,141,21,15,11,50,9,24,4,26,28,40,14,16,5,52,9,20,23,29,5,7,32,29,24,24,16,31,5,24,18,17,23,8,3,45,113,26,27,56,265,11,1,0,7,14,39,16,2,11,42,7,63,1,7,3,11,1,24,23,9,2,51,4,20,9,17,20,15,10,5,12,40,28,10,4,35,24,0,20,21,67,22,7,16,17,5,15,80,27,9,10,3,91,3,3,36,18,7,31,18,4,11,26,13,21,46,1,3,3,8,11,3,20,2,20,4,19,12,8,5,17,2,3,22,4,14,49,8,19,7,13,16,35,57,18,12,30,17,3,8,58,52,20,22,12,35,12,31,60,10,35,45,20,8,12,5,45,19,4,2,5,7,8,27,43,5,6,12,18,26,13,4,5,21,5,32,4,14,28,5,9,58,20,11,9,4,74,19,91,2,2,6,11,71,9,8,36,0,9,7,7,4,12,14,7,5,6,9,18,1,12,6,25,4,4,6,15,38,13,12,3,13,9,4,8,2,2,10,46,4,54,10,17,30,10,8,13,3,14,21,23,0,8,23,1,16,7,24,1,2,2,11,18,2,8,10,3,13,22,10,6,2,28,35,18,12,11,10,3,23,16,4,7,5,9,69,13,9,9,8,4,4,22,6,20,12,1,28,9,13,8,35,5,4,9,15,50,2,42,5,5,17,3,14,39,3,6,6,16,5,17,4,38,3,18,2,10,5,4,4,6,5,4,1,18,6,1,3,5,7,6,4,4,6,3,2,2,4,10,3,5,2,6,7,4,15,15,41,31,24,9,8,0,5,21,6,6,6,7,16,1,1,18,4,17,22,24,5,2,4,29,6,2,7,6,22,10,11,21,15,2,1,9,5,3,3,17,4,1,8,2,17,8,9,15,4,1,5,1,4,5,1,5,4,1,2,74,50,2,2,5,1,1,16,4,0,14,7,18,4,10,9,3,5,4,0,4,0,5,4,5,9,4,4,0,5,1,6,4,12,4,7,7,2,11,17,6,3,3,9,7,4,4,4,18,12,2,1,6,5,11,4,1,9,7,6,4,0,1,40,2,5,14,5,3,5,14,10,12,1,3,9,4,3,18,13,16,6,46,1,2,2,5,5,1,35,6,11,5,8,2,5,3,1,4,8,13,15,8,8,12,1,5,4,23,7,16,4,6,2,4,10,5,9,2,7,13,10,6,2,11,9,15,5,3,5,7,0,3,18,5,8,1,5,4,10,0,9,9,11,5,0,4,15,2,6,8,3,0,17,8,49,5,5,7,52,7,3,4,2,4,14,18,10,1,8,1,5,7,9,9,2,1,4,10,6,8,6,23,5,4,4,2,9,5,2,5,18,3,3,12,8,8,6,3,1,13,7,9,4,2,17,6,2,20,5,3,6,3,4,5,9,37,4,1,8,1,28,3,19,15,21,10,3,7,10,1,0,1,14,4,0,11,2,1,12,2,7,3,5,1,2,20,8,8,10,7,0,11,6,7,2,29,8,3,5,4,34,23,64,41,8,5,5,3,13,11,13,5,18,13,5,15,1,2,5,8,0,1,7,6,8,11,4,2,11,1,3,8,10,7,5,2,1,5,7,5,4,2,3,6,6,3,4,1,3,8,5,11,7,6,3,8,8,14,6,9,2,2,8,5,2,4,6,2,9,1,3,4,8,6,4,1,14,3,3,17,11,6,0,2,4,6,13,3,1,2,4,2,4,4,22,4,8,2,6,11,10,0,7,3,3,1,8,0,5,6,0,4,5,1,6,3,2,3,8,5,1,12,1,2,2,1,10,6,0,0,7,1,6,12,2,10,6,2,6,2,12,6,5,1,10,1,3,22,9,3,1,9,8,7,6,3,4,9,12,5,33,0,40,7,12,4,1,2,6,2,7,1,10,0,4,3,4,0,6,1,6,6,6,3,6,5,11,1,5,3,11,133,22,20,25,36,144,116,1,5,3,1,8,2,43,4,2,20,1,1,4,4,2,7,7,6,10,1,3,3,0,12,7,4,1,1,3,15,2,9,1,9,0,4,22,3,9,2,6,2,5,2,4,7,7,9,11,3,1
3,2,12,4,80,4,14,7,9,2,3,3,8,8,28,1,1,1,10,4,1,0,13,7,22,9,10,3,10,1,21,4,82,23,2,11,19,12,6,12,2,3,4,1,7,11,5,10,13,135,18,15,3,1,17,17,0,25,27,6,11,6,2,0,4,5,3,30,8,0,17,59,8,2,4,31,2,11,3,31,7,50,1,0,6,98,11,10,9,47,13,18,0,20,15,48,19,12,4,24,3,10,18,10,1,14,26,16,22,16,7,16,5,5,7,3,25,10,6,78,56,14,17,24,116,11,1,2,1,10,8,6,1,6,22,2,23,1,4,2,2,1,11,27,6,2,42,0,11,4,5,16,7,10,2,3,16,14,2,3,16,9,1,8,40,54,5,1,8,14,4,8,39,8,1,0,3,65,1,0,21,2,2,21,8,4,6,11,12,10,23,2,0,2,1,7,2,16,7,11,1,11,3,8,4,10,1,4,11,6,8,34,9,15,6,1,8,6,15,11,2,12,10,2,4,21,23,13,12,9,32,4,15,24,9,10,17,18,5,5,5,22,15,4,2,6,12,2,3,25,8,4,7,3,11,4,3,4,30,7,17,1,13,9,8,3,26,8,2,2,2,48,19,56,2,4,6,12,25,1,2,14,0,7,5,7,4,1,3,2,2,10,9,10,12,1,3,26,9,6,4,9,31,7,40,5,2,5,8,2,4,3,5,15,1,33,15,8,18,7,1,10,0,14,4,22,5,1,17,2,15,2,4,0,0,3,5,3,2,2,11,1,9,2,6,4,4,13,12,13,9,13,5,2,20,3,5,1,2,1,13,8,6,2,6,0,4,8,0,4,7,0,10,2,11,5,10,3,1,3,0,27,0,9,4,3,19,4,10,7,2,6,4,1,5,16,3,16,2,9,1,6,7,2,0,1,0,5,2,15,3,0,4,4,2,5,4,2,3,3,2,0,4,8,8,0,4,3,6,11,12,5,21,6,77,7,5,4,15,13,3,2,4,6,4,3,0,13,2,7,10,12,2,3,1,25,6,2,3,3,10,6,5,9,4,3,2,2,5,6,0,8,2,0,3,3,2,1,3,9,0,1,6,7,2,4,0,5,2,0,4,50,19,2,0,3,4,2,8,2,1,4,2,0,1,3,13,1,1,5,1,2,2,2,2,1,3,4,0,3,5,0,6,2,5,7,10,6,7,11,11,3,0,0,1,7,4,2,1,17,4,0,7,1,4,4,2,19,3,3,7,3,3,10,25,3,2,10,3,3,3,6,1,18,0,5,2,6,2,15,24,1,2,11,3,3,0,6,3,0,31,1,7,1,0,3,2,3,2,3,3,1,3,4,3,5,0,1,0,16,0,3,2,3,1,2,9,2,8,2,1,10,23,13,1,6,5,5,3,2,4,3,4,0,19,1,0,1,4,1,15,6,7,7,2,3,5,0,12,3,2,2,0,4,5,9,28,3,7,6,102,6,2,3,2,3,7,12,4,2,6,1,2,16,19,3,5,2,2,6,5,4,1,4,13,8,1,3,3,8,1,15,23,5,3,1,4,3,1,3,10,14,1,3,18,4,14,1,2,3,3,6,5,3,2,3,8,12,3,4,2,0,25,2,10,9,5,3,0,0,6,1,0,0,9,0,4,5,1,1,3,0,9,1,1,1,1,16,1,6,4,3,4,3,10,9,1,8,7,5,2,2,14,9,25,8,8,2,3,3,92,86,3,10,37,14,9,5,2,3,7,1,1,4,10,1,4,12,2,8,4,5,0,5,11,12,3,4,0,4,7,1,2,1,1,8,3,2,4,4,6,4,7,4,1,3,1,1,0,8,2,6,2,9,4,3,1,1,10,2,3,0,3,9,11,4,1,1,20,3,3,7,1,1,1,1,0,4,8,1,2,3,1,3,2,5,25,5,11,1,0,3,15,5,3,3,2,1,13,8,5,7,1,4,1,1,1,0,4,2,11,1,14,48,6,5,4,4,4,5,3,9,10,7,2,6,6,4,2,2,6,9,2,1,1,0,18,3,0,6,10,1,2,4,0,1,18,5,5,9,5,0,10,2,28,1,12,1,2,4,6,0,4,1,3,2,0,1,3,3,7,7,2,0,6,1,2,1,3,3,0,1,8,10,10,13,13,10,22,42,2,4,3,3,3,2,13,4,2,18,1,2,2,1,1,20,44,3,1,2,1,1,1,5,8,1,1,3,1,2,3,9,3,2,0,2,3,2,5,6,4,1,2,4,3,0,5,6,0,3,2
the same time,4,18,7,103,8,6,4,26,6,4,11,3,5,70,2,4,5,8,5,3,4,42,5,14,11,12,12,12,5,12,7,154,91,6,52,50,43,12,14,1,7,7,6,3,40,15,25,27,239,20,59,4,14,38,4,12,62,18,2,20,16,11,2,8,22,2,68,11,3,5,7,6,1,5,81,13,13,4,63,15,52,7,3,4,213,15,9,1,35,6,4,11,3,20,42,11,13,4,31,15,14,22,35,7,6,20,8,9,14,2,18,9,16,16,5,29,4,5,61,140,38,22,23,57,8,1,4,7,4,1,7,6,3,45,12,33,6,5,3,12,3,21,28,2,5,47,5,9,16,7,58,1,15,6,6,23,25,10,7,7,11,3,7,3,8,9,7,19,24,10,15,56,8,1,3,6,127,5,13,32,23,17,11,18,4,9,23,13,30,43,2,6,3,1,1,6,15,1,8,10,16,6,8,9,23,15,6,35,18,33,82,6,16,7,2,3,3,8,15,1,6,17,5,13,53,88,21,38,6,6,14,14,25,29,33,21,27,8,7,5,63,32,5,3,16,9,4,22,41,4,11,31,18,4,8,16,7,3,3,11,3,26,27,3,7,33,14,5,16,5,104,10,40,4,1,1,28,19,7,2,31,12,4,11,7,4,12,15,11,3,4,4,12,6,3,1,39,13,6,22,30,28,2,5,13,3,21,3,6,2,2,18,32,5,24,16,21,41,13,11,45,8,19,3,74,3,5,19,4,22,3,14,5,7,4,19,18,8,5,9,13,10,14,13,6,9,41,53,19,4,12,6,5,33,9,5,4,3,20,29,16,9,5,27,5,2,37,3,7,7,3,16,8,6,8,28,7,6,10,7,59,5,35,11,1,50,4,23,17,3,22,6,8,11,35,12,55,5,20,6,30,3,2,1,3,9,13,6,41,22,1,7,2,10,8,13,7,4,3,3,4,5,13,14,3,2,3,13,10,12,24,4,6,4,2,3,4,12,8,2,17,20,2,14,4,1,5,10,29,9,22,6,6,6,53,9,1,10,3,24,9,16,14,16,5,3,17,22,10,0,10,5,2,4,2,8,3,10,17,7,7,13,1,5,5,4,15,7,5,4,59,30,2,8,4,11,1,21,4,14,14,1,2,5,5,22,4,16,4,6,9,1,7,5,14,11,5,5,7,7,7,18,9,20,10,3,25,4,14,27,6,3,3,7,5,4,10,2,33,21,9,2,2,5,18,7,6,26,9,7,23,2,5,50,5,15,28,8,6,6,19,8,27,3,14,14,5,6,29,37,10,8,10,13,7,11,9,6,4,12,12,14,9,13,6,8,6,5,3,4,19,26,11,3,8,3,8,5,37,14,21,3,2,4,4,17,5,16,7,8,17,11,12,11,26,9,18,4,8,6,11,9,3,20,6,7,7,11,9,22,17,11,14,17,4,5,5,4,7,10,14,0,11,21,8,24,1,7,9,152,17,2,10,6,15,10,42,14,6,13,6,4,25,31,8,4,3,11,9,9,16,13,32,26,27,6,2,4,3,3,6,21,13,7,10,7,19,6,4,6,11,13,13,10,18,8,5,7,7,15,3,2,7,2,14,6,15,9,9,5,1,6,8,22,14,21,5,11,5,14,3,7,3,16,2,3,5,2,2,9,16,16,19,5,14,1,16,7,32,11,10,5,3,9,16,6,14,13,7,8,11,14,2,14,5,14,8,14,2,17,17,10,4,1,22,17,9,5,5,12,7,2,2,9,6,13,7,4,7,9,5,8,10,5,9,8,14,6,11,10,6,12,7,5,8,18,4,5,6,7,9,2,11,2,7,2,11,3,6,5,5,9,14,7,4,4,9,10,4,15,8,8,2,6,6,8,2,9,10,8,4,8,14,4,8,14,9,12,7,3,5,8,5,7,5,4,8,7,6,3,23,18,9,10,5,3,1,6,5,3,7,9,5,3,5,8,3,5,10,11,2,1,13,17,3,7,3,5,15,18,3,15,4,4,9,5,1,4,8,12,2,8,5,4,7,7,3,7,6,2,7,12,4,10,4,11,5,12,6,25,13,12,6,6,7,2,3,4,3,5,8,11,5,6,2,8,2,22,4,9,8,10,11,7,7,3,7,3,4,11,1,11,8,3,11,27,12,16,46,3,3,2,4,4,8,4,12,3,21,6,20,1,5,3,3,20,7,0,0,9,4,4,6,5,7,4,6,7,6,6,10,1,6,21,6,6,3,6,14,2,1,4,5,3,0,1,6,6,7,3
receive,52,77,26,496,40,17,24,87,19,8,109,30,29,158,14,18,22,57,11,13,24,141,23,78,67,57,31,47,22,64,33,661,366,32,166,151,113,39,34,18,35,16,49,15,120,53,103,51,1180,75,157,17,38,75,22,13,219,117,14,54,84,22,4,53,57,19,248,17,34,38,78,22,14,14,177,40,72,24,265,78,175,1,71,19,912,99,46,1,191,21,75,21,12,105,222,59,72,27,113,40,37,117,119,39,23,94,22,11,58,25,64,33,15,52,11,98,37,23,274,569,131,76,133,208,17,13,13,28,20,13,34,12,22,175,61,126,28,13,15,10,5,103,101,11,7,215,16,49,52,50,168,11,70,10,4,69,85,11,23,55,41,10,23,15,8,23,19,43,63,32,67,266,76,5,18,45,555,8,16,94,71,34,24,58,21,72,93,64,148,215,8,14,23,2,5,22,64,15,37,38,72,12,13,54,66,28,24,100,42,65,261,27,83,25,16,12,2,12,32,16,24,51,18,48,181,268,81,107,18,38,47,64,45,46,94,90,129,18,17,27,186,106,24,12,32,21,26,69,148,23,35,88,77,51,38,33,56,15,22,72,24,77,105,28,24,141,28,18,37,22,439,59,200,15,14,2,69,58,48,15,161,17,18,58,38,7,29,37,41,9,31,25,54,25,26,39,1,35,42,61,86,111,11,29,35,7,65,16,8,5,9,54,76,19,215,75,74,139,41,14,156,45,64,26,163,10,17,105,28,65,20,46,29,20,24,56,66,47,23,47,29,57,53,39,22,17,133,213,67,37,44,34,27,107,79,12,21,16,45,89,54,24,23,78,26,5,139,23,25,51,14,83,14,29,23,115,20,26,42,32,215,9,127,24,11,88,14,86,93,18,58,14,56,76,120,32,230,24,129,22,91,10,16,7,13,14,20,20,73,37,10,50,14,43,40,33,41,33,18,14,10,35,51,37,4,8,10,45,39,62,99,50,39,79,7,17,2,60,20,15,61,78,24,50,6,13,36,21,87,35,66,27,17,14,179,37,8,37,26,96,36,60,81,72,13,12,52,43,18,0,51,19,7,4,7,58,9,72,60,15,10,47,22,20,41,36,20,14,17,15,195,133,13,14,29,23,16,100,29,30,41,15,19,19,25,52,4,58,32,10,14,7,38,18,34,67,17,24,11,31,12,61,15,54,20,13,63,23,82,85,43,6,13,27,31,30,43,22,129,62,22,5,18,30,31,29,37,63,47,24,63,28,23,124,25,24,122,10,22,31,99,17,86,13,60,44,47,21,130,87,33,38,59,6,28,45,42,17,24,66,24,64,36,40,19,19,19,30,20,33,64,115,33,17,68,10,16,17,245,76,71,6,27,38,37,84,26,61,27,36,92,85,78,25,103,26,58,6,35,28,56,37,13,130,8,28,52,33,40,84,109,82,64,78,19,17,20,40,16,33,53,11,14,100,58,166,17,33,18,723,62,15,23,8,23,49,146,59,39,53,24,21,98,91,49,61,23,34,31,62,52,16,208,83,134,9,14,48,11,12,18,103,72,28,39,43,59,17,8,57,48,49,73,58,54,33,28,29,55,51,45,19,26,19,28,25,107,26,28,49,12,56,9,120,55,110,36,31,43,21,53,21,25,74,7,21,39,11,20,20,22,55,39,13,36,18,59,19,103,26,24,24,13,39,38,14,50,21,16,42,34,63,35,75,36,60,29,35,21,100,97,54,38,18,66,72,40,21,26,42,11,23,7,64,12,38,16,11,51,38,19,19,44,13,38,21,26,83,46,75,25,37,17,17,36,52,22,28,31,20,16,39,52,23,16,11,30,11,84,23,37,23,55,45,16,18,20,44,34,52,29,16,35,40,19,20,12,22,40,18,40,35,16,26,30,20,23,102,46,64,48,20,23,31,33,28,23,28,29,38,75,85,18,28,12,27,20,44,22,11,25,12,62,4,18,27,13,30,21,70,9,12,63,73,17,9,31,64,54,37,36,45,7,21,79,30,36,29,24,20,27,34,9,50,50,45,17,29,35,18,24,44,8,42,35,33,32,80,32,66,21,35,18,81,23,47,26,27,12,15,41,45,14,35,13,22,32,202,18,36,14,37,32,36,13,20,20,19,22,37,8,70,41,27,17,139,50,40,200,27,8,11,7,19,21,35,20,21,77,31,47,32,24,45,19,84,16,19,17,20,18,18,20,30,43,25,38,24,30,13,54,13,40,58,16,42,22,18,71,6,18,6,19,5,3,35,12,41,11,7
message,26,55,10,221,13,13,6,27,12,2,13,9,15,37,0,7,4,9,7,2,8,16,6,34,19,17,21,6,13,17,4,138,53,8,28,28,27,4,8,4,2,10,13,15,18,7,22,25,169,25,24,7,7,32,10,4,37,32,17,10,16,2,2,15,19,8,56,3,3,8,21,1,1,0,33,9,10,6,43,15,31,1,11,1,136,11,4,2,39,7,6,8,4,13,22,16,11,5,23,16,15,20,11,1,12,41,6,4,7,3,28,7,9,9,4,16,36,0,41,57,19,15,21,58,20,3,1,3,1,4,5,4,4,34,10,21,6,3,7,12,3,29,24,3,4,53,5,8,3,2,30,4,4,5,5,32,21,8,7,12,9,0,6,6,6,7,3,14,18,5,12,61,20,3,0,4,102,0,4,31,13,8,26,29,0,20,13,11,19,28,1,6,7,1,1,1,8,3,11,7,29,1,5,22,8,2,4,17,12,17,47,6,15,5,3,2,3,26,8,0,1,16,3,12,26,58,12,15,3,23,6,12,14,21,23,8,18,11,5,2,28,23,3,2,3,2,2,15,34,2,17,7,12,3,3,7,7,5,2,6,4,19,20,15,6,25,5,3,5,6,61,8,19,4,3,0,16,12,15,7,23,2,0,9,9,1,4,8,9,2,6,10,20,4,9,13,35,1,12,8,12,38,1,5,5,2,14,1,3,1,3,17,18,1,12,13,5,13,13,8,21,4,20,4,43,7,4,26,7,12,3,3,3,12,3,6,2,7,2,4,6,36,12,7,0,5,30,35,10,7,3,7,1,30,17,4,4,2,7,15,35,4,14,12,5,3,31,2,12,5,3,17,6,8,7,9,2,6,4,10,40,0,28,11,5,15,0,18,10,1,19,4,12,19,29,4,42,6,24,1,20,3,5,10,4,3,3,9,15,6,0,7,1,10,10,7,9,2,1,3,3,14,25,10,2,3,4,6,3,19,12,16,2,17,2,6,2,12,5,6,10,11,2,5,4,6,5,10,11,1,12,4,7,2,19,10,1,19,4,13,12,5,18,10,3,3,4,6,6,1,13,11,4,2,3,8,0,8,17,2,4,8,4,7,5,5,4,5,5,1,35,28,2,4,8,7,1,5,2,13,2,1,1,1,5,6,5,10,3,2,3,1,3,7,5,13,6,8,14,4,3,9,10,18,2,3,11,13,14,16,8,2,2,9,8,3,8,7,23,15,2,1,4,2,7,6,1,19,3,5,13,6,5,24,8,6,17,1,6,11,19,5,12,0,5,12,9,5,28,28,6,3,13,7,9,4,2,7,1,22,9,8,0,2,3,5,3,2,2,3,9,22,4,6,17,2,2,2,52,11,17,2,3,5,5,6,1,24,5,4,15,18,12,4,17,0,3,7,11,2,5,0,3,11,4,2,14,5,15,17,1,44,8,14,4,2,8,4,1,4,3,0,0,11,7,31,3,6,9,89,13,0,17,6,11,4,20,7,6,5,3,2,10,8,9,6,0,1,13,10,4,3,43,22,13,4,9,6,2,1,1,18,4,8,11,6,7,9,2,8,9,1,8,2,6,9,4,4,4,13,9,2,15,5,4,11,10,1,3,13,3,12,5,21,11,17,11,2,6,2,2,9,4,6,3,4,1,1,2,5,1,7,1,3,4,3,10,2,11,6,8,1,0,7,10,2,7,7,4,5,5,10,5,12,2,13,4,3,9,3,2,6,0,5,5,4,5,6,9,6,4,3,3,7,3,10,1,1,9,2,3,1,7,0,5,8,3,26,1,14,12,5,4,4,8,11,5,33,4,4,5,3,2,11,2,6,4,3,10,5,1,2,3,5,5,1,5,2,1,3,6,7,14,9,0,7,0,6,12,1,6,1,2,6,1,4,2,15,4,9,12,3,6,5,4,7,3,10,3,3,4,17,6,2,6,1,5,0,2,6,2,2,2,0,0,2,7,9,0,45,1,2,2,5,1,2,4,18,15,2,0,13,1,3,2,1,4,19,3,0,5,5,0,2,5,13,4,1,4,1,2,10,4,5,1,7,3,7,1,15,5,0,1,5,5,4,0,2,2,4,7,5,0,7,0,1,3,29,2,2,8,3,0,1,4,0,3,1,9,7,1,4,5,6,3,8,5,15,16,1,0,0,1,1,5,2,3,2,17,0,4,2,3,5,4,4,1,1,0,5,3,1,3,3,17,3,6,2,6,5,1,0,3,0,15,5,1,6,14,2,4,3,0,2,1,3,2,3,4,3
intend,4,32,11,116,4,8,5,36,2,3,17,4,2,47,5,2,7,11,6,4,2,27,9,28,9,20,11,11,5,18,11,142,53,13,33,53,33,6,13,5,11,6,6,9,21,12,18,4,225,29,34,4,4,36,3,2,45,9,9,17,8,11,1,14,12,13,58,2,0,13,8,5,1,1,57,9,17,6,74,17,21,0,8,6,153,22,5,1,16,0,6,5,2,26,24,13,10,5,23,9,9,22,18,8,4,17,7,4,7,1,11,6,5,16,3,20,4,1,69,130,31,25,5,42,5,5,2,4,0,2,12,1,5,41,28,44,4,3,13,4,3,27,14,0,0,50,4,13,4,8,57,8,15,1,2,23,26,0,7,16,9,3,2,4,5,9,1,14,12,8,11,70,23,1,7,5,86,3,2,25,12,13,9,14,5,20,20,11,24,37,1,2,6,1,2,3,11,4,4,6,19,1,3,10,14,5,3,20,9,16,65,9,26,7,4,13,0,2,4,2,2,13,5,13,20,109,12,13,2,3,8,3,10,17,26,10,20,4,5,5,50,16,4,3,11,5,4,32,35,3,7,8,14,5,9,12,5,0,4,8,6,23,18,6,2,24,1,9,14,4,74,9,16,4,3,5,24,8,5,0,43,6,3,8,10,4,3,4,9,1,5,6,8,4,6,6,42,12,1,9,18,24,0,3,9,1,21,6,3,2,7,11,17,5,29,8,11,18,7,2,25,6,19,1,51,3,4,31,9,15,9,6,6,6,9,10,12,5,1,14,3,15,14,9,1,6,23,43,10,4,19,4,5,37,13,3,1,2,17,16,23,3,3,8,3,2,32,6,6,21,2,35,6,13,4,12,4,0,8,5,59,3,18,4,7,20,5,10,22,3,15,4,28,18,27,6,36,5,23,3,19,8,3,5,1,1,7,1,16,11,1,8,2,7,7,14,10,7,2,8,1,13,8,12,2,8,8,7,7,10,7,1,2,9,3,7,3,10,6,0,9,14,6,3,3,1,13,8,16,7,13,5,7,3,30,7,3,6,4,24,5,16,14,21,3,3,10,12,8,3,9,4,0,2,2,10,3,20,17,5,0,6,8,6,8,5,7,3,3,2,38,19,1,3,11,5,5,10,4,5,9,2,3,1,3,29,0,8,3,2,1,3,5,6,15,11,6,9,1,6,4,3,1,13,5,5,23,4,15,20,11,2,4,7,5,8,8,8,16,12,5,4,2,1,5,3,2,6,13,4,62,3,9,21,4,7,20,6,4,6,21,6,22,3,8,10,10,2,36,36,8,2,22,1,3,8,7,4,8,11,1,15,6,14,3,7,4,4,3,8,20,20,11,7,7,1,3,5,42,10,13,1,0,3,3,14,4,20,1,2,19,11,7,4,18,3,23,8,7,5,7,1,4,22,0,5,6,10,11,23,9,14,15,18,3,4,6,7,6,11,9,4,3,11,5,13,7,1,3,117,14,3,4,9,3,9,19,12,2,6,5,1,15,8,5,7,4,5,10,7,15,3,11,20,18,1,1,8,4,6,10,12,6,6,11,6,9,6,1,6,12,16,9,8,3,8,13,7,11,10,14,4,2,6,10,7,10,2,7,2,3,2,3,18,9,10,11,6,11,4,3,3,6,8,0,2,2,1,1,4,4,14,4,4,2,0,15,3,16,2,7,2,6,3,4,6,10,2,5,9,10,1,1,4,0,5,5,3,5,5,5,8,0,4,8,0,2,4,6,6,2,1,2,9,2,7,3,2,4,6,3,3,8,3,6,1,6,1,4,10,0,6,0,4,4,16,0,10,2,3,8,7,12,4,16,0,5,2,13,7,3,3,17,7,1,4,3,10,4,9,4,1,7,7,3,7,4,6,4,2,7,6,2,4,10,8,2,11,1,2,8,8,6,5,7,1,3,15,6,8,10,13,15,5,1,4,2,2,6,1,5,3,6,5,0,9,0,2,7,3,0,4,5,8,4,2,3,12,11,6,0,9,2,3,6,3,1,4,1,18,5,20,1,5,1,2,2,3,6,6,5,9,4,3,14,5,6,9,7,14,3,6,5,7,14,4,1,8,1,5,6,2,5,16,6,4,4,12,2,5,8,3,4,3,5,2,2,6,5,4,2,5,0,0,4,8,8,7,29,3,0,2,6,3,8,0,0,3,17,3,0,4,5,3,0,19,2,4,3,7,4,1,2,3,5,1,3,10,2,5,6,6,3,5,1,11,5,6,8,1,0,2,7,3,0,0,0,2,1,4
others,5,23,19,151,14,14,11,86,7,5,27,10,31,183,6,27,13,27,18,14,8,70,30,66,49,35,26,41,19,32,19,252,188,14,94,141,136,18,20,6,24,27,7,6,50,40,37,24,416,52,80,22,30,103,29,18,121,37,6,37,47,22,4,25,36,19,170,22,18,18,26,10,7,9,195,30,40,4,138,47,88,4,24,17,315,33,18,0,50,3,6,18,4,64,102,27,23,4,63,33,9,47,63,21,25,36,6,7,25,11,30,8,11,30,10,63,2,5,111,234,76,39,39,100,12,8,9,12,6,6,31,4,35,90,52,89,29,11,3,15,18,74,56,8,6,141,14,35,29,19,127,8,35,14,8,32,77,10,20,38,19,5,18,1,5,23,11,44,56,18,26,194,52,3,14,18,276,14,27,62,46,26,19,22,6,41,78,37,66,63,7,13,14,4,1,5,19,27,20,56,48,3,7,16,50,12,10,68,22,45,122,16,19,29,12,26,4,6,22,4,13,56,9,23,67,197,32,52,14,7,26,31,33,41,69,50,67,14,19,18,113,74,19,19,69,18,11,46,68,9,25,56,42,13,17,37,20,5,5,31,22,43,37,5,20,43,9,19,27,18,250,6,51,11,12,7,39,16,18,8,112,19,7,40,18,4,17,24,36,13,9,10,4,6,4,22,61,8,9,1,53,31,2,4,26,5,70,6,25,2,5,29,30,14,63,18,51,58,54,12,97,20,51,7,190,12,19,56,4,51,4,19,38,7,19,20,32,10,9,19,23,16,41,28,3,11,73,91,25,27,26,14,14,56,39,17,10,10,32,44,33,35,8,31,12,13,57,30,6,44,3,36,14,26,36,43,20,12,59,14,125,10,92,17,12,82,11,50,59,6,61,7,13,19,59,12,79,8,48,10,48,5,9,9,12,32,12,13,51,29,24,20,9,23,17,20,11,17,17,2,23,24,47,20,6,4,5,31,11,49,8,1,7,13,20,8,4,18,16,10,46,50,12,26,8,4,15,19,70,15,35,13,11,9,86,17,7,15,25,40,38,55,79,87,10,4,45,16,9,8,43,15,9,2,8,83,18,23,28,13,16,34,9,13,19,18,18,9,15,7,120,52,10,13,23,12,6,26,16,22,28,9,8,6,13,34,10,41,12,14,12,8,15,8,28,21,6,21,19,21,16,35,11,55,17,9,45,33,35,39,17,9,6,24,19,15,13,22,95,27,9,7,8,20,22,15,8,42,31,9,62,15,17,78,17,22,45,17,11,18,37,7,24,11,24,33,23,12,60,59,25,17,11,14,9,9,16,11,14,35,18,27,29,46,18,17,15,17,11,28,68,64,14,5,96,10,26,11,57,40,39,6,12,5,17,26,9,32,23,8,49,25,27,18,72,17,37,6,14,9,16,13,6,34,2,11,12,14,30,51,13,30,61,47,20,11,34,16,12,22,60,10,19,17,21,29,18,5,15,211,23,18,15,9,16,15,50,34,9,15,10,10,15,13,10,7,2,22,15,18,30,24,28,61,51,14,4,9,2,11,9,36,27,14,18,7,34,11,3,16,26,28,26,19,9,15,14,11,37,23,6,16,6,13,17,11,24,18,12,3,8,11,8,41,31,14,3,14,14,10,13,14,3,33,5,9,13,7,12,31,12,29,16,13,16,11,37,7,45,22,17,8,12,24,23,2,23,17,15,28,21,1,3,12,7,11,13,18,1,26,25,25,2,7,37,39,17,15,16,16,23,7,12,43,9,28,20,5,15,21,15,7,20,8,17,17,11,5,11,25,6,17,6,19,15,27,7,10,3,8,13,5,28,13,25,8,15,14,30,14,9,5,6,22,9,7,10,8,6,25,13,11,14,19,8,9,8,9,13,10,15,8,26,12,20,27,23,50,16,11,5,10,13,18,9,15,15,11,6,25,39,34,14,15,7,3,10,14,12,5,9,18,12,6,6,6,13,6,24,20,3,7,7,23,10,19,3,2,19,2,6,7,5,9,21,6,14,6,4,18,4,14,2,2,21,9,7,5,4,13,5,8,6,14,20,1,0,22,10,34,11,6,10,12,30,8,8,8,15,4,11,23,8,22,3,15,4,17,8,4,10,10,9,14,4,5,10,6,8,18,10,34,7,1,12,22,26,8,21,9,6,5,8,9,2,5,8,10,26,10,7,10,3,13,1,27,10,7,18,17,14,8,16,22,8,3,5,10,24,9,7,10,9,11,10,16,36,9,15,6,3,10,11,2,1,6,7,13,10,8
long,17,47,24,233,25,19,13,84,7,9,57,21,32,210,14,38,26,49,16,16,17,81,62,67,42,41,44,38,22,47,12,358,295,45,105,152,152,29,44,16,19,39,17,12,75,37,47,39,654,100,100,17,41,89,32,22,127,43,24,36,52,27,8,36,55,29,223,19,20,27,21,9,11,12,214,47,57,10,180,73,87,10,30,17,490,40,26,3,78,7,27,21,5,106,120,28,31,9,132,34,20,55,78,34,43,58,15,16,33,20,40,11,23,35,19,82,11,11,103,312,87,69,39,177,37,10,11,16,6,6,40,15,16,82,57,113,21,6,19,30,16,84,90,7,15,155,17,29,28,17,128,12,49,15,15,56,82,20,40,33,28,11,23,9,13,28,8,63,71,37,38,219,64,10,14,44,338,7,27,97,55,42,10,55,14,61,108,61,84,126,6,27,12,10,7,12,31,12,15,36,62,8,9,36,65,24,14,60,41,69,150,23,44,31,19,37,6,21,29,6,1,36,17,32,88,181,57,51,11,23,32,16,40,49,72,50,103,24,19,23,146,75,24,18,47,16,13,78,85,13,37,62,62,9,19,30,31,4,10,25,10,79,32,5,14,57,22,41,29,18,270,12,55,11,5,12,51,15,22,7,141,21,10,40,32,5,18,35,39,9,17,13,26,15,9,30,86,12,18,53,1,53,4,5,24,12,67,6,14,3,6,35,42,19,98,21,32,70,28,10,142,25,81,23,161,9,26,81,12,86,17,11,25,9,24,26,37,18,12,38,23,24,28,21,6,16,125,125,21,31,29,26,10,70,43,0,13,15,35,60,36,17,13,51,3,16,81,30,35,51,9,49,10,35,39,38,19,8,38,22,142,15,89,17,14,100,10,53,76,4,70,16,14,23,69,32,118,4,67,6,58,14,11,13,18,18,14,10,48,28,7,29,20,30,30,27,13,27,16,14,20,17,39,25,14,11,12,34,23,26,26,18,13,26,22,11,4,31,27,10,44,46,7,41,10,12,39,23,87,16,59,9,20,22,124,13,12,24,14,57,47,51,66,87,12,13,56,41,18,13,49,9,6,11,12,47,28,18,45,29,26,27,14,25,20,19,17,23,16,4,184,74,13,23,22,18,5,39,16,31,31,12,10,4,18,73,13,48,13,18,13,15,19,11,51,42,16,26,14,25,15,52,14,46,15,13,53,32,34,61,26,18,17,22,20,20,14,23,120,38,20,0,9,22,38,35,29,40,36,16,78,9,10,89,21,26,57,17,7,17,46,5,38,10,36,34,27,26,53,73,25,26,10,15,8,11,10,14,17,27,20,16,35,49,19,19,15,15,10,24,51,59,18,12,67,13,10,11,111,40,44,12,19,9,17,38,10,46,12,13,37,23,23,19,59,14,33,8,17,10,23,33,2,44,6,23,10,13,26,60,37,46,52,46,14,8,21,14,8,27,20,8,24,53,21,41,7,13,13,421,44,26,17,22,12,27,70,46,22,30,13,15,36,50,22,9,16,27,22,29,44,21,132,51,90,14,5,15,25,14,12,47,29,19,22,17,31,8,10,11,23,29,21,15,16,25,21,20,26,17,17,8,11,16,14,18,41,16,6,5,9,14,20,52,50,53,26,19,17,14,20,2,32,49,12,10,17,9,8,43,19,26,22,19,12,3,45,19,75,17,26,12,5,30,28,17,19,22,10,17,31,7,0,17,6,23,15,17,12,22,17,19,11,5,30,32,17,9,13,28,28,12,11,35,10,23,16,9,43,23,22,13,25,13,19,17,12,37,24,24,19,27,12,14,19,40,11,10,10,14,5,14,33,15,14,4,15,20,31,20,21,6,25,18,9,11,11,20,12,20,22,7,4,12,7,12,12,7,28,9,16,12,17,14,9,17,19,87,16,13,12,10,9,12,18,15,26,10,4,27,48,36,16,17,8,8,13,22,19,4,15,9,7,2,16,19,16,5,25,9,4,6,22,22,14,29,11,47,25,11,13,13,7,23,10,13,17,13,18,13,19,18,1,7,31,30,10,8,10,31,15,15,12,27,8,13,8,16,13,27,11,13,15,13,21,10,1,25,8,2,22,26,12,23,6,17,13,57,15,21,10,13,8,11,11,4,9,16,8,21,7,30,7,8,18,35,27,14,48,8,5,22,12,5,4,4,7,8,13,13,16,13,18,1,0,28,6,4,6,9,23,12,19,17,12,11,8,25,12,11,5,20,19,23,10,10,18,12,50,9,7,8,11,2,2,11,9,3,4,11
recommend,16,122,39,810,19,17,14,75,17,3,34,40,17,118,22,12,17,30,12,11,14,110,12,55,49,37,19,27,6,35,31,637,254,28,145,80,70,34,30,8,12,9,7,22,84,38,101,53,753,40,76,6,27,43,27,9,225,161,9,43,50,17,7,29,64,14,179,17,16,57,70,19,16,5,134,38,41,15,212,23,172,1,23,12,571,50,37,10,110,31,21,13,26,81,153,53,36,12,90,24,64,93,83,23,26,77,66,22,23,13,45,27,40,34,7,60,37,5,226,386,99,41,68,194,17,9,6,7,13,16,25,3,12,210,28,125,11,20,5,12,2,73,66,10,4,163,14,37,29,45,121,5,29,37,14,123,59,16,14,37,62,7,22,20,40,14,13,42,69,18,59,178,44,3,4,17,432,8,23,107,77,38,85,30,14,42,93,56,78,116,2,7,16,0,2,10,96,17,32,28,55,11,15,47,50,28,25,140,21,70,246,12,84,34,3,3,14,37,73,27,8,23,21,35,162,363,51,58,10,83,55,53,91,50,79,91,45,28,25,22,178,72,17,10,25,26,14,42,219,12,54,41,36,23,26,39,17,27,10,64,19,56,73,18,10,196,29,5,22,25,461,52,105,25,22,3,62,85,50,37,98,16,5,44,21,14,30,30,27,8,14,6,52,38,31,28,111,38,24,31,53,1,13,22,30,8,55,16,18,10,11,52,94,20,127,56,46,83,36,13,117,32,47,19,91,18,27,58,7,54,20,38,24,25,11,58,31,15,14,30,29,30,46,21,12,16,131,118,48,17,43,36,10,92,53,32,14,15,48,77,142,27,24,55,16,5,78,16,21,15,39,61,11,19,16,164,43,8,20,25,258,8,175,18,9,110,30,49,61,3,63,15,58,35,139,11,213,28,89,8,46,6,9,0,8,10,18,8,61,37,2,29,13,48,19,13,11,16,10,2,1,17,58,13,4,13,9,23,25,31,32,24,19,46,15,9,1,27,44,13,33,92,19,20,6,6,24,7,70,12,50,11,7,12,98,24,0,22,8,82,23,33,81,50,19,18,47,19,36,2,42,3,14,4,12,16,6,63,46,12,10,22,11,12,21,24,32,8,8,22,197,163,4,4,27,14,13,49,11,31,27,18,9,16,34,50,15,39,29,9,14,20,12,20,40,63,9,23,9,14,9,41,28,42,18,14,58,23,37,137,29,14,13,18,49,20,35,17,92,69,12,11,7,7,36,31,6,47,47,27,114,15,41,109,36,23,78,12,15,94,144,38,136,15,40,58,28,19,134,127,24,41,142,12,30,12,37,13,7,68,31,39,29,17,27,10,26,29,18,41,46,66,30,31,38,9,12,15,107,46,92,10,19,10,25,81,20,91,29,20,53,131,58,17,100,19,63,13,35,22,33,12,18,49,24,42,27,67,36,94,33,102,66,40,25,10,29,31,18,32,30,5,49,58,17,194,24,29,41,437,47,17,11,34,13,31,90,23,13,46,48,16,37,32,17,13,11,28,22,27,61,21,98,89,107,22,26,35,7,20,15,92,35,43,33,35,34,25,35,45,34,31,41,48,26,41,17,13,40,69,28,17,50,19,35,33,33,12,32,18,5,42,10,119,54,79,17,12,17,37,35,16,14,120,4,21,22,10,19,39,25,73,22,17,23,23,121,17,115,19,32,12,31,35,28,25,41,34,15,24,18,29,26,33,18,43,26,81,36,66,63,19,13,25,83,40,45,15,20,41,14,10,9,50,15,49,28,12,48,29,14,18,23,12,34,24,15,35,16,38,27,62,22,14,20,47,22,29,7,43,15,14,32,39,6,9,16,6,73,13,25,7,49,25,11,17,6,22,10,38,18,12,21,44,26,11,8,51,22,9,35,10,39,13,22,17,32,54,23,25,23,33,12,21,13,42,26,20,34,34,35,76,31,17,22,20,15,32,12,8,22,7,16,9,15,27,7,20,13,100,30,16,28,26,16,9,12,19,41,16,20,21,11,9,44,10,29,23,10,12,12,49,5,4,19,30,21,26,18,6,23,10,16,23,30,17,10,17,15,60,16,30,11,35,26,32,11,18,8,13,19,24,17,40,5,12,6,28,18,12,37,23,22,23,27,7,23,21,11,58,13,31,34,27,22,82,31,67,141,7,30,11,15,26,40,24,14,21,124,8,18,18,9,26,10,66,32,25,14,28,12,12,9,12,14,11,24,15,40,21,41,21,21,16,23,12,15,15,42,3,17,12,14,1,17,27,4,19,6,1
total,2,1,0,34,0,5,3,5,0,2,0,1,5,13,0,0,1,1,2,0,2,5,4,6,1,4,1,6,0,10,1,74,16,1,9,11,1,3,7,2,3,1,0,5,8,4,7,4,37,5,6,3,2,2,4,0,15,15,0,11,0,1,0,1,6,0,7,4,0,2,50,3,1,0,10,0,4,0,24,0,74,1,0,5,43,6,3,3,36,11,14,3,11,16,13,6,9,0,15,7,21,12,7,2,4,5,6,12,16,9,8,1,10,0,2,12,10,5,14,35,4,8,11,108,3,0,1,4,0,2,1,0,0,11,3,29,1,6,1,3,1,4,14,1,0,7,1,5,6,10,2,0,6,6,2,20,12,1,1,4,14,0,4,7,66,2,7,4,6,1,4,19,5,0,1,2,15,1,1,20,4,0,17,5,0,5,8,7,1,17,0,0,5,0,9,3,4,4,11,3,7,6,1,1,4,0,3,8,0,1,9,0,10,4,0,2,3,23,4,4,14,5,3,3,15,17,28,20,4,77,3,15,11,1,7,16,7,1,8,3,9,11,4,1,0,3,0,8,14,1,1,9,1,8,0,5,1,7,3,25,6,4,5,5,1,22,3,2,2,0,16,10,62,0,0,1,2,43,2,4,8,0,0,3,4,0,3,3,1,0,5,3,5,13,7,2,11,1,0,2,4,13,1,7,2,1,3,1,0,0,1,4,4,2,25,7,3,13,3,1,2,1,10,8,1,0,0,0,0,3,2,4,0,0,2,9,0,0,7,7,1,5,2,2,3,1,16,9,2,3,1,7,0,4,4,3,0,1,1,40,7,1,0,3,0,0,1,2,2,2,1,3,3,1,1,21,3,1,0,5,7,2,6,2,2,8,0,8,20,0,0,0,2,1,6,1,2,0,5,0,0,0,0,0,5,1,2,0,2,0,0,1,13,3,1,0,4,3,1,0,0,6,1,0,1,0,3,0,1,5,6,8,5,10,0,1,2,0,5,4,5,0,2,3,1,0,5,0,4,7,1,1,1,0,12,0,0,0,4,7,1,7,4,14,3,0,2,2,0,0,1,0,1,0,2,4,0,0,3,3,1,7,2,0,0,1,2,1,0,2,50,10,0,0,2,0,2,10,2,2,5,5,12,1,2,24,0,0,2,1,0,0,3,1,2,1,2,2,0,2,1,8,1,1,0,12,1,4,0,6,1,0,1,1,2,0,1,3,2,10,0,0,3,2,2,1,0,6,1,4,0,0,0,8,2,3,3,2,3,0,2,1,6,1,1,1,0,0,5,5,4,0,19,0,2,0,0,3,1,34,8,2,0,2,0,3,0,0,2,1,2,1,3,11,6,0,0,3,1,2,3,1,1,0,1,3,1,1,3,0,8,7,0,1,2,3,0,1,0,0,0,6,0,8,4,0,0,0,0,3,7,0,1,3,4,0,2,10,1,1,10,0,0,2,0,11,3,5,2,23,2,2,0,0,0,7,7,0,0,2,1,0,0,0,0,0,0,5,0,10,1,1,1,2,0,0,0,5,8,1,13,9,3,1,1,2,2,0,0,0,0,0,5,5,0,5,0,0,3,1,0,0,3,3,1,1,13,0,0,1,0,15,3,6,4,15,1,0,0,4,0,0,2,8,1,0,3,1,0,1,1,0,5,2,1,1,24,4,1,8,0,0,4,8,4,1,20,6,1,1,0,16,59,37,32,2,1,3,1,25,18,2,7,24,5,12,4,2,7,3,0,0,1,3,2,9,6,2,3,0,1,0,7,1,5,2,1,1,4,0,2,1,0,0,4,5,5,4,0,0,3,0,5,1,0,4,0,2,1,1,7,1,2,1,0,0,2,1,2,1,0,10,2,1,1,1,1,0,2,4,7,10,1,0,1,2,1,1,0,0,0,0,0,1,5,22,1,1,0,4,1,8,0,1,1,1,0,3,0,2,0,0,0,3,0,1,0,0,0,3,1,0,11,0,0,0,0,0,2,1,1,4,0,5,1,1,0,0,0,2,0,8,0,0,0,2,0,1,6,5,0,0,1,0,0,5,0,1,2,4,2,15,1,20,0,5,1,0,3,5,0,0,2,4,2,0,0,0,0,6,0,3,0,1,0,6,2,2,1,1,2,4,43,2,11,18,9,74,32,2,3,2,1,5,5,6,1,0,9,0,7,1,0,2,6,11,2,24,0,0,1,0,6,0,1,0,3,0,1,0,2,1,0,5,0,1,0,4,3,0,0,4,1,5,0,6,7,3,0,0
4,1,3,5,59,1,5,2,15,0,7,4,2,5,19,0,4,2,10,4,1,0,18,4,16,8,6,5,7,6,18,8,82,34,2,11,31,6,12,8,3,3,7,0,6,9,1,13,7,116,14,9,3,2,10,4,1,16,19,7,7,0,3,1,2,12,8,35,7,1,13,66,2,1,3,19,4,18,0,31,8,71,5,6,3,91,27,9,6,46,21,13,2,23,8,76,25,7,6,18,5,6,10,11,0,9,14,23,10,27,13,6,0,10,11,4,12,18,4,42,54,6,21,18,117,6,1,1,2,9,13,9,0,1,26,4,20,0,4,0,9,1,10,28,4,3,26,1,8,3,5,8,3,10,4,1,16,11,2,10,8,15,2,8,49,35,4,3,12,7,3,21,33,4,1,1,2,64,0,1,25,10,6,8,7,2,1,10,7,12,40,3,1,1,4,2,2,15,6,17,4,10,2,9,4,12,1,10,7,8,12,24,3,14,5,1,5,16,28,10,4,6,11,2,8,17,19,15,19,9,12,8,25,29,5,10,16,14,1,5,4,14,6,6,2,3,6,2,17,28,5,5,5,9,8,2,4,4,30,4,18,0,17,11,8,2,28,2,1,5,1,63,16,47,3,0,5,14,11,3,1,14,0,6,8,9,3,2,2,10,1,18,3,4,12,40,5,29,5,3,4,5,22,7,1,5,4,5,3,0,1,3,1,16,0,57,9,1,24,5,3,12,4,7,2,9,0,2,6,0,13,2,5,0,1,1,9,8,2,4,11,2,8,7,7,8,2,10,18,9,9,8,4,1,20,4,6,5,3,6,14,6,7,3,11,2,0,4,3,1,3,2,7,1,3,1,10,5,3,2,3,22,0,6,4,3,25,0,13,16,1,2,0,5,3,9,2,10,3,19,3,5,4,2,0,5,1,1,0,11,2,1,6,3,3,1,0,1,1,0,2,1,8,9,7,1,2,4,1,9,19,9,13,1,53,0,3,1,4,5,5,2,2,1,4,7,1,6,3,4,7,17,0,3,4,16,3,0,3,1,15,7,5,4,4,3,12,3,7,2,0,8,2,1,0,1,3,1,5,10,1,3,3,5,1,1,0,2,5,1,3,42,10,1,1,7,2,1,9,3,0,4,2,2,1,1,8,5,5,1,0,2,1,4,1,4,0,0,3,0,4,0,5,1,6,1,3,8,3,5,10,3,0,2,6,7,1,4,1,15,0,1,4,0,2,3,2,51,4,3,7,13,1,4,23,2,0,5,0,0,3,8,2,22,0,0,1,2,0,16,9,1,1,11,1,0,4,6,2,1,28,3,2,0,1,2,0,7,3,2,4,3,4,0,6,4,0,0,1,11,7,4,0,0,4,2,6,1,6,0,2,10,17,8,6,6,1,2,1,0,2,5,16,1,17,2,1,0,10,1,10,12,6,11,9,0,2,3,8,1,2,3,0,0,4,5,26,1,7,1,67,8,2,0,4,4,2,13,2,4,18,2,4,17,6,6,6,8,4,3,1,3,2,7,3,18,1,2,4,15,0,4,14,5,3,3,5,7,3,1,3,11,2,2,7,2,13,3,1,0,3,3,4,0,4,2,6,10,4,0,3,1,38,2,10,5,5,12,1,3,2,0,1,0,10,2,3,1,0,0,2,0,14,8,2,2,5,13,0,3,5,2,1,4,12,8,0,18,3,3,3,3,12,2,29,6,6,2,2,0,107,109,4,19,36,6,11,4,1,2,11,0,2,2,7,0,7,5,1,4,3,1,1,2,3,5,2,3,0,12,9,4,1,0,2,6,4,0,1,6,9,0,6,5,1,1,1,1,1,5,2,4,0,2,4,2,3,0,6,4,3,1,2,7,8,1,1,5,13,2,3,2,3,3,1,1,0,1,14,1,1,1,1,0,1,5,15,2,10,0,1,3,6,1,2,1,6,1,10,1,4,1,2,0,2,1,1,1,7,3,6,2,9,59,10,1,1,0,5,3,3,3,11,4,1,1,4,2,2,2,1,4,3,0,3,0,35,0,4,3,2,1,1,2,5,7,27,2,9,1,4,1,8,3,17,3,22,6,2,3,1,1,5,2,7,1,1,1,0,1,10,3,2,4,4,2,2,0,3,0,3,0,14,5,19,16,19,16,14,44,1,0,0,1,2,4,7,8,1,20,1,7,1,0,0,28,34,1,2,3,1,1,0,3,1,2,1,1,0,2,1,8,1,2,0,2,9,1,1,4,0,0,1,2,1,0,11,3,1,3,1
affect,0,9,21,153,3,3,4,44,2,3,8,15,4,68,0,16,7,33,7,8,3,44,9,22,47,8,14,8,9,11,6,169,132,11,65,48,32,10,40,3,15,4,2,5,23,40,32,18,330,9,52,6,21,32,10,8,61,13,2,17,33,12,6,13,49,4,108,9,18,8,20,6,8,7,97,14,21,14,84,34,51,3,8,10,229,32,23,4,31,3,6,10,2,32,92,24,30,10,37,28,9,28,43,11,15,27,12,1,13,3,10,7,7,22,2,29,5,2,73,202,65,17,51,55,9,4,2,8,3,2,13,3,16,48,18,49,7,1,8,5,4,42,37,3,3,60,11,26,22,13,82,2,13,8,5,35,24,8,15,11,14,3,11,3,7,8,5,19,34,8,12,84,30,0,6,10,182,3,16,40,26,13,14,14,0,34,35,32,87,48,4,4,12,0,2,7,13,9,4,14,66,11,10,11,28,13,8,42,15,24,72,3,26,14,2,4,1,11,11,4,4,18,11,19,52,117,36,36,2,14,20,10,14,35,47,43,38,11,16,12,82,50,16,4,18,14,2,21,48,16,16,40,28,6,18,28,20,3,5,22,15,17,23,5,10,46,5,12,24,7,177,8,35,13,4,1,15,24,15,2,68,16,8,19,13,4,9,6,14,3,4,2,8,3,5,13,35,5,9,26,24,30,2,5,1,15,23,3,14,8,3,24,34,12,35,18,22,62,18,9,46,5,35,2,112,11,21,26,4,29,7,10,10,5,9,25,29,9,3,7,16,13,18,14,5,11,57,56,20,19,15,12,6,36,27,8,1,4,13,29,49,6,14,22,2,1,47,14,13,11,7,16,13,14,22,24,5,10,15,10,57,2,50,24,11,25,12,18,22,5,18,1,18,17,49,12,76,5,37,6,21,5,6,4,8,13,9,3,39,11,8,9,7,31,43,7,3,10,1,0,5,5,28,12,6,7,2,13,12,22,17,3,2,4,4,8,0,10,13,9,14,16,8,12,0,2,6,9,51,19,28,6,1,3,54,13,0,17,12,30,17,19,42,33,3,3,29,17,25,1,35,2,1,4,5,16,6,12,21,6,4,19,2,14,15,11,17,2,1,5,81,35,2,7,17,5,4,24,5,16,14,8,5,3,3,37,12,20,5,4,3,11,7,20,18,22,5,20,5,9,4,22,11,30,13,6,31,19,9,23,13,14,1,19,10,7,10,14,42,27,5,6,13,16,29,11,5,21,25,11,40,2,9,57,24,20,60,10,25,7,39,3,27,7,11,18,13,12,22,29,14,9,16,2,11,8,32,13,9,28,18,18,18,24,9,5,5,14,11,12,22,50,12,8,60,6,4,6,36,22,21,11,6,4,11,25,8,20,10,12,31,19,8,12,38,10,14,8,12,4,8,6,7,21,11,13,7,12,11,28,17,32,27,23,12,8,24,7,2,10,12,6,25,19,8,16,16,3,16,186,27,5,13,12,14,13,49,33,11,17,10,5,22,13,10,8,4,12,9,16,14,12,20,27,25,13,1,11,4,4,1,26,23,6,10,10,18,6,1,14,15,19,17,8,6,8,13,2,24,11,3,10,3,5,14,4,14,6,5,3,7,3,5,48,16,6,1,7,8,7,1,10,4,15,0,8,6,1,6,13,5,15,3,6,3,3,11,3,29,18,11,2,2,9,12,2,18,9,11,6,6,18,5,9,3,13,8,8,1,23,24,13,1,2,19,27,16,5,15,10,9,5,7,21,2,25,22,3,1,14,0,6,18,15,10,15,5,11,14,10,4,24,9,7,5,13,10,6,6,2,3,5,19,10,4,1,14,4,19,10,14,3,16,12,2,10,5,9,2,14,11,3,8,2,5,5,6,5,18,4,13,7,15,3,9,18,14,28,28,10,10,8,8,18,17,14,11,7,15,10,58,24,12,8,2,7,15,10,8,1,12,4,5,6,7,12,11,5,23,15,11,5,16,21,8,8,4,7,14,4,2,4,4,3,1,7,3,10,5,5,3,16,1,5,11,2,1,2,1,0,6,2,1,20,20,5,1,10,9,35,8,4,5,12,14,6,3,13,2,6,11,5,5,16,8,1,4,13,10,16,14,4,9,9,6,4,2,2,3,15,3,15,10,3,22,22,11,27,49,3,0,8,4,1,3,3,2,9,10,2,0,7,5,4,2,30,4,0,4,14,1,7,12,4,4,9,5,7,12,7,2,13,0,10,3,17,18,5,54,7,3,7,2,0,3,6,12,2,2,0
social,0,6,11,39,4,21,3,11,5,5,3,5,15,35,1,9,3,3,9,4,4,3,19,19,4,14,6,18,2,10,1,87,31,2,9,36,12,0,4,4,2,6,1,10,7,9,19,12,46,19,8,6,4,15,11,3,10,3,14,8,2,4,3,8,11,11,51,4,4,8,18,0,4,4,102,2,18,3,18,6,25,6,6,4,48,14,2,6,4,2,4,4,18,3,12,5,4,3,8,3,1,17,10,7,5,7,7,7,4,5,13,2,13,19,6,11,3,1,33,46,11,37,29,61,7,0,1,0,1,5,5,0,9,28,4,51,4,2,2,3,3,10,10,2,5,25,4,15,6,1,5,9,13,6,2,11,20,7,4,17,9,1,40,4,17,21,4,8,9,2,5,40,16,3,2,1,29,2,9,38,5,11,16,12,7,19,7,1,5,17,1,4,1,6,9,2,23,8,8,8,5,12,1,4,7,7,7,51,19,6,18,2,24,9,6,17,3,23,5,1,6,7,1,6,15,27,13,10,2,6,10,7,11,15,7,2,18,6,2,4,19,11,4,3,10,8,5,23,14,9,3,8,12,0,0,3,0,0,1,2,4,13,2,0,3,1,12,19,5,7,27,26,3,1,0,3,18,3,0,1,34,2,5,5,4,1,12,11,5,0,0,2,5,13,2,3,7,2,1,5,12,8,1,4,15,1,10,6,9,2,2,6,23,15,41,0,49,10,5,1,2,3,13,4,16,0,17,15,0,10,3,3,2,0,2,5,3,0,4,1,1,1,10,1,1,3,6,10,4,8,6,17,1,7,7,1,8,2,7,14,10,10,6,14,3,7,4,6,31,8,1,10,22,2,6,14,2,0,5,4,2,5,8,9,8,13,1,4,12,8,13,6,10,3,7,7,5,3,13,1,5,8,1,7,4,8,5,3,5,9,1,1,0,3,1,2,0,0,2,3,1,2,7,0,1,1,1,8,1,5,0,1,0,0,7,1,3,0,8,4,3,2,1,3,0,2,8,7,13,4,241,0,5,0,20,1,0,1,2,8,9,15,9,15,2,2,10,10,0,4,13,2,2,9,2,16,1,3,5,11,2,5,4,7,3,2,1,3,0,0,14,8,3,4,5,0,2,1,1,3,5,2,0,6,7,0,5,4,6,9,1,2,3,0,2,2,5,5,5,8,3,3,1,9,2,6,6,9,3,8,4,4,2,6,4,6,0,1,13,4,2,0,1,9,3,0,3,2,1,1,5,0,0,14,1,2,3,0,2,2,6,2,1,1,0,5,3,3,3,5,7,0,0,1,2,0,1,0,1,6,2,4,1,1,1,1,1,0,1,4,10,5,10,2,11,2,2,7,1,4,1,0,7,0,2,8,0,3,2,0,4,14,3,2,9,2,3,2,0,0,0,0,1,4,0,3,8,4,3,8,0,2,9,9,0,3,6,6,1,1,3,1,9,1,0,2,4,1,3,29,4,2,0,2,2,2,7,7,1,1,0,1,0,4,0,0,0,2,2,1,5,1,0,7,6,1,0,0,0,0,1,3,1,1,3,1,5,7,1,0,3,7,3,2,3,2,1,0,1,1,1,0,1,2,0,4,5,3,0,0,3,2,0,9,10,5,1,0,0,1,1,5,0,6,3,4,3,4,2,3,4,3,0,6,0,0,2,1,2,1,3,1,2,0,1,3,5,5,3,4,4,1,0,0,2,5,2,1,0,5,4,4,1,4,10,3,4,2,2,0,4,5,5,6,2,3,3,3,2,3,2,1,3,3,4,3,1,0,1,2,2,6,2,2,1,4,0,1,1,0,0,1,0,3,1,2,1,1,3,1,0,0,0,1,0,0,0,6,1,6,1,1,4,0,0,1,10,0,0,3,8,0,3,1,3,2,0,6,3,0,0,1,0,1,0,3,1,1,1,5,10,1,3,2,2,0,1,0,1,0,0,3,1,5,1,1,3,0,1,5,0,0,0,1,5,0,0,8,2,1,0,3,1,0,0,1,5,0,1,0,1,0,4,1,2,0,0,0,1,0,1,0,3,2,1,0,0,0,0,3,1,0,5,0,3,1,1,1,1,0,1,2,0,0,2,1,0,2,0,0,1,10,1,0,0,0,3,2,2,6,0,1,0,2,21,4,10,1,2,0,0,1,11,4,0,0,0,1,0,0,0,1,1,1,1,0,0,6,1,0,0,1,5,7,1,2,4,0,5,0,2,2,0,0,2,0,3,1,2,7,2,0,1,12,4,3,11,0,2,2
toward,17,41,14,212,13,23,24,57,9,6,76,24,25,282,13,20,16,25,16,14,11,56,42,50,40,31,45,28,13,21,25,375,239,28,101,208,185,10,19,15,18,39,10,18,64,31,39,29,583,92,63,25,41,135,24,25,96,35,11,88,55,42,13,34,30,11,222,13,20,24,36,11,14,4,252,39,56,16,138,49,84,13,19,26,451,23,14,11,60,3,9,17,8,65,101,14,44,9,111,40,14,61,55,19,30,48,8,12,22,12,38,8,45,37,9,65,13,6,121,274,94,60,20,134,19,12,34,7,3,3,36,18,30,98,58,129,38,6,17,27,16,84,59,12,11,191,20,55,30,26,108,19,26,16,29,34,77,23,43,49,23,12,20,6,8,15,12,59,48,24,26,190,72,12,12,20,280,11,40,108,55,28,18,33,5,73,65,56,73,116,3,17,20,11,1,11,37,18,15,54,39,7,8,29,72,27,11,54,28,89,143,17,43,25,11,4,8,16,13,11,10,46,14,28,83,137,85,58,10,9,21,14,32,47,92,24,85,31,22,35,101,69,13,18,59,6,15,66,94,7,21,25,58,3,18,31,9,5,5,27,8,68,13,5,13,54,15,29,35,24,236,12,24,12,4,40,36,18,25,11,129,15,5,38,16,6,23,31,36,8,9,26,7,9,5,21,65,14,21,70,67,55,3,5,23,10,1,8,24,8,11,42,54,39,58,27,27,75,36,19,124,17,70,19,151,15,40,46,5,71,9,24,26,8,29,16,57,16,10,29,21,26,32,25,17,19,63,111,23,25,21,13,17,56,48,6,14,23,43,98,37,21,30,28,14,7,45,27,26,31,9,51,13,34,17,33,25,6,67,9,163,13,81,41,14,49,7,35,53,7,96,29,29,32,69,17,83,6,65,17,39,10,14,9,9,19,20,24,37,42,31,41,12,21,49,40,19,20,16,14,24,32,61,21,3,5,10,46,14,29,12,16,6,17,20,19,11,38,29,7,29,41,10,30,6,17,37,16,87,16,41,16,90,20,120,24,5,25,29,41,31,59,77,73,17,35,40,23,21,3,44,15,1,6,7,60,14,34,46,11,13,53,16,15,20,17,19,18,19,7,193,53,5,15,18,13,9,41,9,30,26,3,4,7,6,25,23,30,12,11,16,18,16,11,28,30,51,17,6,19,23,35,6,44,11,14,43,25,18,41,23,14,13,17,11,15,12,23,97,23,9,14,7,15,12,22,7,37,23,22,41,7,7,95,37,19,62,11,12,21,33,4,39,6,32,36,33,16,69,94,14,11,18,2,20,6,7,9,16,32,13,31,16,36,22,43,13,18,7,21,60,86,11,7,84,17,22,7,106,58,41,12,6,14,10,30,11,36,17,10,34,27,15,9,40,9,30,7,9,13,19,4,4,24,9,12,16,10,23,53,17,28,37,45,23,7,43,17,10,21,35,16,10,49,25,37,12,22,15,400,48,13,10,6,8,34,63,53,17,29,13,11,42,33,22,11,15,11,15,18,25,10,86,19,44,13,5,12,10,14,9,48,38,19,28,13,45,23,6,14,22,42,22,20,9,15,17,10,20,24,49,18,13,16,15,20,34,20,1,12,10,7,9,75,36,46,23,33,17,17,16,15,33,25,2,14,6,6,16,26,16,29,0,15,6,6,42,12,62,13,20,12,10,11,27,13,22,30,9,12,14,7,2,15,4,16,11,18,10,11,8,27,8,5,34,29,21,11,36,37,20,16,10,22,12,24,30,6,47,23,23,5,27,6,11,15,5,30,10,13,14,15,8,11,5,21,6,11,13,7,14,21,35,13,20,4,19,20,42,8,17,26,21,13,5,15,11,22,7,18,20,4,24,20,3,9,10,8,8,8,9,7,22,19,15,28,21,47,26,16,16,12,4,3,4,15,11,25,8,28,36,47,17,6,3,8,28,12,10,8,16,10,23,16,14,17,11,10,27,8,12,4,13,23,14,15,15,24,24,43,8,5,11,7,10,9,9,9,12,12,7,9,10,9,14,16,19,3,12,18,14,10,15,20,4,7,12,13,9,56,10,20,18,18,13,13,3,14,12,9,21,18,4,14,9,14,11,45,21,1,6,12,7,8,3,5,8,4,18,23,13,20,7,5,16,34,35,11,30,12,2,11,15,5,5,1,4,10,29,23,2,10,6,2,3,43,7,9,5,8,19,12,20,16,6,12,4,7,12,13,1,6,8,9,11,9,17,14,66,8,14,14,10,2,3,3,4,14,11,25
head,5,21,32,63,2,2,4,23,2,6,4,4,3,32,1,4,1,17,4,1,2,23,3,9,17,12,7,5,4,13,3,101,56,12,22,22,10,3,2,2,0,7,1,2,16,5,10,18,76,14,26,4,4,10,18,1,40,31,8,7,3,1,0,7,15,7,40,7,7,11,8,0,0,1,33,5,12,1,35,4,28,4,6,5,80,4,4,1,20,4,6,2,0,8,17,5,12,3,17,9,3,11,24,5,8,29,3,4,8,2,11,3,8,8,5,18,4,3,28,75,24,4,8,43,5,1,0,1,5,3,7,6,4,19,11,39,7,12,3,6,6,25,15,3,4,29,5,5,9,16,17,20,8,2,2,8,26,8,4,7,10,0,13,0,8,13,6,10,6,4,5,46,9,2,2,6,76,0,6,30,15,3,10,9,1,18,31,11,29,22,0,5,4,1,0,3,6,3,11,11,26,0,2,7,8,13,3,21,2,4,43,3,12,1,2,6,5,4,28,4,2,14,0,6,36,53,24,9,4,5,5,17,10,13,16,5,15,5,2,3,27,14,6,8,7,1,5,23,33,3,2,12,7,2,4,11,5,0,1,13,8,6,20,3,4,103,4,2,1,1,52,10,22,1,1,1,5,18,3,5,28,4,1,20,3,2,6,4,16,3,3,5,3,4,8,3,16,1,6,6,6,16,1,3,3,6,8,1,12,4,1,8,13,5,11,10,7,30,5,1,14,5,13,18,22,2,4,16,5,19,1,3,3,5,6,1,8,3,0,5,4,4,2,3,1,3,20,20,6,5,7,6,4,17,18,2,7,2,7,27,16,4,1,6,0,5,13,6,9,6,0,10,2,8,8,38,13,0,9,7,38,2,17,8,3,8,9,8,26,7,9,2,7,6,17,16,26,4,11,4,12,3,6,2,2,4,5,0,2,8,2,5,12,10,0,3,0,6,1,1,7,8,10,8,2,4,1,10,4,15,2,3,0,10,3,2,0,4,0,3,10,4,4,5,1,1,1,0,11,6,14,2,2,2,22,22,1,2,10,11,4,10,17,32,4,0,10,5,1,1,8,2,4,2,3,24,1,14,12,2,5,6,1,3,6,3,8,1,1,5,28,25,9,3,2,2,2,11,8,7,1,3,3,1,3,4,9,3,4,0,8,3,3,2,9,10,1,9,2,5,2,6,1,13,1,4,9,5,3,20,6,6,2,15,7,7,4,6,23,17,0,0,2,9,2,2,2,6,6,1,15,4,4,30,3,11,2,2,2,3,8,4,15,2,7,5,4,2,16,14,7,2,12,2,7,1,2,5,1,13,1,6,3,12,2,3,1,2,2,7,8,12,5,2,19,7,0,3,12,7,4,0,2,1,0,10,3,30,12,4,20,24,12,9,16,7,6,2,5,2,13,0,3,11,3,2,3,4,10,19,0,16,21,13,3,0,6,1,2,8,8,4,8,20,1,21,1,1,3,44,5,3,0,3,1,4,15,15,4,5,4,4,5,8,1,3,0,3,5,8,9,3,14,11,8,2,2,2,1,1,15,8,5,7,7,4,0,2,1,12,6,6,20,3,0,5,5,6,10,5,1,6,2,2,13,4,3,2,1,5,3,7,1,3,6,27,7,3,6,14,6,5,4,30,5,10,2,6,8,7,5,11,0,1,2,5,14,7,8,2,7,2,4,4,2,2,6,6,5,2,4,1,0,16,12,6,1,18,3,15,18,9,1,8,7,12,7,3,10,5,4,4,4,3,1,8,2,4,4,6,6,3,4,4,4,3,4,10,2,12,1,3,1,2,5,7,2,7,3,22,3,1,4,3,4,2,2,4,6,1,0,0,0,3,3,3,4,5,2,2,1,1,3,11,4,5,6,5,1,2,8,2,3,2,3,5,1,9,2,5,3,4,5,3,4,0,1,7,4,10,6,11,9,1,2,5,9,1,2,1,2,3,4,4,0,2,1,2,3,11,22,1,2,1,1,1,0,0,4,0,2,0,12,3,7,3,4,3,5,0,4,8,5,1,1,5,5,6,3,3,3,2,2,3,0,4,0,2,1,8,4,2,4,8,2,6,2,1,6,1,5,7,1,2,0,3,4,7,3,0,4,1,4,3,2,1,3,1,3,9,2,6,11,3,3,5,1,5,12,0,4,6,3,2,4,2,0,0,5,2,0,3,11,6,5,2,3,1,3,1,4,0,5,2,3,1,0,0,9,1,4,1,7,1,2,1,4,5,0,1,1,1,5,2,1,3,2,4,0,1
welfare,3,11,8,77,11,15,5,33,3,4,17,8,15,75,7,11,6,12,9,3,2,26,38,46,22,15,15,10,6,10,1,143,91,9,41,78,26,6,7,6,2,9,0,12,20,10,21,19,145,24,17,9,23,34,72,9,24,11,12,23,10,1,4,10,15,12,177,8,13,7,39,2,4,3,122,11,47,3,51,28,32,4,6,11,137,9,15,2,23,2,2,6,5,6,39,6,12,5,37,18,4,13,18,6,18,24,3,10,12,6,18,9,4,30,32,24,3,2,34,59,38,19,18,83,12,1,3,4,4,0,25,7,7,44,33,199,4,14,0,6,8,27,13,2,3,44,14,14,11,7,40,5,5,12,22,41,30,6,13,58,8,10,8,6,11,38,6,17,31,12,13,88,38,8,3,4,88,5,5,57,19,10,39,15,3,17,24,14,22,50,6,3,5,7,8,6,13,9,8,16,47,5,1,9,11,27,3,57,25,13,62,22,24,6,4,19,2,5,8,3,2,15,4,11,22,62,30,26,4,8,15,9,4,16,25,1,34,13,6,12,46,28,13,10,20,5,3,18,45,1,8,12,19,0,1,14,1,1,0,4,3,13,9,0,15,32,31,4,15,5,61,7,6,11,2,10,17,8,5,2,67,8,6,25,4,3,76,77,15,4,0,3,9,8,2,6,8,3,3,25,14,18,0,0,14,9,24,12,1,12,6,28,18,10,34,5,25,23,7,14,31,11,19,22,49,2,30,33,6,11,1,5,5,6,13,7,14,5,0,3,4,4,42,8,8,8,18,36,15,38,6,6,5,34,11,5,7,8,10,37,40,16,17,11,0,18,11,7,76,16,1,33,6,38,10,15,12,1,24,6,52,3,34,19,9,26,19,14,21,9,14,0,8,1,9,9,17,4,28,1,7,8,5,2,3,16,10,4,9,28,10,4,1,21,7,3,1,8,2,2,13,10,12,3,5,3,11,16,6,6,3,2,0,4,18,1,0,3,3,2,13,12,5,4,0,7,8,7,30,5,14,1,26,1,18,5,1,2,11,11,8,22,29,41,7,11,15,7,5,3,36,1,4,13,4,54,8,16,28,8,11,13,3,8,9,3,5,3,3,0,28,22,2,4,7,2,8,5,4,4,12,5,2,2,5,8,16,7,1,5,3,2,4,13,3,7,2,12,0,8,11,11,4,12,5,3,8,13,5,22,4,10,3,15,5,1,3,9,44,29,8,1,2,48,4,3,7,6,10,4,16,1,1,20,7,2,10,0,9,6,8,5,5,4,4,2,8,3,20,22,3,3,3,3,8,0,7,2,1,10,3,4,11,18,5,14,4,8,1,10,9,25,5,6,63,15,18,14,7,21,8,4,7,2,0,9,2,9,3,1,19,13,1,7,11,0,7,3,4,0,6,0,1,9,3,2,2,2,10,26,0,17,35,22,5,7,25,6,2,6,17,1,4,8,3,8,8,4,12,68,15,6,7,6,6,8,14,22,5,7,8,3,1,1,3,0,4,4,7,5,10,4,1,8,6,6,3,3,2,6,0,10,9,8,4,5,7,12,2,2,4,22,3,2,2,8,2,0,4,0,15,7,4,4,0,7,9,2,0,2,3,1,2,28,11,5,1,5,4,3,0,9,3,3,3,9,2,12,10,14,7,1,1,9,3,0,2,8,17,5,7,3,1,5,3,2,8,13,1,10,4,0,0,2,3,6,8,5,2,3,3,10,0,2,9,16,11,9,20,5,12,7,4,4,3,11,6,6,25,5,1,3,12,4,13,3,4,2,5,12,4,11,7,3,16,13,2,1,2,2,0,2,9,5,11,4,6,2,5,2,0,1,0,2,3,3,3,5,2,5,1,4,2,2,0,6,9,3,0,2,0,5,5,0,7,5,5,13,4,4,0,9,3,6,4,2,6,5,2,15,9,12,3,1,2,2,12,2,1,0,1,5,7,5,1,4,2,1,3,13,2,0,0,0,6,3,1,2,4,2,1,0,2,1,1,0,5,5,3,1,2,4,1,5,0,0,4,6,6,2,7,1,1,8,2,1,2,1,0,16,7,5,6,5,0,0,0,0,4,1,3,5,5,0,2,2,1,6,4,2,6,18,4,3,1,1,1,3,2,15,6,7,0,2,0,2,3,6,6,1,1,6,2,2,3,2,0,1,6,8,3,0,5,5,3,0,5,3,3,1,5,3,11,3,0,1,4,0,4,2,1,3,2,0,4,1,7,4,4,15,3,4,2,1,1,10,10,0,2,5
level,0,1,3,39,1,12,1,11,2,0,1,5,10,18,1,1,3,2,1,0,1,5,11,10,3,5,6,4,1,6,4,60,30,7,16,20,4,7,25,4,4,5,2,7,6,0,12,10,39,22,17,11,8,23,15,0,5,18,7,11,2,2,0,8,12,5,23,21,2,3,17,0,3,1,38,0,4,3,12,13,37,7,3,5,63,3,3,6,7,1,2,1,6,11,16,12,10,0,23,4,6,3,5,1,2,11,1,4,5,4,6,2,9,14,8,12,0,1,9,37,12,13,11,37,4,2,2,1,0,1,10,0,3,24,5,29,0,8,1,6,4,20,8,2,1,24,11,15,5,4,15,1,4,4,5,28,13,8,1,17,8,3,5,2,19,7,3,8,13,2,13,22,9,1,0,1,18,4,1,30,6,3,23,10,3,6,10,5,3,9,3,1,5,1,1,2,12,2,4,7,19,4,12,3,17,2,2,7,2,9,12,5,9,13,0,6,3,21,5,4,4,3,0,8,13,22,15,6,1,6,4,6,15,11,15,2,6,6,15,3,13,7,7,6,3,2,3,5,26,5,1,7,8,1,0,5,2,2,0,5,2,11,7,1,3,14,25,6,3,4,20,3,4,3,0,7,11,11,0,2,23,0,1,5,5,3,8,3,3,0,0,1,2,2,4,2,5,1,2,2,3,10,0,1,8,2,8,4,12,1,1,7,13,8,6,8,3,15,4,1,7,2,19,10,3,1,6,10,4,11,2,4,1,1,2,0,7,2,4,1,1,13,3,1,1,4,11,11,4,2,1,2,1,8,4,3,2,0,5,8,11,7,8,3,1,2,3,5,5,10,0,17,3,6,5,1,1,1,2,1,7,1,17,9,2,7,12,9,2,1,4,0,1,0,3,1,3,2,2,3,4,3,1,3,3,0,10,0,10,8,2,3,8,4,0,0,2,6,2,0,2,4,11,1,2,2,1,1,0,2,1,2,0,2,1,3,3,3,8,0,2,2,2,4,2,2,3,2,4,6,5,1,3,0,12,3,0,0,4,1,4,10,11,7,8,0,7,5,9,0,7,0,2,2,2,10,1,2,10,3,7,5,1,0,3,2,5,2,1,0,12,9,0,0,2,0,0,2,2,2,5,0,0,5,4,4,9,2,1,0,1,1,0,1,5,1,2,3,19,7,3,1,0,3,0,0,13,1,0,8,2,3,3,1,2,0,0,0,15,10,1,0,0,9,5,2,1,6,1,2,1,1,2,9,5,2,12,6,1,0,2,0,3,3,4,1,1,7,4,11,1,1,0,1,3,0,3,0,2,16,1,3,3,5,1,0,0,3,1,4,4,3,3,7,13,9,7,9,4,4,3,3,2,0,0,3,0,4,2,5,13,6,1,1,8,1,1,1,0,0,5,1,2,0,2,0,1,0,1,13,3,4,10,8,0,4,2,7,1,4,1,3,3,1,0,3,4,9,1,12,0,2,0,0,3,1,3,11,3,5,1,2,0,0,3,0,0,1,2,1,4,0,0,5,0,0,0,2,3,2,14,5,3,2,1,1,0,5,0,0,2,8,0,0,0,4,7,0,3,1,9,0,0,2,3,7,8,4,0,0,0,0,3,5,2,3,5,0,0,8,0,3,0,3,2,4,2,2,1,4,0,5,2,1,0,0,2,0,0,3,2,0,4,1,10,3,8,12,2,1,2,2,1,1,4,7,2,1,0,14,12,6,0,10,6,1,7,2,7,0,5,7,4,2,2,3,5,1,7,1,2,0,1,2,6,3,1,0,3,4,3,1,0,2,6,6,7,2,1,0,4,0,3,0,1,1,1,1,4,0,9,4,2,1,1,1,4,2,0,3,0,0,3,10,1,0,1,5,0,0,1,0,3,1,1,4,1,4,2,4,0,3,2,9,0,1,1,11,0,5,3,2,2,0,4,0,5,0,0,3,0,1,0,4,0,0,10,0,1,2,0,5,0,3,2,1,0,1,0,0,0,0,0,0,1,0,2,2,1,0,4,9,2,0,2,2,0,2,2,5,0,0,2,2,1,0,0,0,0,7,2,2,0,2,2,1,3,7,2,0,0,2,0,1,0,1,1,0,1,0,2,8,1,0,0,0,0,1,0,3,3,2,9,0,0,1,5,3,2,1,0,3,1,0,0,0,0,1,4,0,0,4,0,1,4,4,2,0,0,1,0,0,8,1,0,1,1,0,1,0,0,4,1,4,0,0,2,6,0,2,3,5,1,1,2,8,11,0,7,0
assistance,2,3,4,41,1,4,0,5,1,3,11,2,8,23,1,1,4,2,1,8,6,6,4,7,3,17,2,1,3,11,6,50,42,6,13,35,19,2,5,2,0,12,1,8,9,1,18,19,85,23,11,6,0,20,14,0,10,3,4,4,2,7,3,6,1,3,29,2,1,3,17,4,0,5,36,8,5,3,22,6,29,1,6,2,66,4,5,1,11,1,6,5,6,7,10,0,6,5,16,9,9,7,8,0,5,7,1,3,7,6,7,6,2,8,5,8,0,1,16,23,10,13,4,29,7,3,0,1,2,1,4,3,5,19,7,23,1,3,2,4,2,15,6,1,1,12,1,2,8,1,7,3,6,6,4,40,9,16,12,31,4,2,2,3,9,4,6,13,13,4,17,19,12,1,3,6,30,3,3,29,1,1,37,7,2,6,12,7,3,14,0,0,4,0,2,6,4,5,8,5,21,1,2,3,11,9,5,16,3,8,31,2,8,5,1,3,3,2,6,2,1,2,1,3,10,23,5,4,3,12,10,9,5,6,9,4,8,6,12,1,26,13,7,1,8,13,1,3,37,0,6,3,7,2,1,3,5,1,3,5,3,10,8,0,1,20,9,1,7,8,21,6,1,1,2,0,10,5,0,3,15,3,6,8,3,5,10,4,0,0,1,3,6,2,3,2,9,3,7,5,6,11,1,3,3,2,11,1,6,1,1,9,19,13,3,6,5,11,1,6,13,1,9,15,7,2,16,7,2,6,4,3,3,3,1,10,5,6,6,2,2,12,9,2,6,2,17,17,23,4,1,2,2,11,3,2,1,0,3,7,13,13,14,8,1,1,3,2,9,0,3,23,3,4,4,16,1,3,9,2,27,3,12,9,1,5,10,6,3,1,9,3,2,7,0,4,9,1,12,0,8,1,2,3,2,1,5,1,13,8,0,4,3,6,2,3,2,1,2,4,2,4,7,2,1,3,4,6,3,7,3,1,0,5,3,0,2,7,8,7,3,12,3,8,3,3,7,8,8,3,23,0,6,2,8,8,0,1,5,5,5,0,7,7,4,2,9,5,1,1,8,1,1,1,3,1,2,1,5,2,0,1,1,1,4,0,4,2,0,4,12,5,1,6,7,1,1,3,1,1,5,2,0,3,3,12,6,3,0,1,0,3,5,5,2,2,1,1,0,3,1,5,4,1,0,0,3,3,7,4,6,0,5,3,7,1,1,3,8,7,3,4,0,7,8,3,2,6,4,2,1,0,1,8,10,7,10,3,2,0,2,1,10,4,4,3,7,2,8,9,5,2,8,7,2,1,2,5,2,14,0,7,3,1,1,0,2,2,1,3,5,8,1,2,8,1,2,0,12,4,2,3,3,1,2,4,1,7,2,2,4,11,4,3,7,4,1,3,1,1,5,0,4,3,2,2,5,2,0,9,0,8,0,2,6,2,1,2,6,1,0,4,2,7,2,3,5,7,5,43,9,1,1,2,1,5,6,7,2,3,4,2,3,0,5,3,0,0,1,5,8,4,12,5,3,0,0,1,3,0,7,8,1,8,2,5,2,3,0,1,1,8,2,3,7,4,1,3,5,1,13,3,0,0,3,3,3,4,0,2,2,3,0,7,2,2,2,0,2,1,1,1,0,10,0,2,4,0,1,2,1,6,0,6,1,3,2,2,5,2,6,0,4,0,2,0,1,11,4,1,0,0,2,3,2,3,0,7,3,5,1,6,1,0,9,7,7,3,11,3,2,5,1,9,3,2,8,4,0,1,0,0,5,1,1,5,1,4,2,5,1,3,1,0,0,7,1,1,2,4,2,0,3,0,0,5,3,2,2,3,5,5,0,1,1,1,2,4,1,3,0,2,5,3,0,3,3,3,0,0,2,1,2,5,1,0,3,7,0,4,4,1,0,2,2,5,0,3,0,2,3,10,4,1,4,0,4,1,2,4,2,2,1,9,2,0,2,0,4,2,0,0,1,3,0,0,1,4,3,1,0,0,0,0,1,3,3,1,0,1,0,1,1,4,0,1,0,6,0,2,3,0,3,1,2,2,16,4,4,8,5,21,1,2,3,2,0,0,1,0,2,3,1,2,6,0,0,1,1,1,2,7,3,0,1,0,5,0,2,5,0,1,2,1,6,7,1,4,4,0,2,6,4,8,3,1,3,2,4,1,0,3,2,2,0,3,0,0,0,1,0,1,4,5,2,1,3,0,2,3,2,2,1,0,5,1,2,7,1,0,3,10,0,4,2,2,2,1,2,1
national,1,22,14,218,6,22,11,41,5,0,6,25,32,147,20,26,13,28,1,4,6,56,14,30,66,27,22,21,12,20,12,280,181,17,72,49,26,13,11,6,34,12,4,6,66,25,40,60,473,22,60,17,16,35,59,5,60,23,10,14,24,11,13,11,34,13,134,14,6,27,52,6,7,0,185,40,47,7,74,43,96,3,22,24,595,47,22,2,36,2,6,10,4,22,71,26,39,6,44,35,22,102,66,14,27,53,9,13,29,5,37,7,20,26,2,44,0,2,126,263,105,20,96,89,16,1,6,3,10,3,43,9,9,56,16,146,10,4,8,13,12,45,29,18,1,106,7,39,34,11,141,4,20,22,26,96,78,17,13,32,24,23,26,4,8,39,13,40,36,13,18,178,49,23,8,5,253,3,12,84,61,32,23,40,3,36,63,47,53,44,0,17,16,3,7,17,57,14,14,55,104,4,6,7,28,38,45,97,10,47,127,5,56,9,4,4,0,10,10,12,8,35,3,31,58,246,67,39,13,25,28,40,30,120,72,19,47,25,18,18,105,39,9,20,31,9,9,45,155,8,16,32,18,11,8,13,7,2,5,30,23,32,13,3,18,105,35,8,15,11,108,18,41,15,6,5,49,24,9,10,116,30,3,32,39,10,36,42,28,4,3,1,16,10,5,18,54,17,11,29,35,52,4,1,24,6,42,8,28,7,9,1,60,22,50,15,41,83,37,12,43,10,49,26,108,20,39,24,2,47,4,24,13,16,7,10,30,16,14,7,25,8,16,52,24,25,61,72,29,11,20,13,11,98,60,13,7,13,44,33,66,24,37,51,2,4,41,14,18,39,5,32,7,16,31,60,13,8,14,6,73,5,75,19,26,97,10,27,27,10,41,11,10,8,38,18,67,13,38,3,38,5,15,1,11,20,21,3,26,23,1,13,9,53,9,16,1,11,13,2,13,21,60,10,4,7,5,37,12,6,16,1,0,4,15,3,1,10,36,12,50,24,18,11,1,14,16,4,72,25,46,7,8,4,81,12,2,16,32,46,22,15,49,75,24,5,22,11,38,3,37,12,15,17,6,62,5,25,67,23,14,16,4,12,11,11,30,4,32,9,105,65,2,5,9,10,10,13,5,21,28,15,14,9,16,70,28,35,9,14,8,14,16,39,22,23,6,18,20,19,9,30,26,91,36,5,61,54,42,28,19,5,3,33,21,14,16,28,72,76,15,2,15,34,8,22,9,15,11,26,90,3,10,84,22,11,71,9,17,18,20,16,16,10,13,18,23,31,42,69,15,11,32,19,12,5,6,18,17,43,10,17,23,25,23,10,16,14,2,28,25,47,22,9,79,8,13,11,15,16,46,17,6,1,9,25,10,32,17,9,61,64,15,12,46,17,15,18,31,2,19,11,12,23,16,15,9,13,16,50,14,31,36,54,25,10,73,34,6,11,28,8,6,47,14,16,19,5,20,142,13,31,17,15,6,8,51,40,5,16,11,6,3,9,2,0,1,1,8,11,35,8,5,49,14,17,7,2,3,19,6,56,11,24,11,4,16,18,23,12,10,20,17,13,5,23,7,10,31,8,18,19,5,17,15,7,23,8,7,0,4,7,5,38,34,49,8,8,24,25,3,3,6,41,13,18,11,14,6,15,83,31,4,17,2,2,16,14,24,11,51,0,6,11,7,8,23,30,13,7,13,2,4,5,1,14,21,28,22,26,22,31,3,4,22,20,37,26,32,2,18,16,2,26,5,27,18,9,4,8,2,3,12,20,28,5,15,1,14,20,5,33,20,6,75,54,16,4,4,0,7,2,11,5,7,4,4,7,28,8,6,0,4,8,3,5,14,16,0,19,4,1,5,27,3,4,7,13,6,7,15,0,24,5,9,14,10,17,18,7,5,32,14,7,12,12,20,17,10,12,21,83,20,11,10,10,15,5,6,9,10,3,5,13,7,8,5,4,14,15,22,4,21,31,5,1,7,7,12,2,0,4,11,4,7,3,6,4,5,4,4,19,10,3,4,2,2,8,11,9,13,3,4,9,20,1,4,6,2,32,20,21,12,7,8,2,9,6,8,7,4,4,7,4,4,2,2,0,2,9,12,13,3,5,3,10,7,6,3,27,3,34,4,1,3,20,10,10,53,1,9,7,5,11,10,5,3,7,6,1,17,18,0,3,4,13,7,3,7,15,3,4,17,11,1,3,4,3,17,13,2,5,4,9,11,36,8,21,10,3,7,8,9,6,11,21,2,5,19,3
meet,10,85,39,434,27,47,22,87,11,4,39,32,43,225,6,17,17,37,27,17,19,101,63,68,35,54,44,77,25,69,23,471,340,42,132,219,140,32,54,24,29,40,11,28,80,49,68,47,476,161,131,16,43,182,55,7,115,103,45,54,28,25,12,35,90,54,258,24,20,39,121,10,15,8,367,30,77,32,250,60,197,13,33,23,481,65,54,16,117,8,21,15,18,74,115,43,29,21,123,35,30,76,94,35,52,94,30,20,58,23,50,25,40,53,19,83,18,16,168,325,68,95,58,277,40,15,11,12,6,13,66,14,17,150,62,197,11,16,15,37,11,72,65,15,16,191,13,54,47,63,108,14,32,42,29,86,114,45,17,106,52,14,21,28,20,36,14,60,69,22,59,209,55,17,23,15,310,11,25,264,37,34,68,49,12,61,66,56,55,152,8,23,18,7,13,12,62,27,24,28,76,13,13,27,83,64,31,90,24,78,188,28,56,40,16,24,35,48,31,19,16,46,15,37,145,200,76,77,18,25,33,52,65,38,81,89,81,29,44,20,161,87,15,24,36,30,21,82,193,21,33,59,57,35,25,43,31,26,17,46,7,98,59,10,25,124,21,46,25,19,300,55,91,9,11,30,63,76,20,12,167,22,13,47,33,9,40,35,40,10,20,23,50,46,15,32,76,18,17,30,42,94,4,16,34,23,54,13,18,13,19,60,1,41,117,49,35,99,37,33,84,15,70,49,91,4,62,95,11,78,25,24,15,9,20,27,47,13,14,36,21,30,51,30,26,16,100,129,48,45,33,36,6,73,32,19,18,17,43,100,50,35,63,38,18,87,85,30,31,53,13,80,20,50,21,103,27,13,35,25,143,5,142,37,24,75,8,89,60,14,45,35,31,30,77,29,87,20,99,16,31,18,5,18,18,7,20,11,67,42,3,31,31,30,19,25,19,14,18,26,13,24,61,25,6,12,9,26,28,41,60,37,18,40,19,12,10,45,68,12,30,29,25,35,13,13,66,19,92,25,83,10,37,24,109,20,10,22,25,65,41,49,55,70,13,9,55,20,17,8,65,15,11,18,25,31,9,34,48,25,14,31,13,20,21,14,36,24,11,3,187,109,2,20,62,9,14,42,25,13,24,19,4,14,14,104,28,23,14,8,6,11,29,14,23,37,13,18,2,31,4,28,9,29,20,19,49,8,38,79,42,14,23,21,27,16,29,18,86,63,14,28,11,33,40,25,6,51,39,10,67,9,15,76,25,33,72,19,8,27,40,11,51,24,44,45,39,19,87,75,38,17,68,10,14,19,47,16,10,53,17,38,32,33,18,7,27,16,9,42,44,57,23,15,62,5,29,11,94,26,48,5,12,12,20,37,23,52,27,15,71,93,46,9,48,20,30,19,16,13,35,24,18,78,23,22,13,17,30,69,53,30,50,44,39,7,29,26,11,23,16,7,16,47,16,73,17,13,29,260,40,15,26,16,17,39,69,35,15,28,13,17,44,42,16,16,17,16,37,29,42,22,53,42,49,18,11,16,12,8,23,85,23,26,24,34,55,27,13,32,36,50,45,53,25,26,24,11,30,26,21,14,14,9,27,27,42,31,13,12,11,21,20,64,27,65,31,16,27,21,17,10,15,42,16,19,18,4,6,32,25,51,22,16,10,9,66,18,51,21,21,10,15,31,34,13,31,40,32,14,39,40,15,36,17,48,22,24,16,32,28,59,13,31,40,60,30,11,29,29,23,11,12,15,14,32,52,10,17,26,3,12,34,23,37,10,24,43,20,34,25,9,4,18,12,34,15,20,11,16,21,19,16,26,16,15,40,12,35,12,24,8,13,17,8,13,18,38,7,22,8,7,42,17,17,10,22,23,29,10,36,18,19,11,22,14,16,51,18,23,13,33,7,21,19,30,26,41,12,23,47,60,12,10,12,10,21,14,13,12,24,8,15,20,12,25,6,18,20,60,18,11,35,48,24,15,11,31,25,8,8,13,16,14,57,14,19,11,11,14,11,26,12,18,17,25,12,21,17,22,24,17,19,14,28,26,3,37,17,61,14,50,11,43,20,32,11,18,10,9,17,24,18,17,11,14,5,31,13,16,17,25,11,18,12,13,20,41,8,15,14,33,45,24,43,65,39,60,160,16,16,9,7,57,22,27,6,16,69,15,2,10,7,8,11,32,9,8,6,17,25,12,27,22,6,7,18,21,14,7,24,16,13,23,12,9,17,37,31,9,7,14,12,36,13,19,6,13,10,19
strengthen,0,11,9,92,12,13,5,32,5,2,10,10,30,94,2,6,11,21,12,11,2,24,38,26,12,28,25,37,10,23,10,165,104,28,37,87,63,2,17,13,9,27,7,14,25,19,29,31,159,87,27,20,27,89,36,3,18,11,13,36,11,15,9,15,14,8,71,10,8,5,17,3,12,0,137,10,22,2,50,24,71,6,5,8,136,7,8,3,18,0,8,9,5,27,32,10,11,4,61,26,3,22,17,15,20,20,3,13,18,5,18,10,35,36,27,27,1,0,42,79,32,46,24,85,6,9,8,1,1,2,21,4,8,71,17,93,1,6,6,9,7,33,18,2,4,83,9,18,12,5,48,8,8,16,10,45,34,9,10,76,9,4,10,6,10,21,4,32,21,10,22,59,20,7,13,5,72,9,6,61,11,9,49,22,0,26,17,18,10,39,1,6,6,4,5,4,14,18,11,7,36,3,11,14,34,12,11,46,8,20,57,13,20,11,7,16,2,15,16,4,3,14,4,8,36,74,9,20,4,8,16,6,31,26,29,7,17,19,12,8,47,25,7,4,21,1,9,45,61,9,23,11,16,1,7,13,3,6,0,19,7,42,5,1,5,34,23,25,22,10,69,16,11,8,3,8,39,11,2,4,69,8,5,9,7,9,28,29,9,1,3,13,10,4,1,5,19,1,5,14,19,20,2,0,12,15,39,5,10,8,13,22,41,1,16,14,25,19,18,9,27,8,22,18,49,2,11,33,2,14,11,8,6,5,5,8,26,4,9,7,10,9,15,5,7,7,25,33,19,40,6,11,3,41,8,4,6,3,9,35,30,38,32,11,5,8,16,8,25,26,11,56,5,36,6,19,2,6,13,7,34,5,26,8,21,8,8,16,14,5,25,13,9,7,9,11,25,2,18,4,15,12,4,9,1,3,7,8,34,29,8,8,5,13,2,20,11,7,3,22,4,13,30,8,10,4,6,13,10,16,9,3,0,9,9,4,10,16,35,7,13,12,4,18,9,9,41,10,15,10,57,5,26,8,29,7,8,2,4,13,10,28,23,23,11,5,26,6,6,6,17,8,1,11,7,7,2,6,21,10,0,19,2,5,9,4,20,11,4,7,38,11,6,6,13,6,2,8,7,3,6,6,5,21,8,34,13,7,2,6,3,4,3,2,13,13,10,9,0,8,3,8,4,13,1,2,20,10,3,14,7,9,13,6,5,6,3,9,22,10,4,15,6,18,11,4,3,12,3,8,19,1,5,22,15,8,24,5,2,1,9,2,8,14,9,3,12,3,28,26,8,7,6,12,5,1,2,1,5,17,3,8,7,15,8,2,5,5,2,11,20,18,14,3,16,3,15,7,17,7,13,5,6,3,3,7,3,6,5,5,12,7,4,4,9,4,11,6,3,1,2,1,1,14,3,7,3,0,5,35,10,16,5,13,3,7,12,8,4,5,6,3,6,10,2,7,15,5,5,78,7,4,10,7,4,16,19,7,4,7,7,7,3,4,6,4,1,2,2,4,11,0,7,19,6,5,1,3,2,2,3,12,7,4,9,5,7,15,3,4,4,23,4,10,3,5,10,1,7,2,19,2,3,4,7,7,9,6,2,3,0,1,1,31,6,13,11,4,2,7,2,2,5,8,3,1,2,4,0,16,7,11,3,4,1,1,12,3,10,5,8,1,2,1,2,6,11,23,10,4,17,1,1,3,1,13,3,7,3,3,2,10,7,8,21,7,3,7,20,6,13,6,8,7,6,7,22,5,6,4,0,3,11,2,4,10,8,1,2,1,10,4,0,0,7,9,7,3,1,1,6,3,5,6,12,4,25,4,9,3,3,6,2,2,4,3,4,10,2,6,1,0,9,7,0,4,7,4,10,5,10,8,18,5,8,13,7,16,5,10,2,3,4,2,2,6,8,11,3,10,4,21,9,5,3,5,8,0,5,6,2,7,3,16,4,2,1,0,10,13,4,6,12,19,1,3,0,3,9,7,1,0,5,0,1,4,3,3,4,2,4,2,5,2,0,1,2,2,3,14,4,0,10,3,0,1,0,10,1,8,15,14,1,3,8,3,1,6,9,1,3,5,1,3,3,1,5,5,3,2,4,8,2,1,1,3,9,2,7,9,6,8,2,2,8,9,6,2,14,0,2,3,6,6,3,1,0,8,6,1,0,3,2,3,3,8,1,2,2,2,4,9,10,16,9,5,6,8,9,2,2,5,0,4,3,2,16,26,10,7,5,12,3,16,4,5,6,3,10,17
pay,10,50,35,388,23,49,18,65,10,11,47,34,25,174,7,11,32,65,25,9,12,133,91,126,71,71,16,43,16,93,40,736,373,43,170,197,69,106,120,15,95,12,8,24,90,38,91,32,737,71,143,15,19,81,73,9,306,84,29,46,36,12,9,25,69,38,321,62,19,52,228,5,11,8,276,40,124,12,322,70,382,8,59,22,734,222,69,19,164,37,53,31,65,101,370,137,45,29,106,42,46,117,94,52,39,96,75,84,84,30,89,17,42,55,55,118,26,51,232,597,126,122,352,513,40,13,15,11,38,25,28,10,25,156,71,160,21,10,11,21,10,89,130,22,13,201,28,58,55,123,97,19,79,15,17,82,96,10,5,82,168,15,52,39,47,94,18,32,66,28,77,289,76,14,49,33,477,16,32,165,98,17,45,69,24,88,126,68,77,165,14,20,46,9,27,25,83,27,59,44,111,28,36,27,108,24,36,132,59,59,240,41,90,85,35,109,46,52,48,10,71,87,23,40,191,283,98,145,24,100,30,80,114,21,138,174,96,34,37,21,255,98,20,37,31,33,20,100,150,20,27,112,52,71,39,62,30,51,12,103,41,61,47,27,24,159,32,16,29,26,415,112,421,16,14,4,53,113,38,8,188,21,12,36,55,4,75,71,56,29,15,9,88,54,33,24,215,12,29,63,98,127,25,57,35,41,58,11,34,6,3,50,117,16,1,58,106,99,50,9,149,26,98,28,116,2,34,80,10,75,24,58,13,18,24,37,36,16,27,66,27,40,59,34,43,9,102,139,52,95,62,30,14,164,67,31,21,5,38,186,62,24,21,58,6,8,129,42,44,67,6,70,21,39,36,144,21,39,38,26,222,15,142,30,16,95,15,83,153,15,47,17,36,26,79,30,155,11,84,8,35,3,15,6,35,16,41,9,73,26,6,26,47,47,24,11,14,10,19,3,12,23,31,23,6,13,5,29,16,55,120,54,47,52,9,7,3,18,36,18,28,36,20,69,7,7,51,12,89,40,95,14,15,33,111,15,4,31,26,112,48,76,90,110,13,11,93,35,8,10,68,18,8,22,2,80,20,18,57,31,22,35,5,11,17,30,53,7,6,9,216,110,8,12,52,21,15,167,35,24,51,23,23,35,60,169,16,63,57,23,27,15,19,9,31,31,22,30,10,33,6,62,18,38,15,25,61,30,54,83,36,18,9,31,25,48,15,17,112,55,10,5,12,37,57,24,3,66,39,23,37,8,20,127,10,37,43,32,29,27,64,15,66,7,37,42,25,15,106,103,41,21,98,2,6,17,52,33,37,108,44,37,41,43,21,23,17,20,23,30,45,74,54,25,98,26,28,53,130,31,48,10,16,11,16,72,23,40,21,57,88,35,29,19,92,22,50,21,21,28,37,46,9,159,20,38,12,40,23,77,210,59,96,53,20,17,20,37,23,36,45,8,35,59,22,110,17,28,12,475,56,12,29,12,10,48,158,28,40,55,13,11,76,20,29,23,12,30,28,29,48,29,108,36,191,7,14,34,16,19,36,105,33,16,31,45,68,17,4,14,52,31,46,35,35,26,20,4,66,31,20,20,12,12,31,19,59,10,17,11,5,65,27,81,52,116,21,17,40,33,23,14,4,104,10,16,33,21,6,23,18,72,71,10,13,24,77,28,46,49,33,15,12,46,18,25,77,21,38,50,23,77,41,96,88,52,24,26,13,238,234,73,33,75,43,112,37,25,19,42,17,14,16,55,12,48,69,14,23,42,6,7,33,47,41,18,39,10,55,53,28,21,6,23,37,70,22,13,14,5,20,20,50,14,15,9,23,42,71,22,118,9,75,28,25,8,28,33,11,52,12,24,1,36,11,16,24,31,36,19,67,20,20,7,20,15,13,62,21,8,12,8,4,19,37,80,43,17,16,26,40,58,14,34,6,34,9,57,22,15,37,15,25,6,28,16,9,5,9,42,6,9,211,101,13,9,14,51,15,1,71,33,6,5,38,22,16,10,3,33,12,22,33,10,17,47,2,10,37,14,33,16,19,25,7,23,4,85,41,53,9,60,23,257,28,30,34,8,15,7,19,23,11,93,6,18,5,23,19,61,10,25,25,20,11,32,16,43,9,25,9,84,74,90,85,229,191,92,327,13,20,14,10,13,30,41,34,4,72,11,25,8,12,27,32,62,7,44,3,5,17,14,30,38,21,4,12,19,19,7,78,14,43,64,17,74,12,22,77,14,3,5,10,8,5,73,48,18,4,2
operation,4,19,5,201,5,8,5,35,4,1,12,12,17,54,4,7,10,20,5,4,7,68,12,21,27,11,15,17,8,35,12,257,172,23,73,40,20,26,35,4,16,4,4,15,42,13,48,28,343,21,65,7,17,32,0,1,102,153,9,23,28,8,5,15,31,8,93,16,17,20,33,7,5,4,80,7,32,9,88,27,155,3,21,4,312,32,24,1,97,9,29,5,9,56,84,29,29,22,36,24,33,50,43,19,13,44,24,10,34,8,33,13,19,23,5,42,17,8,142,206,47,23,25,159,6,3,7,0,16,7,8,5,4,67,30,71,3,0,7,9,1,54,42,7,3,82,5,10,34,41,69,1,19,8,1,34,29,8,4,9,35,4,18,9,8,10,9,28,35,16,21,85,29,5,9,9,248,3,12,47,30,12,10,46,6,33,48,19,26,68,3,10,20,1,3,6,39,10,18,21,67,10,6,13,36,15,20,96,12,36,86,12,31,18,4,1,6,9,41,3,14,20,13,28,75,194,57,40,8,25,17,27,53,43,45,92,38,16,12,9,76,44,12,9,11,19,7,46,72,8,15,49,16,29,23,16,17,10,14,67,16,56,43,10,18,160,14,13,18,11,189,36,104,13,10,3,28,72,34,2,68,6,3,18,12,6,4,10,13,1,11,5,30,10,15,16,75,13,8,18,21,56,7,9,18,0,27,10,5,8,6,15,49,14,58,1,28,83,29,10,54,8,25,7,50,9,8,25,3,25,3,16,10,8,6,24,23,5,15,26,7,11,25,9,19,6,63,60,28,10,36,19,5,59,32,15,4,8,26,73,39,24,7,34,4,2,48,8,13,22,7,33,7,21,20,132,16,14,23,18,69,6,83,13,9,70,4,23,36,8,20,5,7,10,46,29,85,29,56,30,35,5,5,4,18,14,14,0,48,17,1,10,14,21,0,16,9,7,4,9,5,15,22,12,2,9,10,29,13,24,28,13,22,31,6,4,1,15,11,4,34,28,6,13,5,2,25,13,74,26,20,8,6,5,79,26,3,7,8,79,23,24,41,40,20,7,33,18,8,1,29,6,6,0,11,23,1,7,38,10,7,15,4,2,24,2,26,13,4,8,124,58,1,4,20,10,13,29,18,14,10,8,4,3,11,59,9,23,7,14,13,9,7,19,26,28,7,15,27,14,4,29,19,25,11,6,36,25,20,29,17,10,8,8,7,10,19,5,60,49,6,6,11,16,16,10,6,30,18,9,28,7,22,60,30,16,64,12,3,10,36,10,54,12,21,29,21,7,53,57,18,15,30,5,9,11,56,11,13,40,22,33,24,20,12,1,9,13,9,7,38,37,17,10,44,5,6,15,35,17,27,6,13,2,7,23,19,30,13,25,42,45,13,15,45,18,34,12,14,7,26,12,9,43,13,10,11,17,14,63,40,43,25,28,16,5,10,18,9,24,20,4,8,49,13,113,14,4,7,182,14,3,14,12,11,30,63,11,0,26,13,8,21,30,8,8,1,13,14,13,32,16,36,20,27,16,13,20,15,9,20,29,19,11,23,19,21,8,3,13,9,14,25,10,11,21,14,2,28,21,4,7,12,12,30,7,23,6,11,7,6,42,9,35,27,63,21,11,13,21,18,5,10,36,7,8,13,7,7,24,10,18,19,10,10,14,48,10,30,8,11,9,7,22,18,4,42,15,13,9,16,43,38,72,43,41,6,29,17,56,68,11,12,25,39,32,19,11,23,13,17,3,2,15,12,19,24,7,15,20,8,13,16,4,12,9,15,5,16,33,8,10,3,16,33,26,28,27,13,12,13,8,17,8,13,1,13,7,22,13,27,5,14,14,13,7,12,16,5,23,2,27,9,27,15,9,2,13,23,12,15,17,21,8,10,19,16,34,8,10,6,10,5,12,20,13,10,13,23,5,19,27,5,21,4,16,12,24,5,7,9,6,11,7,7,17,2,5,11,28,17,13,30,35,6,11,7,21,20,6,2,14,16,10,27,13,8,30,7,16,8,12,0,3,6,14,11,4,10,9,13,11,9,5,0,4,2,31,18,15,14,17,7,48,16,12,8,12,11,4,9,10,6,34,15,12,2,9,9,22,12,3,9,24,10,22,11,11,6,20,8,19,39,6,36,45,24,49,136,7,6,6,9,7,5,28,47,2,36,9,10,3,8,6,9,26,13,16,2,9,24,7,6,8,8,8,6,14,18,1,36,8,7,32,11,14,13,6,4,1,7,4,24,1,0,10,4,18,3,5
benefit,2,16,27,161,12,20,11,65,3,5,21,10,14,106,8,13,12,22,9,3,5,36,35,44,27,26,23,32,6,24,8,264,247,33,122,137,48,16,36,8,21,24,12,16,63,31,56,31,312,45,79,15,31,68,30,7,120,29,13,29,20,9,10,27,30,23,238,19,10,22,53,14,13,8,182,24,54,6,118,59,140,2,20,17,284,59,25,1,33,3,13,9,18,34,97,26,21,13,53,65,27,43,38,16,29,40,31,19,35,5,32,19,22,33,26,36,5,4,72,277,59,58,77,123,9,3,8,10,8,8,20,7,24,111,40,103,16,4,12,11,5,52,40,2,5,99,7,26,49,37,72,7,33,18,16,51,111,10,10,69,45,5,31,9,14,43,7,27,64,10,27,166,62,4,17,8,196,8,15,101,47,21,35,25,8,73,56,40,41,57,2,9,22,5,7,3,39,10,12,39,57,12,12,13,43,19,6,132,26,65,124,18,29,35,10,12,11,12,17,8,3,40,7,20,68,152,23,89,10,33,16,19,40,44,59,30,42,33,18,18,119,48,23,7,29,18,9,42,70,17,17,83,21,11,20,29,7,5,6,31,17,33,21,3,17,46,49,20,34,11,213,30,34,17,4,7,44,28,15,5,107,12,7,32,23,11,50,56,24,27,2,4,31,17,8,21,74,5,11,51,32,46,3,1,22,49,27,7,25,3,5,41,35,25,106,28,1,90,28,6,59,11,62,26,73,6,18,41,3,31,10,28,10,14,8,28,28,12,8,11,14,15,29,15,8,14,45,75,31,37,29,24,10,52,36,20,2,9,34,43,58,36,35,32,8,6,55,27,29,36,7,58,16,39,17,83,8,21,21,8,77,5,66,38,23,65,12,31,52,11,25,12,14,12,48,14,59,6,64,9,19,9,8,4,18,20,21,2,67,25,6,21,14,29,8,17,6,16,7,7,18,10,27,18,1,17,13,8,7,21,9,7,1,7,5,6,2,12,14,10,28,52,21,34,3,5,27,10,71,22,71,3,22,4,105,17,4,1,20,25,18,34,53,57,11,10,52,28,14,4,39,4,7,4,8,70,6,11,32,17,5,32,10,8,13,5,26,7,8,4,81,47,4,5,29,7,15,18,11,14,44,12,11,44,14,24,22,35,14,8,15,11,7,16,32,21,6,19,11,19,9,21,11,35,22,6,47,10,22,57,19,16,2,16,12,15,11,22,71,52,12,8,25,49,29,11,8,23,18,17,36,2,8,61,10,22,53,10,23,13,22,7,33,3,22,33,16,13,52,83,25,11,29,3,11,4,36,12,17,29,33,15,54,25,16,10,12,10,9,26,39,28,13,15,44,7,16,35,34,34,30,4,11,2,7,34,8,29,10,21,50,23,8,29,35,16,35,18,13,4,16,18,6,27,11,13,15,28,10,52,16,20,30,26,7,11,22,11,4,12,38,8,6,25,18,21,18,11,21,152,28,11,14,22,5,18,60,11,9,30,20,7,10,22,8,7,6,8,13,12,30,12,18,19,31,15,10,7,4,7,18,52,6,11,20,12,21,13,7,10,15,19,14,20,6,15,14,5,23,12,6,7,6,9,21,9,31,8,6,4,4,5,5,48,14,29,10,7,9,27,9,5,4,20,6,12,12,9,7,20,7,44,19,14,10,6,20,8,19,28,13,11,4,18,12,16,25,29,21,19,24,4,4,7,8,25,13,15,16,17,26,48,2,2,62,36,9,13,19,14,14,6,12,19,3,18,13,5,26,23,1,3,20,7,20,11,20,0,7,31,7,7,5,13,18,38,7,9,11,3,3,8,11,4,9,6,7,12,17,7,30,5,10,5,5,3,8,11,6,17,3,1,6,10,6,8,8,7,19,10,7,8,28,6,12,13,8,33,17,6,7,4,9,14,9,16,24,11,12,11,18,21,14,23,10,11,9,17,6,1,20,7,10,8,7,6,3,1,4,30,6,13,16,23,6,15,0,7,10,4,1,3,2,4,9,6,6,5,7,9,7,21,7,5,9,7,3,3,2,4,19,5,8,4,14,4,6,15,8,35,6,6,14,12,14,2,5,17,19,7,11,6,6,22,4,11,2,7,4,8,8,13,11,6,12,4,21,11,13,52,17,29,6,3,9,35,39,14,29,3,5,6,14,8,7,3,9,8,17,4,3,7,12,18,8,18,11,18,2,21,2,4,11,32,4,8,40,6,19,11,8,11,7,12,17,16,12,18,5,5,3,9,6,10,3,21,26,5,10,5
result,22,57,38,446,19,24,14,102,20,9,81,35,43,187,16,35,26,44,13,23,17,139,27,66,100,29,36,61,10,46,27,599,432,32,166,160,133,36,63,20,20,35,18,22,111,71,83,95,934,60,177,47,54,125,45,20,173,142,3,76,62,21,16,59,85,16,332,30,35,50,61,15,11,17,270,40,60,23,248,73,208,13,55,32,768,81,52,7,141,10,36,22,26,90,197,56,93,31,138,63,51,93,132,34,62,81,52,28,59,22,53,23,51,50,8,103,22,9,203,628,136,69,70,276,36,6,18,23,17,10,37,25,17,147,60,216,36,32,21,35,22,154,111,16,12,230,29,60,63,51,189,11,43,28,24,83,104,24,34,45,86,10,36,15,42,20,26,108,94,33,48,297,75,5,11,49,593,12,30,104,69,36,20,74,8,86,114,72,145,194,10,14,41,6,17,9,55,33,39,48,130,28,14,39,92,36,27,142,36,114,276,18,67,24,8,7,16,23,56,15,16,67,35,54,158,313,146,121,17,50,63,63,94,77,117,88,107,36,40,24,248,105,28,29,63,33,33,79,146,17,29,116,72,24,40,44,42,13,27,73,27,78,89,22,34,200,26,10,44,18,411,21,133,18,12,4,47,54,38,14,182,35,24,58,53,11,12,26,42,11,22,20,36,30,18,41,139,13,18,58,70,83,13,24,62,10,75,30,23,15,11,83,99,19,99,83,90,1,62,20,150,26,92,40,165,20,36,86,16,102,15,38,24,14,31,41,67,35,18,48,37,49,44,37,19,25,146,210,68,21,52,32,22,110,89,20,18,16,66,126,93,29,36,67,22,5,139,28,43,36,10,64,21,33,45,120,35,30,71,17,169,8,133,45,10,117,19,77,93,24,85,14,31,43,127,39,225,21,134,28,74,7,17,4,19,27,47,14,68,52,5,37,34,62,55,30,10,28,15,7,24,33,83,39,21,19,29,50,33,70,53,21,7,51,10,20,5,118,21,26,54,68,35,57,0,9,21,35,134,27,47,26,18,21,198,49,2,27,35,127,47,69,96,86,37,8,60,48,43,4,77,24,10,13,21,67,11,58,71,17,32,55,19,19,34,38,54,19,17,15,235,132,5,23,40,24,13,79,31,55,41,22,24,8,39,122,36,50,28,26,20,36,29,40,75,62,26,42,54,35,23,76,26,89,39,16,84,44,81,79,44,20,9,34,42,19,28,27,121,72,17,16,18,38,57,48,25,65,37,23,104,8,34,141,30,31,117,21,20,21,74,13,79,20,50,63,50,37,110,158,38,37,47,23,20,21,68,23,23,59,33,53,49,52,42,32,36,26,12,35,70,104,37,13,88,24,24,33,169,69,80,16,21,20,56,72,17,84,55,24,112,103,49,41,137,27,62,22,26,12,50,43,25,69,13,27,22,35,49,116,76,67,90,58,17,18,36,35,8,48,37,14,43,84,50,84,32,23,28,555,83,17,32,17,24,41,150,58,23,60,19,15,59,81,37,19,31,30,32,41,63,39,130,108,100,16,11,29,11,21,23,99,54,30,36,20,49,20,11,25,43,36,71,37,25,40,43,23,47,48,42,23,19,25,27,23,72,18,17,14,16,51,20,104,35,94,20,31,33,43,28,30,24,92,15,28,39,16,21,58,19,77,18,20,32,22,73,29,91,33,47,18,15,38,53,15,60,40,31,26,35,28,14,60,44,42,41,57,22,86,95,78,23,31,61,66,41,28,60,46,26,17,18,49,19,54,41,14,57,37,12,14,44,17,44,35,27,48,28,54,40,66,22,29,53,61,55,21,29,21,30,16,37,23,19,10,27,17,61,26,38,12,42,26,22,25,21,39,20,41,21,19,65,44,21,21,13,24,24,18,41,32,45,10,20,44,33,102,47,16,40,32,19,50,42,46,31,42,27,36,91,71,33,31,25,15,36,27,18,13,29,20,24,27,24,44,32,12,34,54,28,20,43,39,26,24,17,52,40,22,21,28,25,17,61,26,27,25,23,29,7,30,1,16,43,29,18,18,27,10,29,25,5,35,61,26,12,23,25,72,21,33,25,30,29,26,15,20,22,11,26,31,17,36,12,19,18,65,23,40,23,16,24,26,12,16,28,24,25,50,32,28,29,13,39,54,37,50,110,20,22,18,22,11,17,19,14,15,46,30,20,26,24,26,26,51,21,22,22,21,16,13,36,22,27,16,13,20,38,11,41,27,29,55,17,22,37,13,91,8,20,13,19,5,4,19,10,17,13,2
capital,7,26,7,136,6,13,5,40,3,28,36,29,18,88,3,9,11,31,8,3,9,52,19,27,28,34,3,19,6,22,10,192,182,7,63,51,33,20,27,4,12,11,16,3,24,18,41,15,284,27,60,13,46,60,12,3,44,25,6,19,28,5,4,14,27,6,125,9,13,40,40,3,6,3,122,15,27,9,87,36,84,5,23,12,246,37,18,1,59,10,15,5,6,17,104,30,16,10,46,42,20,38,53,12,14,29,17,21,16,13,30,9,20,28,19,28,6,6,68,181,54,25,48,89,13,2,5,1,6,8,15,4,10,83,32,100,12,4,10,8,15,62,18,1,5,94,14,24,35,23,70,2,28,13,12,34,35,10,7,26,32,3,10,8,6,15,12,30,41,21,43,182,39,1,6,19,232,6,13,74,34,13,11,35,11,51,69,22,42,67,2,6,26,0,2,2,47,10,19,17,83,12,31,7,33,7,10,43,15,21,80,6,27,15,6,6,3,9,10,13,10,46,4,16,66,112,41,61,11,42,17,44,40,36,47,31,20,27,29,9,109,48,12,5,34,9,4,27,55,29,15,61,22,12,17,15,10,4,4,23,9,29,8,7,12,37,3,5,19,6,126,20,77,4,14,1,25,15,12,10,65,10,7,30,23,4,5,8,15,3,7,3,20,10,7,13,41,13,7,54,28,36,3,5,18,5,36,5,7,4,1,37,37,18,50,29,28,62,1,16,73,11,32,8,83,11,22,22,6,51,1,14,38,9,16,24,32,7,6,10,14,16,19,37,10,13,51,61,20,26,18,26,10,66,38,11,11,5,33,44,25,5,22,32,24,1,50,11,6,18,5,24,2,28,29,13,5,18,23,10,57,7,48,7,4,48,20,33,35,9,32,5,16,12,30,9,55,6,32,7,24,1,6,5,7,24,14,6,41,7,5,15,11,22,2,9,5,14,5,2,16,12,21,12,8,8,6,20,12,23,44,14,2,16,6,6,0,14,7,8,37,29,10,27,3,7,11,14,63,7,29,4,9,13,44,12,1,9,29,25,31,23,39,55,16,7,33,16,7,4,29,10,11,0,2,27,2,17,25,7,13,14,11,3,8,2,11,2,16,6,48,29,5,8,32,9,7,13,13,25,15,7,17,1,126,142,21,39,14,21,11,9,18,6,21,12,8,16,60,12,6,34,16,28,8,7,46,70,19,34,12,4,15,9,12,9,15,10,40,39,9,10,4,22,23,7,10,25,11,19,33,6,16,57,23,10,52,9,6,14,28,12,29,10,21,25,17,15,58,65,18,8,8,5,12,5,9,3,12,29,45,26,11,27,8,8,6,3,10,6,27,22,10,1,242,9,7,24,18,15,23,5,2,1,7,25,6,9,12,4,36,22,15,10,38,7,16,37,7,5,20,63,4,48,15,7,9,15,6,40,39,21,42,27,60,12,26,12,16,29,31,8,8,44,8,20,29,6,10,158,28,10,9,8,7,9,45,32,10,23,6,4,10,12,10,3,4,12,18,11,19,13,49,25,10,18,7,9,3,11,5,26,12,17,17,6,16,6,12,6,10,13,11,2,14,9,14,7,21,13,13,2,5,5,8,12,18,4,7,6,4,9,3,27,16,17,4,10,8,2,11,5,5,11,1,6,24,0,1,25,9,14,7,7,3,7,5,8,18,14,14,10,9,15,8,5,19,36,8,11,9,5,8,9,10,9,8,14,9,43,41,13,8,7,19,26,61,14,17,18,12,2,8,18,2,17,22,3,3,16,3,18,11,32,17,8,15,2,30,11,12,32,15,5,15,18,11,8,8,4,3,10,17,10,7,7,15,8,14,6,16,5,5,8,7,4,5,11,16,12,2,5,25,5,1,3,6,10,28,9,7,8,19,7,5,13,9,30,9,3,6,2,5,12,16,14,14,6,10,14,15,25,9,8,5,9,15,29,11,20,4,16,10,10,10,11,5,3,4,10,7,5,22,52,8,9,3,7,13,3,2,19,4,6,14,2,9,3,2,7,2,14,0,6,11,8,2,6,6,6,9,2,3,14,4,24,4,15,5,24,3,26,8,13,5,11,1,12,22,5,4,9,3,30,2,4,4,18,1,37,10,3,14,3,2,7,18,9,4,29,4,25,2,10,27,33,25,14,44,3,1,9,4,6,5,8,6,6,26,9,7,4,4,5,7,11,6,0,14,2,24,5,9,12,5,2,2,5,12,7,0,5,3,22,9,10,7,12,4,1,4,6,6,3,9,10,2,11,1,4
essential,1,12,3,81,7,7,1,22,5,1,9,3,6,68,11,6,2,10,5,3,3,23,8,10,8,4,13,13,5,8,4,106,58,5,21,34,44,4,10,11,7,11,1,9,21,9,21,14,128,16,21,6,15,46,7,3,31,12,2,12,9,4,1,5,18,8,70,5,5,6,17,1,4,3,71,5,8,7,36,10,31,9,5,2,139,8,21,4,6,0,4,2,3,19,23,11,6,5,24,11,7,18,25,6,12,15,8,6,9,4,16,4,14,12,5,10,1,3,31,95,21,9,12,31,6,5,6,6,2,4,16,6,8,41,15,24,2,2,5,7,1,23,13,4,1,40,2,16,12,3,40,1,3,8,13,32,19,9,3,14,16,4,2,5,13,2,4,10,15,9,12,42,20,3,4,6,94,5,8,51,14,10,25,9,1,9,32,11,19,25,2,5,3,1,1,5,6,11,6,9,32,3,7,5,19,12,5,36,8,12,43,1,20,5,0,1,6,16,13,1,1,11,4,9,29,76,15,19,8,16,16,13,24,19,11,13,21,6,9,10,30,18,3,6,6,3,4,18,40,2,12,13,9,4,5,9,4,0,0,7,4,16,11,1,4,35,11,11,8,3,64,5,16,8,2,3,18,19,6,0,29,11,8,20,3,7,13,17,11,3,0,2,12,8,1,11,14,8,2,12,10,13,1,3,9,1,19,1,14,1,6,12,33,9,9,10,6,20,16,1,28,7,23,7,37,4,10,20,1,20,5,4,10,4,7,11,14,6,7,5,4,3,15,9,5,2,34,20,15,5,8,3,5,24,8,8,4,2,9,16,23,11,5,14,4,1,10,3,15,4,6,17,6,16,2,37,5,1,11,5,38,2,30,12,7,23,2,28,13,7,15,2,6,1,13,11,32,4,11,4,16,4,3,6,2,5,3,1,16,7,4,3,3,13,3,3,5,6,2,6,8,9,12,10,1,5,3,9,9,15,9,3,0,4,4,2,6,5,12,9,5,20,8,7,2,4,8,5,27,4,25,1,4,2,24,9,0,2,3,16,7,16,21,22,9,1,17,4,8,1,13,2,5,1,2,18,5,2,13,6,14,5,1,2,6,4,4,5,6,2,42,23,1,3,9,7,4,4,5,9,9,9,6,3,4,19,4,6,4,6,1,7,2,11,11,4,3,6,3,14,2,4,3,16,4,6,16,13,10,17,11,8,5,9,7,4,5,4,23,17,1,6,2,4,4,1,2,12,11,4,32,1,8,18,8,5,22,7,4,5,12,5,15,10,5,7,14,8,26,28,13,4,6,3,4,3,11,1,6,10,8,5,4,9,6,8,5,4,3,8,22,15,5,3,22,5,12,6,9,7,11,3,4,1,5,16,3,10,5,1,16,25,7,3,12,4,14,4,4,4,9,7,10,13,0,8,4,3,7,17,3,12,14,15,10,4,14,4,3,6,13,1,9,17,5,11,8,2,10,65,4,3,2,10,4,4,9,12,3,7,2,3,13,8,1,2,4,6,2,13,10,11,5,14,9,7,3,3,1,0,6,13,5,4,1,1,9,14,0,6,6,8,9,4,7,10,3,1,7,13,5,4,1,2,7,4,12,6,3,0,1,1,5,19,11,16,4,5,2,14,6,3,2,13,5,14,6,0,7,9,8,9,0,7,1,5,14,1,11,5,10,1,6,2,5,5,8,8,5,7,7,7,7,3,2,6,4,8,6,6,3,10,4,4,11,8,7,7,10,8,7,3,7,9,11,13,6,5,5,7,2,0,9,4,6,6,0,3,3,8,1,3,0,3,6,11,7,3,4,1,7,2,2,3,7,0,6,2,6,8,4,3,2,5,2,1,5,2,4,4,2,2,10,7,10,1,3,4,15,1,2,2,10,5,4,2,3,10,7,2,1,4,2,6,3,2,5,9,4,5,5,14,1,1,2,1,11,2,3,2,2,11,3,7,1,2,7,1,9,14,12,2,1,8,2,2,1,3,5,4,0,3,1,1,3,2,4,3,0,4,0,2,2,2,1,2,5,8,2,6,2,7,3,5,3,1,4,5,4,7,3,3,4,2,1,2,0,4,3,4,5,4,2,6,4,2,3,2,3,1,5,7,3,2,2,0,5,4,3,10,3,9,6,1,7,4,3,4,11,3,7,5,3,5,3,0,0,6,8,3,2,2,1,1,1,6,7,0,2,2,6,2,5,1,2,2,2,4,4,4,5,5,5,7,3,4,6,11,0,0,9,9,1,0,4,6,1,2,0,0
citizen,42,73,38,423,51,26,24,100,17,12,161,60,27,318,15,61,30,52,20,30,13,150,44,95,48,56,53,64,25,58,59,686,537,32,210,245,222,23,16,24,29,57,32,15,119,70,76,46,1564,149,150,31,44,134,33,31,213,52,17,71,83,45,6,41,73,30,351,23,34,37,46,27,13,23,266,42,68,26,287,89,121,4,75,23,1017,39,40,0,148,4,39,31,13,128,203,27,53,20,129,41,13,97,154,51,39,106,12,10,43,16,77,20,27,55,20,129,28,10,247,465,124,122,27,229,15,23,7,15,15,5,52,20,34,195,74,133,86,24,17,48,8,133,114,10,6,298,35,58,47,41,210,4,72,19,11,97,92,28,44,41,31,10,31,12,6,31,21,86,107,49,70,296,73,10,14,73,682,12,53,96,77,69,20,57,8,52,92,73,133,216,15,25,24,4,3,15,32,14,30,59,63,5,5,42,114,37,16,80,57,82,241,22,72,32,6,18,4,4,30,9,6,90,19,40,141,438,69,83,13,9,39,46,59,60,145,52,105,35,21,29,317,104,35,33,79,33,28,59,172,27,55,55,94,18,23,55,59,8,22,53,5,109,71,28,12,89,37,34,64,32,488,15,118,27,17,13,161,21,53,19,302,31,2,89,32,4,35,35,69,9,24,14,18,13,10,45,156,21,25,97,142,117,2,12,46,2,124,14,31,7,13,43,84,27,149,54,59,150,73,28,1,32,109,18,398,64,21,110,21,114,48,32,31,17,27,54,70,49,13,38,47,47,64,52,15,18,152,232,73,38,47,49,37,100,144,14,15,23,57,82,69,37,21,59,43,14,155,29,21,53,12,72,15,58,21,72,32,6,71,29,265,21,146,42,21,130,76,128,98,29,140,27,44,55,86,37,266,4,148,17,117,11,19,16,18,18,44,25,86,48,18,34,14,49,83,55,16,38,23,13,20,36,45,47,5,21,26,63,38,55,19,16,19,47,16,29,2,68,38,10,109,166,37,43,9,17,50,34,102,20,83,27,18,20,180,39,9,63,22,108,35,97,134,67,26,6,74,62,25,6,99,22,11,6,7,52,18,62,62,26,23,50,25,27,38,64,36,27,30,30,249,97,9,24,62,34,10,99,50,23,25,15,12,9,43,26,15,70,29,13,14,25,42,19,48,51,22,21,12,43,15,254,29,76,43,31,108,13,88,100,53,17,22,22,44,17,52,29,227,49,19,8,17,12,19,48,23,111,87,25,114,27,20,179,34,39,129,11,23,35,79,7,119,15,65,72,63,34,142,147,33,39,38,38,21,33,29,28,26,47,22,66,43,61,34,36,25,34,16,33,101,129,36,12,74,30,16,15,337,69,78,7,26,29,50,66,16,73,13,23,75,94,49,36,140,38,70,24,27,13,44,8,14,48,10,20,23,29,73,121,24,95,98,89,56,24,34,27,21,64,50,17,12,76,63,53,15,27,17,1098,95,22,26,20,31,47,125,83,32,56,20,30,136,89,57,19,26,54,53,57,64,28,397,86,377,24,9,25,24,19,8,108,68,28,57,51,79,27,13,41,56,61,53,46,37,30,59,51,59,57,84,16,23,42,20,23,75,27,6,21,19,29,38,75,72,81,34,39,45,11,28,22,46,76,10,15,23,16,14,50,40,58,22,22,37,7,56,42,186,27,31,36,16,23,55,23,51,27,26,59,49,14,4,34,7,45,30,51,14,14,19,34,19,11,87,42,67,19,18,55,26,17,23,173,20,71,26,11,58,50,35,25,53,11,44,23,29,75,41,42,32,39,28,20,25,66,4,28,19,27,14,27,56,20,32,10,30,30,83,29,27,15,72,25,30,24,21,58,30,35,53,12,15,35,8,15,16,18,16,20,24,33,45,24,39,30,55,113,44,35,42,16,17,30,49,37,43,32,15,160,106,141,61,20,6,7,31,33,79,10,27,47,36,9,25,43,16,11,30,27,10,10,29,28,17,34,36,67,35,11,50,26,9,23,44,15,36,29,24,10,38,47,12,15,112,65,38,20,21,14,37,22,17,42,40,17,33,33,15,68,13,15,52,47,47,26,11,52,13,17,25,55,18,48,13,35,37,124,48,3,20,11,32,31,14,8,18,31,57,31,11,75,9,20,14,94,66,15,53,45,3,29,12,19,5,11,5,19,60,43,5,13,10,9,5,124,19,13,9,36,36,26,28,27,32,33,10,36,22,31,10,24,34,8,26,24,50,19,115,13,18,12,14,4,8,11,3,27,9,19
feel,11,18,8,97,13,10,6,15,4,6,13,3,12,76,9,10,2,12,4,9,2,20,13,23,24,13,9,10,13,6,11,127,106,9,43,63,36,6,7,2,7,11,4,2,15,19,15,12,200,27,23,0,18,40,9,4,58,14,5,17,16,3,0,7,17,3,87,9,9,21,8,4,5,7,53,14,14,0,41,21,27,1,15,12,150,20,5,4,16,0,5,7,3,8,56,4,14,7,29,8,4,25,28,7,11,25,9,6,7,1,17,7,15,5,4,18,1,3,30,127,33,13,16,36,6,4,4,6,3,1,19,1,8,38,31,31,19,2,5,4,5,31,13,2,2,32,5,14,11,13,68,1,8,4,6,11,24,2,11,9,7,6,7,3,2,16,4,15,20,5,10,64,16,3,3,18,133,1,9,29,14,9,2,24,3,25,26,13,31,30,0,7,1,0,2,1,14,4,4,15,12,0,8,10,19,14,9,32,10,20,49,6,20,7,6,18,4,8,9,7,2,17,5,8,22,80,21,20,5,4,10,7,9,20,25,16,29,9,3,7,52,24,11,8,13,6,5,20,19,2,11,10,23,5,8,15,9,1,3,13,0,20,13,2,3,24,3,5,16,2,127,3,11,5,5,2,20,13,4,3,70,11,1,22,9,0,7,9,15,1,2,0,6,3,0,8,45,4,6,20,25,32,1,4,5,3,17,5,11,2,1,10,15,8,26,8,11,26,11,7,32,1,21,4,60,5,6,21,5,21,5,4,11,7,7,13,18,9,1,10,9,4,12,5,5,2,20,40,9,5,10,13,7,28,16,2,10,5,11,15,13,5,4,18,4,0,21,5,7,16,4,12,2,10,10,12,4,4,17,3,44,3,32,13,4,16,5,21,24,4,24,3,5,11,30,12,34,4,28,2,26,2,6,5,8,9,2,10,15,14,7,10,2,8,7,6,1,5,6,1,4,3,13,10,2,1,2,11,11,12,9,1,1,7,1,10,0,6,8,5,10,16,3,16,3,4,4,8,19,4,8,3,4,1,36,8,1,4,1,19,16,15,26,29,4,3,16,4,2,2,17,6,5,3,0,16,5,12,15,7,6,8,5,7,13,6,8,2,5,2,48,30,6,9,8,4,1,11,9,13,7,4,3,2,4,30,5,8,4,7,2,6,7,5,10,12,2,8,3,7,4,24,2,25,8,5,17,9,7,16,12,11,8,10,4,6,9,6,32,17,4,1,5,7,1,3,2,12,13,7,22,7,0,27,4,6,15,2,7,15,21,5,13,4,12,8,12,6,25,16,3,7,8,0,4,3,6,10,7,12,6,9,8,14,4,4,4,5,2,10,16,36,6,2,19,4,1,1,14,26,13,0,2,2,1,16,2,17,8,3,17,11,13,5,34,4,20,1,9,4,8,2,6,14,1,2,6,14,15,13,6,23,21,21,4,1,10,2,8,2,6,2,7,8,13,7,6,3,4,110,15,0,10,4,7,11,18,8,6,15,7,5,6,11,5,3,2,3,7,7,9,4,26,17,20,4,8,7,3,5,3,21,10,5,11,11,13,8,0,4,7,9,16,7,6,8,2,1,8,12,7,3,1,10,8,3,18,5,4,2,7,2,3,22,16,8,1,3,5,3,1,3,7,8,1,2,9,2,1,8,7,5,3,3,5,4,9,13,20,7,20,2,0,6,6,1,7,6,1,4,11,4,0,1,1,5,7,9,3,6,5,9,1,0,13,7,3,6,7,8,2,6,3,12,4,14,4,4,14,6,3,8,4,7,9,1,6,0,5,8,6,10,3,4,7,17,0,3,5,1,5,6,12,5,3,1,9,8,14,1,2,1,5,3,3,6,3,2,3,7,5,3,4,8,3,4,10,3,1,5,5,7,13,8,8,13,5,23,7,3,5,3,3,10,7,3,10,1,8,7,18,19,9,3,5,6,11,3,8,0,3,2,10,3,3,4,5,2,3,8,3,1,3,8,1,0,5,3,21,1,4,2,4,4,4,3,5,3,4,4,3,5,3,5,7,1,4,4,3,1,6,2,0,15,2,3,0,4,1,12,6,4,10,2,7,2,3,3,2,1,8,4,5,4,0,4,2,12,4,3,3,5,10,6,5,4,1,3,6,11,5,10,3,1,5,4,10,10,16,3,0,4,3,5,3,2,5,4,12,8,4,3,4,7,0,5,7,2,3,6,16,4,5,10,4,6,3,7,7,3,2,3,3,3,5,5,6,4,11,2,2,0,3,0,0,7,1,2,2,0
even,12,89,25,269,23,55,13,78,17,9,43,22,47,229,13,32,16,57,29,26,21,90,66,97,64,37,60,57,31,71,37,443,305,42,149,246,150,11,38,15,25,35,20,17,92,59,48,24,597,124,171,28,28,146,51,21,128,38,38,45,44,39,9,26,82,45,299,44,25,28,39,19,20,11,356,36,83,15,235,89,127,9,34,27,441,46,39,11,72,6,30,23,22,62,126,35,55,12,79,37,37,54,73,40,39,72,18,37,39,25,47,11,45,38,41,112,10,11,163,470,135,83,53,238,45,9,17,22,13,14,56,18,33,102,94,222,33,16,18,38,27,106,57,13,15,199,51,59,46,19,166,13,40,17,20,67,157,31,31,77,52,11,43,12,29,56,23,41,84,26,42,264,77,16,27,39,381,24,33,156,77,31,29,69,30,77,91,80,92,105,13,25,11,15,20,11,42,24,29,41,75,6,17,28,54,25,15,82,28,49,185,37,84,20,25,72,23,29,35,4,23,62,13,38,102,247,75,104,15,35,53,35,53,48,87,57,94,25,24,35,221,97,25,37,47,12,19,96,97,23,22,58,55,15,24,59,23,10,12,47,18,94,22,7,16,54,35,46,58,8,312,16,49,12,16,7,60,25,19,5,183,32,11,60,47,8,28,42,58,16,3,18,43,14,14,19,64,20,19,51,81,47,10,7,35,13,70,13,19,19,9,49,70,22,98,25,62,92,32,23,109,21,1,36,177,26,44,123,13,66,37,37,32,11,32,38,52,18,12,47,32,46,52,33,16,19,105,121,51,38,27,27,14,90,77,19,24,20,41,79,64,12,27,44,5,20,83,35,25,78,9,68,9,54,46,58,27,10,30,19,135,17,93,34,27,70,35,79,73,8,69,16,41,34,59,30,99,16,63,7,39,21,12,18,33,9,31,8,58,23,17,43,11,66,38,32,12,21,17,23,17,25,48,40,26,14,12,29,33,34,27,14,2,25,19,11,14,22,35,23,39,47,16,34,16,14,56,29,95,36,51,19,25,6,126,31,16,26,36,59,45,78,104,114,20,20,65,47,28,21,70,30,17,16,11,89,12,43,56,41,27,27,13,17,20,19,15,35,18,8,227,91,8,22,33,12,13,19,20,39,44,21,7,12,19,55,6,25,10,19,11,19,18,21,37,30,25,22,11,34,18,53,18,62,24,20,61,23,59,67,38,22,28,34,21,26,22,31,116,48,20,5,22,16,35,22,12,45,28,21,114,12,18,129,13,38,78,6,13,20,40,8,46,9,38,35,41,36,63,98,29,13,22,12,13,14,18,20,33,41,27,26,49,63,24,15,22,19,15,35,59,92,44,18,78,28,19,33,72,52,30,8,22,11,12,67,13,35,18,15,66,25,22,22,89,19,48,8,22,11,26,26,13,40,8,24,19,21,40,54,43,41,79,68,21,16,46,23,11,17,47,27,28,45,17,32,9,9,23,328,52,25,29,9,14,32,78,40,33,27,9,10,15,33,11,7,3,14,35,34,52,33,109,55,47,23,5,14,11,19,12,90,34,13,23,9,37,14,6,21,20,35,26,31,16,18,39,12,33,25,36,8,4,24,21,14,49,24,9,7,20,11,12,47,51,78,30,21,21,31,17,26,20,80,14,19,25,11,11,39,21,24,7,20,13,10,60,28,70,29,33,8,16,52,44,22,32,14,22,16,30,13,5,9,12,27,26,22,9,32,32,50,4,11,47,36,25,21,11,13,30,15,13,54,11,27,28,9,22,29,20,8,77,4,17,11,9,29,30,26,10,33,13,13,11,46,15,11,8,16,4,12,35,12,29,14,20,13,41,21,17,11,19,26,15,13,15,21,12,27,11,23,10,4,6,18,19,21,9,12,15,14,14,18,27,18,28,55,24,7,6,10,11,19,14,22,33,24,12,41,67,54,21,15,11,9,19,11,14,6,6,19,10,9,20,22,39,14,35,9,6,20,10,28,16,9,5,19,22,17,1,8,9,10,8,8,9,12,16,15,18,28,10,9,34,9,13,4,12,32,13,11,14,26,15,3,11,11,9,55,9,9,14,21,27,4,15,24,14,8,15,14,13,15,3,12,11,22,9,10,6,12,11,11,10,12,8,24,9,21,14,41,6,7,18,22,29,21,50,13,7,22,12,15,11,10,20,20,16,15,8,8,9,10,8,41,5,2,15,19,28,23,29,22,10,13,14,24,14,10,16,22,11,31,18,5,24,24,41,18,17,9,3,8,14,11,13,11,16,19
school,4,16,11,80,5,27,5,17,1,9,5,13,24,73,3,1,5,18,5,4,6,29,26,38,36,35,20,28,11,32,2,219,115,16,55,65,15,2,4,1,6,16,4,12,28,20,18,10,136,98,21,11,10,40,195,6,18,26,32,27,15,1,10,11,24,9,72,7,14,6,58,1,10,2,167,14,46,0,42,29,65,6,4,27,120,18,5,2,20,2,3,8,15,20,8,11,21,8,42,12,24,33,15,14,13,51,1,11,17,9,29,5,10,15,30,14,0,7,41,56,53,35,36,101,13,3,3,10,4,6,30,37,24,53,20,151,1,8,3,3,9,34,13,5,6,81,13,25,3,6,24,30,7,11,21,50,29,6,9,121,15,1,13,10,20,50,19,20,34,5,27,116,18,4,11,6,76,4,10,82,19,5,42,35,4,43,32,29,20,39,2,10,2,7,15,5,20,5,17,10,26,1,9,12,12,18,4,24,9,9,83,28,19,15,10,46,8,17,5,3,4,28,5,9,27,35,18,18,6,17,13,12,12,13,33,2,34,27,10,9,35,23,16,13,6,3,4,35,37,15,14,13,17,1,1,17,3,8,0,45,0,21,7,0,6,34,161,11,29,2,38,22,3,7,1,15,11,5,3,0,132,0,5,16,16,5,21,17,6,7,0,4,5,21,4,3,26,4,1,7,23,19,8,2,2,4,19,18,22,10,15,26,49,18,28,7,26,40,8,7,18,4,36,1,40,2,32,52,4,24,7,13,3,1,4,21,26,6,7,7,1,25,20,8,5,5,23,30,27,37,4,4,5,33,24,1,9,17,5,19,30,20,25,6,0,14,13,21,31,51,3,51,0,68,8,13,7,6,9,1,18,3,15,12,25,36,29,18,15,4,7,4,14,2,8,9,4,1,6,0,9,14,5,6,7,6,17,2,6,23,9,7,7,8,0,7,3,2,5,8,6,12,13,3,15,1,0,5,1,6,0,0,0,4,12,5,1,4,11,10,9,6,6,6,2,4,36,19,27,16,17,3,16,4,21,0,5,1,23,20,16,20,24,27,8,6,30,18,9,6,50,14,1,10,15,66,4,12,35,8,4,15,0,3,19,1,6,20,3,0,16,18,1,9,11,3,1,2,2,1,37,0,4,2,1,4,24,1,2,2,4,4,1,2,5,0,8,8,0,7,10,25,1,9,11,6,14,3,15,24,3,17,3,16,3,5,1,6,38,16,1,3,1,34,8,6,0,12,2,3,3,1,1,20,1,3,6,6,6,3,6,2,11,2,5,1,2,8,20,13,5,3,11,2,5,0,3,3,6,25,5,12,11,6,2,2,6,0,1,20,1,9,11,4,36,10,22,5,8,3,15,4,6,0,4,7,3,8,4,0,17,5,7,3,13,1,4,11,0,0,15,0,5,9,2,1,0,5,16,29,4,5,31,20,8,3,22,3,3,6,29,21,3,6,2,15,5,1,9,37,8,9,2,8,1,6,7,24,6,11,1,4,0,0,0,3,0,4,3,1,10,6,1,10,7,10,2,4,0,8,1,10,2,3,13,2,2,6,1,10,6,29,5,2,7,10,1,2,3,1,0,0,0,10,5,14,10,10,0,2,0,5,4,19,11,12,7,1,5,14,0,5,0,19,29,5,3,29,5,9,8,10,1,5,1,4,3,6,27,19,1,7,23,3,0,0,12,13,5,6,9,0,2,3,0,7,7,6,3,16,12,19,0,3,8,9,25,4,26,1,11,1,6,4,5,4,7,5,75,10,26,1,16,7,10,3,7,0,2,13,2,45,11,1,9,13,0,11,3,0,4,11,3,2,14,4,1,3,7,1,3,0,1,2,4,0,5,3,2,0,1,1,4,10,0,3,23,4,1,5,2,1,16,4,9,7,0,7,3,3,0,12,5,2,3,6,5,1,3,22,3,7,8,0,20,11,9,0,2,6,7,12,3,5,3,4,1,2,1,2,0,7,0,0,4,1,3,0,1,0,0,0,6,0,21,1,10,3,3,5,15,0,30,0,2,5,1,19,12,8,2,8,5,11,0,0,0,1,0,7,5,8,2,0,1,1,7,1,2,2,1,3,1,0,2,5,1,1,0,1,4,12,0,8,0,0,11,2,0,10,4,4,5,0,7,5,1,9,3,0,6,10,15,4,0,0,1,0,2,1,17,0,1,1,7,1,8,0,2,2,0,0,19,11,1,1,9,0,10,0,0,3,1,0,3,7,6,20,1,46,5,4,5,5,7,6,3,2,17,3
right,45,105,70,566,75,48,39,249,16,24,119,36,45,633,30,112,50,90,46,26,26,192,122,189,128,90,130,71,59,84,96,824,583,70,275,330,318,32,22,31,27,116,44,26,179,131,132,86,1906,230,253,45,57,285,81,63,264,54,53,94,156,86,22,66,97,49,582,42,65,100,55,24,26,38,553,56,125,27,377,149,111,7,67,49,1235,61,27,6,131,5,20,45,26,188,280,70,114,24,171,58,70,133,174,69,53,122,8,52,54,15,94,25,33,87,53,159,19,17,391,1003,190,158,137,242,31,43,16,27,15,7,82,30,56,216,145,316,145,20,38,48,48,179,108,7,17,402,58,97,75,32,488,21,81,20,25,180,183,21,77,112,35,19,42,17,10,87,15,112,109,42,97,540,148,13,45,47,916,16,76,179,152,104,27,101,29,110,150,111,330,242,16,27,13,6,10,15,64,51,20,161,112,10,10,73,170,91,43,117,60,106,397,57,180,39,35,68,16,25,62,13,12,160,20,95,224,624,103,113,16,16,61,37,49,154,200,34,157,41,19,61,415,188,30,40,105,30,29,175,201,58,57,55,116,14,39,92,55,8,18,55,37,180,111,19,19,71,40,71,132,21,628,21,55,41,23,16,218,16,62,18,428,85,3,86,39,9,36,67,116,23,15,29,125,23,22,74,163,43,51,190,161,91,1,9,112,16,151,22,49,3,7,108,91,49,116,50,73,165,83,37,398,60,177,40,1,78,56,203,22,139,77,55,77,29,34,103,151,42,5,38,90,94,126,118,16,27,228,287,86,69,65,57,57,152,186,20,73,29,77,132,88,35,55,114,34,23,230,57,65,111,23,140,50,91,75,67,56,21,128,20,457,55,206,66,43,226,66,166,135,23,217,35,64,58,193,66,299,10,150,18,206,25,25,21,25,36,28,30,91,62,37,53,15,76,149,59,40,72,29,34,49,45,101,88,21,29,21,120,43,82,27,19,6,55,39,44,6,79,72,43,99,155,30,81,3,21,72,40,214,29,108,49,41,26,330,99,26,98,58,93,109,114,166,137,26,19,104,80,88,11,126,46,7,23,32,146,34,69,116,39,38,63,35,82,45,61,29,32,42,34,516,169,17,44,43,34,15,72,39,63,50,24,11,10,89,46,11,40,36,40,5,43,31,42,61,92,25,62,40,64,46,228,43,259,92,39,133,96,92,133,84,47,35,70,62,48,63,65,178,104,33,12,27,22,26,28,29,88,97,45,292,41,34,280,42,41,155,20,22,31,103,21,104,18,65,95,56,44,164,272,35,46,34,46,31,56,14,39,53,70,24,50,49,132,54,54,29,31,24,52,207,251,59,25,224,48,28,17,383,118,128,12,31,32,61,117,26,117,55,11,134,76,42,67,205,71,75,26,64,17,36,12,16,85,8,27,89,40,81,174,15,90,184,182,73,31,60,35,36,57,90,42,105,103,33,75,24,14,42,1061,143,40,38,58,66,52,208,177,53,82,34,35,91,161,37,32,22,64,54,49,96,37,191,257,175,57,19,22,56,48,60,132,90,24,43,27,97,31,24,42,57,65,74,83,25,31,54,44,79,72,26,53,24,55,33,36,87,59,24,23,30,22,52,160,115,70,46,65,59,17,37,29,40,75,19,31,32,20,25,55,62,48,21,23,33,7,56,13,257,39,44,42,11,35,82,22,43,42,22,71,72,2,1,19,11,56,60,45,12,26,20,44,11,20,109,57,30,26,9,44,51,28,8,114,36,68,18,14,60,47,24,23,69,16,53,37,32,66,56,53,34,48,24,27,57,122,39,50,8,17,24,19,133,16,47,18,28,33,82,20,21,42,68,25,19,40,36,58,30,97,35,14,31,28,19,33,36,36,23,27,32,31,65,67,38,35,72,140,147,9,28,44,58,50,25,50,32,42,33,74,284,141,93,26,8,22,47,24,64,10,27,95,29,13,36,31,21,23,101,32,2,20,12,10,36,38,33,72,71,32,6,23,16,33,26,9,26,17,28,20,59,54,13,30,57,25,29,26,22,66,19,30,39,72,67,10,43,21,12,138,40,12,86,18,82,13,8,51,23,12,38,48,17,42,21,33,29,93,22,13,30,20,45,42,22,11,14,35,55,49,15,59,3,3,9,35,16,8,47,19,4,35,16,27,27,8,22,48,50,36,26,19,25,19,3,166,19,5,41,68,45,64,74,33,30,32,16,42,55,58,31,31,18,7,37,28,72,22,164,43,19,12,9,6,4,12,22,17,11,47
jurisdiction,4,17,7,105,2,2,4,23,2,1,16,8,5,36,7,8,2,9,2,1,2,32,1,14,19,7,8,6,3,8,9,100,58,6,26,17,20,5,0,2,3,2,4,1,15,7,11,7,327,7,26,2,2,8,2,0,24,14,0,4,17,3,0,3,6,1,34,2,3,16,1,15,1,5,22,5,13,0,25,11,6,0,5,5,171,6,3,0,18,0,1,4,0,10,17,5,6,1,5,8,19,13,15,5,6,17,0,3,4,1,14,2,1,16,0,15,8,2,87,85,20,3,2,12,2,1,2,1,0,0,5,2,4,41,6,20,6,4,2,2,0,23,11,3,4,44,7,8,3,4,64,2,5,2,2,60,14,0,9,0,4,1,6,5,0,3,1,10,12,5,8,51,15,0,0,3,109,1,8,12,22,8,0,10,6,5,17,10,57,28,3,2,2,1,0,2,11,1,3,9,11,2,1,6,17,4,1,12,2,6,60,0,26,8,0,1,0,1,8,4,0,19,2,9,22,118,11,10,0,2,5,7,3,32,10,8,11,0,4,7,50,17,2,14,3,0,3,10,34,5,14,4,15,6,9,3,7,1,2,3,6,16,17,4,1,31,1,5,4,0,95,1,11,3,4,0,17,4,13,3,31,4,0,14,10,0,6,2,8,1,1,3,14,0,5,3,10,7,3,12,9,18,0,0,11,0,15,2,2,1,2,20,4,2,2,9,6,20,11,4,64,5,26,2,78,1,2,13,3,19,3,7,6,5,3,7,17,2,1,4,4,2,2,12,1,6,24,33,11,4,11,12,6,12,20,7,3,4,15,7,25,3,1,14,10,1,18,1,1,5,1,4,3,3,7,14,4,2,4,7,61,5,24,6,1,27,25,12,21,0,27,1,8,12,14,11,69,0,17,1,14,1,3,0,3,2,5,1,8,5,2,0,1,12,9,3,1,3,2,0,3,5,13,8,0,0,2,7,5,8,3,1,0,7,2,4,0,5,6,3,13,20,5,3,0,2,3,5,13,2,7,5,1,2,33,6,0,18,7,11,7,8,15,6,2,2,3,8,18,0,17,1,3,2,1,8,2,8,10,0,7,4,1,5,1,13,3,2,5,18,30,24,2,1,2,7,4,7,11,2,3,0,0,1,10,6,2,9,2,1,3,5,10,9,8,12,1,2,8,9,0,23,6,45,15,5,25,12,16,14,7,1,3,6,9,4,11,2,20,11,1,4,5,0,1,7,1,16,18,5,63,8,15,89,5,7,29,2,2,5,11,2,12,1,4,13,12,10,21,18,18,4,13,8,5,4,8,8,6,24,0,9,6,6,7,3,6,6,1,1,15,24,3,8,12,17,3,1,39,10,13,0,1,3,5,21,1,18,4,1,13,19,8,2,47,9,12,1,6,2,6,2,2,18,1,4,3,4,10,44,0,14,23,16,19,2,6,4,2,7,4,2,10,30,8,11,3,4,10,178,22,7,4,9,7,4,19,13,7,13,1,5,11,22,3,1,1,4,4,11,5,9,33,124,30,9,4,6,4,6,8,26,6,6,5,1,11,2,1,7,5,4,7,6,5,2,7,10,8,14,13,4,7,5,3,6,5,4,7,2,3,5,2,9,28,11,8,3,7,0,4,3,3,20,2,11,2,0,2,4,6,3,1,4,3,0,11,2,64,6,7,2,1,9,14,3,6,10,1,5,6,0,0,4,1,6,3,8,3,1,1,6,0,1,33,5,6,3,4,5,1,6,0,31,2,21,0,2,19,5,2,8,8,2,4,4,5,22,2,12,2,24,7,2,5,8,6,3,2,4,1,2,15,2,3,1,5,3,13,4,1,4,15,4,5,4,1,4,4,16,3,7,1,6,3,5,2,4,1,1,3,2,2,2,3,3,5,17,10,3,4,4,13,10,4,10,7,2,4,25,16,42,12,2,0,5,3,4,21,2,3,11,6,1,5,2,5,2,19,9,9,6,1,0,3,4,5,2,1,2,4,1,2,1,3,1,5,2,8,3,3,17,0,1,10,6,7,3,3,0,5,4,4,5,0,2,19,1,7,14,2,0,8,4,8,0,2,8,2,0,6,5,3,8,2,8,8,8,4,1,4,1,5,2,3,2,1,4,6,15,1,4,0,0,0,4,5,1,8,2,1,2,1,1,6,2,3,7,13,5,0,1,9,2,0,27,2,0,1,8,0,7,4,5,4,3,0,1,3,9,1,10,1,0,2,0,8,0,15,2,0,1,1,0,0,1,1,1,1,0
problem,2,21,11,134,3,34,3,35,14,5,12,30,22,115,7,6,12,27,18,8,23,32,29,38,42,23,19,28,14,17,1,152,111,22,67,96,52,2,20,7,6,14,3,16,35,15,27,35,173,44,33,18,17,82,55,8,16,28,18,29,8,4,3,16,32,47,116,8,5,20,27,2,4,10,205,21,54,11,75,39,58,10,5,17,214,18,9,8,18,1,7,7,13,21,38,11,36,3,65,25,20,40,26,13,29,25,12,20,15,8,13,5,19,27,20,39,3,6,42,116,55,41,38,108,20,7,2,4,1,6,24,5,14,35,24,132,12,5,9,6,15,53,14,5,9,83,11,28,18,4,32,3,14,17,26,58,52,11,9,50,18,11,14,7,8,41,8,34,44,12,17,141,40,14,20,7,110,3,10,75,27,7,34,39,5,43,48,17,39,37,3,16,11,12,9,6,26,11,22,14,42,15,9,4,20,29,7,27,8,28,94,11,30,5,10,41,27,17,7,13,10,38,9,24,40,61,26,39,14,9,10,13,18,32,49,10,32,15,28,20,47,42,14,20,29,18,3,36,50,7,13,29,37,4,2,20,2,3,5,26,7,17,8,2,17,48,22,9,12,5,73,2,10,6,1,10,12,6,3,10,79,10,11,10,16,13,27,20,12,7,2,3,13,8,1,5,17,4,4,19,26,27,0,2,21,17,40,4,30,6,16,39,62,11,34,8,18,36,22,10,21,6,44,32,56,2,1,49,8,26,6,10,8,1,8,15,26,6,12,10,11,9,22,7,8,14,33,26,21,31,13,3,7,42,19,24,5,5,16,32,31,11,36,9,2,8,23,13,14,18,5,22,18,26,28,22,7,6,18,5,68,4,34,27,18,15,9,26,19,4,17,19,25,14,22,10,22,4,26,11,8,12,16,5,8,14,6,2,19,4,14,5,13,23,10,4,4,16,4,9,11,14,29,16,6,14,9,17,8,15,3,2,0,8,15,4,2,5,6,14,11,15,3,17,4,11,13,7,50,5,24,2,7,2,31,7,3,1,18,12,23,34,31,44,15,14,42,10,13,6,36,10,2,15,8,50,4,12,21,14,5,9,4,5,4,5,7,12,15,1,59,47,6,12,31,2,5,4,5,15,15,5,4,2,9,10,33,14,6,4,1,14,3,17,13,15,10,13,8,24,14,11,4,6,6,4,16,16,10,20,12,18,12,11,12,9,4,17,45,19,2,6,6,51,22,6,4,19,13,3,15,2,5,30,26,6,22,4,7,6,13,1,14,12,10,6,18,11,31,31,15,3,4,6,6,1,7,7,6,13,5,22,11,14,7,12,13,4,0,18,18,17,5,2,111,8,13,11,4,11,12,5,12,0,4,12,5,15,16,0,28,38,11,1,21,2,5,3,3,0,8,0,5,11,7,4,3,9,8,18,9,27,28,25,18,5,44,7,6,11,21,11,10,11,3,13,18,2,17,72,33,13,4,2,6,10,14,19,10,7,1,2,2,1,1,1,1,2,16,2,13,11,3,12,5,8,3,5,3,3,13,23,8,10,5,5,6,7,0,3,4,10,9,6,3,11,4,1,5,4,2,8,4,1,8,4,16,8,0,3,8,2,3,22,7,7,3,5,11,9,1,10,0,3,3,1,10,8,4,10,3,14,4,21,4,0,10,3,14,14,17,7,0,5,0,4,8,22,7,6,7,2,1,5,6,16,8,3,8,10,11,22,0,3,9,11,28,7,45,4,17,6,5,9,3,9,9,15,1,1,1,2,13,11,13,6,2,0,2,7,5,16,11,8,25,27,14,3,4,2,7,5,5,4,8,12,3,3,19,2,4,2,0,12,2,3,9,19,3,7,1,0,19,14,1,1,9,1,1,11,5,5,3,4,8,6,4,24,5,7,2,17,2,5,9,0,9,14,9,9,19,13,2,1,25,2,14,2,0,2,0,6,2,15,2,6,3,1,11,14,12,4,6,7,11,2,1,2,9,3,0,5,5,4,2,5,12,3,3,9,4,9,5,2,1,2,0,8,3,5,3,2,9,5,2,0,0,5,1,30,5,7,3,3,10,5,2,1,7,10,2,9,3,3,1,2,0,3,1,0,12,18,4,2,3,4,2,0,2,15,3,6,3,1,21,7,15,7,13,5,3,4,9,5,4,2,5,3,10,2,2,7,0,0,8,1,6,0,3,3,6,2,10,11,0,1,4,0,10,3,1,2,5,2,6,4,12,10,8,4,6,7,0,3,9,8,5,2,6,7
know,33,92,47,334,65,72,12,108,27,19,49,38,63,230,6,36,47,54,90,25,22,133,154,170,46,96,94,102,55,137,40,545,365,75,214,352,164,17,37,25,24,91,20,40,161,39,67,43,654,266,169,46,56,272,132,25,128,50,99,57,22,23,9,44,103,49,347,30,28,41,60,9,25,29,303,47,164,8,224,131,110,13,44,42,503,48,34,14,67,6,47,30,25,110,90,29,70,9,95,54,21,81,89,70,41,104,25,42,39,21,68,12,49,59,66,130,19,20,132,339,119,165,67,292,48,29,14,21,3,10,102,31,57,145,145,247,24,11,23,47,26,103,76,11,21,264,55,55,34,22,138,32,55,23,18,55,183,30,28,166,52,11,47,10,11,118,21,73,74,27,62,334,101,14,54,29,333,15,45,198,76,29,54,100,9,96,71,59,77,117,22,26,18,25,32,13,68,30,27,35,82,1,15,20,68,51,9,72,46,51,272,103,78,29,93,171,31,40,49,8,20,66,15,40,83,196,90,68,33,36,41,40,41,70,105,44,97,17,18,27,192,122,32,43,65,15,18,108,84,22,24,32,60,18,15,105,15,8,13,37,12,120,27,15,19,71,25,79,61,12,255,12,50,13,10,16,83,14,21,15,271,16,9,49,31,3,58,62,60,28,9,26,70,23,17,19,105,26,31,56,81,58,0,6,26,15,46,16,33,10,7,24,95,33,80,25,41,86,22,20,110,21,123,52,203,13,49,1,28,74,49,29,25,7,34,34,80,16,12,27,18,60,111,26,14,12,90,134,40,85,16,35,12,89,66,16,26,15,27,90,33,16,28,37,9,34,100,53,73,136,18,127,18,74,30,60,11,11,65,20,122,9,86,29,53,65,39,52,78,15,47,32,64,36,71,40,97,9,66,8,43,48,12,36,17,16,23,6,52,37,13,27,14,38,9,60,37,39,21,56,9,31,46,39,31,9,6,25,20,55,42,13,5,39,31,13,16,53,43,17,42,43,18,56,18,23,98,34,59,27,97,6,55,21,114,16,40,30,20,64,50,76,76,111,18,18,100,36,25,21,113,52,11,22,14,33,24,37,61,27,25,36,18,28,31,15,20,44,10,10,237,66,30,33,38,10,19,25,32,25,17,21,18,21,29,46,19,48,13,16,11,6,17,12,28,39,21,22,15,35,15,31,13,51,12,19,67,14,37,71,27,23,38,27,33,29,28,25,91,40,20,5,21,28,37,31,29,49,24,9,79,11,17,89,25,29,56,7,12,11,37,13,40,8,40,32,35,22,94,72,35,24,34,10,22,6,19,14,20,52,13,37,31,63,18,14,22,16,7,40,65,66,37,20,39,10,13,12,88,47,40,7,9,12,12,33,14,51,21,12,61,29,34,23,51,14,34,20,14,18,25,12,11,56,7,7,22,10,23,61,29,26,83,47,13,8,19,10,42,19,32,26,11,68,16,48,13,14,11,393,38,14,23,7,13,37,62,37,17,34,12,27,23,41,17,15,8,17,33,26,40,13,100,34,68,27,1,16,8,14,19,79,27,13,12,20,30,18,16,25,23,72,30,25,13,29,17,12,39,24,23,3,8,16,22,23,45,30,17,12,24,18,14,53,33,58,67,17,37,13,29,15,19,59,15,30,31,13,5,28,15,35,16,8,11,12,16,15,78,24,35,18,13,11,23,7,44,22,16,19,43,12,7,18,21,20,14,17,12,33,30,45,13,10,39,48,30,16,22,29,36,16,17,42,6,28,15,11,43,19,18,14,32,8,21,11,11,58,8,39,22,19,7,6,15,45,10,12,21,16,12,23,16,31,66,20,24,17,57,8,26,18,27,20,8,9,16,53,17,19,23,9,14,20,8,12,47,24,23,16,21,15,38,16,30,29,24,69,19,29,23,11,3,26,22,5,22,14,10,33,78,51,23,16,9,15,13,6,24,4,5,21,16,6,5,15,29,9,30,17,9,8,11,17,22,16,6,42,26,13,3,13,6,7,23,16,19,15,15,13,32,28,33,10,11,10,19,19,16,65,12,23,16,27,27,9,21,21,19,29,11,17,19,11,32,19,15,13,20,7,15,20,11,17,10,10,11,62,9,10,11,18,13,18,7,6,8,7,9,24,10,44,6,6,11,28,29,22,42,15,16,28,14,8,6,4,7,8,34,15,3,9,9,6,8,32,5,14,7,10,35,11,50,44,21,14,24,17,25,7,8,13,16,30,18,9,24,39,36,35,13,11,9,19,4,11,16,8,12,38
answer,6,18,13,44,0,3,0,9,7,6,7,9,6,28,2,3,8,4,11,1,8,13,12,30,14,10,4,11,2,12,5,75,55,6,23,26,24,2,5,1,2,9,3,1,13,4,12,5,132,17,26,4,8,22,6,2,21,9,2,7,4,6,1,5,13,7,52,1,8,7,16,2,1,3,40,9,5,2,44,10,16,0,12,5,97,6,2,0,20,0,10,4,1,16,18,3,6,0,14,1,8,9,10,5,9,22,3,3,4,6,12,4,3,12,7,16,3,4,12,61,14,10,7,32,4,1,1,5,1,0,10,0,3,20,10,18,3,4,3,5,4,21,29,0,4,25,4,8,8,4,25,4,9,1,4,10,16,1,7,18,2,2,4,0,2,4,9,7,21,6,8,49,11,0,1,7,62,2,1,14,14,7,6,13,2,4,12,9,56,18,2,3,2,1,1,5,6,0,7,7,13,1,2,15,10,4,3,10,8,9,32,4,6,4,4,9,3,2,4,4,4,7,2,8,18,24,3,11,0,2,1,8,5,9,8,5,17,1,4,1,24,23,4,3,4,3,7,11,12,4,4,5,8,7,4,9,6,1,0,3,0,10,10,5,1,15,3,4,2,1,36,4,19,0,2,0,5,3,11,0,27,4,1,7,7,2,3,1,3,0,1,1,9,1,2,4,28,7,9,4,12,7,0,0,4,0,5,5,6,4,2,2,11,2,10,3,3,16,6,1,21,5,13,4,22,3,8,28,1,6,1,2,0,5,2,4,9,5,5,5,11,4,7,0,2,4,9,28,7,3,1,3,0,12,11,1,6,2,4,22,3,4,2,3,3,2,13,3,1,4,2,3,5,6,2,9,3,1,2,2,25,0,14,7,3,5,4,18,9,2,4,3,17,3,13,12,20,3,18,0,7,2,5,0,2,1,2,1,13,4,1,1,0,2,3,6,2,2,4,0,1,3,9,4,0,3,2,4,3,5,14,5,0,2,0,1,3,6,5,0,3,4,2,2,3,5,11,4,6,2,14,2,6,3,29,3,1,7,6,8,5,14,13,9,2,0,9,8,1,0,7,3,2,4,3,4,3,11,2,2,1,8,3,2,4,4,7,4,3,1,34,27,2,0,3,1,0,3,2,2,6,1,0,0,4,13,2,4,2,3,1,0,0,0,8,15,4,0,2,4,0,8,3,2,1,3,8,4,18,6,8,2,2,3,8,10,5,3,18,9,7,0,0,2,3,4,2,12,10,1,11,4,3,19,2,3,13,2,3,5,10,1,3,0,3,6,8,2,24,8,7,3,4,1,1,9,2,0,2,5,0,5,4,7,2,1,6,3,3,5,5,5,4,1,4,4,3,6,27,10,4,0,3,0,2,9,2,16,0,1,10,6,3,0,21,1,10,5,1,5,7,13,2,19,2,0,6,1,13,12,10,6,16,11,1,4,4,6,1,3,0,1,1,10,7,13,1,3,1,71,4,5,7,4,5,2,16,7,3,5,3,1,4,19,7,5,3,6,6,10,8,4,20,14,4,3,0,3,0,1,0,9,8,3,3,5,3,1,0,2,10,8,10,0,7,3,2,2,7,6,0,1,6,0,1,4,7,5,3,3,0,8,5,8,7,3,5,4,4,1,3,6,4,6,2,5,3,1,0,3,4,6,1,2,2,2,5,2,12,0,3,2,3,2,1,2,4,3,1,0,5,1,2,6,3,8,2,3,0,2,3,2,3,4,6,12,2,3,1,4,1,4,4,8,3,5,2,1,2,6,1,3,5,4,4,1,1,8,2,4,3,0,0,1,3,7,1,5,2,2,5,1,6,4,3,0,4,1,4,3,1,1,3,5,1,6,1,2,2,2,4,0,0,4,6,2,3,0,9,2,6,3,6,3,3,2,1,9,3,5,9,2,2,8,0,3,3,4,4,6,5,12,4,2,0,1,2,3,10,3,5,0,7,4,0,6,5,3,3,3,1,0,2,5,3,5,3,6,3,1,1,5,4,6,2,0,2,4,6,3,2,1,1,5,7,3,1,4,5,1,1,4,2,4,0,2,0,7,1,15,2,6,2,2,7,2,0,4,4,1,3,2,0,3,3,2,0,22,2,1,1,1,5,2,0,1,3,3,4,0,2,2,3,2,1,3,1,3,18,6,3,1,1,2,2,3,0,0,5,4,0,0,2,3,3,10,1,4,1,1,4,3,1,4,7,3,2,4,1,1,0,4,4,1,5,1,3,2,14,2,0,1,3,2,1,3,0,5,1,2
hold,15,83,42,337,29,22,12,112,14,6,63,42,27,167,9,23,30,55,20,13,8,102,44,78,49,38,44,55,29,60,24,468,330,29,107,151,104,28,39,15,21,43,14,19,66,39,60,39,732,109,107,22,26,142,26,14,119,62,17,32,44,18,7,37,42,31,296,25,9,113,39,6,14,11,232,37,37,11,193,52,111,20,20,15,547,52,31,18,96,8,27,13,11,72,110,29,47,13,103,49,25,60,79,22,36,52,12,26,35,25,54,15,27,46,16,72,25,8,181,412,100,72,23,171,25,11,11,14,23,5,41,8,25,107,57,112,19,15,14,17,17,82,76,11,5,182,20,30,39,43,178,10,54,18,16,64,80,16,21,40,33,10,38,14,18,29,21,52,43,27,49,256,76,4,30,13,404,10,36,75,58,31,31,50,8,80,72,44,102,95,2,17,31,4,10,15,37,17,37,37,61,5,8,22,69,39,19,50,30,61,193,44,72,13,10,17,6,27,56,1,16,58,11,32,120,273,69,71,27,42,24,47,38,73,70,25,65,23,31,15,165,59,29,34,30,15,28,80,110,18,23,38,43,21,28,31,23,14,5,55,13,69,44,14,13,57,20,35,27,16,308,29,78,11,10,9,47,31,16,13,139,15,8,47,29,8,5,17,35,6,12,20,26,16,15,22,65,12,15,51,86,54,3,13,29,10,71,19,11,11,6,47,78,14,75,25,31,102,51,20,114,21,66,24,139,19,26,74,6,1,31,21,38,16,30,33,41,20,10,25,20,41,32,29,8,22,116,121,23,18,21,38,22,95,54,8,24,20,30,79,58,14,22,36,11,7,97,26,33,37,6,50,15,35,33,56,19,8,34,13,185,8,83,35,11,99,21,63,69,20,64,12,28,24,83,32,115,18,72,10,63,7,18,9,15,23,17,10,66,34,8,30,26,46,35,36,12,26,12,12,16,32,55,32,16,8,12,43,19,45,58,18,6,37,20,12,7,39,34,14,35,46,15,38,10,17,33,28,79,14,51,21,18,26,119,23,9,27,15,61,28,52,86,95,20,18,44,23,18,7,66,19,12,8,4,52,10,56,42,18,24,21,12,15,18,22,18,19,12,9,231,59,22,12,37,17,15,52,11,23,36,17,12,2,38,99,7,43,23,21,18,29,25,14,23,40,14,30,27,25,4,79,13,68,14,15,59,46,46,65,16,13,43,21,25,26,18,28,87,41,16,30,13,9,20,20,7,41,27,22,143,16,28,116,13,17,40,7,14,11,60,15,57,8,35,28,42,21,64,84,9,12,22,4,21,27,11,11,16,44,16,36,43,35,24,15,14,18,13,21,50,77,31,3,62,7,27,16,72,50,63,7,13,8,12,54,10,79,13,7,64,54,51,17,72,29,26,11,19,10,21,42,8,62,17,13,17,20,38,79,70,52,56,75,29,19,21,12,11,27,42,11,68,57,14,50,15,21,17,428,70,25,17,15,14,28,97,40,26,37,5,14,50,48,13,9,5,27,17,28,31,25,128,164,74,10,5,11,13,22,35,50,25,12,28,30,35,11,18,31,27,44,38,41,15,21,24,10,24,30,22,22,10,17,31,23,36,16,9,11,19,32,12,42,32,57,36,16,25,10,18,13,11,64,6,22,21,9,10,35,20,29,14,12,23,27,36,24,75,11,38,41,9,16,23,16,19,15,10,15,30,10,7,19,10,25,22,18,10,39,29,27,26,16,49,42,35,22,20,30,21,16,16,50,11,30,24,15,47,19,9,11,24,37,31,19,16,34,41,38,20,56,12,10,12,43,4,12,16,22,7,13,30,26,21,5,29,21,33,18,12,23,22,29,10,17,14,28,23,37,6,8,109,23,12,10,8,14,27,12,29,8,34,27,21,23,23,53,21,10,13,35,27,26,11,22,26,16,11,34,60,74,26,14,9,14,22,22,12,14,16,19,25,13,22,34,6,12,28,13,8,13,35,46,18,17,3,24,29,33,7,20,22,18,39,10,10,14,20,11,14,17,2,8,19,22,8,28,30,32,21,9,15,28,55,21,29,26,4,47,7,23,20,12,37,15,7,5,17,6,20,15,12,15,13,9,13,17,8,30,10,11,12,12,11,7,10,11,16,9,9,33,7,9,6,46,44,18,83,8,8,24,15,10,8,13,22,10,34,15,6,9,15,13,6,16,28,4,18,16,76,28,23,21,7,13,6,17,11,19,1,9,18,43,12,12,12,15,43,3,11,7,23,9,3,9,3,10,6,24
vote,0,45,51,171,7,9,3,59,2,2,2,7,8,29,5,7,21,8,10,3,4,28,36,46,15,33,30,26,13,35,6,100,52,20,28,78,14,1,1,10,8,17,3,11,37,12,20,8,225,47,56,8,11,42,7,0,23,12,26,8,3,4,0,13,17,12,115,6,1,13,15,0,9,3,65,9,24,1,41,23,6,0,5,5,84,10,1,3,22,2,11,11,3,35,23,2,10,3,23,0,0,9,14,11,6,21,3,10,13,13,19,1,8,13,4,22,0,1,70,92,8,37,12,51,8,5,4,1,3,1,15,7,12,27,29,40,9,6,8,3,4,17,9,2,0,53,9,9,1,5,53,1,11,0,2,17,35,1,4,29,8,1,6,3,3,25,9,12,16,8,18,72,18,0,18,3,80,4,11,34,8,7,14,16,1,16,14,4,28,36,17,3,0,5,3,5,2,5,10,6,6,0,0,6,14,11,1,10,10,2,57,23,64,8,16,24,2,9,15,2,1,10,1,11,34,86,28,19,4,2,8,7,10,10,17,5,29,1,0,8,57,17,7,9,7,3,3,32,25,7,8,12,6,5,2,7,6,1,0,24,0,28,23,7,0,9,5,22,20,6,105,2,4,3,1,6,17,2,7,8,46,1,1,9,5,0,10,6,12,2,0,14,45,7,2,3,20,3,9,4,17,20,2,2,7,3,9,1,1,2,4,4,25,11,24,3,10,15,1,5,48,5,37,7,77,3,6,49,1,31,1,7,7,2,8,8,11,5,9,0,2,23,19,10,1,5,27,24,19,12,1,8,4,27,17,1,10,0,0,25,7,2,2,11,0,6,41,18,23,39,3,52,4,16,17,4,1,0,12,1,54,3,20,3,21,2,5,15,18,1,20,10,70,45,7,10,14,2,7,0,9,10,6,11,12,1,2,0,0,6,0,5,0,8,6,14,9,9,16,16,2,3,13,7,1,7,4,4,8,12,1,4,2,11,7,1,3,13,13,8,8,9,3,3,1,4,24,9,14,7,21,7,15,1,13,9,12,16,6,14,11,13,19,32,6,5,23,5,1,3,18,8,2,4,2,6,1,44,15,4,2,9,0,3,1,21,1,16,0,2,53,18,1,8,6,1,3,4,1,8,1,5,4,3,3,9,0,19,4,6,1,2,5,2,8,14,2,3,0,13,0,6,5,36,5,9,11,2,10,18,9,5,4,6,6,6,3,12,18,12,0,0,10,0,0,4,3,6,4,1,132,7,3,24,8,6,3,3,4,1,3,5,15,3,6,7,11,9,14,11,4,1,10,5,2,7,7,2,3,11,2,10,6,16,3,5,1,3,2,10,13,10,13,3,2,0,1,0,13,11,21,3,3,9,2,8,4,29,4,3,21,6,7,1,15,13,7,2,4,0,3,0,1,19,0,2,0,5,4,10,3,6,25,26,3,9,2,2,13,1,9,9,9,6,2,3,0,6,3,64,9,1,2,15,10,8,32,18,25,4,8,7,36,0,4,9,0,9,2,3,4,3,1,14,11,11,2,3,1,1,3,15,3,2,3,8,13,1,6,1,4,22,4,0,3,6,11,0,8,6,0,3,3,3,6,4,3,9,7,9,4,2,3,15,2,6,17,2,8,3,2,8,3,13,1,3,5,1,2,2,0,7,1,4,3,1,5,0,26,5,3,3,0,3,0,1,13,2,2,8,7,0,1,3,0,1,6,5,0,7,7,4,8,0,6,4,4,3,0,2,8,0,0,7,1,3,2,1,2,2,2,2,2,3,25,3,2,3,3,2,3,7,2,0,2,5,0,9,0,7,2,1,20,9,12,1,1,2,12,2,3,1,2,6,0,2,3,17,0,5,6,3,3,0,0,3,7,25,4,4,7,0,3,3,11,8,3,16,4,0,0,17,1,10,0,0,2,4,0,8,26,19,7,3,1,3,2,0,10,3,1,20,2,1,5,3,0,9,6,3,1,2,3,1,3,5,0,1,13,0,1,0,2,0,1,2,0,1,0,2,10,0,1,3,0,7,0,15,2,16,3,4,7,2,82,1,0,3,0,9,1,0,4,2,9,3,6,0,5,1,5,2,3,8,0,4,0,2,0,3,1,13,10,3,3,0,3,6,2,0,0,10,0,0,3,1,2,0,2,0,3,2,6,0,0,0,1,0,8,7,1,3,0,1,2,0,0,0,71,0,2,10,3,25,2,0,7,2,0,2,0,5,7,0,2,11,5,9,2,7,0,4,3,4,0,0,3,1,0,19
least,6,20,10,138,3,8,2,24,1,5,12,3,2,74,7,3,2,11,6,5,3,48,18,30,32,15,12,17,17,28,8,224,114,13,57,60,27,17,26,3,20,5,1,4,73,23,23,18,248,21,56,7,15,37,18,5,70,27,9,15,11,10,2,5,33,3,87,17,14,16,32,6,8,4,94,12,22,4,111,27,98,3,8,9,218,38,11,2,43,4,14,5,11,29,47,24,26,10,40,28,23,31,38,14,10,31,11,5,26,9,19,2,10,21,3,29,1,9,54,254,68,20,80,102,7,1,7,7,11,7,15,5,8,56,32,54,5,1,7,6,1,27,21,3,3,79,8,19,25,14,96,9,25,8,4,45,44,7,3,31,27,5,17,9,17,22,10,23,32,6,16,128,31,5,3,11,162,9,17,43,44,10,8,23,4,16,59,37,34,54,5,9,11,4,6,10,20,6,12,19,58,6,1,14,26,7,4,34,7,19,97,4,29,18,5,12,6,3,15,2,14,29,4,28,70,120,37,33,12,24,23,25,19,25,25,29,32,9,6,14,63,28,4,18,15,3,6,40,54,9,12,20,24,14,21,21,16,6,2,32,18,32,14,0,13,54,13,3,14,5,130,8,52,5,1,4,21,20,9,4,74,8,5,20,12,4,12,15,10,2,0,10,19,24,4,14,46,3,6,19,11,38,4,5,10,3,24,3,5,4,3,24,24,8,58,16,28,38,14,4,32,4,37,13,55,7,10,29,2,21,7,1,10,5,11,7,16,7,5,16,9,8,11,6,10,3,43,48,24,7,10,9,11,45,26,6,3,3,21,38,25,6,4,30,0,4,38,10,7,21,0,21,3,20,19,52,12,10,12,12,62,4,53,13,4,32,12,21,24,5,13,6,7,14,26,12,59,8,34,4,20,4,4,2,4,13,13,2,20,6,4,8,12,19,13,15,6,7,4,2,2,9,22,10,3,8,5,12,14,15,20,6,3,8,2,3,1,8,9,5,16,18,9,12,1,1,15,3,41,12,14,10,2,8,49,10,0,13,13,23,15,21,41,53,14,2,23,12,10,2,17,13,4,7,6,31,3,17,29,7,15,10,1,1,8,8,14,4,5,4,79,48,3,10,14,10,9,8,4,14,23,7,13,5,11,33,5,9,7,6,12,5,13,5,18,25,9,12,12,14,6,19,6,38,5,5,27,15,16,28,10,3,1,20,7,7,9,9,44,25,2,1,4,10,10,12,0,18,8,7,27,3,10,64,14,22,25,9,11,17,24,8,27,8,14,13,8,12,31,37,9,12,18,0,8,8,19,9,10,24,8,14,19,26,13,11,12,10,9,18,33,43,20,7,35,11,15,11,19,17,25,2,8,1,3,22,4,16,13,8,27,24,13,6,57,8,23,3,17,7,20,16,1,23,6,11,1,11,11,22,23,22,22,33,7,4,13,31,3,11,23,6,13,18,11,46,3,4,13,122,8,9,10,8,5,7,35,19,4,10,4,4,4,12,2,2,4,8,8,11,21,10,24,36,20,8,6,5,5,5,9,27,15,9,13,11,15,5,2,17,9,14,13,9,1,18,8,6,28,10,10,2,7,16,19,4,28,11,3,1,2,7,7,25,23,36,6,6,10,20,11,3,5,43,11,7,12,0,6,13,7,14,6,11,6,9,43,11,26,15,8,6,4,20,13,10,18,10,5,8,16,13,6,12,6,14,10,5,5,37,39,26,1,8,22,37,13,5,7,9,7,5,9,14,5,16,13,2,33,12,8,5,15,9,11,3,7,2,22,13,6,13,3,4,23,30,4,9,4,4,4,8,8,12,3,6,8,6,19,7,14,8,12,14,3,2,3,14,1,19,7,8,10,15,6,6,6,12,16,3,13,11,6,1,6,4,9,26,12,2,2,4,10,10,14,15,8,12,4,16,13,24,3,10,5,9,5,10,4,3,6,9,7,2,8,11,7,7,5,14,8,0,10,19,5,3,0,8,7,7,0,6,3,2,10,0,4,4,1,3,2,14,8,0,6,7,5,4,11,3,8,5,5,14,5,2,1,13,5,21,6,10,4,15,13,4,9,4,10,3,10,2,6,19,4,4,1,7,1,8,6,7,9,7,6,10,6,9,7,17,15,24,11,6,9,27,22,16,44,2,4,7,9,6,10,3,3,9,29,2,2,4,6,5,5,10,12,6,3,4,15,9,10,6,5,1,0,5,15,4,8,3,9,20,3,20,12,7,25,1,1,4,6,0,1,15,2,7,1,3
neither,4,21,12,82,18,6,3,40,2,3,15,6,3,75,2,14,6,23,7,9,3,34,9,10,19,27,11,7,3,15,11,104,95,13,43,54,58,3,12,9,5,8,2,2,30,18,19,9,214,22,46,4,12,27,2,10,69,6,3,12,20,10,3,7,9,2,80,10,2,14,6,14,8,5,70,12,18,5,60,14,29,4,9,3,216,14,14,0,17,0,8,4,0,22,51,14,8,2,23,12,7,24,27,14,14,22,4,4,9,6,19,6,5,11,3,27,4,6,42,138,33,16,6,34,8,1,4,4,5,0,7,1,7,29,29,41,14,2,6,7,8,22,17,9,4,50,8,13,14,7,64,1,9,6,8,15,30,5,19,7,3,6,4,1,0,6,2,10,14,9,6,82,11,2,2,10,127,1,13,24,22,15,5,12,1,28,19,15,39,49,3,4,4,3,1,4,3,8,6,26,27,0,1,8,20,6,3,17,13,23,72,4,26,5,3,3,2,0,14,1,3,18,5,10,38,74,12,19,1,6,5,10,11,13,21,11,30,4,8,8,63,35,9,3,29,6,6,23,26,1,6,21,22,1,5,17,9,2,5,8,8,20,12,3,7,24,2,7,24,2,115,0,10,8,10,3,19,7,5,3,46,6,1,10,7,1,4,5,18,4,7,9,8,1,0,5,29,3,6,38,25,24,0,0,10,2,26,3,5,1,3,13,15,6,13,10,10,24,38,10,31,11,32,3,77,6,8,25,0,38,7,10,1,5,12,8,19,4,7,12,9,9,16,15,2,6,45,50,10,11,8,14,8,20,25,2,5,9,12,16,16,2,5,17,1,2,25,16,1,8,4,19,3,15,13,13,7,4,20,5,72,3,25,7,1,16,6,22,33,3,30,1,11,16,14,7,38,3,17,1,17,3,9,3,4,8,8,1,28,8,14,9,2,13,11,9,3,12,4,5,9,8,11,7,5,0,1,15,15,19,3,3,2,3,3,6,6,5,7,5,22,21,9,16,2,1,13,5,24,3,12,7,3,3,53,13,1,13,10,15,9,27,22,32,4,3,17,24,3,1,17,2,10,6,3,26,5,4,13,6,8,11,4,8,6,13,9,1,6,3,78,32,4,7,7,10,4,8,9,10,13,4,0,1,2,5,6,16,4,2,4,3,0,8,10,15,7,14,2,7,4,19,7,26,14,2,10,10,22,26,13,10,5,12,3,6,14,11,31,13,7,3,3,1,8,8,6,17,15,10,37,7,5,30,6,10,29,1,9,13,23,0,8,6,14,11,9,6,19,30,6,7,9,1,3,6,8,6,6,16,8,10,11,27,7,8,3,13,4,4,35,39,3,1,57,4,10,12,29,25,16,4,14,1,4,17,4,27,6,4,21,17,4,5,24,11,11,2,8,1,10,2,4,10,1,11,4,5,17,22,13,14,28,18,3,2,13,5,12,12,22,6,13,14,7,6,7,1,7,128,33,1,9,5,8,17,36,18,5,7,3,4,13,25,7,3,0,11,5,12,10,11,25,25,27,8,1,5,5,2,2,23,14,7,5,10,20,7,2,17,8,10,9,7,3,2,5,6,17,18,1,3,1,4,2,4,10,8,3,1,8,7,2,18,12,4,4,11,13,4,4,8,5,17,2,21,10,3,5,11,7,3,3,12,0,1,14,5,25,8,16,8,4,16,9,5,5,3,5,7,10,2,0,2,3,7,3,8,2,8,8,11,2,0,15,14,6,7,2,11,4,3,1,16,4,11,6,4,1,7,5,4,9,1,9,0,4,4,4,11,2,11,1,7,11,12,4,5,2,7,3,4,11,3,6,4,7,3,11,5,7,10,21,6,0,2,7,11,3,12,2,2,0,1,1,4,6,5,3,3,4,4,10,5,9,12,6,22,8,0,2,9,8,8,11,1,5,3,6,11,42,23,8,4,1,1,10,0,7,1,8,15,3,0,11,7,5,4,8,6,0,1,4,4,3,8,3,15,7,2,1,3,6,6,7,8,2,3,4,1,4,2,0,1,12,6,4,2,2,5,4,1,6,5,2,1,3,7,1,8,1,2,5,2,9,3,0,3,1,4,3,5,4,6,1,6,11,11,2,3,4,5,5,7,6,1,3,6,7,6,5,11,0,1,3,13,3,5,9,5,3,5,5,2,1,1,3,9,8,8,3,3,5,2,3,22,3,2,5,5,17,10,4,4,8,6,0,15,11,4,1,10,3,10,7,1,16,3,36,0,3,0,4,2,0,0,2,4,1,0
properly,1,12,12,75,3,1,5,10,2,1,8,3,6,26,2,3,7,2,1,2,2,27,3,13,19,7,6,3,4,9,7,109,59,14,27,19,18,6,3,1,5,5,0,1,14,11,17,8,120,2,20,3,11,12,2,1,44,11,0,3,8,2,0,5,9,3,46,2,2,12,9,8,4,1,40,14,7,3,26,7,32,2,4,6,121,15,15,0,10,0,4,6,0,9,25,15,2,3,18,16,10,20,17,10,5,16,7,1,6,2,4,3,8,9,0,12,1,2,19,72,23,8,4,19,7,2,1,1,3,0,4,0,1,25,11,42,6,5,4,1,2,11,9,1,1,28,5,10,11,6,54,3,7,6,3,15,26,2,3,3,9,4,6,3,3,4,3,8,10,5,7,43,14,0,0,4,84,3,3,33,21,5,2,27,1,15,11,15,28,16,1,3,2,0,0,0,18,2,2,4,24,1,0,8,12,14,14,30,12,12,37,1,5,6,1,0,0,14,16,2,0,5,4,3,15,77,19,14,7,5,5,14,8,19,15,19,14,5,7,5,27,13,2,2,8,2,5,14,36,4,8,10,5,3,6,8,3,1,2,11,6,11,12,4,3,46,6,2,10,4,76,2,17,3,3,0,18,17,4,2,19,10,0,8,3,3,9,9,8,0,1,2,7,2,0,7,20,12,6,7,9,25,0,1,5,0,8,5,6,1,3,16,9,5,18,8,14,14,9,4,17,7,11,1,29,5,1,7,5,16,2,5,5,1,4,4,11,4,2,6,7,7,10,7,3,5,26,21,10,5,12,6,13,24,11,4,4,12,14,10,15,5,5,13,3,0,24,10,4,7,3,8,5,8,10,35,10,3,9,5,35,0,21,5,2,26,0,9,11,3,11,1,10,3,18,10,35,9,17,1,14,4,2,0,8,5,13,0,10,9,3,9,2,7,11,3,4,1,2,0,3,9,6,7,0,3,3,12,4,8,8,1,0,6,0,2,1,5,4,6,10,14,7,4,0,1,4,3,17,10,5,6,0,3,36,4,0,5,5,17,6,9,19,24,5,0,5,3,14,0,11,3,4,1,1,6,2,6,11,8,3,4,1,4,5,7,7,3,4,1,30,18,2,3,2,4,2,5,5,10,4,0,0,0,6,27,2,7,5,0,3,1,4,2,7,9,4,8,6,9,1,8,6,30,6,5,11,7,5,16,2,5,3,9,7,3,3,4,18,15,2,2,0,0,0,3,3,10,7,10,13,3,10,15,1,3,11,4,4,2,26,2,12,2,11,9,6,5,23,26,3,3,21,2,5,12,12,5,1,19,1,12,7,7,5,6,5,4,1,6,6,20,8,4,15,5,3,2,10,17,14,0,1,0,3,16,1,18,7,5,14,16,11,6,18,7,17,1,11,3,13,4,3,13,5,8,3,5,9,19,7,12,12,13,3,1,7,3,2,5,9,1,11,10,2,20,2,4,5,46,9,5,3,2,3,2,18,4,2,6,3,7,4,9,2,0,3,8,6,6,13,6,10,33,10,1,6,5,3,1,7,19,3,5,7,6,3,2,0,8,5,5,8,8,7,5,2,4,13,10,0,2,2,0,1,6,6,3,2,3,3,1,4,10,10,18,6,2,3,4,7,4,5,28,3,2,3,4,3,5,10,2,3,5,3,4,19,2,7,6,12,2,5,10,8,2,10,5,6,1,5,2,0,2,0,9,2,8,2,4,3,9,0,3,13,6,6,12,10,8,2,0,1,7,3,15,0,6,17,6,3,5,4,9,7,5,5,6,6,13,2,9,4,3,4,12,2,7,0,11,4,0,2,3,2,1,2,0,9,2,5,0,8,8,3,3,3,6,6,8,0,3,4,17,4,5,5,4,6,3,7,3,12,1,8,6,0,8,2,1,0,7,3,9,1,1,6,4,0,4,4,14,6,7,1,9,1,2,1,0,5,3,8,0,6,1,2,2,5,6,17,0,3,7,0,1,0,3,9,2,2,4,1,2,2,1,2,1,3,1,0,24,0,2,4,2,4,5,2,1,8,1,1,3,0,2,4,8,4,12,8,2,8,2,4,1,5,3,4,2,9,3,2,9,3,4,2,3,1,6,8,2,0,3,2,2,5,3,0,6,1,10,2,2,4,6,4,2,15,2,0,3,2,2,4,0,6,2,11,4,5,3,6,9,0,5,7,0,3,9,0,1,0,3,2,6,1,1,4,2,7,9,3,4,6,4,2,2,5,0,1,3,0,1,0,6,0,2,1,0
indeed,0,18,8,81,9,4,7,29,1,4,20,4,7,80,4,11,6,21,3,5,3,27,18,19,17,10,15,14,5,8,9,138,91,8,48,75,42,1,10,6,1,4,1,1,40,12,12,6,166,17,37,5,12,31,5,6,51,11,4,13,12,5,6,10,17,5,95,8,8,8,11,4,2,4,77,15,26,5,64,17,22,1,14,6,134,15,12,1,29,1,7,5,2,24,38,7,14,7,31,7,8,21,22,8,10,26,4,4,11,9,15,5,7,9,5,33,1,5,32,127,38,15,8,62,3,4,4,3,6,1,10,5,6,31,30,35,14,4,5,9,7,31,18,2,3,36,9,10,6,9,72,3,6,3,6,13,32,10,7,11,4,3,11,0,4,8,6,15,21,9,6,99,21,2,2,5,102,5,8,31,15,12,1,19,3,35,23,31,30,37,10,7,6,1,6,2,9,8,11,15,32,4,3,3,21,8,5,28,13,21,74,5,21,8,2,1,0,1,6,0,8,23,6,22,33,60,20,40,7,21,12,7,11,12,29,24,31,6,3,17,47,19,6,7,13,1,5,25,30,4,3,8,13,4,6,9,8,1,2,12,5,18,7,2,7,16,5,7,16,3,86,2,26,8,3,1,8,9,6,4,53,6,3,16,11,3,3,6,12,1,2,2,15,2,3,4,24,3,9,19,24,11,2,1,9,2,29,6,13,2,1,7,20,5,24,6,8,31,16,7,27,7,32,4,34,3,8,34,2,30,8,11,12,4,1,15,8,6,4,6,4,9,7,9,5,5,35,29,11,7,10,6,7,17,20,0,5,6,9,18,14,5,10,13,3,5,34,7,3,6,0,12,2,13,11,8,8,7,18,7,79,1,23,11,1,20,10,21,21,4,24,3,17,16,20,3,48,3,24,2,13,0,4,3,10,6,11,5,15,7,7,7,4,12,9,11,1,6,5,2,8,4,11,10,6,6,3,7,7,16,15,5,0,6,4,3,3,4,13,3,4,14,5,16,3,2,11,7,24,12,18,4,5,5,40,6,1,5,8,24,9,32,34,27,8,18,19,7,6,1,19,3,3,4,4,33,7,13,15,7,3,11,8,4,10,12,4,8,6,1,58,26,4,3,9,7,3,7,1,10,18,14,10,1,5,50,5,8,6,4,6,4,6,6,15,14,3,13,1,10,1,10,11,29,5,12,15,10,12,33,10,9,7,11,8,11,4,13,33,22,5,0,1,5,4,4,9,10,8,5,37,5,4,30,2,8,21,2,0,4,10,4,21,4,13,13,20,12,26,39,10,9,17,5,6,0,7,0,9,10,5,8,13,23,11,10,5,9,3,13,24,40,6,1,23,2,9,10,20,16,12,2,2,3,2,18,2,20,5,4,22,8,5,12,37,8,9,4,12,5,9,21,4,12,0,3,5,4,11,22,16,30,40,16,9,2,5,6,3,4,14,1,11,14,4,7,1,3,4,92,19,7,3,6,6,8,27,17,9,8,7,4,16,6,6,6,1,5,10,5,20,6,18,24,33,4,2,2,5,4,3,16,16,8,6,3,9,1,5,7,6,15,11,3,2,10,13,3,11,6,6,3,6,9,2,3,11,16,5,2,7,3,3,18,14,15,7,4,11,8,4,8,5,10,3,7,4,2,9,21,9,9,3,6,5,4,18,7,13,3,8,5,3,14,10,5,12,4,2,6,9,8,4,4,2,1,8,6,1,4,3,14,4,2,13,8,4,4,5,7,8,2,3,9,4,11,8,1,5,10,1,5,19,1,12,2,5,0,16,5,2,4,1,7,14,21,2,1,2,0,2,4,14,4,8,9,10,8,22,4,6,1,5,9,4,2,1,10,4,13,3,2,3,7,9,8,3,7,10,5,5,6,11,4,12,10,6,15,4,3,6,5,2,15,7,6,11,3,1,14,13,14,9,4,1,3,9,4,2,1,2,4,3,0,4,0,0,2,3,2,1,6,2,17,5,7,3,6,7,1,2,8,3,1,4,2,2,4,4,7,3,4,1,4,5,1,0,1,5,3,4,2,2,10,3,0,2,5,4,12,2,1,4,6,8,1,0,3,9,0,4,1,3,6,3,3,1,10,2,18,5,1,2,4,5,2,0,4,1,3,9,9,5,2,12,10,10,13,17,5,0,3,5,3,3,0,0,2,9,5,0,1,0,3,2,6,0,0,11,7,9,5,7,2,1,2,3,4,0,1,0,9,2,14,2,3,4,2,23,2,3,2,0,0,0,4,2,4,1,1
grant,1,34,15,293,6,3,4,34,8,5,25,11,15,77,9,13,11,24,9,5,9,47,14,24,46,34,10,12,10,13,13,258,118,13,60,49,26,14,7,8,6,16,0,8,51,21,71,17,482,27,51,6,12,32,17,10,48,38,3,17,19,6,6,23,16,9,145,11,7,16,40,5,5,17,83,18,42,6,120,31,67,1,16,5,305,42,20,1,53,7,16,6,3,32,76,28,19,13,49,8,77,39,48,12,16,33,11,3,28,4,12,7,8,32,5,35,9,11,113,183,42,17,17,115,15,4,5,6,4,3,8,5,5,76,24,85,4,7,18,8,6,35,48,3,6,106,10,13,26,19,196,5,20,11,2,83,41,8,24,31,15,4,10,6,11,10,6,21,28,15,22,122,38,1,3,6,205,10,18,58,28,13,27,28,38,20,51,33,34,61,1,6,5,0,4,6,31,5,14,17,40,4,6,5,26,14,21,44,13,49,129,3,33,11,4,5,0,10,28,11,3,20,8,7,66,132,20,25,6,33,29,22,23,53,41,26,32,19,8,7,86,48,7,1,13,31,10,14,66,10,21,37,29,17,15,27,18,3,5,30,5,20,28,11,18,34,33,6,18,10,193,38,56,5,7,1,18,17,18,9,54,13,1,20,6,7,8,12,22,1,5,3,45,11,5,19,56,6,10,20,26,58,9,9,25,5,16,1,7,0,10,10,27,8,37,24,28,41,24,11,54,13,38,21,103,7,15,34,4,33,8,7,8,4,15,1,17,13,11,13,7,11,15,27,10,4,53,58,59,15,27,26,11,65,36,11,11,15,13,33,40,16,18,31,12,6,42,13,4,13,8,24,1,12,11,33,5,3,16,11,121,11,63,11,2,162,11,45,42,2,29,8,31,11,49,15,101,6,45,2,26,3,3,4,2,8,8,2,20,16,1,10,7,20,12,5,11,3,11,0,2,1,33,18,2,18,9,10,9,20,11,8,4,17,2,6,1,12,10,16,29,41,19,6,0,6,16,9,50,15,9,6,4,7,54,7,1,18,8,45,20,37,34,17,5,35,21,23,44,1,21,6,3,4,8,10,6,22,15,10,2,11,7,4,8,11,9,6,2,3,74,42,2,4,5,14,2,26,7,15,13,7,6,3,44,31,11,35,11,15,1,4,13,13,14,37,3,17,12,4,5,23,19,45,24,10,35,31,19,45,23,6,6,15,17,7,22,13,27,34,13,5,3,3,19,13,4,19,10,18,89,16,9,85,3,9,42,8,14,19,29,10,48,2,31,8,9,6,55,61,25,12,32,1,6,13,7,6,10,43,10,22,15,14,12,12,7,10,7,12,37,53,26,15,24,6,4,0,64,21,32,4,2,9,22,21,31,33,8,6,34,35,7,20,61,7,22,10,14,4,23,3,6,28,11,14,23,19,27,41,8,27,27,24,9,4,23,10,7,9,6,3,21,35,6,49,1,22,12,230,62,7,5,10,9,23,78,18,15,16,5,6,24,20,8,7,1,7,11,13,26,9,48,40,37,8,9,31,29,6,32,37,15,1,7,11,16,6,6,7,23,9,27,16,12,27,12,9,14,33,4,6,12,14,22,8,27,10,7,15,8,13,11,26,38,15,10,18,9,3,15,3,8,21,2,6,18,2,4,11,7,19,32,3,18,5,20,12,50,12,14,14,11,4,8,7,15,41,6,23,17,14,17,17,8,10,21,12,9,8,7,7,7,6,27,19,24,16,6,33,1,2,3,14,10,17,19,5,20,11,0,8,7,4,10,8,4,13,11,19,12,28,9,15,43,17,46,13,5,1,3,3,26,11,1,2,7,6,28,8,2,13,24,25,3,9,14,13,18,13,2,5,7,17,20,10,9,21,7,8,9,15,10,2,13,14,11,17,17,5,8,12,5,7,1,11,11,8,25,16,37,80,10,15,3,2,5,31,9,1,2,12,13,9,2,9,3,6,8,21,11,18,4,4,6,6,7,19,19,5,4,19,3,6,16,3,7,5,2,23,5,6,24,11,8,11,4,11,7,2,8,13,4,7,12,3,11,23,8,19,10,34,30,16,24,8,2,35,2,3,14,6,12,23,5,8,3,9,4,10,7,14,12,16,11,14,18,1,9,30,7,9,22,5,9,19,16,17,27,18,3,6,6,4,3,7,17,8,41,6,89,6,4,15,2,32,22,25,4,6,5,17,6,3,6,6,8,7,18,4,8,9,4,6,4,9,11,13,19,3,7,14,8,0,4,9,5,13,2,1
lead,4,36,18,164,31,25,7,48,8,9,25,20,32,171,6,16,16,26,16,12,9,56,55,47,39,43,39,45,16,51,18,275,244,33,82,206,120,14,18,11,15,38,12,19,56,38,46,21,452,157,86,24,39,159,35,16,64,25,38,39,32,27,9,26,43,18,194,14,25,19,14,12,15,7,180,41,52,10,136,53,77,4,22,23,358,24,13,3,53,7,7,19,5,45,78,12,42,10,63,33,24,52,49,31,29,58,15,10,26,11,36,7,28,42,22,51,8,8,88,273,70,57,49,128,13,6,5,12,4,0,47,10,21,78,39,114,13,8,20,26,9,76,38,5,21,137,15,34,26,19,112,4,23,13,10,30,79,17,15,75,10,6,15,3,5,30,10,60,39,18,33,166,69,16,16,19,276,8,14,71,41,18,15,43,14,31,47,51,73,99,2,12,16,5,7,8,22,10,12,33,48,3,18,17,40,21,11,54,22,42,124,23,43,20,13,31,14,8,29,5,3,41,6,32,69,103,36,40,13,18,22,21,38,43,55,23,59,23,13,15,89,66,10,8,35,7,11,58,41,15,24,42,61,8,20,29,14,4,6,22,15,79,32,2,8,51,16,30,47,5,209,17,20,13,7,10,33,17,17,4,140,24,8,31,17,12,25,24,21,9,2,8,21,18,3,18,66,2,12,32,37,31,0,8,29,3,57,8,14,7,5,30,47,26,36,23,28,67,32,14,70,18,52,26,151,17,26,80,9,41,11,16,19,11,8,17,1,11,4,14,17,24,38,21,10,16,72,97,39,17,13,21,11,52,46,6,7,7,26,57,34,11,24,25,11,12,66,20,22,47,8,72,11,32,13,39,20,13,20,9,75,5,65,25,18,66,11,33,40,9,38,14,23,17,42,24,84,12,37,7,28,19,7,16,11,15,18,6,49,21,10,13,9,25,52,21,18,17,10,27,14,16,30,27,9,12,4,22,17,46,20,4,3,16,15,16,6,32,22,8,29,34,8,30,7,13,45,20,43,17,55,10,19,12,99,22,13,14,12,41,33,44,58,58,12,9,51,29,16,6,49,18,11,6,8,34,17,12,34,8,13,31,6,14,15,5,11,18,13,1,153,37,5,19,17,10,10,17,7,32,21,7,5,3,24,30,16,17,8,14,8,20,10,9,17,23,14,10,10,17,8,18,13,36,18,5,46,12,19,41,20,17,9,20,16,15,12,15,56,28,6,11,11,7,20,5,14,27,22,9,32,7,6,71,11,11,45,7,17,10,46,6,33,14,30,23,19,11,41,39,9,16,11,5,20,16,6,10,17,22,6,27,16,44,20,13,10,4,9,28,52,62,31,4,38,7,18,17,70,52,35,5,14,3,17,50,15,42,10,7,47,19,16,12,48,17,24,7,14,6,22,15,7,29,2,9,11,18,28,53,22,25,30,47,9,5,22,10,4,14,23,9,13,37,20,40,9,5,8,293,40,15,16,5,15,20,52,47,7,25,21,19,23,48,5,3,5,20,20,19,27,12,51,19,34,17,9,6,2,10,9,41,22,21,19,2,18,15,4,21,14,42,20,31,5,17,19,5,27,15,24,8,7,14,19,10,26,21,6,2,11,14,9,44,27,26,33,14,8,15,16,4,9,24,21,13,15,9,4,17,8,12,8,9,11,6,24,14,45,18,12,10,8,8,15,9,22,21,10,11,22,4,1,6,5,18,12,23,8,32,40,15,2,2,27,24,14,13,15,20,14,11,10,24,10,29,8,8,42,18,9,12,28,2,20,5,10,17,11,14,16,8,4,5,20,15,10,12,4,10,4,9,24,4,25,4,21,7,21,6,8,4,13,11,6,14,12,25,8,18,14,2,11,15,5,12,18,8,23,8,12,9,25,18,16,20,20,51,20,10,11,7,6,7,6,8,10,18,12,15,58,29,2,13,10,5,15,5,9,10,10,15,10,15,15,13,9,2,30,16,6,6,14,35,12,7,8,19,19,11,3,5,5,9,8,7,15,9,11,7,16,20,11,6,14,6,13,12,9,32,7,7,12,21,3,9,11,12,3,31,8,6,12,6,25,5,3,10,11,8,17,9,7,15,8,4,12,33,7,6,8,10,9,19,14,11,7,7,8,15,7,25,2,3,10,15,11,6,27,5,2,8,10,10,7,7,7,12,18,11,10,9,11,6,4,34,11,4,5,21,18,16,21,15,7,11,7,14,18,9,9,13,7,20,10,22,26,14,47,11,4,5,3,7,2,8,3,6,10,23
recently,11,17,3,102,5,7,5,27,8,2,25,12,10,42,3,1,1,6,3,3,7,29,5,20,14,7,11,9,5,8,11,131,105,10,26,37,39,3,5,5,4,13,14,2,26,18,16,11,233,20,31,6,4,28,9,7,30,25,1,14,22,10,3,13,17,2,43,4,5,7,8,2,3,7,47,6,7,3,35,10,33,0,21,7,178,11,5,0,18,3,13,3,1,23,22,10,9,7,29,9,10,23,27,4,11,15,5,4,17,9,12,10,4,10,2,16,2,3,40,63,23,14,16,38,9,3,7,4,5,4,9,5,2,34,10,26,6,2,4,6,3,38,29,2,4,46,4,13,10,7,40,2,25,2,8,11,16,7,12,8,7,2,6,3,2,6,5,17,26,8,27,53,12,2,7,8,114,2,10,18,20,13,8,19,3,13,20,11,36,51,0,2,3,3,1,2,17,0,2,5,21,2,2,11,16,7,1,10,9,15,50,6,17,4,2,8,0,3,4,4,2,19,8,8,18,65,14,9,6,7,8,6,14,18,21,3,32,4,7,4,38,15,10,2,9,2,6,7,24,5,9,16,19,3,9,6,15,1,7,11,6,23,17,8,2,39,2,3,11,3,78,9,18,2,2,3,10,5,5,4,22,5,3,15,8,6,3,1,3,2,2,13,8,2,2,8,47,7,5,10,18,15,0,2,9,0,16,3,5,2,6,16,13,4,16,5,12,35,7,6,49,9,18,6,42,2,6,16,5,20,5,7,4,4,6,13,11,1,0,8,3,13,7,5,4,6,37,40,14,8,12,7,5,19,12,3,4,3,7,10,19,9,10,14,4,1,24,3,4,5,6,16,4,5,4,19,6,0,10,5,34,0,27,13,5,10,9,17,18,1,15,3,9,13,20,4,51,4,33,5,13,3,1,1,3,3,5,3,24,9,2,15,7,16,3,8,5,3,2,7,4,9,15,9,2,2,3,10,10,12,11,1,0,4,1,5,5,15,8,3,14,15,6,15,5,13,7,5,27,4,14,11,3,5,37,11,0,12,7,19,9,13,30,18,7,1,14,12,4,1,10,4,4,1,0,7,3,12,14,5,9,4,6,4,5,10,7,6,6,3,55,27,0,6,7,9,9,10,11,4,7,7,2,1,4,15,5,8,5,5,2,4,4,4,8,13,1,4,2,9,5,11,3,12,4,1,24,9,31,10,9,3,1,6,8,9,5,5,28,10,2,6,1,13,6,8,9,14,17,7,13,9,4,28,9,3,24,3,3,8,10,3,15,2,12,8,12,8,29,14,6,11,5,4,7,2,5,4,5,16,8,9,7,9,4,2,5,6,3,6,9,21,4,3,17,4,2,3,62,9,16,4,4,7,10,11,3,9,16,3,17,16,15,5,27,5,9,2,8,2,13,3,2,18,3,3,6,6,13,23,4,17,13,12,9,3,6,5,2,8,4,2,4,17,10,24,8,10,8,160,12,4,3,3,6,9,16,14,9,7,4,5,18,17,13,9,1,10,9,11,12,4,59,25,32,8,2,6,6,7,2,20,15,7,11,7,10,5,11,18,5,3,10,17,6,7,6,9,10,7,21,8,1,7,3,6,13,3,1,14,2,6,5,17,7,19,8,6,4,7,7,4,9,15,1,7,6,0,2,6,1,4,4,3,4,5,11,6,34,4,8,10,3,5,9,0,10,7,9,9,10,2,2,4,1,11,10,14,6,6,9,15,1,1,20,14,17,5,14,9,3,6,2,10,8,10,2,0,25,4,16,6,10,6,8,3,0,21,5,7,7,15,7,2,11,8,3,6,10,9,3,10,12,5,3,3,3,5,20,8,0,5,13,9,4,3,4,13,9,5,8,3,10,6,8,4,4,4,4,3,9,8,10,5,3,6,11,21,7,10,10,6,5,8,6,11,2,10,1,16,19,11,3,0,11,2,8,2,6,4,1,9,5,3,4,5,3,3,5,7,2,1,8,10,5,4,10,22,12,8,2,5,5,2,19,4,5,5,9,4,5,5,3,5,10,4,11,5,4,1,1,9,5,15,5,1,6,10,2,14,5,4,6,2,6,5,5,5,3,5,10,12,3,8,6,6,10,35,8,5,4,3,9,5,1,2,2,6,5,6,3,7,1,0,1,12,6,11,12,3,3,5,2,4,4,1,12,8,11,9,4,5,1,1,1,24,7,2,6,5,5,1,4,2,7,5,1,9,5,1,7,5,6,4,5,3,5,7,23,1,2,5,3,3,0,1,0,5,8,5
finance,0,6,11,60,2,3,1,6,2,1,5,7,3,30,3,1,2,8,2,0,3,21,3,5,11,10,4,7,2,5,1,76,60,7,23,21,7,4,10,1,9,0,0,6,17,11,20,20,91,12,12,2,10,13,9,1,11,13,1,9,7,1,3,2,8,3,33,3,0,2,35,1,3,1,37,6,14,3,20,8,43,3,4,3,143,19,10,1,29,2,5,2,7,19,43,9,11,0,18,18,20,21,16,4,9,11,13,5,9,1,10,3,14,10,4,4,2,3,20,43,14,8,21,56,6,2,1,0,2,1,7,1,6,32,5,17,0,5,2,3,0,8,15,1,1,18,1,8,4,16,17,1,5,11,2,40,7,1,3,4,4,1,4,5,14,10,2,7,10,14,7,26,9,1,4,1,50,5,4,16,13,3,17,8,2,10,16,6,8,11,0,3,6,0,2,7,16,2,5,3,24,6,6,6,13,7,9,18,5,11,30,3,10,11,2,2,10,15,1,6,17,7,7,9,29,24,12,16,1,27,9,19,20,6,16,35,12,7,4,2,22,12,1,3,9,8,3,10,42,2,3,12,6,10,5,3,2,1,9,7,1,1,11,6,6,20,5,1,0,5,54,17,51,3,0,2,7,36,3,3,17,3,2,4,1,2,2,4,6,3,2,0,12,8,2,5,23,2,1,9,12,14,7,4,3,4,10,0,0,4,6,14,14,9,27,15,8,18,6,7,13,1,12,7,5,1,12,12,5,10,9,5,7,2,4,11,4,0,1,14,9,1,11,2,1,2,18,11,16,5,6,6,1,16,4,4,1,0,4,24,15,5,4,10,6,1,1,4,11,4,0,13,3,9,2,14,2,3,3,5,37,4,27,1,5,17,0,5,15,1,3,2,7,7,18,7,19,4,5,2,9,3,4,0,5,8,2,1,10,7,0,0,11,15,2,2,7,0,3,0,2,3,10,0,0,7,6,4,2,4,16,10,11,4,4,3,0,4,3,4,6,9,6,5,0,0,8,0,25,12,15,2,0,6,19,5,0,3,1,13,3,5,9,9,7,1,13,2,2,2,2,0,0,2,3,3,2,4,5,3,5,4,0,1,2,2,6,1,3,1,53,30,2,2,4,4,2,16,1,5,8,2,6,9,3,39,14,6,3,3,3,1,1,7,9,3,2,2,2,3,1,10,5,6,3,3,3,33,4,6,2,4,0,7,4,7,4,2,16,13,1,2,3,9,6,1,3,14,4,3,11,4,0,17,2,7,18,1,6,2,9,1,7,4,7,8,2,2,15,19,10,6,13,1,2,1,3,0,3,16,3,7,4,8,3,0,1,3,4,4,10,11,4,5,7,0,6,3,6,7,5,5,2,2,2,7,6,3,4,6,8,8,5,1,4,4,6,0,1,1,7,5,5,12,4,3,2,4,7,16,9,7,8,8,2,6,4,5,0,2,7,4,1,7,2,24,7,5,2,46,5,4,1,5,1,9,10,6,3,3,0,1,7,6,3,2,0,1,2,6,7,2,1,2,5,1,2,5,1,1,1,13,3,2,4,8,14,10,0,1,2,2,9,0,4,7,4,1,7,7,3,0,2,5,7,0,19,2,0,1,0,8,2,12,8,2,0,2,3,2,0,1,0,5,3,0,5,1,1,3,0,6,8,2,1,1,4,1,2,8,6,1,5,1,5,2,6,3,4,3,7,25,20,15,9,8,7,5,1,4,4,4,2,13,8,12,8,3,17,5,7,0,2,1,1,5,23,1,0,1,0,0,2,5,0,5,3,0,6,2,1,5,3,3,1,1,13,0,2,1,3,0,2,3,0,1,6,4,7,0,3,3,1,2,1,0,2,0,1,11,0,0,0,6,0,1,4,6,4,5,6,7,9,3,2,6,3,5,2,2,1,2,0,0,1,3,6,1,3,2,3,16,1,5,3,2,1,5,0,3,8,3,1,6,2,4,1,3,1,5,0,4,16,13,1,2,0,7,2,1,0,1,2,3,2,5,4,1,1,8,0,1,2,2,1,3,0,1,2,1,9,2,3,2,1,7,1,8,9,7,8,38,2,14,4,4,1,1,1,4,4,0,8,0,2,5,2,2,2,4,2,9,2,2,3,6,8,3,0,3,0,3,11,22,20,35,21,23,65,2,0,0,1,8,1,12,3,0,13,6,2,1,1,3,4,3,0,0,0,0,0,2,0,7,3,1,1,2,9,1,0,0,3,9,2,10,4,3,1,0,1,9,7,1,10,2,3,5,0,1
period,8,22,21,147,11,10,11,47,5,4,26,11,14,71,2,9,3,13,3,4,7,47,7,32,18,11,15,14,5,30,10,196,147,21,35,50,66,18,30,7,9,15,4,5,28,16,36,24,364,25,58,6,24,47,8,3,59,45,1,22,14,4,8,13,31,9,71,6,7,9,37,10,4,5,72,16,19,14,165,28,110,2,23,6,231,31,20,2,65,8,42,5,10,39,78,17,19,8,50,10,14,38,41,8,20,31,22,7,20,17,32,9,12,22,4,39,18,7,97,155,39,24,13,215,11,7,7,5,24,5,9,2,3,63,42,37,7,5,7,29,3,39,59,8,15,74,6,23,25,22,64,1,15,11,3,29,25,7,24,10,22,4,7,11,17,5,11,9,18,16,26,92,16,11,10,30,169,5,7,25,18,15,21,13,2,21,51,16,38,69,6,4,3,2,6,13,19,9,22,9,31,5,6,10,49,9,15,36,10,31,81,3,23,9,1,1,7,6,21,3,16,22,5,20,50,82,34,39,20,30,15,49,37,25,30,41,42,2,13,8,58,36,3,6,6,10,14,21,62,1,19,24,14,24,13,22,15,8,13,18,0,41,16,16,3,49,7,9,12,14,157,17,91,9,2,2,21,59,11,4,51,10,7,17,19,3,6,9,19,4,9,4,8,10,11,9,47,4,14,19,38,30,7,11,7,1,29,5,3,1,2,7,36,7,66,26,11,48,10,5,38,10,47,7,38,4,10,27,5,25,0,16,12,6,6,13,14,8,14,1,10,15,14,12,14,2,43,49,18,5,11,14,5,23,17,3,9,2,19,71,21,10,9,21,3,0,39,12,6,9,7,10,9,7,11,28,5,6,13,13,81,3,53,17,2,50,2,30,29,11,18,7,19,11,32,11,58,8,36,5,18,2,9,1,4,6,10,4,21,9,3,11,15,6,9,6,6,2,3,2,6,12,16,17,1,3,5,11,11,21,19,18,19,32,5,6,3,7,9,11,21,15,8,32,2,3,16,5,54,13,13,9,2,1,66,12,1,9,7,46,10,24,27,31,10,0,15,8,2,2,13,4,5,1,3,3,10,13,23,8,8,21,6,7,15,9,19,7,5,9,138,71,1,7,16,11,7,20,18,10,15,8,5,1,7,46,7,11,17,4,6,6,14,6,23,17,6,8,2,7,4,25,6,23,6,10,32,4,13,26,18,6,4,7,11,9,13,11,60,22,9,11,6,5,15,13,54,16,24,9,58,7,10,71,13,5,22,3,10,6,23,4,36,8,16,13,18,0,51,25,15,5,25,2,2,4,8,6,11,24,5,13,9,15,16,4,10,8,7,12,12,38,8,10,30,3,4,8,54,8,27,3,12,6,4,17,6,17,2,3,33,24,13,9,23,10,25,2,8,6,19,17,4,35,9,14,5,10,12,32,27,17,27,18,13,1,3,5,3,10,9,5,9,27,6,52,6,9,8,228,17,4,9,8,3,35,43,22,9,29,9,9,22,20,14,11,8,9,15,18,22,15,62,18,41,4,4,7,23,10,13,32,19,9,17,14,13,11,3,8,24,22,20,12,10,16,15,6,8,19,8,1,1,4,6,6,24,13,3,6,8,44,9,34,24,38,10,8,8,10,6,7,10,24,5,21,15,1,3,40,7,13,7,8,8,3,21,7,39,16,5,9,3,15,5,4,17,8,6,4,15,26,27,55,26,11,11,13,18,52,46,18,16,28,47,28,12,9,16,11,6,2,6,13,7,17,22,8,15,14,4,2,13,11,15,8,8,50,9,15,13,9,2,10,9,14,2,6,10,6,4,5,14,8,2,7,10,3,17,10,10,3,7,15,2,9,5,13,6,20,4,18,16,18,6,8,1,3,8,4,16,8,12,4,4,6,19,22,6,7,10,8,2,4,6,13,14,9,5,13,13,28,7,13,2,11,7,19,6,7,9,4,6,10,5,8,2,5,7,6,3,1,24,19,4,7,5,22,10,5,2,19,5,11,16,12,14,7,5,16,3,9,1,9,13,38,3,5,17,5,3,10,8,16,4,28,1,19,6,26,2,25,7,29,20,23,7,6,3,3,7,8,8,8,0,12,6,16,9,14,6,2,9,15,4,12,8,14,2,7,7,19,23,22,13,37,29,42,77,11,6,6,2,5,6,14,8,2,19,6,14,1,4,4,6,16,4,4,5,2,7,7,9,8,7,2,3,12,5,12,12,3,13,24,3,7,12,5,17,1,1,3,14,2,1,3,5,12,6,1
avoid,1,12,9,83,14,7,4,29,2,3,11,5,5,79,7,9,3,16,7,0,10,46,18,22,15,12,8,8,2,12,10,148,106,8,35,59,62,7,21,7,4,9,3,2,33,17,30,17,238,12,54,12,11,37,5,6,56,13,3,17,24,17,6,10,20,7,102,6,12,25,17,2,5,1,113,11,15,16,82,23,27,1,13,13,214,21,15,4,19,4,6,8,2,27,58,8,19,1,28,10,6,29,39,14,13,21,9,5,10,4,17,5,22,20,2,24,3,5,46,193,45,19,20,45,2,1,3,8,4,4,21,3,9,34,20,38,15,6,6,4,6,33,14,3,1,65,5,7,18,27,60,0,13,11,7,41,24,7,11,12,13,9,12,4,1,11,4,10,20,8,14,77,17,3,0,11,156,0,13,36,27,20,6,16,5,17,32,23,49,48,4,9,5,1,1,5,24,3,7,18,35,1,2,10,23,15,10,35,13,31,72,8,20,4,2,4,3,3,5,1,6,28,3,21,40,72,16,18,0,6,8,16,10,33,33,18,30,12,6,12,74,30,7,10,15,3,5,33,45,13,15,14,22,11,4,16,17,1,2,11,2,30,22,5,7,26,1,4,13,6,164,7,17,11,3,1,20,11,13,3,54,7,3,14,9,2,5,18,15,4,8,5,17,3,1,13,29,6,3,23,23,29,1,2,16,1,21,4,4,1,2,25,21,10,27,7,14,37,14,4,47,9,32,1,90,4,11,18,11,20,2,9,9,7,4,7,17,3,9,10,1,17,11,18,8,6,34,47,21,5,12,12,1,42,29,4,1,3,14,21,20,4,8,15,1,0,64,7,2,17,5,11,4,10,6,8,9,5,19,10,50,3,48,12,3,17,0,21,25,0,31,2,6,7,27,11,46,8,40,3,21,1,5,3,3,6,11,3,15,8,1,0,2,13,26,15,9,16,6,3,1,6,25,18,1,13,3,17,18,25,11,1,3,4,4,7,4,10,8,2,10,12,6,14,0,6,6,10,32,13,16,10,5,2,52,16,3,10,10,26,12,24,22,23,2,5,8,11,10,3,17,8,1,2,6,10,3,14,36,5,5,12,1,9,10,14,10,4,9,1,97,55,7,8,9,1,3,18,9,12,10,6,4,2,11,27,3,13,4,3,8,6,5,3,16,21,11,9,6,7,3,18,8,32,9,5,26,6,15,23,14,7,8,8,8,7,10,14,36,32,6,3,1,10,8,13,5,20,18,5,31,6,7,48,3,6,23,7,7,3,25,1,14,3,10,30,10,11,30,31,6,9,20,7,7,3,5,10,13,6,4,18,14,18,17,4,6,9,4,12,19,39,9,2,18,4,2,4,39,30,21,3,4,4,12,33,4,26,8,3,23,24,14,6,27,12,25,8,16,11,18,9,3,19,2,7,8,10,16,21,6,15,24,23,5,2,11,6,3,3,6,1,8,20,10,23,5,3,5,113,19,7,13,3,3,4,48,25,6,10,10,3,14,6,8,3,3,7,19,12,15,12,46,18,25,12,1,3,3,5,6,18,11,8,12,17,14,3,5,5,11,9,11,12,10,5,10,5,17,12,0,7,2,7,6,9,20,9,3,6,6,9,5,36,12,12,11,11,10,8,5,7,2,7,0,7,7,2,1,5,13,19,2,8,6,5,20,8,14,5,18,3,7,7,4,3,14,3,8,7,25,4,1,3,5,11,8,6,4,5,5,9,4,3,17,6,6,9,6,12,9,6,1,14,2,16,7,9,4,5,0,6,8,7,3,6,7,22,6,10,6,2,2,4,6,22,4,5,4,4,5,5,12,5,5,1,16,3,15,5,1,7,5,2,2,6,1,5,5,9,7,2,5,17,1,5,10,2,5,3,8,2,19,8,2,16,12,23,23,5,3,10,12,13,5,7,10,10,8,9,45,26,13,3,4,6,16,6,8,3,2,4,8,3,7,4,6,6,22,7,1,1,6,10,4,6,7,4,10,0,1,4,5,6,7,4,9,4,18,2,8,6,1,5,18,11,6,8,7,8,9,9,4,20,8,1,5,10,4,21,9,6,6,10,13,2,6,4,6,2,4,12,6,3,0,5,3,15,5,8,7,2,5,5,7,3,3,6,5,7,1,4,6,2,10,18,20,12,28,4,0,1,2,9,2,1,0,6,18,5,0,2,4,0,4,15,5,2,0,7,11,3,16,2,7,6,2,18,5,6,0,4,10,4,9,10,13,4,26,4,3,8,4,1,1,5,2,2,1,1
send,18,36,17,184,23,19,4,19,10,4,25,21,27,74,2,4,16,12,16,14,5,37,52,37,19,47,24,31,12,35,17,209,124,23,39,119,43,8,9,5,11,10,10,18,39,20,26,16,333,80,56,12,8,58,41,6,37,40,38,19,32,16,3,17,25,11,108,10,11,17,14,5,9,2,90,13,31,14,90,34,29,6,24,12,203,16,20,7,37,5,23,10,23,45,34,18,34,2,35,9,6,25,26,22,13,47,7,24,15,14,26,7,7,27,18,47,10,5,74,142,45,74,14,87,17,6,4,8,5,7,27,11,16,61,34,68,8,4,11,8,9,56,35,2,3,101,24,25,10,13,37,9,31,1,4,16,60,18,18,55,22,4,23,7,8,29,21,24,28,19,20,115,31,7,15,9,136,5,6,80,33,10,14,32,5,31,26,24,39,60,3,4,12,6,8,3,16,10,13,7,16,4,5,22,21,19,10,12,17,27,101,30,33,9,18,31,16,39,15,3,2,31,5,14,52,80,39,18,16,10,15,21,15,11,32,12,31,8,7,14,77,44,11,17,9,6,5,40,41,13,10,15,27,3,6,14,13,6,2,27,2,54,15,10,4,43,14,20,30,4,91,8,28,8,4,7,42,3,17,6,74,11,7,8,17,2,11,12,17,8,10,22,36,13,9,10,57,36,15,16,24,30,5,8,13,1,26,4,4,13,12,8,30,9,40,11,15,49,16,3,47,4,46,25,94,2,9,60,4,41,23,8,9,7,9,11,24,13,1,15,17,1,32,18,4,11,37,51,26,17,11,19,9,46,25,9,9,4,9,31,32,10,13,13,4,13,51,8,25,44,2,45,1,26,9,34,7,2,19,3,61,4,39,12,20,36,8,22,31,13,16,8,19,11,37,9,33,3,55,9,12,11,6,9,3,1,19,11,23,17,1,17,3,13,37,17,6,17,5,16,4,25,24,13,7,4,5,19,22,18,15,7,4,12,7,6,8,18,27,3,17,16,8,25,2,11,33,19,27,8,24,3,12,6,45,11,7,18,10,12,20,23,24,51,6,13,32,20,17,8,44,19,2,5,9,14,2,22,25,16,9,9,5,10,8,19,6,12,1,3,135,32,3,5,24,11,8,10,5,7,6,8,1,3,7,11,2,10,6,5,0,2,8,6,6,19,13,3,0,16,5,23,6,18,7,8,32,2,21,22,18,2,17,1,9,12,9,10,40,13,7,5,4,6,8,5,8,18,10,8,22,7,5,39,5,6,19,2,3,6,19,2,22,5,10,13,15,12,34,22,9,4,20,3,3,2,4,3,7,23,2,15,10,17,6,5,13,7,4,13,13,42,13,17,6,8,2,5,42,23,17,2,5,5,13,23,5,19,3,7,37,26,12,4,37,6,4,4,6,8,17,1,5,27,2,2,11,8,18,27,15,14,19,25,11,3,3,14,8,13,7,7,8,38,8,45,10,15,3,216,76,6,2,4,13,15,32,20,11,14,3,11,14,17,12,7,4,8,8,7,15,7,37,20,24,8,2,6,8,5,10,22,17,9,14,5,8,4,6,27,14,27,15,22,9,6,16,2,5,14,31,8,4,3,1,9,17,18,2,11,9,18,6,29,22,41,57,9,12,17,23,6,18,36,7,14,4,7,2,12,13,12,5,3,7,6,34,10,50,9,13,6,6,36,28,5,12,11,5,3,18,0,4,15,7,20,11,10,5,14,14,17,8,14,18,11,11,6,11,8,9,11,7,32,1,5,5,7,26,11,4,3,9,5,12,3,5,27,4,16,6,7,2,3,4,7,0,13,3,5,4,12,17,7,12,5,5,9,13,12,5,8,15,14,5,5,3,18,7,10,8,2,17,14,8,3,9,6,9,4,8,5,3,8,7,6,9,22,14,9,9,4,1,9,6,3,8,22,7,18,46,32,4,1,12,4,3,3,5,2,5,4,19,7,8,8,13,4,13,9,0,2,3,3,5,1,10,8,14,16,1,13,7,5,13,5,5,9,14,4,20,17,17,5,10,14,7,20,11,22,7,16,12,14,11,8,23,11,6,29,8,11,5,8,7,11,3,4,4,3,4,7,5,5,10,9,1,56,8,2,4,11,7,5,4,0,4,6,7,3,3,11,4,0,5,7,6,6,14,6,3,14,7,6,1,3,7,8,17,3,10,3,3,4,3,38,6,2,3,14,15,1,16,12,8,4,7,5,4,7,18,6,10,1,5,1,5,17,36,13,1,5,2,4,2,4,9,6,4,12
want,13,50,30,237,14,32,8,36,9,16,10,13,25,111,15,12,18,19,27,17,7,60,68,91,25,37,28,51,26,42,15,258,224,31,83,184,83,27,27,12,21,46,6,15,65,32,41,27,311,161,60,31,25,106,82,13,80,25,58,35,21,18,3,23,53,21,249,12,17,19,37,20,18,5,176,32,81,3,136,56,70,2,16,18,260,34,50,4,40,2,19,12,14,43,71,23,29,9,63,32,21,36,36,36,22,58,10,20,25,4,37,10,40,47,65,61,4,7,76,210,52,84,50,162,9,13,3,6,3,4,40,13,28,87,55,204,5,12,17,16,10,77,46,5,12,116,16,40,30,16,85,13,33,14,10,24,66,18,23,116,19,7,21,14,14,80,15,27,40,21,23,156,39,12,26,14,140,7,12,115,36,22,34,34,9,43,44,21,35,67,15,8,23,14,7,5,49,7,13,6,44,7,8,18,33,29,4,70,30,27,137,48,40,15,35,83,11,24,24,5,5,18,8,30,69,109,44,38,13,14,20,31,51,19,47,47,43,15,19,14,95,62,25,23,26,12,19,71,79,13,16,54,33,10,15,26,9,4,9,31,5,51,25,6,10,39,29,32,51,16,178,16,42,4,7,11,42,16,14,4,132,11,6,34,12,8,39,45,28,21,2,8,30,22,2,14,53,12,14,41,28,46,2,7,18,10,32,2,42,3,9,16,51,15,59,25,29,44,19,15,64,12,52,20,126,2,22,111,7,32,19,11,16,10,7,15,38,7,11,14,11,32,1,6,10,15,49,70,26,51,12,21,7,69,25,10,13,3,18,46,22,21,15,34,8,21,43,11,40,53,7,74,17,49,12,57,14,6,35,8,77,14,67,14,37,53,3,47,46,10,31,17,33,17,40,24,51,7,18,4,30,17,8,15,10,10,8,9,28,32,7,13,13,18,12,18,8,17,7,21,6,13,32,6,8,11,2,15,12,10,25,5,3,10,16,5,6,10,28,9,23,29,6,21,13,4,49,9,42,24,48,5,21,16,57,23,11,14,23,38,15,26,57,37,7,9,64,22,15,12,83,21,8,5,15,32,26,19,28,12,12,14,7,13,25,12,24,12,2,8,119,59,8,14,30,10,12,20,10,18,14,11,3,14,12,40,8,21,12,12,14,13,6,12,31,12,7,13,1,16,4,18,13,16,6,14,30,8,22,37,12,11,8,11,12,17,11,14,62,26,15,4,3,9,22,13,3,23,17,6,45,2,7,50,12,14,46,8,12,13,32,3,32,5,22,23,27,8,37,42,26,9,28,6,13,7,15,5,12,23,15,19,24,23,14,3,12,11,11,22,25,35,27,12,37,4,6,18,24,18,26,3,13,1,6,38,12,18,4,12,30,14,4,9,25,11,23,7,10,10,27,10,7,53,8,11,11,18,25,31,22,41,37,24,8,5,13,5,19,20,18,11,8,20,6,41,14,3,5,174,36,12,10,3,4,28,49,17,6,13,8,7,9,10,9,7,0,12,11,19,24,11,28,18,28,9,8,15,4,6,3,40,23,12,27,11,16,7,3,23,9,41,23,12,3,10,17,1,23,15,8,5,8,8,18,13,32,20,6,1,11,3,8,35,18,35,23,5,13,7,7,10,1,32,12,19,13,10,11,17,9,27,15,12,5,3,20,9,30,10,13,11,11,12,12,11,26,12,7,12,15,5,1,4,3,21,14,21,5,14,9,25,4,5,31,34,26,12,12,10,14,10,15,19,4,14,17,2,26,19,8,11,24,3,12,12,17,4,8,16,10,23,9,10,12,29,2,5,3,5,5,13,14,15,17,11,16,13,26,7,16,3,11,8,4,5,9,19,1,7,4,5,2,11,5,10,20,11,13,11,13,6,18,10,15,11,14,23,20,9,7,14,1,3,8,7,6,9,8,20,53,22,4,10,4,8,11,7,3,6,5,6,11,5,7,13,7,5,21,19,4,4,7,26,5,8,1,3,15,2,8,5,3,2,15,2,9,6,12,10,17,11,16,8,11,8,4,5,10,22,10,10,16,12,9,1,1,25,6,25,10,13,9,18,25,4,3,9,9,4,11,6,7,26,4,8,6,11,6,9,7,11,7,7,6,9,12,15,9,17,5,29,4,12,18,20,29,16,54,3,7,7,11,10,6,12,10,14,24,3,8,7,2,16,6,25,12,5,5,8,22,2,21,21,5,11,16,11,16,10,4,9,8,13,12,15,17,11,15,17,11,6,11,13,2,5,20,10,10,10
assume,12,28,10,120,10,5,9,38,4,5,29,10,9,88,7,10,3,26,4,3,3,53,12,11,23,15,9,11,4,11,19,169,120,13,47,54,29,4,5,9,18,17,4,1,27,29,25,17,393,27,65,8,8,47,15,9,52,10,2,13,31,11,2,8,22,12,122,8,5,19,40,5,4,5,106,15,16,7,70,36,25,0,14,12,241,13,10,0,27,5,13,5,0,24,52,14,25,5,32,10,13,32,32,12,11,38,4,4,19,8,19,9,4,14,3,29,5,4,80,214,37,12,17,54,12,3,5,8,3,2,19,8,3,35,16,38,8,2,3,7,3,32,23,3,1,96,2,12,11,8,78,4,6,1,8,32,17,7,23,9,6,1,10,7,3,6,2,28,15,8,13,106,23,1,0,9,191,2,10,24,28,21,5,7,9,14,33,30,60,50,2,7,3,1,1,4,11,6,8,16,18,1,3,20,35,56,6,24,10,23,64,9,31,5,1,1,2,1,16,2,3,17,3,9,38,71,26,20,7,17,8,19,8,28,38,14,32,9,5,13,75,46,6,7,21,12,6,20,50,5,7,13,20,7,7,18,10,5,3,12,3,31,15,3,4,23,4,3,21,3,120,4,12,5,6,1,30,9,14,4,50,13,3,22,12,0,2,19,25,1,5,2,12,10,6,13,39,7,9,28,21,21,2,7,14,1,25,3,8,1,2,52,30,5,34,9,15,37,37,9,52,5,33,8,118,12,7,26,0,29,10,6,15,7,9,27,21,5,2,12,18,18,6,1,6,10,55,70,13,7,15,15,3,36,39,3,9,13,14,33,17,8,13,16,4,1,42,8,11,5,1,19,6,10,11,20,8,9,16,8,68,6,36,12,2,41,5,21,20,6,27,5,14,20,43,7,48,5,31,5,22,0,4,2,4,4,9,5,25,12,1,10,3,17,32,11,11,5,7,2,4,20,20,26,1,8,4,14,10,17,7,6,5,9,8,8,1,18,13,4,13,25,28,15,1,7,10,9,36,8,13,8,6,5,53,14,2,24,6,22,16,25,26,20,3,1,10,8,9,1,16,1,0,6,7,5,3,10,23,5,7,9,8,15,6,11,5,7,7,2,84,41,2,6,4,9,2,15,5,8,11,3,1,1,12,5,4,16,6,1,3,9,13,3,7,15,4,7,6,11,8,18,13,44,19,8,17,6,10,34,23,8,7,17,14,6,18,19,44,18,9,6,3,13,5,8,1,18,11,13,51,5,9,59,5,6,22,5,10,10,18,1,11,3,15,10,14,13,37,29,8,7,14,8,5,7,12,15,9,18,5,11,8,29,8,11,3,3,2,12,29,43,6,1,30,5,1,4,68,16,34,6,2,6,18,28,3,25,5,8,35,13,12,5,30,13,12,5,12,3,11,2,3,27,4,4,7,12,18,36,4,17,28,24,17,4,9,9,7,5,15,4,14,31,8,9,8,6,7,209,36,9,13,9,12,16,43,36,18,6,6,5,25,21,9,6,3,15,6,10,10,9,63,36,21,13,2,9,12,7,23,27,12,6,6,5,37,9,11,9,14,14,12,11,9,7,7,12,18,15,1,8,6,3,14,6,14,10,6,6,7,9,7,28,20,32,6,13,14,10,11,3,10,15,1,16,8,2,4,14,5,19,7,11,7,12,21,6,56,5,13,12,7,6,10,7,15,13,8,4,9,7,7,7,6,11,15,11,3,23,27,15,10,4,21,9,16,6,4,9,2,1,2,15,4,16,3,3,28,15,4,10,11,2,6,8,7,47,7,11,6,10,1,10,10,36,7,1,0,2,5,8,22,1,7,9,2,6,18,5,2,17,12,13,2,11,7,10,9,11,3,4,5,7,2,9,4,5,2,8,2,7,12,9,5,10,18,20,23,3,5,9,4,14,4,8,4,8,5,14,52,38,17,11,3,7,8,7,9,4,6,10,6,6,3,5,8,4,16,5,5,5,12,4,7,9,11,12,14,14,6,6,9,10,9,3,8,2,7,6,6,15,3,3,6,14,3,11,6,2,11,13,5,16,10,3,12,6,4,27,10,3,13,11,19,8,3,2,3,3,9,5,5,12,4,8,5,20,9,5,3,10,8,4,7,2,2,5,12,10,1,20,8,4,13,17,14,11,13,6,1,6,5,3,9,3,5,9,13,11,0,2,1,3,4,25,6,2,1,7,18,6,15,5,8,5,2,8,2,12,5,8,4,2,9,11,12,3,42,7,4,4,2,0,2,2,3,2,5,1
rapidly,0,1,0,74,6,4,3,21,3,3,7,7,10,61,7,6,5,11,3,0,5,21,5,5,10,8,8,7,5,16,7,90,91,8,22,41,19,5,15,9,17,2,3,2,25,4,12,8,117,10,23,1,10,24,2,3,26,28,1,18,14,4,1,7,22,7,76,1,1,5,24,5,4,1,62,12,12,6,61,16,97,2,16,6,117,19,24,3,20,3,6,5,1,16,42,26,12,6,25,8,9,33,15,7,17,16,7,4,14,5,12,7,10,16,3,27,2,5,38,71,37,8,11,75,8,0,13,1,7,3,19,1,1,39,9,34,0,2,3,6,3,14,19,8,4,44,2,20,20,9,35,2,9,10,4,20,17,5,3,8,6,12,4,0,4,7,1,7,13,7,21,44,11,8,3,4,67,4,4,34,11,8,8,10,9,7,21,16,11,27,0,6,3,2,2,5,9,6,8,5,9,1,1,3,20,4,13,31,2,24,39,7,13,5,0,0,1,2,8,3,2,13,5,9,23,45,21,20,8,14,14,19,18,15,28,23,23,7,15,5,43,21,4,0,9,8,3,7,29,6,5,16,12,13,5,9,6,6,2,18,3,26,11,2,6,40,5,4,10,6,76,5,25,4,3,5,16,19,3,1,40,1,4,5,6,8,9,18,6,1,2,1,4,6,4,6,22,0,1,3,6,12,3,8,5,1,17,1,8,1,6,24,26,7,43,19,8,19,10,5,15,5,16,5,16,1,8,14,2,8,1,10,2,3,5,10,10,4,1,14,8,4,10,6,1,6,25,30,6,3,4,6,1,30,10,10,2,7,14,33,9,19,25,18,4,1,3,3,5,11,3,10,4,5,7,24,4,2,8,3,40,0,35,6,6,36,4,16,11,6,6,6,3,2,16,8,25,6,13,9,14,1,9,1,5,12,5,3,13,10,0,9,3,10,0,6,1,5,2,3,1,4,8,6,0,3,4,1,8,8,9,7,2,7,0,0,1,1,8,5,4,14,3,19,4,1,16,3,19,9,10,1,14,4,31,0,0,3,4,15,10,13,19,26,4,8,10,11,6,2,9,4,1,6,2,8,9,2,25,11,6,22,3,2,6,4,8,2,4,1,47,20,1,2,9,5,6,10,8,4,12,4,3,2,5,12,13,5,2,9,4,0,14,6,12,10,7,8,1,2,3,6,3,4,6,0,10,6,6,13,1,1,1,5,8,5,2,8,33,24,0,0,0,9,10,10,3,13,14,3,12,1,2,24,10,3,27,6,3,3,12,3,10,5,10,8,7,2,16,20,7,6,7,1,8,2,2,3,10,14,9,6,10,4,6,2,4,5,5,9,10,12,4,6,7,7,5,1,8,7,10,5,6,0,3,11,2,9,7,2,16,4,2,6,11,5,8,1,5,11,14,3,10,12,6,5,5,18,7,18,13,13,16,11,8,0,10,6,2,5,2,2,2,13,6,18,0,2,6,62,6,1,8,0,4,6,14,3,1,7,6,7,2,4,3,4,0,3,11,4,10,3,4,2,11,4,5,1,3,11,3,17,8,8,5,11,6,3,5,12,2,2,4,13,5,15,7,0,7,5,5,1,1,3,8,8,7,6,4,3,3,6,2,18,6,10,5,5,4,5,3,2,0,9,1,5,10,2,1,10,3,7,9,6,1,4,18,13,25,23,13,2,11,10,8,5,8,7,10,7,6,1,10,16,9,12,3,9,3,16,15,15,3,5,22,14,7,6,11,8,3,7,4,11,4,6,7,1,16,5,7,7,7,2,7,2,9,3,6,1,4,7,4,5,16,18,5,5,5,1,2,1,5,1,1,3,7,4,7,4,1,1,0,8,3,3,3,3,2,5,1,6,2,6,6,0,3,7,8,5,5,2,7,1,5,7,4,16,8,2,2,3,3,0,8,10,9,0,3,6,5,10,2,5,3,5,2,2,4,3,3,0,0,7,5,3,2,0,3,17,4,3,21,11,1,3,0,1,6,5,0,3,3,2,8,1,7,4,2,6,0,6,1,0,2,0,3,3,5,1,7,0,2,4,1,2,0,11,1,6,1,5,3,15,11,2,4,7,8,2,2,0,3,1,5,5,0,0,3,5,1,3,2,8,3,5,10,6,2,11,1,16,5,8,3,12,6,8,24,2,0,0,1,7,4,4,15,3,9,4,4,6,2,0,7,0,5,4,2,6,3,2,10,4,0,3,4,8,2,1,12,2,3,10,2,11,2,12,1,0,4,2,5,1,0,4,2,1,2,2
along,6,16,4,72,7,7,10,14,4,3,11,5,15,52,4,3,6,17,5,4,2,26,12,20,12,13,19,16,10,25,8,125,74,12,41,42,26,4,4,5,6,7,3,6,19,5,17,11,174,36,29,7,12,44,25,4,18,22,10,12,10,6,1,11,13,10,58,3,4,80,7,7,8,2,73,23,27,0,34,26,36,1,12,5,132,10,8,0,16,2,11,9,6,13,30,3,12,3,22,6,14,31,13,12,5,14,3,3,13,1,20,3,10,7,4,18,1,4,31,108,28,25,13,40,8,4,4,3,1,1,12,4,4,42,11,62,4,0,9,8,6,29,16,5,5,47,9,14,11,6,44,4,3,8,4,16,25,5,11,26,8,6,5,2,3,17,8,23,23,12,15,68,27,11,13,3,64,4,5,35,21,14,11,16,9,21,18,19,25,37,3,2,9,2,3,9,22,4,4,8,12,1,1,3,25,8,2,15,13,22,45,15,23,6,5,12,5,4,8,3,0,14,3,16,23,50,16,18,6,0,11,15,10,16,26,6,17,8,14,8,26,21,10,12,14,7,4,30,25,1,15,13,15,5,5,9,1,0,1,8,1,26,13,3,4,16,2,13,21,6,87,2,4,6,1,1,17,3,6,2,45,8,9,15,9,3,11,15,9,6,2,6,11,2,4,9,17,5,6,11,16,16,1,2,11,3,19,3,8,4,2,25,16,7,9,6,14,25,13,2,18,2,19,5,27,6,14,12,4,22,5,3,6,5,5,4,16,6,2,2,6,11,15,10,6,1,27,53,9,9,4,3,6,26,16,4,2,4,6,20,21,18,32,18,3,2,19,4,12,14,2,21,1,12,7,12,9,4,14,3,31,1,41,7,4,25,4,11,18,2,13,7,10,4,16,14,19,7,31,4,8,8,8,7,6,9,11,1,24,15,5,13,1,14,0,10,4,18,2,12,5,4,12,13,4,4,0,5,6,7,4,2,1,9,6,1,1,8,8,1,14,27,8,7,7,10,21,7,17,8,17,2,9,9,52,2,4,4,5,14,13,9,14,23,7,7,14,8,16,2,35,6,6,3,1,18,3,13,19,8,12,5,2,1,5,1,3,7,8,2,61,19,6,3,6,6,6,4,5,7,15,2,0,4,0,5,11,4,3,4,1,3,5,7,7,6,3,5,1,7,7,19,4,14,2,5,14,14,6,13,2,3,14,8,3,8,7,10,35,8,6,0,6,10,7,3,4,11,8,6,8,1,0,21,7,12,49,7,4,6,11,6,16,3,2,2,6,3,10,19,10,2,5,2,9,8,4,9,3,10,3,15,8,16,3,6,14,6,2,8,8,20,5,6,13,5,6,4,26,12,7,1,3,0,3,11,4,6,7,7,19,19,7,6,11,4,9,1,5,0,3,1,3,9,2,1,7,6,4,30,3,10,8,12,7,3,8,6,2,12,4,1,6,11,4,22,2,6,9,105,16,14,5,1,6,5,22,13,7,11,2,11,7,15,4,2,1,7,9,11,11,9,62,6,7,11,1,3,8,3,18,27,3,12,9,3,6,8,8,56,16,11,8,34,3,8,6,1,7,2,15,5,0,3,5,6,11,5,3,2,3,1,4,12,12,18,19,1,4,7,8,6,5,13,1,16,7,4,1,13,8,11,1,6,2,11,14,3,37,3,7,15,13,9,11,7,4,16,0,2,7,2,1,4,1,10,3,12,7,1,0,8,2,2,30,6,10,2,12,13,5,15,0,8,3,8,1,6,22,14,7,1,8,1,4,2,8,19,0,8,4,4,12,1,33,15,3,2,1,0,4,9,5,0,9,5,1,2,7,9,2,3,8,2,1,4,5,7,8,5,2,5,6,7,10,10,5,6,3,3,4,16,2,7,4,0,4,12,7,2,2,4,3,1,5,0,3,11,1,13,10,12,3,6,12,2,4,1,0,4,2,2,3,4,0,4,7,4,4,9,0,7,1,1,0,2,1,4,7,3,2,4,7,2,8,3,1,4,25,4,7,38,0,0,0,1,14,2,4,7,7,0,6,6,0,2,1,6,1,20,4,5,2,2,5,2,1,12,7,5,9,5,3,0,1,3,4,4,2,3,6,3,2,2,1,0,6,2,3,6,1,6,1,3,1,3,0,5,7,1,6,7,3,6,4,2,10,21,8,0,0,32,0,0,3,11,11,2,3,20,16,1,4,7,0,12,6,3,9,7,6,4,1,2,4,8,9,9,4,6,0,4,1,3,1,2,3,3,1,4
exist,19,83,41,521,35,15,16,163,16,18,93,30,12,186,23,30,27,38,13,10,17,175,27,71,72,32,34,38,17,74,36,536,510,45,180,146,146,27,49,12,24,25,25,10,113,85,122,53,1237,45,183,10,43,102,25,23,259,88,1,45,119,22,8,39,94,17,351,24,59,46,63,9,14,12,253,47,52,25,296,71,174,9,58,17,886,65,46,1,118,15,23,22,4,118,230,54,49,14,133,67,34,105,127,56,40,120,22,12,42,14,60,26,23,56,10,123,21,17,257,562,152,50,42,233,30,10,15,14,15,9,35,6,22,155,78,107,34,14,15,26,10,129,141,9,16,177,27,53,48,54,274,9,61,24,12,110,101,16,56,32,38,12,20,13,22,20,18,66,84,50,67,282,76,5,10,34,651,6,48,109,73,55,35,71,4,63,106,88,155,220,6,24,17,2,6,14,74,24,29,49,113,8,14,41,112,35,19,141,43,110,246,16,99,24,5,10,4,10,50,7,19,52,23,49,177,560,100,91,14,64,33,46,78,94,122,114,103,31,41,26,264,139,19,25,51,32,23,49,203,32,42,80,72,32,41,50,46,12,21,64,15,75,92,22,24,163,9,16,45,22,532,39,106,32,17,1,62,64,58,10,164,33,8,58,46,6,24,25,68,3,16,6,64,28,13,41,133,30,23,73,125,131,16,10,57,6,63,20,18,11,17,61,100,25,102,63,45,146,51,34,152,20,105,23,228,24,33,90,9,116,27,43,45,26,35,53,72,37,18,43,34,37,49,55,25,27,1,218,65,30,48,47,24,98,86,23,22,17,60,101,106,38,38,90,17,3,142,27,31,51,18,66,14,37,28,130,24,16,48,28,263,12,174,60,7,99,34,85,115,15,102,16,44,35,129,54,266,25,110,22,101,11,17,4,20,30,36,16,126,43,13,46,25,53,62,39,11,34,8,9,21,26,65,59,7,13,14,50,45,58,73,24,14,40,6,17,5,58,32,15,57,89,27,55,8,12,23,44,178,37,56,24,11,25,170,42,7,55,28,147,32,84,99,74,17,7,54,40,23,3,37,10,13,8,6,38,25,68,78,14,38,35,13,16,24,32,38,14,19,20,284,172,5,19,38,32,10,70,47,60,38,13,13,0,34,113,15,74,22,17,21,33,24,47,57,89,21,36,55,27,27,56,42,98,45,15,124,42,60,106,53,29,16,33,39,17,51,22,131,68,17,8,13,17,41,26,28,83,70,29,199,19,46,189,31,51,106,22,21,37,102,23,108,12,63,77,56,25,119,120,44,40,59,22,21,16,60,19,23,62,31,50,32,68,36,19,23,30,18,34,96,122,33,21,79,18,9,11,169,78,89,12,44,18,35,93,17,107,25,23,116,68,46,30,117,44,90,21,40,32,55,40,26,108,15,31,26,46,31,112,69,99,94,96,39,20,36,33,13,41,43,9,29,73,31,120,18,13,36,645,75,23,33,22,23,44,149,86,26,72,28,43,53,79,25,10,13,32,65,28,71,37,196,103,94,42,13,27,17,24,19,72,69,33,49,44,58,19,13,36,57,32,61,56,24,25,40,12,61,64,39,22,36,28,45,22,61,20,26,21,25,35,46,97,84,65,21,24,25,29,29,29,55,86,12,26,29,5,20,48,30,48,26,24,18,6,78,19,147,47,34,19,10,39,38,19,63,26,27,22,47,30,27,51,27,43,38,68,25,75,83,48,9,21,83,71,41,23,26,42,24,18,8,69,19,48,30,19,44,55,23,20,51,20,49,26,27,127,24,53,24,46,15,30,46,81,22,31,13,23,15,14,55,28,6,11,27,18,54,26,38,9,44,31,14,21,15,21,21,44,26,16,20,29,14,22,11,24,32,22,34,28,55,11,32,40,44,110,44,19,24,39,25,36,16,51,29,17,21,44,81,105,37,28,11,22,29,19,22,7,28,31,24,7,32,46,23,21,35,55,23,21,50,65,17,29,17,72,38,22,7,27,22,38,31,27,20,24,21,27,12,34,1,19,30,13,17,26,9,9,32,19,14,49,38,18,18,46,14,66,31,37,27,29,65,14,12,26,18,17,38,49,28,40,25,37,19,71,20,35,32,18,38,40,19,20,24,24,15,43,23,35,32,16,38,64,44,78,160,8,12,27,15,30,13,15,14,14,77,36,21,20,11,18,8,80,18,28,21,15,16,26,29,11,18,35,8,47,40,29,14,24,18,43,26,20,31,19,94,10,4,12,15,3,8,15,3,19,10,9
part,29,102,34,576,45,28,53,187,20,19,120,55,47,309,28,27,41,62,27,21,24,172,54,127,103,64,69,87,37,85,52,803,638,51,211,293,240,37,47,20,28,54,21,15,147,94,116,46,1640,145,227,32,52,217,33,30,291,102,23,65,101,41,17,55,77,30,415,29,51,97,35,43,15,23,331,62,77,19,358,110,195,6,86,33,952,64,66,4,167,9,38,27,7,153,244,36,70,18,172,59,76,130,139,55,45,129,25,24,49,26,72,33,29,70,22,143,25,26,314,703,161,89,58,246,29,26,24,28,20,6,67,26,32,220,93,212,47,19,39,40,17,185,147,12,17,337,34,65,66,52,303,9,77,29,17,95,123,22,85,70,51,26,29,11,14,39,25,103,97,46,81,418,87,13,33,41,706,15,63,149,90,57,44,90,31,82,143,119,181,286,14,36,39,5,10,25,71,19,31,71,89,10,2,69,138,44,30,126,60,123,317,33,129,45,9,24,9,17,60,26,18,89,27,58,163,402,113,103,22,25,88,50,66,94,159,87,143,34,47,35,276,118,28,29,86,17,18,97,181,25,46,114,77,21,45,80,48,5,29,62,16,115,80,24,23,142,32,36,90,27,564,45,130,29,18,10,100,48,60,18,328,28,12,76,51,9,36,45,71,19,24,44,48,35,12,53,213,35,43,91,125,118,9,18,56,10,111,20,36,11,17,72,129,33,139,60,75,210,61,20,232,40,121,30,287,33,26,134,28,121,24,48,50,21,29,58,97,40,11,49,47,51,70,70,30,53,218,1,75,34,63,53,23,140,110,17,35,32,60,106,78,41,43,98,25,14,164,37,40,57,11,77,32,64,32,71,41,18,96,25,299,13,181,59,18,141,27,94,120,9,105,21,55,90,159,48,262,19,141,18,122,20,35,16,26,31,29,26,95,63,16,76,23,63,66,58,48,48,23,20,24,40,73,76,10,24,15,75,51,78,56,26,11,50,27,27,5,105,56,29,70,83,32,77,14,23,61,41,141,32,69,44,15,33,300,34,14,58,46,130,52,90,118,102,23,19,91,77,55,8,70,18,17,15,14,76,16,75,67,35,28,81,25,29,45,46,40,34,27,16,368,149,14,25,33,37,13,69,41,52,91,22,18,8,40,66,19,46,30,20,14,31,42,41,48,76,22,44,15,39,25,75,26,91,18,34,115,24,82,126,37,20,28,35,54,25,49,52,181,65,26,12,6,27,39,49,23,65,63,31,159,36,24,207,30,43,136,16,30,38,140,17,107,16,70,56,32,29,146,147,52,36,80,31,44,59,33,34,26,107,44,62,53,78,54,36,40,35,24,52,93,149,47,21,74,25,16,28,338,99,91,8,26,61,44,97,28,131,43,37,136,87,83,29,104,40,99,33,34,24,50,29,18,77,10,39,36,46,65,114,38,96,128,111,38,10,42,42,23,54,34,12,47,83,57,107,22,25,27,1035,111,37,44,33,41,61,166,89,48,79,28,57,117,149,56,55,22,53,57,49,90,45,333,98,153,21,15,34,21,40,53,131,64,43,51,37,76,27,19,69,89,53,71,60,33,41,53,43,67,71,36,24,34,29,33,29,91,31,14,32,22,37,35,152,90,119,43,42,62,40,43,33,50,110,16,70,46,7,7,62,39,71,14,32,34,29,75,23,215,41,52,42,25,46,64,18,67,41,25,29,49,25,12,48,15,52,38,36,24,58,59,46,19,16,118,58,48,44,28,53,38,39,10,69,20,57,18,17,55,54,28,26,65,26,48,47,28,187,32,51,34,59,28,31,27,66,16,31,18,29,18,26,52,26,35,18,43,36,70,36,28,41,87,46,22,33,26,55,32,49,47,23,52,39,48,37,24,39,30,27,39,34,41,29,33,36,46,129,37,45,53,37,15,35,35,41,29,38,23,48,116,112,53,29,16,21,28,6,37,13,57,28,34,26,19,45,35,21,34,51,14,41,42,26,38,37,40,81,72,57,25,38,19,25,94,17,29,30,32,45,15,100,22,31,37,36,33,26,23,24,35,36,20,36,45,30,31,44,18,107,20,13,25,36,42,22,22,56,21,20,47,41,25,77,18,39,22,100,31,15,37,19,43,36,23,18,17,32,24,53,18,57,30,18,16,57,32,46,93,31,25,21,14,13,36,28,24,27,65,53,17,40,19,17,4,111,26,12,17,39,49,35,38,44,41,35,13,37,41,34,15,26,27,22,27,13,32,23,150,18,16,21,23,9,6,15,11,36,16,22
aid,3,20,10,214,12,11,9,42,10,5,25,10,23,100,12,15,14,19,9,14,14,58,20,30,44,32,19,24,10,30,21,205,165,26,77,102,63,16,19,10,11,18,8,17,43,34,55,35,410,55,78,5,28,81,30,11,84,30,9,22,15,8,2,13,30,4,168,8,12,23,69,9,9,5,152,22,29,7,115,36,93,0,20,14,349,38,27,1,36,5,16,11,2,50,80,11,33,13,72,27,67,43,49,15,21,58,7,5,29,8,20,9,14,21,6,50,5,6,81,202,57,28,19,104,18,7,6,7,9,5,25,10,15,91,34,122,17,4,8,13,12,50,42,10,4,94,13,25,22,17,89,4,39,12,11,65,35,9,17,61,22,5,20,11,31,9,9,43,49,22,29,106,33,5,11,18,205,2,21,96,33,27,53,33,25,40,41,30,40,58,2,6,17,3,1,1,24,5,18,21,52,3,6,17,45,18,14,37,25,46,141,12,25,11,7,6,7,13,20,10,5,22,6,25,69,160,42,26,3,19,28,10,25,24,60,28,41,25,17,14,106,40,9,9,26,22,11,27,77,18,18,41,30,14,16,22,12,12,5,23,6,46,29,8,16,72,35,20,29,12,203,27,49,10,5,1,39,37,11,4,99,18,16,36,24,11,18,16,16,2,4,8,29,18,13,19,67,10,10,25,21,48,2,9,20,4,23,6,15,4,23,29,48,19,52,28,31,68,20,15,73,9,51,27,86,11,21,40,7,23,19,24,10,10,11,59,39,14,16,18,21,26,26,13,6,9,65,75,1,27,21,23,7,58,28,9,9,8,35,68,34,16,29,24,17,5,48,6,16,27,9,45,17,38,6,50,9,8,22,17,101,5,77,13,9,64,6,15,42,7,35,12,21,3,47,14,100,4,43,4,27,14,5,6,9,9,12,5,53,31,3,15,11,40,35,22,10,16,5,14,6,13,31,22,4,6,9,21,8,23,20,10,3,12,11,3,2,17,26,15,28,31,19,30,3,8,31,17,49,16,25,8,17,10,53,17,6,8,10,30,18,31,46,33,17,14,30,19,19,1,35,10,8,0,13,19,4,19,35,12,6,27,10,11,14,12,28,7,7,10,106,70,4,8,20,8,8,28,11,18,9,13,14,6,14,62,16,13,5,11,3,12,3,14,29,33,12,15,6,11,10,15,12,33,11,5,51,36,36,39,19,7,3,16,20,11,20,18,56,29,9,5,4,29,20,6,12,42,14,20,43,18,8,88,14,8,65,7,21,17,31,4,27,7,23,24,21,11,61,59,23,25,17,13,16,7,5,8,7,45,14,38,21,26,18,19,9,6,10,20,26,65,10,9,42,14,9,4,22,28,30,10,7,0,12,40,18,40,7,14,29,24,18,4,56,16,25,2,15,9,23,17,13,38,7,13,18,15,29,50,19,33,38,43,14,2,20,18,6,30,7,2,15,40,13,48,13,2,12,202,58,11,12,10,7,17,52,27,10,17,11,4,4,9,5,6,1,8,12,17,38,15,60,24,42,13,6,19,4,9,17,41,16,8,15,10,25,12,1,17,16,26,17,44,13,19,14,4,19,29,22,5,5,9,16,9,29,15,5,10,7,15,7,48,31,33,16,14,10,13,14,8,10,38,6,10,16,6,7,9,19,25,12,12,11,7,39,10,59,19,22,7,15,15,16,3,28,36,9,12,29,15,7,22,17,23,16,21,12,27,23,16,2,10,27,16,19,11,37,13,10,7,3,19,8,19,32,10,33,18,11,9,12,11,12,9,12,9,9,21,6,13,6,10,17,23,28,7,5,16,3,5,16,10,9,5,16,10,31,12,3,16,6,15,22,5,13,12,13,12,7,11,14,14,9,7,13,10,11,7,17,13,27,9,5,14,16,40,17,13,9,11,7,13,3,8,26,6,16,18,33,49,15,7,8,8,11,12,11,0,6,9,8,9,8,13,10,7,18,22,26,13,19,20,15,15,7,9,9,11,3,6,6,2,6,6,10,10,8,21,10,12,7,5,8,7,9,11,9,19,14,11,9,18,5,3,9,22,1,24,16,33,6,14,12,7,10,15,3,4,18,6,10,5,3,14,1,13,4,10,16,6,12,10,8,8,15,9,9,28,5,11,24,11,16,21,18,20,53,5,6,6,15,16,16,5,7,13,31,8,24,3,12,3,6,15,14,12,3,11,12,12,21,9,5,6,18,13,14,6,8,13,6,9,9,5,12,20,20,3,13,23,5,7,13,4,2,8,3,7
family,19,25,18,114,17,24,2,19,6,9,10,18,31,89,4,10,25,22,21,15,2,29,105,80,16,73,32,52,19,39,9,217,119,35,65,143,41,15,24,6,24,28,8,34,31,8,38,21,167,135,33,15,30,58,189,6,21,6,68,15,19,4,4,11,41,37,105,12,13,21,97,0,8,11,136,16,87,6,114,41,55,8,8,14,121,25,4,10,28,3,10,14,19,40,27,14,29,1,32,22,12,20,17,32,29,32,17,52,26,15,35,13,37,32,67,61,3,2,50,118,29,99,132,164,15,18,6,3,3,18,33,14,49,68,47,256,9,12,8,10,13,38,35,7,3,115,21,29,12,6,32,21,19,7,6,49,52,11,9,126,43,11,30,3,19,79,14,15,37,14,18,145,45,10,19,8,77,5,7,112,34,15,42,31,1,35,34,25,22,55,6,5,8,16,20,12,31,6,27,17,40,14,12,9,14,30,7,24,17,28,130,33,52,52,28,92,24,41,19,0,8,21,4,13,39,80,30,39,12,20,15,31,42,16,60,5,23,12,4,12,61,28,23,13,13,19,4,54,70,14,12,19,37,1,2,25,2,7,1,32,18,43,7,3,4,35,33,39,14,4,74,15,12,13,2,11,34,1,3,1,130,2,11,24,12,12,79,86,17,16,0,16,26,12,9,4,37,7,4,27,31,17,3,9,19,8,25,5,38,2,4,11,45,40,95,10,37,21,26,5,38,5,38,37,69,4,31,85,3,18,12,7,11,5,7,15,17,8,5,5,5,17,51,7,3,9,30,34,27,1,9,9,4,51,15,6,19,1,7,37,29,15,9,18,2,13,19,14,32,54,7,79,7,68,18,33,1,11,19,7,19,2,22,16,47,68,6,25,53,12,14,9,27,3,18,16,21,1,23,4,20,21,10,7,3,8,13,2,10,19,9,5,2,20,1,13,6,4,6,13,2,12,13,5,9,2,1,3,9,18,1,1,1,16,12,7,4,7,16,2,19,9,4,10,3,2,32,13,24,17,30,1,24,8,27,3,16,8,6,6,17,38,29,33,7,2,83,10,7,22,75,19,6,16,4,20,8,4,17,13,5,15,2,9,8,4,5,18,0,0,41,31,15,21,17,4,3,9,6,2,4,3,7,38,16,17,32,6,8,9,3,4,7,6,10,7,17,6,3,13,9,5,4,13,2,6,19,2,7,19,11,12,6,3,12,8,3,6,36,20,2,3,5,15,14,4,2,33,6,2,11,1,3,55,2,4,7,3,6,4,5,3,10,5,7,4,10,2,9,24,9,1,3,0,2,0,10,4,7,30,7,11,8,21,5,3,6,5,2,12,10,12,28,8,37,2,13,25,16,10,11,6,13,1,5,5,6,13,3,2,29,5,7,7,15,2,4,2,2,0,9,0,4,15,9,4,0,5,2,21,2,9,19,11,9,4,12,6,19,4,14,8,5,8,2,12,22,8,16,83,5,5,3,5,2,12,13,22,10,4,10,4,5,5,2,2,1,16,2,3,14,1,25,6,9,3,3,5,2,1,3,12,2,4,6,6,9,9,2,3,9,42,7,1,10,8,5,4,5,6,4,1,3,4,3,9,15,9,2,2,7,3,3,13,12,8,12,3,4,5,8,4,2,15,1,7,17,19,1,7,1,11,13,5,7,0,11,1,11,10,13,3,8,5,2,2,12,15,9,11,6,0,0,5,5,13,4,5,6,15,15,28,4,11,24,44,24,3,8,10,14,2,22,19,2,17,29,2,17,6,9,1,6,0,17,7,5,14,3,8,17,7,4,3,6,19,3,2,3,1,1,7,7,5,12,5,3,4,6,3,2,0,0,2,1,1,4,17,0,6,3,2,14,3,5,1,27,2,4,4,9,0,9,8,4,4,5,15,2,5,1,4,2,4,5,2,7,5,1,9,12,7,7,2,2,7,7,10,1,6,2,10,6,2,2,7,8,1,6,7,6,0,6,0,3,4,0,2,7,3,2,3,2,3,2,1,9,6,9,4,19,4,52,5,3,6,4,7,5,16,14,0,11,3,10,1,1,0,0,18,7,13,3,8,5,1,2,2,7,10,1,3,2,2,1,4,3,10,4,9,5,9,2,8,2,2,3,5,5,5,0,15,3,0,9,20,9,9,2,1,1,19,10,0,5,1,1,3,7,3,19,4,0,22,7,3,2,7,7,1,2,2,12,22,2,4,13,0,5,4,0,2,2,2,6,3,5,28,4,41,2,8,1,15,28,41,25,3,8,16
apply,9,45,13,191,2,5,5,42,1,4,13,7,10,55,5,29,6,32,3,3,6,45,12,24,19,10,18,10,5,13,5,217,136,13,57,45,33,24,12,10,19,10,4,8,30,18,29,27,314,19,50,4,18,33,10,7,73,30,1,17,19,14,6,16,24,5,97,7,8,11,21,7,5,10,107,7,8,5,80,19,68,2,17,4,219,43,22,1,48,7,9,4,5,46,96,23,25,7,32,21,8,44,53,14,10,28,31,11,17,6,27,9,12,22,0,51,5,4,97,193,41,19,47,102,9,5,3,4,7,4,10,1,6,58,18,42,11,2,10,3,3,27,27,4,5,47,4,15,21,32,96,1,14,9,2,51,28,5,3,10,20,3,9,12,5,9,1,20,22,13,27,88,20,4,4,10,196,9,20,49,22,16,8,15,7,28,36,40,40,38,0,5,9,1,3,5,18,5,10,20,38,3,5,11,16,11,5,41,12,31,60,5,38,12,1,1,6,13,19,4,25,20,8,19,54,170,41,26,11,10,19,32,38,23,55,85,36,8,13,6,86,33,1,7,18,13,9,13,51,3,15,37,16,22,20,24,8,2,10,18,15,33,22,10,9,63,4,1,16,11,202,52,94,15,2,1,15,57,12,5,55,8,8,27,8,3,7,9,15,4,3,5,19,11,13,12,44,3,19,26,29,43,1,8,15,6,21,7,6,1,1,20,33,6,62,36,29,52,18,8,47,10,27,4,65,11,13,16,1,21,1,10,8,12,10,27,13,12,6,11,12,11,12,15,4,4,48,63,21,9,1,17,7,53,13,17,9,6,20,47,36,13,9,35,5,0,54,8,7,11,6,20,12,13,9,40,8,5,14,10,101,4,63,10,5,39,4,22,42,2,32,4,17,10,38,9,59,9,37,6,20,1,5,0,4,8,9,2,32,13,3,9,9,18,22,14,4,4,2,3,4,7,16,17,6,4,1,13,9,20,20,29,18,19,2,7,1,9,11,8,28,26,6,7,1,1,4,2,39,20,19,13,4,5,58,30,3,14,5,36,14,22,28,32,4,12,15,18,17,2,21,4,3,3,10,27,3,18,18,10,6,15,6,8,4,12,20,2,6,10,62,61,3,2,9,3,2,31,5,20,23,4,5,7,4,32,7,24,9,3,9,30,11,18,16,15,7,10,6,10,1,23,9,37,16,5,17,12,24,27,16,9,3,10,15,5,19,3,45,28,4,3,1,13,6,8,4,19,19,7,50,4,26,75,6,12,37,6,10,11,24,11,36,6,22,22,21,16,51,47,15,7,41,6,9,6,17,5,11,27,11,17,10,17,13,11,12,8,3,13,52,44,8,5,36,2,6,6,48,26,23,1,7,4,9,28,16,25,14,15,36,18,7,11,52,11,61,5,10,7,12,6,4,20,2,15,4,18,18,31,9,22,34,23,8,7,12,12,7,23,11,5,19,20,9,38,10,3,10,138,19,7,6,10,13,9,53,20,5,11,8,14,16,14,11,6,5,9,11,16,17,13,52,67,33,12,9,9,4,13,8,24,16,9,7,23,28,3,4,11,18,8,18,10,8,12,12,8,24,22,4,12,3,7,16,2,17,5,6,3,4,15,8,32,20,26,2,10,6,12,14,6,1,26,5,10,13,10,17,15,6,20,11,7,12,7,30,1,43,6,13,5,2,9,15,3,14,10,6,22,10,27,20,59,39,18,9,16,7,42,41,18,10,11,25,17,12,13,14,7,7,9,3,15,4,14,7,4,6,15,3,7,16,3,9,10,10,2,9,12,5,21,11,6,15,24,4,12,7,16,2,7,23,5,3,5,9,7,26,4,21,2,18,14,3,9,4,8,4,22,4,3,4,8,5,7,6,8,6,5,25,15,12,1,4,11,7,17,20,4,8,8,9,18,8,15,11,7,5,6,40,31,10,14,1,5,4,9,7,3,5,12,4,2,9,17,4,2,8,16,6,11,32,16,4,10,2,9,10,6,1,9,7,2,4,6,5,4,5,4,3,14,1,6,10,8,2,2,2,1,9,4,8,7,6,3,2,9,13,27,10,9,9,45,10,7,5,13,6,5,6,5,9,15,9,10,2,5,3,11,2,2,9,8,13,14,10,8,9,32,8,14,37,56,46,48,42,56,105,7,2,6,4,2,17,26,2,7,29,7,13,6,12,4,3,22,6,6,7,9,6,5,9,2,1,4,2,9,9,6,13,9,9,6,8,16,17,4,18,2,2,1,7,2,0,12,2,4,2,1
trust,3,30,15,150,19,8,10,40,6,7,10,13,5,62,6,18,20,29,16,8,4,56,31,28,42,11,13,17,9,20,4,213,133,16,55,108,41,10,22,8,11,20,3,12,35,19,30,19,299,36,40,11,17,59,14,3,73,14,14,15,14,2,5,19,31,11,158,11,8,14,22,5,8,5,107,16,22,8,63,41,30,1,14,12,202,24,5,2,31,1,3,6,0,24,64,4,23,5,48,9,5,40,47,17,12,32,10,5,15,11,19,6,10,16,6,29,8,5,79,154,41,28,10,64,3,9,3,6,11,2,31,4,5,65,21,47,5,3,3,16,4,34,25,3,2,61,12,14,21,12,92,3,22,9,4,47,40,9,20,25,11,2,16,0,10,11,5,28,27,15,12,94,29,2,8,8,167,11,15,31,33,12,14,19,4,32,38,19,61,65,6,6,10,4,3,5,17,8,8,15,65,12,9,17,26,14,2,46,21,23,94,8,27,4,3,7,8,13,26,1,10,19,3,12,41,121,23,25,2,11,8,13,19,31,29,14,27,11,8,10,85,33,7,4,17,12,9,29,34,16,8,12,26,12,13,18,13,5,8,21,1,15,24,1,9,16,6,16,23,4,146,67,27,9,7,5,17,18,10,6,76,11,3,28,4,4,13,14,21,1,4,8,13,10,5,6,34,7,4,14,26,36,7,4,12,17,13,6,6,2,2,13,36,11,30,19,24,32,26,3,49,13,27,4,57,12,3,35,3,38,8,9,14,6,6,26,21,7,6,14,12,19,21,15,6,3,47,53,23,9,17,1,6,43,17,9,9,9,21,31,51,8,11,15,14,3,22,8,11,29,8,28,6,16,22,15,9,4,19,7,65,6,34,14,9,24,8,18,32,6,25,7,8,15,34,15,76,9,22,3,35,5,3,2,8,9,7,3,35,16,2,11,3,11,7,15,9,5,3,8,5,6,29,29,7,5,1,14,5,17,12,4,3,9,7,3,2,19,12,4,15,21,9,6,2,4,21,17,19,13,40,2,10,6,59,13,10,23,11,25,22,30,38,31,3,7,21,12,3,1,24,7,5,11,0,8,8,10,10,4,9,12,4,5,12,22,9,11,4,2,35,37,8,14,9,3,1,12,9,32,7,3,3,10,34,39,0,16,6,6,3,12,8,13,18,26,7,21,54,14,1,24,18,35,10,6,30,31,14,25,16,14,4,11,14,9,17,10,30,17,6,5,5,3,8,13,1,28,12,7,59,10,26,37,3,10,39,5,17,5,26,4,29,5,18,17,22,9,42,49,10,10,17,7,15,15,28,9,5,24,17,18,17,16,15,7,6,8,3,10,23,65,13,6,16,0,20,4,43,15,21,7,6,2,7,24,3,25,6,3,28,13,27,6,34,9,32,20,12,7,14,3,4,24,1,4,6,9,23,26,15,24,32,28,16,7,12,9,12,15,9,3,10,18,8,16,4,9,16,147,16,3,8,7,7,15,38,21,1,24,10,3,27,15,10,6,5,11,14,10,8,10,16,53,26,4,9,9,0,7,4,21,13,8,5,14,16,11,0,4,9,24,11,13,5,9,10,4,11,17,4,7,12,5,12,3,11,5,5,3,15,9,4,28,26,5,8,10,10,11,5,5,6,17,0,1,11,4,3,10,7,13,10,6,7,8,8,2,25,7,13,4,0,1,10,9,15,3,7,7,11,5,4,3,3,14,8,7,2,6,4,14,3,7,21,11,6,10,11,16,16,2,1,21,9,13,8,8,24,14,4,6,15,12,6,5,8,6,5,16,11,17,11,8,4,15,3,8,1,9,5,3,11,4,7,4,26,11,24,6,4,4,5,5,1,5,3,8,3,12,4,6,4,12,3,3,5,8,11,7,17,4,19,3,10,7,13,28,9,7,7,14,14,35,6,5,11,9,4,18,19,35,12,7,2,7,5,16,20,1,7,4,8,10,8,10,5,4,4,14,10,6,7,9,5,8,5,8,14,5,2,2,5,14,13,2,9,6,3,6,7,7,0,1,3,2,6,2,3,7,4,5,2,19,5,5,1,16,3,17,7,3,16,6,17,4,2,2,3,3,10,14,7,11,4,14,1,13,9,7,5,2,13,7,1,1,1,5,5,6,2,18,0,13,8,11,11,14,26,6,1,10,5,7,8,8,1,2,14,16,0,5,17,7,0,10,5,3,1,7,3,5,8,4,6,12,3,8,12,4,1,13,9,8,11,4,6,6,10,2,2,4,4,3,6,5,0,7,4,7
belong,4,21,15,69,6,1,3,21,0,2,19,9,2,52,5,6,3,6,5,2,1,27,5,17,13,6,10,7,6,10,12,80,75,6,32,18,20,6,1,1,3,8,1,1,15,9,12,6,194,8,24,4,3,16,6,5,51,8,1,10,8,2,0,2,7,4,70,3,0,16,5,2,4,4,36,8,5,4,24,8,17,0,10,3,128,14,8,0,15,0,3,6,0,19,23,1,6,8,16,9,5,11,16,6,11,12,0,0,4,3,10,2,1,3,1,14,0,3,27,80,24,7,6,21,4,2,1,4,1,0,16,0,5,30,14,11,6,2,3,7,0,29,8,3,4,33,3,7,4,5,74,0,17,3,10,19,14,4,9,3,1,3,7,1,1,8,6,12,10,10,9,65,12,0,6,7,76,4,10,17,21,4,2,11,2,5,17,7,39,29,2,5,1,0,4,0,9,4,6,15,8,1,0,9,9,6,3,18,9,7,42,2,10,3,0,0,0,0,18,1,0,18,3,5,24,55,16,12,1,10,10,7,6,12,18,6,26,5,5,11,31,25,2,2,5,1,2,16,22,6,3,15,5,3,7,12,2,1,2,8,0,15,15,1,2,30,10,1,7,1,64,16,9,3,2,0,13,8,8,4,32,4,0,14,8,0,1,6,12,0,1,0,4,3,2,5,27,1,5,14,10,10,0,1,6,1,17,4,5,1,2,11,6,3,14,5,10,22,10,5,37,7,14,5,57,6,7,12,0,22,4,11,8,13,7,11,11,5,1,5,1,9,7,3,1,6,24,23,7,4,7,6,1,14,16,8,6,5,2,11,11,2,4,8,2,0,26,5,9,7,2,9,3,13,8,17,9,0,23,3,45,2,30,13,4,32,0,14,14,5,14,0,4,6,20,4,36,2,16,0,25,3,4,1,1,10,2,2,8,4,10,8,1,11,1,5,2,4,0,2,12,5,9,4,0,7,1,7,5,11,4,3,0,6,4,3,0,9,3,3,11,13,2,11,1,4,0,2,18,2,5,5,0,0,29,6,1,7,4,21,5,14,28,32,5,3,7,7,8,0,14,3,4,2,1,27,5,12,7,2,4,3,3,11,7,11,5,2,5,3,30,15,3,3,2,3,1,9,4,5,13,2,1,0,3,10,2,10,3,1,2,4,5,9,4,6,2,7,2,7,3,26,4,24,11,2,15,6,5,16,5,6,3,10,4,2,7,7,18,12,3,1,2,4,3,2,2,8,18,10,28,5,2,23,6,7,18,1,4,4,24,1,13,3,10,7,14,7,18,21,5,4,6,0,2,16,0,8,7,11,8,9,8,10,0,13,1,6,5,7,23,18,2,1,8,3,15,2,24,11,21,3,3,1,3,13,4,29,2,7,16,5,5,8,32,6,11,1,9,6,9,6,2,8,3,2,7,3,5,21,4,12,10,14,5,1,4,5,7,9,15,0,16,11,5,9,2,2,2,96,11,8,4,2,1,8,21,15,8,8,0,6,10,15,4,2,0,5,8,8,16,5,17,34,25,2,2,3,9,3,7,19,13,5,8,9,4,1,1,7,10,4,10,7,6,6,1,5,12,9,6,7,4,3,9,2,8,5,7,1,4,0,5,13,8,17,4,5,5,5,7,5,7,13,2,4,3,3,5,6,4,1,2,4,4,2,10,4,29,4,3,5,2,16,13,2,9,3,2,8,7,3,0,5,0,9,5,4,1,0,1,6,0,0,8,6,11,6,4,12,3,3,1,9,1,5,3,0,17,8,9,4,4,4,13,3,4,6,6,9,6,6,6,4,6,15,4,6,3,13,1,1,6,0,1,5,2,1,12,2,6,1,12,4,5,1,3,7,6,14,4,4,4,4,5,4,3,4,6,3,1,6,11,0,4,5,4,12,6,3,2,8,10,10,2,1,6,0,1,9,13,23,6,2,1,10,10,2,1,0,6,3,6,4,3,2,1,2,1,5,8,5,6,3,1,2,2,8,8,3,7,2,2,2,5,2,1,0,3,1,4,11,2,1,3,3,2,5,2,3,4,2,1,7,2,0,0,5,2,14,2,2,5,7,10,1,2,5,0,0,3,6,2,14,0,7,6,6,6,3,8,2,5,8,5,5,2,3,4,12,1,5,0,1,6,5,4,3,19,8,2,5,1,2,1,0,3,2,7,4,0,3,4,1,0,17,9,2,9,6,13,5,2,2,4,2,0,3,7,1,2,4,5,3,2,3,7,0,7,1,5,0,1,1,0,1,0,3,2,1
use,17,71,22,343,13,51,7,54,10,18,31,37,57,232,33,20,20,77,19,5,14,117,74,83,96,65,46,43,35,43,33,639,341,48,124,168,108,56,87,15,30,32,8,21,106,33,79,54,708,114,175,26,42,153,76,13,164,77,34,46,35,29,7,30,64,27,337,22,14,46,71,13,20,16,397,56,83,19,216,72,167,6,54,31,556,147,80,7,78,15,22,19,22,93,138,51,72,15,140,58,69,109,85,36,58,96,27,38,67,19,86,18,43,67,27,84,7,13,161,440,119,76,66,202,19,11,9,17,14,14,98,15,25,159,80,222,21,21,32,22,14,88,58,28,10,233,31,65,78,49,226,8,63,101,27,84,100,37,20,103,54,71,47,22,39,81,23,72,68,19,59,287,101,40,28,12,435,21,46,171,93,34,38,85,11,83,131,88,75,138,9,24,42,8,21,27,66,23,33,41,104,22,19,27,84,14,49,106,34,75,235,40,77,30,23,41,12,27,41,24,23,55,18,45,125,336,97,69,28,47,41,79,64,99,144,79,104,40,55,20,196,126,17,31,63,14,17,103,143,22,45,114,46,21,32,59,36,10,17,80,29,104,42,13,20,155,28,41,55,27,360,67,89,28,8,12,95,34,21,10,214,39,15,44,51,19,39,77,33,23,7,19,36,23,20,33,107,30,37,56,70,92,4,20,36,7,56,17,34,8,11,98,73,41,164,59,52,110,66,24,100,28,90,33,152,12,42,89,12,95,27,45,20,24,17,65,52,19,16,23,42,46,69,36,30,26,98,140,58,51,53,43,14,1,64,20,12,18,38,86,75,42,74,115,8,11,92,23,26,81,7,79,19,54,44,80,22,28,27,19,142,16,142,34,33,222,36,78,93,5,67,21,34,18,56,27,159,13,86,12,36,16,20,13,24,31,30,6,75,52,10,30,21,69,23,31,14,31,24,24,13,24,47,31,15,17,17,34,35,43,62,17,5,30,17,5,20,21,44,33,37,62,24,28,7,17,61,30,100,29,80,14,33,12,151,19,11,20,41,82,33,44,87,97,19,7,101,47,95,9,75,55,3,31,28,62,8,38,74,69,58,20,17,13,18,26,31,16,28,6,209,90,4,13,39,15,20,37,23,34,50,23,19,11,46,145,61,40,19,35,4,17,27,29,36,47,14,31,13,23,28,54,18,57,16,21,129,42,71,84,31,16,33,32,40,25,15,40,109,98,16,10,10,57,40,25,4,57,24,46,72,17,24,90,22,44,70,23,27,23,49,9,59,17,24,45,31,18,136,144,30,14,49,21,17,9,47,28,29,68,66,56,57,47,3,9,28,40,19,53,52,97,67,21,83,37,24,21,72,55,59,12,18,9,18,87,15,48,51,36,105,54,28,30,86,30,45,24,11,15,53,42,11,99,55,28,24,37,28,71,102,61,75,64,19,7,48,23,10,48,40,16,23,51,30,90,36,9,25,391,38,31,43,14,15,34,126,35,17,34,7,18,16,19,17,12,6,32,29,22,49,20,52,65,46,28,11,13,27,29,45,81,27,29,25,18,33,12,8,51,26,44,34,35,17,35,23,5,46,31,25,15,16,33,38,20,36,29,14,9,10,19,6,85,58,62,29,12,10,28,29,12,19,85,13,49,29,13,5,25,37,51,32,18,31,6,73,22,62,14,62,16,38,49,38,21,46,67,16,14,32,17,13,32,28,36,30,24,11,98,92,45,10,24,46,72,48,21,49,36,34,39,15,51,18,32,34,5,37,18,8,18,29,18,23,22,30,8,27,33,17,25,10,10,43,82,22,23,9,10,19,12,11,6,18,11,9,23,34,22,42,8,27,29,16,18,22,30,12,32,13,11,28,33,25,23,26,20,43,10,39,10,37,25,19,37,23,56,22,17,8,16,5,15,44,25,39,34,13,30,35,88,24,30,17,23,15,28,20,17,10,19,22,13,23,19,30,9,15,45,18,7,54,69,14,7,4,26,42,11,8,20,14,6,28,8,17,10,19,20,13,52,23,15,16,22,6,12,11,25,24,15,24,19,9,7,9,31,21,56,25,32,21,27,29,10,14,22,12,18,16,7,11,55,10,15,9,18,9,53,16,23,15,20,8,22,24,13,10,35,11,46,9,11,46,73,34,21,154,3,10,14,8,24,29,8,15,25,63,10,17,29,11,19,9,46,24,6,3,29,23,8,25,24,16,11,9,25,25,5,21,23,16,87,18,29,23,36,20,15,13,13,8,12,9,10,14,4,12,19
either,16,40,28,225,15,9,8,59,9,9,43,13,12,141,8,29,8,23,11,22,3,69,16,53,43,16,19,19,11,25,31,314,220,13,108,67,79,12,21,6,13,10,11,3,65,40,32,36,640,39,86,13,15,53,10,11,116,42,3,21,47,13,11,23,37,33,187,15,24,54,15,15,13,11,162,29,41,10,146,39,85,2,35,19,431,41,20,0,60,6,25,9,4,58,100,28,29,10,67,25,27,63,64,17,34,40,15,6,24,6,37,7,8,29,4,59,7,9,106,418,103,33,45,113,16,5,6,5,17,2,30,7,11,71,39,86,26,13,13,10,11,73,49,9,7,133,19,45,34,30,131,3,26,10,13,52,65,6,22,13,16,9,20,4,2,26,6,34,37,14,31,183,46,6,11,19,346,7,22,64,58,22,9,27,4,41,46,46,99,136,1,21,14,1,5,7,18,12,19,50,60,0,4,28,66,15,7,38,22,40,146,9,59,17,3,14,7,3,10,3,11,43,7,33,71,224,45,58,3,19,34,29,25,64,61,40,56,21,16,19,159,61,22,25,26,11,9,43,88,12,17,34,39,13,16,41,21,3,7,21,7,55,41,8,16,80,18,8,36,8,250,17,49,11,5,0,40,34,28,5,92,16,5,28,34,2,10,19,33,2,9,5,26,16,3,9,79,17,13,39,43,53,4,4,27,7,48,18,11,4,3,60,32,8,67,32,36,89,38,8,144,16,77,24,186,20,19,66,11,54,17,26,25,11,20,36,46,12,4,17,29,25,25,39,10,16,86,110,28,15,13,17,16,64,1,10,11,17,34,44,44,11,23,39,15,2,87,19,8,33,5,18,9,26,16,45,26,7,36,17,134,11,81,15,4,64,26,53,52,6,44,6,29,21,48,23,103,13,55,6,51,6,9,4,19,19,10,6,37,18,7,31,7,26,24,20,10,48,6,6,17,14,35,23,6,11,9,22,20,40,19,7,7,15,7,10,2,38,16,11,35,55,16,17,5,10,12,14,81,15,50,13,5,12,123,28,1,26,25,39,26,48,42,54,16,5,29,34,32,4,38,15,10,9,7,65,8,30,40,14,18,18,14,14,25,17,20,11,15,8,142,65,4,10,14,16,5,27,20,25,30,9,20,2,21,39,17,23,12,10,11,11,15,8,27,38,4,19,12,19,5,70,26,83,25,8,49,30,42,64,27,12,22,24,19,12,26,16,82,39,17,5,4,30,9,11,3,27,36,27,91,12,10,101,13,16,69,8,19,18,54,8,57,2,38,46,24,32,54,61,19,12,33,1,12,18,22,20,10,32,16,26,33,29,16,7,12,19,12,15,48,66,22,7,60,19,4,18,131,35,33,8,11,10,21,35,11,60,14,15,57,51,15,15,83,14,37,10,26,12,31,22,10,48,5,12,22,20,19,49,31,43,60,45,14,13,28,15,6,24,31,7,22,36,23,30,13,10,7,386,55,17,15,12,10,15,77,44,20,33,18,28,45,71,15,8,19,31,23,19,46,16,74,53,100,24,9,8,22,14,24,53,33,11,27,15,25,12,7,20,27,18,35,26,8,18,26,15,30,33,15,14,8,20,16,9,36,12,5,13,9,15,13,44,43,43,24,14,24,15,11,13,16,57,3,18,20,4,7,13,16,26,12,9,8,8,47,19,85,20,24,18,8,19,24,14,24,20,11,9,17,12,3,15,4,25,27,24,13,26,22,26,1,7,41,26,24,16,22,16,8,14,9,45,9,31,17,9,20,21,8,7,19,11,19,18,11,23,19,28,13,18,8,12,41,35,19,9,4,12,11,8,29,19,8,4,10,17,31,11,15,19,35,12,6,9,8,19,14,24,9,10,10,13,7,22,6,18,20,12,13,12,16,10,16,6,21,48,41,12,16,18,13,19,18,24,15,18,12,33,129,86,20,11,5,6,26,8,20,4,11,18,14,5,16,23,27,8,24,16,3,19,26,16,11,8,7,31,23,4,12,16,7,25,18,18,12,10,15,11,13,40,3,2,16,14,16,11,10,15,17,16,11,28,27,10,6,22,8,35,11,10,19,13,29,8,6,16,10,8,8,17,9,26,11,17,16,18,13,15,6,7,16,12,7,10,11,13,9,14,7,30,9,2,6,31,20,18,45,6,3,11,7,4,4,3,16,12,27,18,3,9,8,8,7,57,8,2,13,22,27,9,17,4,10,16,1,15,28,17,13,16,7,15,12,16,30,1,59,4,12,6,7,1,0,14,5,9,0,0
transportation,0,10,4,92,0,15,0,9,1,1,3,1,3,28,3,0,8,8,1,0,4,30,8,11,26,2,6,7,2,4,2,118,73,9,38,39,3,6,8,3,2,3,0,3,12,6,11,14,105,24,30,5,11,21,7,2,13,31,3,11,17,4,1,2,11,18,25,1,3,39,14,2,2,5,78,12,13,2,30,23,77,2,17,4,76,11,19,0,26,2,7,5,3,8,22,40,18,7,30,23,10,17,19,7,12,14,3,3,7,3,18,6,7,13,15,15,5,3,48,74,9,13,6,64,2,0,3,2,2,3,4,1,2,30,2,29,1,2,3,1,2,38,4,0,0,49,2,7,11,16,33,1,8,11,8,34,12,8,3,17,41,2,6,3,10,7,3,11,10,3,17,60,33,0,4,4,89,7,5,55,21,2,14,15,16,20,23,12,11,14,1,7,11,3,4,2,22,2,3,3,21,2,12,4,13,3,3,40,11,42,35,8,10,3,0,1,3,2,11,5,12,14,8,4,32,72,18,15,2,7,16,12,19,14,26,21,8,6,10,6,36,29,4,2,14,5,3,11,44,3,15,9,9,9,8,13,2,5,7,11,7,15,3,0,7,82,12,0,6,1,70,10,38,3,6,1,15,31,8,8,22,6,0,8,9,2,7,10,2,1,2,1,7,4,5,5,12,4,3,17,0,32,3,6,8,1,6,2,5,3,2,13,19,4,31,15,20,20,11,8,14,2,19,1,20,7,24,16,1,8,1,6,2,4,0,11,6,3,4,3,4,9,10,3,10,4,23,17,9,6,17,9,8,20,10,1,2,3,7,34,31,27,21,8,3,5,12,6,7,7,8,6,4,12,4,69,7,3,5,1,35,0,24,7,4,26,8,16,14,0,4,1,4,1,16,1,36,6,17,5,9,1,3,0,6,4,8,1,28,17,2,7,15,12,2,3,1,4,3,0,4,3,8,11,2,8,3,4,1,11,2,3,5,6,1,9,0,3,6,3,18,5,13,9,3,2,15,2,24,7,15,4,3,0,24,0,0,8,7,23,4,5,14,19,6,3,10,23,7,0,7,10,1,0,1,8,0,1,14,1,3,3,1,0,2,5,8,2,1,0,23,30,1,0,6,2,3,9,2,12,13,9,4,2,29,5,9,13,8,2,4,4,5,20,3,11,3,5,5,4,0,14,11,11,6,4,8,13,14,23,11,0,5,2,12,3,6,17,21,34,5,1,1,8,16,3,3,12,12,6,2,2,11,29,2,3,44,7,11,4,15,2,11,3,7,6,7,7,23,37,4,2,11,6,5,4,5,3,0,21,12,12,13,7,3,3,4,2,3,13,4,8,5,2,16,2,1,3,2,9,18,8,2,0,2,14,3,7,15,0,18,33,2,3,20,5,12,10,9,0,4,2,7,0,3,5,11,14,4,28,1,13,20,8,9,4,9,8,7,17,3,0,0,15,6,12,6,2,8,57,2,6,2,3,2,7,20,8,4,5,2,1,2,4,0,2,2,0,21,7,10,1,4,18,6,3,10,5,5,1,5,33,3,9,5,2,5,5,2,8,4,4,12,8,4,11,3,1,5,6,3,3,3,0,25,2,14,5,3,2,0,9,4,5,10,7,4,5,2,17,6,3,1,12,1,2,6,5,2,2,2,8,3,0,4,22,20,5,7,17,6,4,3,14,12,6,9,19,4,9,2,9,5,23,10,15,1,18,8,19,21,8,0,4,9,4,13,7,10,6,7,0,0,8,4,16,8,1,4,3,0,4,7,1,0,8,0,1,8,19,3,2,0,2,66,16,39,3,5,2,3,2,3,3,3,12,2,1,4,1,10,4,12,5,8,3,3,4,5,3,5,11,2,10,6,1,4,4,2,0,9,0,4,1,3,3,1,10,7,2,0,0,5,3,5,24,14,4,11,5,6,16,6,3,6,1,1,5,7,1,3,3,1,3,2,5,3,5,0,10,7,2,5,2,4,1,0,2,5,2,1,1,2,1,6,3,3,0,0,9,9,12,1,4,1,2,1,1,7,1,1,0,1,1,0,3,5,3,2,13,7,1,7,7,18,1,7,6,2,0,4,9,9,16,3,1,1,0,1,0,4,7,3,0,2,3,24,4,4,18,4,4,9,0,10,15,3,10,12,0,5,2,2,6,8,8,23,5,17,5,0,2,0,15,0,14,5,2,0,5,0,4,2,2,1,6,2,0,6,2,101,5,1,0,2,2,5,13,1,5,2,5,11,0,6,7,5,2,4,0
choose,5,48,11,102,3,9,0,27,3,7,29,4,10,35,0,14,6,7,8,3,4,16,24,22,13,23,15,9,7,19,7,106,59,12,20,44,32,2,2,5,4,32,0,4,19,13,12,11,216,35,20,4,12,43,28,1,25,2,6,8,10,6,3,2,13,11,136,10,6,4,15,1,4,6,67,5,19,4,48,29,19,4,12,11,131,18,5,0,15,1,7,4,8,19,25,3,11,1,48,4,4,6,18,5,8,27,3,5,10,4,16,4,13,17,19,17,7,2,69,63,17,23,11,56,4,0,3,6,4,5,16,2,8,25,12,30,7,3,3,9,7,23,16,2,2,43,5,5,6,4,34,8,11,0,2,8,24,9,13,28,6,0,15,3,9,39,7,12,13,12,6,60,19,3,1,1,67,7,6,35,7,4,8,12,3,7,18,9,24,24,3,9,0,3,2,2,18,12,15,4,17,5,5,6,21,11,2,15,18,10,52,13,23,4,7,7,2,6,22,1,3,10,4,5,17,74,13,10,3,4,4,10,1,18,15,5,14,7,8,5,47,25,1,6,8,1,5,20,48,3,8,4,17,2,3,11,5,1,0,12,1,10,12,3,2,9,7,4,14,4,67,9,2,2,2,7,17,1,0,2,39,3,6,13,7,4,37,31,11,2,2,3,10,7,1,4,21,4,1,10,13,14,0,5,1,8,14,7,7,2,1,7,18,6,21,4,2,18,11,4,15,10,24,9,73,3,5,26,6,24,10,3,5,4,5,11,7,4,1,9,1,9,13,9,2,2,22,35,9,19,9,9,6,12,11,2,1,8,1,22,15,1,3,17,2,6,18,7,16,12,1,24,0,12,5,21,7,5,11,4,39,5,6,5,7,12,1,15,19,4,6,5,13,12,13,10,17,2,18,1,17,3,1,4,0,7,7,1,8,12,3,9,1,6,8,4,2,8,3,4,2,13,10,6,1,7,0,7,8,12,1,4,3,6,4,2,2,7,7,4,5,4,0,5,4,4,13,5,12,1,17,2,7,1,13,3,2,15,4,17,14,15,16,22,1,4,11,7,5,0,10,3,0,0,3,9,3,20,13,3,6,7,1,7,10,5,3,6,1,5,33,10,3,5,2,3,1,3,1,6,4,4,2,14,4,12,1,6,3,2,2,1,6,1,0,6,4,4,1,5,0,12,3,11,1,6,14,5,3,12,4,7,3,1,13,5,3,6,20,5,3,2,3,5,7,0,5,7,8,0,53,4,5,23,1,5,2,1,7,8,8,3,1,1,3,4,5,7,19,16,3,7,5,1,3,5,2,2,2,13,0,7,10,6,2,3,2,0,0,12,9,14,7,5,5,3,1,5,15,12,18,1,6,4,5,16,0,27,26,3,12,5,16,2,13,4,2,2,5,3,1,1,0,10,1,2,4,5,9,22,1,7,23,27,6,1,2,2,3,2,2,0,19,31,2,6,6,0,6,92,25,0,2,3,7,10,9,28,10,8,5,6,17,4,1,0,5,3,2,3,7,4,47,29,21,0,4,1,1,3,1,11,6,0,7,5,5,3,0,2,17,6,9,1,7,3,3,2,6,8,9,0,2,6,1,3,7,5,4,4,3,0,2,7,12,18,0,1,9,4,4,11,6,19,0,11,2,4,5,7,1,8,0,2,2,0,3,4,30,1,5,1,2,0,0,3,3,5,1,4,4,1,0,5,1,1,2,3,2,2,2,12,3,2,10,5,3,6,1,1,7,2,0,11,2,2,4,4,5,8,0,1,5,0,16,2,3,56,3,3,10,11,2,1,2,10,4,0,1,7,0,6,10,4,8,1,0,7,10,4,1,5,8,3,1,1,2,6,5,1,2,1,2,4,1,2,10,11,1,5,6,0,5,5,7,10,6,7,4,4,2,28,3,4,0,0,1,3,5,8,20,10,5,1,2,1,1,2,3,1,0,9,3,0,1,1,3,9,7,5,1,5,0,1,5,4,1,0,14,1,2,2,7,5,2,0,2,1,1,1,4,4,13,4,1,4,0,21,6,15,1,1,1,3,26,5,1,1,3,12,2,6,9,1,12,5,0,1,2,1,1,5,2,7,5,3,4,10,0,3,2,3,10,2,0,2,2,1,5,3,1,4,2,1,2,2,4,6,7,1,1,6,0,1,2,3,0,1,3,0,0,0,1,0,7,7,0,0,13,0,9,1,5,2,4,2,1,0,0,3,0,3,0,0,4,2,3,4,2,8,1,1,3,3,1,4,5,4,4,7
fit,0,6,3,49,6,4,9,3,1,8,8,4,4,65,1,5,3,25,2,1,2,35,2,8,11,5,4,8,6,7,6,110,66,11,46,21,27,9,0,7,4,4,2,1,18,13,14,11,104,5,19,8,6,19,2,4,43,13,0,13,8,4,0,2,9,4,70,4,0,9,4,4,3,1,77,11,17,2,48,38,14,1,3,10,88,6,13,0,10,0,4,4,0,10,19,5,11,5,21,8,3,10,14,3,3,15,2,3,3,4,8,3,4,7,1,8,2,3,25,66,35,7,3,22,5,1,3,0,6,1,6,8,6,20,14,46,4,0,0,6,3,18,16,1,1,54,1,6,6,3,51,6,9,5,8,5,32,2,13,6,6,1,4,1,4,6,3,16,7,0,9,46,14,1,2,5,77,5,4,32,27,10,5,15,2,10,20,13,10,30,3,0,4,0,2,1,16,3,7,10,9,1,1,1,12,10,0,21,8,13,55,6,5,1,0,0,0,1,11,1,2,9,0,8,14,43,27,16,3,2,10,8,10,12,21,11,14,12,4,8,23,16,3,2,7,2,1,23,24,6,4,6,14,3,2,9,5,5,2,9,3,16,9,3,6,17,15,4,8,2,83,4,4,2,3,1,5,3,6,5,37,4,2,12,7,1,6,5,11,0,2,0,16,5,2,3,16,2,2,10,15,15,1,3,4,2,23,2,8,0,0,13,17,3,5,8,9,16,5,2,23,5,20,17,29,4,5,15,2,20,0,3,9,12,6,15,7,3,0,2,3,4,3,13,7,4,17,32,8,1,6,9,5,18,17,3,8,1,10,12,9,4,18,4,0,2,19,12,3,4,1,6,2,7,5,31,8,0,10,4,36,1,10,8,0,27,3,6,16,2,10,0,2,2,15,5,25,3,19,2,7,0,6,1,3,2,3,1,15,15,5,8,1,17,6,5,2,4,1,0,6,16,4,9,5,0,4,7,3,10,4,2,0,5,3,3,0,7,6,6,9,11,4,7,2,1,7,1,20,2,3,1,1,0,27,5,1,4,11,19,9,11,18,59,7,13,14,3,4,0,10,0,0,3,2,26,8,9,13,5,4,9,6,1,7,8,3,1,4,1,50,17,4,4,7,0,2,9,4,1,12,4,1,3,3,4,6,4,4,1,0,1,2,2,6,8,2,7,2,6,4,11,4,17,5,1,11,4,7,23,7,4,3,14,1,0,3,6,27,7,4,1,2,4,2,1,1,8,7,4,10,3,4,18,5,6,13,0,1,3,15,2,14,4,9,8,12,7,9,18,4,4,7,3,9,9,3,2,2,10,3,8,9,5,4,13,2,8,3,22,18,18,6,3,22,2,8,2,14,17,13,0,0,1,2,9,1,13,7,2,11,11,9,3,16,6,15,3,2,4,8,2,0,10,5,2,1,6,11,17,3,9,10,18,6,2,10,9,2,5,20,7,7,7,0,19,6,3,4,66,27,3,4,3,4,8,26,10,5,5,2,3,3,11,4,0,1,4,1,7,12,6,17,5,3,6,0,4,1,3,2,19,7,4,4,5,9,3,2,3,10,5,4,2,1,5,1,1,4,6,0,3,1,9,8,7,10,7,0,3,12,0,3,6,8,19,3,5,4,13,12,8,8,32,5,3,3,8,4,7,8,9,3,3,2,4,39,7,26,7,5,5,12,16,13,1,9,6,3,6,4,0,0,1,1,2,3,3,2,2,2,16,2,1,8,4,6,2,2,2,11,2,0,10,1,6,4,4,9,7,2,4,7,2,6,1,9,9,5,4,3,9,9,5,2,11,3,6,2,3,4,2,8,1,7,1,3,3,8,3,1,1,8,9,1,1,4,2,2,9,4,2,1,16,5,2,2,2,4,2,3,2,7,2,2,13,3,9,2,2,2,0,0,2,0,2,7,1,3,5,9,13,6,3,2,2,4,3,4,2,0,2,5,5,2,5,5,0,2,8,0,4,0,3,1,0,0,3,4,14,0,1,3,1,6,0,0,3,3,3,2,12,2,1,0,4,1,4,8,5,4,3,4,4,0,2,0,5,2,5,3,0,3,2,6,1,2,0,2,0,2,4,8,4,0,2,2,4,0,4,2,1,3,1,0,0,1,1,4,6,8,6,1,0,0,1,0,5,6,2,2,2,7,7,3,1,2,1,12,0,3,2,5,3,0,17,4,0,0,0,5,4,3,3,3,0,1,2,4,6,0,2,0,3,1,0,6,0,6,1,3,4,3,0,0,0,1,1,2,0
accomplish,5,29,11,187,10,12,14,56,6,2,33,7,13,108,6,11,8,22,11,7,4,48,18,24,21,13,13,22,3,30,15,251,158,9,71,90,50,10,24,7,22,5,4,7,46,14,25,25,331,24,67,18,23,40,15,9,48,38,3,31,10,12,4,20,45,10,144,8,8,14,11,13,4,5,129,20,33,6,99,36,69,3,22,12,298,41,19,2,49,5,12,5,0,41,65,15,33,6,38,21,13,40,44,11,19,37,19,7,23,4,33,14,17,21,3,48,7,4,81,215,66,26,15,103,13,5,4,5,3,2,27,10,6,50,20,99,20,9,7,11,9,48,46,8,3,78,10,16,19,17,87,3,27,13,12,42,37,10,13,10,19,12,10,5,2,6,8,37,29,12,15,110,42,5,11,8,224,7,18,70,57,19,13,24,13,39,73,29,57,83,0,6,9,4,6,8,21,14,18,26,48,8,5,25,38,7,22,59,14,42,72,1,28,18,0,1,6,2,10,11,8,25,8,26,50,172,32,47,8,6,19,31,21,38,55,21,73,19,21,17,124,42,15,9,33,13,4,28,80,8,11,29,32,10,17,28,11,4,7,21,7,37,28,7,13,60,16,10,19,5,182,13,25,8,5,3,24,28,8,5,76,15,6,25,24,2,7,14,26,6,9,6,14,9,1,20,45,7,17,32,35,48,1,6,13,7,43,7,10,5,3,44,43,9,38,26,34,66,33,9,57,11,41,5,77,15,16,27,4,30,0,21,12,14,9,13,26,7,4,19,14,9,18,14,14,6,60,60,35,7,20,21,2,38,34,7,1,10,1,49,34,10,20,27,12,5,44,15,25,18,8,18,8,13,23,25,9,10,22,11,97,4,78,13,5,48,5,16,43,9,45,9,16,26,47,17,81,9,25,8,22,2,7,2,11,11,8,4,39,17,4,10,4,20,21,11,9,9,5,2,13,11,33,21,9,9,8,26,18,20,23,7,5,16,4,6,0,25,9,10,23,28,13,10,2,3,10,3,40,15,22,11,1,14,65,13,5,14,18,43,13,34,49,42,13,3,16,17,20,1,23,8,12,6,9,27,5,22,29,17,11,15,3,6,7,11,15,3,13,6,69,51,4,8,18,8,5,19,12,24,21,8,8,4,8,33,21,10,12,10,18,15,9,15,23,31,11,13,13,17,9,19,24,25,14,7,45,29,34,32,14,10,7,11,18,13,13,14,54,33,9,7,7,25,15,16,8,26,24,8,57,3,11,60,14,4,49,6,8,13,45,12,28,11,30,27,27,15,70,58,9,8,26,14,16,8,5,5,11,21,10,21,16,18,20,8,16,9,6,19,34,31,11,3,48,10,7,7,65,34,35,5,7,2,14,25,9,38,14,13,36,28,8,0,34,16,90,19,14,16,13,18,5,27,7,13,11,17,11,43,23,27,38,28,10,7,28,10,6,21,31,13,10,38,6,23,12,1,16,160,38,11,9,11,5,18,55,14,8,12,8,7,15,11,11,11,4,16,34,13,34,16,51,46,28,13,4,8,5,12,8,34,16,8,15,14,9,8,4,12,10,14,26,10,9,20,9,9,12,29,9,6,15,14,14,7,29,8,3,3,6,10,9,26,13,38,8,7,14,14,12,9,11,33,4,12,11,5,7,14,12,24,12,17,10,4,31,9,40,10,15,3,7,13,15,4,14,18,7,10,6,7,4,16,4,23,12,12,5,9,8,21,5,2,24,21,22,16,22,20,12,7,2,9,3,20,13,6,27,13,7,8,18,7,14,7,11,9,12,10,10,12,3,3,6,43,4,9,9,1,12,11,17,7,3,15,12,6,17,7,9,8,5,17,1,5,4,13,11,24,8,5,9,14,11,9,4,11,20,13,18,7,26,4,9,12,10,41,12,6,16,14,11,11,6,14,9,5,9,17,18,33,18,10,9,6,7,12,9,3,11,4,6,12,4,16,7,7,6,20,11,6,22,32,6,10,6,12,13,1,2,9,8,4,14,10,10,11,4,10,5,24,1,3,7,12,5,3,8,6,11,11,4,9,7,6,10,18,2,24,6,20,15,13,18,3,5,11,7,6,11,11,7,14,1,13,8,16,4,4,8,6,15,6,11,2,4,14,5,21,6,27,4,9,5,26,19,15,46,7,4,4,9,3,6,11,10,3,36,8,4,5,5,3,1,13,7,4,4,12,5,7,9,5,16,7,1,14,11,12,4,11,8,22,10,16,15,3,15,0,2,7,6,5,0,5,5,8,8,8
end,8,37,41,402,20,33,13,76,10,7,45,24,56,187,9,20,37,53,23,14,13,68,68,96,54,62,71,60,36,112,20,520,259,39,113,220,134,24,54,18,28,35,11,28,93,41,68,43,542,134,125,44,50,157,39,23,117,142,31,53,30,19,6,27,63,28,282,36,18,35,152,18,13,16,299,37,82,15,242,83,272,12,36,37,497,49,47,10,215,11,57,21,34,135,172,42,77,24,131,41,25,63,91,34,46,84,59,25,68,31,89,18,46,44,23,84,29,11,168,368,88,88,76,842,38,21,10,13,23,14,50,11,25,116,75,199,18,17,20,35,23,108,90,26,15,189,26,49,62,109,121,16,52,27,19,37,135,42,30,93,73,11,33,28,52,41,31,83,67,30,50,271,72,13,42,21,348,13,36,140,66,33,53,104,14,79,77,64,77,148,9,13,24,27,9,17,42,25,41,39,89,16,7,34,61,37,17,83,32,62,211,35,65,26,20,52,42,38,62,9,93,57,9,34,126,226,165,112,44,70,37,92,139,55,110,166,68,30,35,26,153,80,21,26,55,11,28,100,129,21,25,59,75,79,27,49,26,10,13,89,16,103,53,17,26,231,26,45,53,19,285,49,392,19,5,18,57,303,33,7,149,28,11,24,30,4,37,35,35,9,15,20,42,69,13,29,89,15,16,44,60,77,40,14,29,14,98,27,37,8,7,33,100,35,186,73,43,126,44,16,82,15,79,19,132,7,32,90,22,79,25,38,16,10,18,33,57,10,24,71,21,31,46,33,33,20,101,106,68,37,47,31,11,86,44,34,22,12,49,1,75,30,35,41,13,12,62,19,49,65,14,96,10,45,25,111,18,21,53,70,175,4,142,25,31,69,19,49,161,17,65,17,32,27,68,34,110,14,77,14,47,22,15,21,21,25,19,8,40,49,11,23,58,21,62,42,30,19,14,33,21,22,46,16,7,13,7,30,27,53,51,21,126,44,21,16,9,46,41,23,37,28,14,38,3,5,70,27,103,31,58,14,29,21,122,20,19,18,23,72,47,59,70,100,21,18,63,35,14,9,70,27,4,10,10,49,13,29,65,20,22,35,8,19,27,6,30,31,15,12,320,153,6,19,31,14,14,52,14,45,30,16,33,8,31,76,20,43,14,21,19,15,12,19,30,46,32,34,41,32,19,41,14,39,16,27,52,36,39,79,34,20,12,26,13,31,25,36,107,48,16,12,15,23,19,18,8,38,34,17,47,3,22,126,20,29,57,7,12,24,38,17,42,13,31,42,40,13,103,96,24,20,74,12,28,14,34,13,24,152,17,37,28,37,26,28,11,16,11,35,34,51,42,22,76,15,24,23,67,50,51,10,13,7,18,45,20,58,14,29,66,38,25,13,53,19,41,12,28,11,21,12,7,68,21,18,15,9,22,40,44,54,49,40,21,10,27,26,24,30,41,27,24,57,17,133,18,12,21,335,67,11,12,15,11,61,73,40,16,24,14,14,27,42,11,6,11,28,20,15,38,27,85,54,50,20,7,17,29,13,32,66,22,20,32,15,29,15,4,10,26,47,58,17,19,30,36,7,40,26,25,10,22,16,35,20,51,21,12,13,8,87,25,55,43,67,50,13,18,16,16,18,20,46,5,15,26,5,13,26,13,54,16,16,12,16,47,12,62,33,30,6,14,22,13,18,55,21,6,13,24,205,241,575,461,37,20,35,14,75,79,67,24,66,50,75,20,14,22,30,22,19,12,30,12,31,43,12,33,25,8,11,15,13,30,12,11,33,24,27,20,14,9,15,51,26,21,23,20,11,12,24,25,17,23,24,17,16,30,10,43,5,17,22,5,10,19,28,8,33,5,67,21,9,6,7,21,23,16,9,65,59,28,10,18,24,17,67,21,11,9,17,8,17,8,48,18,28,19,29,44,52,31,26,5,17,15,35,11,10,14,9,17,25,14,30,12,4,18,26,19,8,30,30,27,18,7,21,34,26,5,30,10,24,28,10,16,11,24,12,12,16,14,15,19,16,10,5,23,33,14,7,23,34,23,40,2,15,41,49,9,58,15,151,23,69,7,5,15,19,12,21,13,15,18,4,9,21,8,16,18,7,23,15,15,50,16,26,14,28,24,21,218,84,68,74,76,317,306,9,8,18,16,16,36,67,35,2,41,6,16,6,14,12,9,28,16,46,14,11,21,10,37,20,15,7,13,13,19,8,61,10,29,10,16,12,27,29,33,11,5,13,18,18,2,20,10,45,5,23
legislation,3,51,29,558,12,11,4,50,5,6,15,18,22,114,13,21,12,38,8,5,17,58,34,50,56,47,30,36,8,15,7,356,194,24,97,104,33,19,42,5,21,10,6,39,64,39,105,87,478,49,71,12,38,57,54,3,88,49,10,22,29,10,9,23,37,24,192,17,7,37,43,11,13,5,230,35,49,7,151,50,124,6,20,15,390,35,30,2,53,15,15,13,6,40,106,46,40,11,66,57,43,62,56,14,25,56,16,12,27,6,22,19,21,48,21,53,15,4,176,333,74,37,54,140,21,5,7,9,11,9,26,7,6,144,37,123,8,13,13,12,13,80,35,8,4,126,16,32,35,27,145,12,41,16,17,148,73,36,15,51,35,8,24,3,18,20,1,47,42,11,45,151,51,6,13,12,397,6,20,150,65,28,55,43,15,58,76,47,82,74,5,8,21,2,9,4,30,18,23,26,110,11,11,23,37,33,16,80,16,66,166,13,101,23,6,11,5,28,16,13,5,41,7,29,110,333,44,45,6,39,40,27,38,74,71,58,53,26,14,16,119,72,22,14,42,20,7,45,194,14,64,44,60,15,14,29,6,7,6,48,48,28,47,4,10,87,26,15,40,13,238,26,35,21,3,5,54,49,24,14,94,24,8,30,19,15,37,34,28,4,3,15,46,13,8,16,54,35,23,33,36,142,7,6,49,10,37,16,40,11,13,66,50,30,62,39,58,93,25,23,69,13,64,30,88,25,31,33,3,58,7,25,16,15,14,40,34,19,15,21,20,32,22,17,9,21,106,78,34,29,36,51,11,75,44,31,15,9,34,75,1,45,27,48,13,3,41,11,24,39,17,49,16,31,28,70,7,10,32,19,138,10,119,34,25,86,31,55,42,7,33,10,48,26,55,28,161,10,58,9,50,3,8,4,9,14,13,1,44,38,2,9,18,46,13,9,5,10,8,3,17,14,73,36,9,14,9,26,15,29,13,14,1,14,13,4,1,11,7,9,29,51,24,16,1,6,30,12,81,21,35,12,20,10,76,14,0,23,21,54,30,34,63,70,17,7,39,24,33,2,43,9,11,5,10,56,8,48,53,18,15,22,6,14,16,14,17,6,13,12,79,63,1,5,27,10,8,24,24,42,30,9,12,30,26,30,20,24,21,15,8,23,9,38,20,42,16,35,23,16,3,29,38,49,26,9,61,44,29,56,24,11,9,20,26,12,17,31,87,55,9,15,16,18,25,19,5,27,26,24,89,10,30,91,15,31,46,9,21,33,43,26,60,18,29,40,24,19,79,92,22,15,50,20,17,9,34,14,22,52,12,31,28,35,15,15,10,13,8,16,47,56,20,19,79,15,32,20,44,38,53,11,6,6,29,39,13,66,25,9,63,55,15,14,64,7,38,21,25,11,24,7,19,37,8,26,14,40,37,72,18,67,67,44,15,9,36,26,6,8,27,7,19,34,15,50,26,13,100,236,28,12,15,28,16,14,65,40,7,31,23,8,19,24,11,2,1,19,22,15,30,11,10,92,44,5,11,22,2,9,16,71,6,18,31,12,23,19,1,5,29,26,18,10,12,30,13,4,23,19,15,17,15,20,20,13,18,7,33,11,10,13,7,55,31,21,2,13,12,20,7,14,12,40,4,7,12,2,12,21,22,34,4,16,10,6,19,8,66,13,35,15,9,24,10,8,27,33,19,19,18,11,20,18,15,35,12,22,20,24,23,33,4,22,41,45,24,19,20,12,12,2,20,36,6,24,25,11,24,11,2,10,17,11,18,14,9,0,13,28,15,54,26,13,63,46,19,20,3,7,17,9,17,36,12,6,17,9,36,11,16,3,9,14,8,6,5,20,9,20,6,19,8,14,9,12,8,20,9,13,12,3,24,10,11,29,12,56,17,15,4,13,30,27,19,32,19,25,15,13,23,62,21,13,14,14,22,23,2,5,8,12,15,17,15,13,2,13,9,55,12,21,10,29,6,11,2,13,24,1,1,14,8,1,15,8,17,17,6,16,4,14,2,11,6,6,4,6,13,8,13,4,4,18,25,6,1,11,5,54,22,21,15,7,17,15,9,11,14,13,10,9,10,19,2,7,1,3,5,16,28,18,10,6,19,9,14,10,10,28,9,23,26,5,19,41,30,39,63,5,5,12,8,15,12,7,3,4,47,10,21,4,4,26,10,21,17,21,8,9,5,9,10,10,5,10,20,8,20,8,10,18,9,25,13,23,10,12,7,2,4,15,5,8,27,12,15,8,5,1
improve,0,10,9,125,6,15,5,18,3,5,8,11,15,68,4,3,2,23,10,8,2,32,14,21,12,22,8,21,3,12,9,214,99,17,55,71,44,9,14,4,9,13,3,19,38,16,44,31,155,54,25,3,16,48,39,1,35,46,8,25,17,5,4,10,31,15,72,9,4,26,36,17,9,1,119,15,35,8,60,15,93,4,11,6,160,16,23,7,37,1,8,6,14,19,38,14,14,5,57,28,17,36,18,10,19,25,11,14,20,9,19,14,22,34,14,33,1,2,54,103,37,34,29,128,19,2,6,3,7,5,17,6,8,82,10,80,3,6,7,7,1,31,18,10,1,50,5,15,11,9,46,8,19,22,12,61,33,16,7,58,27,8,16,6,26,20,7,30,31,10,21,66,34,9,8,3,89,8,6,97,24,19,60,15,10,28,42,17,20,40,1,2,12,6,4,6,41,4,17,16,29,8,16,16,31,16,6,67,7,30,54,15,19,7,3,12,2,7,13,8,11,14,8,10,32,68,30,25,8,14,22,22,34,15,34,24,17,27,26,8,42,26,15,3,19,8,8,25,79,9,19,15,21,4,10,13,2,5,2,25,10,21,14,0,3,70,39,11,9,3,82,17,15,16,3,9,38,26,8,5,56,10,12,13,17,15,50,34,10,3,1,7,27,9,6,9,24,4,3,35,17,27,1,7,6,10,21,4,16,7,13,24,35,38,24,24,36,29,5,11,37,5,12,20,35,3,11,16,4,14,2,6,2,5,5,16,11,9,5,10,4,10,21,8,19,18,38,41,16,15,13,8,2,42,11,27,1,4,10,30,45,1,43,25,6,5,20,4,21,12,6,24,15,15,5,94,17,8,12,8,44,6,37,14,7,29,6,17,22,3,7,22,12,9,20,8,35,8,31,13,13,6,4,3,4,4,10,5,24,33,6,7,6,24,3,4,2,3,4,5,3,9,18,9,5,8,6,9,8,7,1,7,2,7,2,7,1,5,20,10,10,33,10,5,5,8,32,3,64,6,31,2,24,5,43,18,0,5,12,20,10,17,32,27,10,3,23,14,23,3,51,3,4,0,8,11,7,4,29,9,9,13,1,0,15,4,30,5,3,6,42,33,3,1,8,2,4,11,6,7,16,5,6,18,4,11,22,10,1,2,3,3,2,13,13,12,10,8,0,12,9,10,8,6,3,4,13,5,8,13,9,5,5,7,8,1,3,3,31,18,5,11,5,17,8,4,1,16,3,5,12,3,5,38,15,13,31,4,8,8,14,5,18,8,12,9,10,3,27,27,11,9,21,4,15,2,3,6,4,36,5,13,11,10,7,1,8,6,2,11,14,18,9,5,31,9,12,13,15,10,19,4,5,2,9,13,6,17,23,8,7,18,12,5,22,5,5,8,2,5,3,0,7,9,13,5,11,12,8,28,4,19,11,7,9,5,18,7,7,11,5,2,0,13,9,29,19,3,11,68,29,10,4,6,3,6,25,9,2,5,8,4,3,8,5,1,0,6,4,11,24,4,9,11,13,1,6,6,4,4,10,27,8,22,9,6,7,18,1,15,14,32,12,20,10,14,1,5,8,6,7,4,6,6,18,4,24,10,4,4,2,6,2,27,13,17,6,6,2,27,8,5,3,23,6,9,5,9,4,18,4,14,2,4,5,7,29,12,23,18,8,9,8,34,14,4,11,40,17,6,6,4,5,15,8,16,2,15,15,16,14,14,2,8,22,15,20,5,21,9,11,7,11,9,6,11,10,15,17,6,6,3,10,1,7,8,6,1,5,10,4,9,5,4,16,20,1,4,1,11,3,4,3,6,7,13,6,6,10,9,5,4,9,5,5,1,6,6,2,5,4,8,3,7,6,5,9,13,2,5,10,5,6,7,7,3,8,15,3,8,2,6,4,6,5,4,5,8,8,8,11,13,5,6,9,5,9,4,1,6,3,6,2,8,5,5,3,6,5,17,8,8,3,4,8,0,0,3,3,0,4,1,2,1,11,4,8,2,9,7,7,19,6,4,1,7,3,8,7,8,8,4,5,5,3,2,0,7,1,13,12,9,7,4,7,6,7,32,7,5,4,4,3,4,1,4,2,2,7,0,8,13,3,5,3,5,12,5,6,25,8,9,7,1,6,4,8,11,8,6,15,6,4,10,7,2,17,11,13,3,5,15,2,8,7,3,7,5,1,7,6,2,12,6,4,8,8,3,3,3,21,4,4,1,7,2,10,29,5,7,7,16,1,3,2,14,12,3,6,8
develop,4,9,8,107,7,16,13,19,3,7,6,8,33,151,6,4,9,27,4,13,2,28,18,22,15,25,17,27,11,20,8,180,139,19,59,99,45,6,13,5,11,20,2,4,33,12,25,37,192,61,53,27,22,81,36,6,19,21,12,31,20,16,5,17,37,10,119,8,4,21,25,4,8,13,230,33,36,8,84,34,65,2,12,9,172,16,24,2,27,3,5,10,14,16,67,16,20,13,60,33,14,33,14,10,32,25,7,5,20,3,23,6,19,33,15,20,1,4,64,128,52,38,26,86,9,2,6,2,1,7,28,7,12,57,10,123,12,4,8,12,9,43,20,15,4,77,11,30,11,6,42,10,12,57,21,39,28,46,11,63,8,12,13,6,9,19,9,48,35,3,34,80,46,21,4,3,129,12,5,103,46,12,26,35,9,36,29,35,34,26,3,6,11,7,12,9,34,18,21,14,70,0,13,10,29,10,11,42,7,42,85,10,21,17,2,10,2,9,11,12,4,13,5,15,33,71,30,27,16,8,28,15,25,19,58,11,38,26,17,7,44,47,2,10,23,14,5,34,58,9,7,24,22,9,2,15,8,6,0,13,1,20,12,5,16,31,39,13,22,6,92,15,10,8,2,11,24,5,4,4,62,11,12,6,19,13,16,11,11,5,2,6,5,9,2,5,23,14,3,8,13,24,0,3,14,6,30,1,17,8,14,37,63,32,21,7,35,36,22,5,21,4,27,25,55,1,36,28,2,22,2,4,5,5,10,18,24,10,4,9,8,13,15,13,25,32,38,43,29,9,9,11,4,74,23,21,3,18,20,35,27,43,1,30,7,11,22,17,8,17,6,36,6,19,16,33,6,7,16,6,57,6,40,17,8,72,6,24,22,10,21,12,10,7,25,14,27,6,18,13,10,5,3,10,7,17,5,5,51,36,4,11,17,21,9,11,8,9,11,19,6,10,16,10,9,9,8,12,11,14,6,2,0,2,8,9,6,16,20,10,10,22,18,17,16,15,46,13,47,6,30,1,11,1,61,5,0,2,11,29,15,19,26,30,16,32,24,29,37,3,27,15,5,10,7,34,5,13,30,15,8,19,6,7,15,8,13,2,10,3,58,30,2,7,19,5,12,10,4,7,32,6,4,8,9,18,25,10,2,3,1,1,6,17,12,7,7,12,1,4,7,10,7,12,4,3,29,10,13,21,13,8,8,13,12,3,2,30,46,34,6,12,5,23,20,7,4,24,13,12,6,0,3,21,23,11,30,2,13,14,10,3,12,5,15,12,16,8,28,34,8,4,10,9,13,2,6,2,7,23,8,11,16,18,8,17,10,7,2,19,22,30,21,2,35,6,17,5,17,30,21,5,6,0,2,27,7,14,14,1,35,25,11,9,10,10,7,25,9,3,8,6,4,12,10,5,6,15,17,30,6,16,19,14,6,4,33,10,5,2,12,7,8,14,5,26,2,3,13,103,76,20,5,2,10,11,26,20,9,6,4,11,3,7,7,2,2,3,12,14,12,10,14,6,12,8,3,0,2,12,5,29,8,21,4,4,15,19,6,17,15,29,9,28,6,15,9,2,10,0,8,7,3,10,11,15,13,11,3,6,11,2,6,27,20,12,4,2,10,20,6,14,6,7,13,11,9,15,2,9,6,10,6,13,2,0,19,11,38,13,15,8,13,22,2,4,8,68,12,0,5,2,2,4,4,33,8,3,9,13,10,20,0,5,20,14,11,14,12,5,12,20,5,4,3,11,10,7,16,7,5,8,11,2,13,20,8,2,4,7,2,6,8,5,28,19,7,7,2,2,4,3,11,3,11,19,8,4,11,5,5,5,8,11,6,7,8,6,5,6,0,0,25,6,5,1,9,6,2,3,1,3,12,6,6,12,6,17,13,12,4,5,0,3,7,10,9,14,3,5,19,10,2,1,22,3,8,3,3,5,6,3,0,16,3,7,7,6,8,15,7,7,8,4,5,3,0,5,8,9,1,4,3,2,7,1,8,2,6,5,5,11,7,1,2,3,6,9,7,7,10,4,6,10,2,3,3,7,3,22,11,4,1,2,14,1,1,7,5,7,1,3,7,4,6,4,2,4,4,7,6,9,6,2,3,2,9,4,3,13,6,7,1,2,7,4,6,7,16,1,2,6,3,6,3,2,5,14,8,2,6,21,2,2,3,7,8,2,1,16,4,5,7,7,1,2,2,5,6,3,1,3,3,0,5,2,6,19,10,7,8,15,1,10,6,5,6,1,18,5
permit,18,22,12,186,17,14,12,39,6,7,36,22,17,149,12,13,9,46,6,12,14,62,7,28,49,17,26,20,18,16,20,276,258,19,69,107,69,18,37,9,31,23,7,9,42,31,59,31,402,42,88,6,22,77,12,10,84,25,5,20,27,14,3,16,27,18,157,14,12,34,13,4,5,2,177,22,53,8,123,42,79,4,32,14,372,40,28,0,40,2,9,20,7,44,94,33,28,7,68,32,16,38,52,16,29,39,18,9,24,3,18,11,20,50,4,50,6,6,109,336,84,33,91,83,10,6,2,7,5,3,33,8,19,91,31,59,27,13,21,10,4,70,40,11,3,118,22,30,35,29,106,6,29,19,15,39,71,10,24,22,16,30,26,9,9,14,5,32,32,17,21,149,55,12,8,20,289,11,28,54,22,33,16,28,6,44,72,51,55,65,9,16,11,0,8,8,51,13,10,34,47,8,6,22,38,12,11,74,17,46,133,15,43,16,10,2,2,7,9,1,12,32,17,29,62,198,40,33,9,14,35,27,34,46,52,31,51,28,13,13,89,42,18,15,46,18,12,41,82,3,34,31,42,14,10,31,15,5,8,31,12,47,25,9,8,67,12,8,30,14,207,17,61,11,3,4,37,11,20,7,92,24,2,35,14,6,11,31,28,3,4,5,40,8,6,27,78,12,8,31,51,55,3,11,22,14,28,6,11,3,8,51,38,11,58,34,32,67,32,14,59,18,44,6,114,14,9,37,3,36,11,30,17,13,13,31,25,14,10,21,15,13,34,16,18,18,90,98,24,18,35,15,8,115,39,8,17,4,27,41,48,25,30,1,7,1,42,11,12,28,7,30,10,17,22,35,15,10,47,7,116,4,78,17,9,75,11,38,39,6,48,11,24,18,38,23,91,13,63,4,36,6,16,5,10,21,18,6,37,20,9,14,6,39,13,19,7,10,18,7,12,14,33,30,5,5,6,22,17,36,41,10,2,15,13,9,8,10,14,11,32,53,25,29,12,1,28,22,82,15,29,5,7,15,65,18,5,26,20,42,28,21,53,72,18,7,32,32,42,3,30,18,7,13,8,58,14,22,59,27,20,16,11,14,9,9,13,7,12,2,147,61,10,10,18,11,10,18,17,27,22,12,10,9,13,56,20,22,8,15,12,7,21,17,8,43,7,19,22,14,7,36,12,31,11,9,53,30,25,51,23,12,17,22,24,9,12,17,70,58,12,6,8,24,14,13,11,35,19,14,40,5,18,69,7,21,57,16,13,16,43,6,28,7,18,20,12,13,63,69,23,15,29,6,14,8,15,12,12,38,13,28,29,27,17,21,11,21,6,10,39,60,40,4,32,11,13,14,47,41,35,3,13,5,10,36,6,47,17,14,45,28,7,17,58,12,30,13,14,10,25,26,2,62,12,15,11,19,12,52,15,29,37,49,17,6,36,20,6,13,24,8,23,36,13,39,15,9,27,243,28,16,18,8,18,29,73,33,14,22,9,13,10,25,13,9,6,18,12,10,33,9,81,62,41,10,10,10,8,13,5,31,25,10,9,13,26,15,2,16,17,32,24,7,9,16,20,9,31,14,16,4,6,21,13,16,26,17,12,11,7,5,5,38,35,42,12,11,14,8,11,15,11,36,3,11,20,9,12,16,15,12,11,15,4,14,30,9,43,21,33,8,8,13,20,13,19,38,3,11,22,8,4,9,9,23,21,19,6,48,44,28,4,4,21,38,21,16,20,25,10,13,11,30,10,25,9,7,9,14,9,6,8,8,22,8,13,37,17,25,11,26,11,8,18,26,11,8,4,8,16,10,16,6,15,5,11,8,31,10,14,8,22,13,5,11,11,3,12,13,7,3,7,4,4,5,9,16,10,7,6,7,16,16,3,15,12,49,12,7,11,9,12,10,12,11,16,12,6,24,20,31,20,13,0,5,17,18,9,3,20,9,9,5,7,22,23,9,6,22,4,5,28,23,9,6,8,16,26,11,1,4,2,6,6,4,14,11,18,8,5,8,1,12,14,5,8,7,6,4,17,10,9,14,12,4,7,17,7,20,11,10,20,13,12,5,11,52,10,4,12,12,7,9,11,12,7,23,7,28,12,11,3,7,9,11,6,2,7,24,1,28,12,8,18,37,21,8,65,4,0,8,10,19,10,3,5,3,23,4,11,3,2,2,1,35,19,8,6,7,24,6,13,9,8,8,2,9,11,12,4,4,5,13,16,34,20,7,12,4,6,4,12,4,10,14,3,4,6,3
enterprise,1,4,4,42,7,1,6,11,3,2,22,4,4,35,2,6,1,8,6,1,0,12,12,8,6,7,4,13,2,4,4,58,86,4,17,48,29,6,5,5,5,11,2,1,12,8,12,4,150,21,29,6,19,24,1,2,13,11,2,30,11,0,2,12,19,1,56,3,2,11,6,1,5,2,39,4,6,4,27,13,31,0,10,6,94,5,9,0,14,1,2,2,0,12,20,7,5,8,10,31,9,12,29,3,3,10,0,0,3,1,7,7,13,11,6,11,2,0,27,76,8,19,5,24,2,1,4,0,0,2,12,4,5,38,3,31,3,0,4,4,1,19,14,3,2,33,4,7,4,2,41,2,6,18,4,6,7,15,5,12,5,2,5,4,2,4,4,6,10,9,18,27,9,1,2,4,53,2,8,23,9,9,1,7,6,9,19,6,14,27,0,3,9,0,0,2,5,2,0,13,23,1,9,7,19,1,1,11,3,25,28,2,9,7,0,0,0,2,1,4,3,6,5,6,14,58,11,9,5,3,7,3,10,10,32,7,8,14,11,2,20,15,4,1,11,5,8,11,23,6,3,14,13,4,5,10,4,0,2,10,0,4,11,2,2,10,3,1,10,4,58,5,12,2,4,0,22,5,5,1,50,5,2,17,8,5,1,7,9,0,0,0,4,4,0,5,26,5,3,12,3,16,0,2,2,3,14,0,0,1,1,2,18,5,6,4,8,22,24,4,43,4,5,0,34,10,2,9,3,11,0,0,1,3,3,12,11,4,6,3,1,4,8,4,4,3,17,25,17,2,5,14,2,8,15,3,2,0,12,13,13,6,7,7,1,2,11,3,4,7,2,10,3,6,6,5,6,4,20,0,35,4,22,5,1,27,8,9,14,1,10,4,3,2,13,4,21,1,9,2,4,1,1,0,2,6,2,2,23,15,4,13,6,8,3,0,3,3,1,0,1,0,13,5,2,1,4,2,1,7,4,3,0,3,3,1,0,4,3,1,16,11,9,10,5,3,8,5,11,5,10,4,4,2,26,3,0,1,1,10,6,19,13,14,11,2,18,17,9,0,4,1,5,1,3,8,1,4,3,1,1,9,10,2,9,2,10,2,3,3,27,21,2,1,10,1,1,8,6,4,8,6,2,0,8,11,6,10,0,2,3,1,2,1,15,8,0,3,4,3,3,22,2,15,3,2,14,5,7,15,11,3,2,3,4,10,7,3,13,9,4,1,0,5,7,1,3,12,11,10,15,2,3,29,1,1,37,2,5,2,13,8,9,1,10,4,14,2,19,23,8,2,8,4,5,4,3,2,3,4,6,8,10,6,2,1,1,2,2,7,3,11,3,1,9,5,7,3,16,9,7,3,3,5,4,11,2,6,2,3,5,7,1,7,11,3,9,11,3,2,4,4,5,5,1,4,10,4,13,15,1,3,12,11,4,4,2,5,1,9,2,0,1,7,2,9,0,1,2,93,3,2,3,0,0,7,18,2,0,8,1,4,3,10,4,2,1,5,8,5,5,3,28,6,10,2,2,1,1,6,9,17,12,6,5,5,4,4,2,8,0,11,13,21,4,4,6,4,4,7,9,0,8,4,7,5,16,10,1,1,1,2,1,9,14,3,0,1,1,2,8,3,1,10,2,4,6,4,1,9,4,13,2,4,3,0,9,7,23,13,7,5,0,5,12,2,14,20,3,7,11,1,0,3,0,10,5,10,2,4,3,7,0,3,21,10,6,3,10,9,9,6,1,17,3,5,9,3,2,2,2,5,4,2,2,9,3,2,2,7,10,5,2,5,14,5,7,1,3,1,1,3,5,0,2,3,6,5,9,5,5,3,5,3,8,2,7,5,2,5,3,1,0,2,11,5,0,2,2,4,2,5,12,2,2,4,3,22,5,4,4,4,1,3,4,2,6,0,2,8,5,14,3,9,2,0,4,7,2,0,9,2,0,4,3,10,0,3,3,4,1,2,2,7,4,4,0,4,6,3,0,1,5,3,2,0,1,4,3,1,8,14,0,5,3,1,4,0,0,2,5,0,5,4,0,2,6,7,1,6,3,6,7,1,1,2,2,7,4,3,6,2,0,3,1,2,7,1,0,1,3,4,1,0,3,1,4,1,1,9,2,6,1,3,5,7,6,5,9,5,0,5,4,1,3,2,3,7,9,4,3,5,2,1,2,8,0,0,2,16,5,8,8,7,6,8,1,2,11,0,2,1,2,4,1,7,2,3,1,0,8,5,9,0,0,0,2,3,6,1
challenge,0,16,6,54,7,25,2,10,4,6,4,4,12,57,1,7,9,10,14,9,3,7,34,29,4,20,17,35,17,17,2,77,51,12,20,104,22,1,2,9,6,24,3,6,21,7,6,4,46,101,14,6,12,84,37,5,10,5,37,13,2,3,0,4,21,40,72,4,4,2,11,0,4,2,81,14,24,0,42,25,13,2,4,6,37,2,4,3,7,2,3,3,10,16,9,6,6,2,24,6,0,6,3,8,12,12,2,9,5,2,15,2,13,10,17,16,0,3,21,24,7,43,7,53,13,4,3,3,2,1,25,4,8,25,19,69,1,4,1,14,6,8,12,2,6,42,2,10,2,0,25,2,6,3,3,10,35,8,4,31,4,1,6,1,4,18,4,18,11,5,11,64,18,14,11,0,15,1,3,40,10,6,14,11,2,12,14,11,6,15,0,4,2,8,1,7,11,5,7,3,16,1,2,1,4,8,1,8,6,8,40,18,11,9,6,17,3,11,6,2,2,8,0,4,15,16,10,2,4,3,9,5,8,5,11,0,11,2,3,2,12,19,3,4,12,5,7,24,20,2,3,2,10,0,2,2,2,9,0,8,3,15,2,0,5,3,3,19,11,2,23,12,0,3,5,7,15,0,1,0,78,8,3,3,1,1,12,15,3,6,0,4,10,4,4,2,5,3,2,13,16,5,0,0,1,7,7,5,18,2,1,4,87,8,8,2,6,5,1,1,14,0,20,14,23,1,8,34,2,7,6,4,2,0,5,6,12,1,1,0,0,13,21,1,1,2,3,14,5,13,0,3,0,11,2,5,6,2,5,12,3,5,11,1,2,1,5,9,18,24,2,28,3,31,2,6,1,0,7,3,13,2,5,2,9,8,8,10,7,4,6,15,4,2,2,5,3,2,3,1,8,13,3,5,0,1,6,0,7,6,2,1,2,8,0,6,4,1,2,10,1,5,15,1,4,1,1,2,3,1,0,1,0,4,15,4,3,3,12,2,4,2,0,3,0,4,20,4,4,6,19,0,14,3,17,3,10,3,4,4,12,15,5,11,3,2,19,7,2,7,25,5,1,7,5,4,6,1,4,4,2,3,4,7,4,2,0,7,1,1,18,4,3,8,11,3,1,0,4,1,3,2,0,3,4,4,4,1,5,1,0,0,1,3,3,1,1,1,1,7,2,1,2,5,2,2,6,3,2,3,4,2,2,2,3,4,1,1,6,2,2,1,4,5,3,5,5,7,0,0,6,0,2,6,2,1,7,0,3,0,1,0,1,2,7,1,3,0,8,10,10,1,0,2,2,0,1,0,0,4,1,2,7,12,6,0,3,0,0,15,3,3,5,1,3,1,3,5,0,3,4,0,4,0,0,3,1,5,1,0,6,8,2,3,1,0,0,3,1,0,1,0,1,5,2,0,1,1,8,9,1,5,6,8,0,0,3,1,2,0,4,3,0,0,0,5,1,2,0,24,2,6,0,0,0,3,1,3,1,1,0,2,1,0,0,0,0,1,1,1,1,1,2,6,0,0,1,0,0,0,1,6,1,0,4,1,2,4,0,0,2,22,0,0,0,2,1,0,5,1,1,0,1,1,4,6,8,11,1,1,1,0,0,7,3,1,4,1,12,5,2,2,0,5,0,0,0,3,1,7,2,2,1,1,0,0,1,3,2,1,1,2,0,0,1,0,1,5,5,0,10,0,0,0,1,4,0,3,0,0,1,4,0,5,7,8,2,1,0,0,4,2,2,3,0,1,3,1,1,0,0,0,4,1,2,0,1,2,2,1,1,0,0,1,3,3,2,2,0,3,0,1,0,0,8,5,4,4,2,2,1,1,1,2,0,0,2,6,0,1,0,0,2,1,0,0,8,1,1,0,4,1,3,3,4,1,3,6,3,6,0,0,2,5,1,1,0,1,1,3,6,2,4,1,3,1,0,0,0,3,0,1,0,5,0,3,4,0,3,0,0,0,1,0,1,1,1,2,2,0,0,0,2,0,0,0,0,0,1,1,8,0,8,2,1,0,2,1,3,17,0,0,11,0,6,0,4,1,0,4,2,3,2,0,2,0,0,0,3,0,0,1,0,0,0,0,1,0,0,1,0,3,0,2,0,0,0,2,2,1,1,4,0,0,0,1,3,0,0,2,4,5,4,2,0,0,0,1,1,0,3,1,0,0,2,0,0,2,1,0,7,0,16,12,0,0,2,0,2,1,0,3,0,0,0,0,2,11,0,16,2,1,0,5,1,1,4,0,5,16
might,23,106,35,478,26,15,12,110,11,8,59,25,16,210,5,13,15,53,19,10,32,140,20,103,63,36,29,29,13,39,37,464,343,26,183,144,174,24,33,11,23,25,27,6,103,55,108,32,959,63,214,9,40,116,13,39,180,63,12,36,57,28,13,53,37,17,282,14,34,55,24,10,25,11,184,36,41,29,286,62,85,5,51,25,614,60,42,1,111,7,35,23,6,87,180,42,60,13,83,28,22,69,113,37,26,102,16,6,34,17,51,23,18,43,2,84,15,20,230,825,123,63,37,170,29,21,5,13,14,4,37,14,21,142,73,84,25,6,22,12,6,102,75,8,6,214,21,30,43,39,216,4,59,12,5,64,78,10,32,24,40,8,26,8,1,19,9,58,65,28,50,249,65,3,14,36,465,13,46,76,65,39,6,47,6,62,108,60,122,174,30,34,17,3,4,9,64,12,22,35,66,1,13,59,94,30,25,96,49,72,191,23,140,20,10,7,7,6,38,3,11,64,12,55,166,271,37,75,12,15,41,37,32,77,102,55,83,23,27,27,241,110,21,24,38,17,17,64,123,34,36,60,85,31,42,74,41,8,21,37,6,96,82,20,18,93,10,15,42,10,382,30,93,18,15,3,67,27,36,38,147,34,20,48,37,6,14,26,36,12,17,13,67,22,8,37,139,31,32,57,81,78,1,4,47,4,45,13,11,3,3,41,85,16,129,48,55,139,50,10,155,21,83,13,230,18,23,100,13,97,41,38,25,24,34,42,66,24,1,39,64,51,43,42,3,19,142,164,48,19,54,22,26,92,87,12,18,19,44,62,41,20,22,42,11,5,1,32,16,41,12,54,17,31,26,53,25,15,45,21,154,9,123,47,7,86,22,70,73,17,54,10,69,34,143,30,198,18,137,6,71,9,17,4,21,9,28,9,72,29,7,31,11,37,67,35,19,31,13,9,9,37,45,45,3,8,7,33,39,55,56,13,9,38,8,25,6,64,42,19,41,51,30,68,2,12,33,22,121,24,46,19,11,31,145,28,6,45,15,94,45,58,79,60,21,5,44,43,27,5,56,16,9,8,12,22,11,67,67,14,15,48,29,20,27,23,27,17,17,6,270,106,13,20,41,26,5,56,23,48,28,20,10,3,35,127,5,34,24,12,18,20,29,21,40,73,17,38,16,31,16,74,25,77,34,21,97,43,72,83,37,12,19,22,25,30,47,40,139,58,15,8,14,11,22,32,19,55,53,25,143,26,24,129,24,31,98,29,25,19,98,19,76,9,56,54,46,31,98,88,35,21,48,13,21,28,22,15,30,32,16,56,42,55,29,15,24,21,18,33,63,105,34,8,47,13,12,6,144,69,70,4,29,12,31,99,19,79,24,25,98,52,50,24,125,39,84,15,33,25,56,48,8,77,10,21,34,51,33,83,78,63,104,81,22,10,23,10,8,43,32,4,18,91,28,95,24,17,19,524,71,18,36,11,23,34,138,57,22,59,29,26,47,66,40,16,12,41,39,49,50,33,199,86,62,35,9,22,14,14,19,106,62,19,36,31,49,19,10,41,57,29,54,48,11,21,37,27,36,89,28,18,23,18,29,20,51,18,25,19,10,30,27,92,59,87,34,38,24,17,22,9,33,69,5,20,28,1,11,46,29,53,17,12,28,10,38,18,129,24,33,33,9,25,32,19,34,14,16,23,59,10,0,18,7,32,35,34,7,23,26,26,9,7,55,45,33,16,19,22,17,14,5,45,9,57,26,13,28,45,19,25,51,32,36,29,33,73,24,56,21,23,15,18,22,44,6,25,16,10,16,26,47,37,34,7,28,8,51,16,28,12,42,36,18,23,14,37,27,43,26,5,35,51,14,23,14,23,34,27,36,15,43,21,14,27,38,104,55,18,23,31,18,38,23,34,49,27,30,52,120,83,20,12,6,17,23,26,29,5,37,23,29,10,19,25,9,11,39,23,10,9,29,47,17,32,14,57,43,11,2,20,15,12,35,14,31,9,19,22,21,25,3,18,36,28,8,35,16,12,28,29,19,48,39,15,19,42,8,78,22,24,22,36,40,9,10,15,5,13,38,18,28,34,8,40,6,82,11,25,28,13,27,35,25,12,17,20,17,21,13,31,6,10,18,61,64,22,120,15,9,22,11,20,21,10,9,23,69,19,7,9,12,8,2,70,16,4,39,30,27,20,19,14,30,11,6,28,29,31,22,18,23,39,17,9,21,12,64,10,13,13,11,4,2,8,5,21,4,7
true,7,16,9,62,13,11,3,42,4,5,19,2,8,82,3,16,10,11,6,4,2,34,21,38,34,11,23,18,12,12,12,118,97,17,64,81,50,1,10,7,6,18,1,5,40,16,14,12,222,56,50,6,14,61,20,3,34,7,10,12,9,14,6,18,14,11,96,13,12,10,5,1,7,3,120,16,37,3,77,36,46,0,6,8,141,19,13,0,25,5,5,4,0,37,55,7,10,6,20,9,8,28,25,14,12,22,5,5,12,8,12,0,10,12,8,40,2,3,46,139,38,28,8,65,10,15,4,4,2,2,19,4,22,42,43,59,6,5,6,13,11,24,13,3,9,61,6,17,12,8,63,2,13,7,8,10,52,7,14,25,8,5,14,2,2,14,8,22,16,5,23,77,32,3,7,13,117,5,12,42,32,13,5,17,3,43,36,29,45,31,1,13,3,3,2,2,10,8,9,13,29,0,1,3,34,11,9,23,8,20,75,15,20,12,9,8,1,5,8,2,0,19,8,12,25,68,21,38,7,2,13,15,15,23,33,10,33,7,8,9,61,32,2,6,16,3,3,21,28,3,6,21,10,0,11,15,11,5,1,30,7,36,11,4,6,19,23,17,23,3,96,2,12,4,5,1,17,5,3,1,63,6,0,26,10,1,3,4,23,2,3,5,6,6,0,3,23,2,6,30,30,16,2,3,14,6,27,6,7,5,2,14,30,8,42,8,27,28,11,3,29,5,35,21,57,1,13,53,3,26,18,10,16,10,7,13,20,3,4,12,7,8,11,8,3,4,27,37,6,14,8,8,5,23,19,6,7,12,15,19,11,4,17,11,3,9,32,1,5,29,5,25,5,11,18,22,7,5,30,2,48,6,28,16,15,41,12,12,27,6,23,7,7,7,21,9,36,2,22,1,20,5,5,3,8,9,5,3,22,10,9,17,1,29,5,9,6,5,5,7,10,17,19,15,7,4,3,17,7,22,10,12,1,11,3,3,5,7,10,11,11,10,7,10,1,10,13,8,31,6,15,6,11,4,45,6,5,13,14,25,11,33,32,64,10,6,17,16,4,3,44,6,2,9,2,41,4,8,13,12,5,18,2,12,9,7,9,3,6,1,83,27,5,5,12,6,2,10,10,8,25,3,5,1,6,9,3,11,6,4,3,6,2,5,11,12,2,20,7,9,6,15,4,20,7,1,24,13,12,28,5,5,6,20,5,9,6,12,22,14,3,4,5,19,8,6,10,13,8,3,43,0,13,26,3,18,14,4,3,3,10,2,9,6,10,10,15,8,27,24,11,7,6,0,7,4,5,6,9,13,3,7,8,26,8,10,5,10,0,23,27,25,11,1,36,5,6,9,26,17,13,2,8,2,2,13,2,29,3,3,39,5,4,7,26,8,17,4,3,4,6,0,0,9,2,5,3,2,11,20,4,7,30,20,6,5,13,6,6,7,19,7,35,7,5,15,6,4,10,118,16,6,8,4,7,8,20,16,7,8,5,14,6,8,2,5,9,5,9,7,6,17,44,27,17,9,2,1,2,5,4,13,9,3,8,7,5,2,5,6,16,11,11,8,0,7,5,3,8,9,0,0,3,11,9,7,6,7,3,3,5,3,7,25,7,28,11,6,7,6,12,6,10,13,13,20,12,8,2,13,6,9,7,5,0,2,22,10,28,4,12,5,3,20,24,6,11,7,3,6,2,2,0,4,0,10,14,4,2,9,8,8,0,9,10,24,6,7,8,8,12,5,2,8,6,9,5,1,7,5,3,3,16,1,12,7,8,39,3,14,2,7,4,10,10,15,4,5,3,3,1,4,8,3,12,6,5,8,9,2,3,3,8,6,5,4,5,7,3,7,5,3,6,4,0,3,7,4,3,4,4,5,14,7,15,9,7,19,5,5,2,4,3,9,3,6,9,2,4,5,8,21,7,7,1,2,7,0,4,2,5,2,4,2,4,6,10,3,5,5,0,4,5,10,7,8,2,7,12,1,1,3,3,5,0,3,3,5,2,2,2,10,0,3,2,1,4,3,0,14,1,2,2,9,23,1,1,2,1,17,1,2,6,1,9,2,9,1,4,2,8,12,3,4,3,3,3,5,4,1,3,1,5,5,3,3,2,5,3,4,5,15,3,1,0,7,6,7,10,4,2,5,5,0,4,0,4,4,8,1,3,1,6,3,1,7,2,0,8,5,5,4,8,5,4,2,3,5,10,3,0,7,2,1,6,1,13,4,12,4,3,4,6,4,0,3,2,6,3,4
reform,4,29,28,176,9,22,3,6,1,2,4,9,26,51,1,5,22,13,19,16,8,33,65,40,30,44,25,47,15,40,2,215,112,20,63,103,33,3,8,10,15,21,7,26,45,19,48,34,157,87,38,23,12,53,38,4,34,32,29,26,11,5,3,17,47,21,129,10,3,7,32,0,16,5,178,17,36,7,80,35,50,10,5,15,175,16,15,8,30,4,10,10,30,34,39,17,14,8,32,15,3,35,11,16,9,37,23,22,15,7,28,7,34,32,52,35,1,3,78,85,32,79,82,130,13,8,3,1,7,7,32,6,16,54,29,155,2,8,10,10,7,51,16,8,4,91,13,20,7,11,59,6,14,3,11,43,56,9,5,99,52,7,17,8,22,53,7,29,43,13,17,115,37,11,33,2,101,3,5,90,21,16,37,38,9,25,30,16,27,50,9,1,5,8,18,8,31,22,16,9,45,15,9,14,16,31,4,96,28,28,78,23,54,18,8,48,17,40,29,4,7,34,1,12,40,88,26,15,6,9,12,12,45,22,47,44,23,13,1,10,53,47,14,16,22,14,22,52,54,11,17,15,32,3,5,14,1,1,1,17,10,34,16,2,14,43,24,26,28,9,72,14,5,8,5,19,27,8,7,8,81,30,1,13,13,3,116,98,18,15,2,10,37,20,4,7,25,12,6,6,35,21,2,1,13,31,26,9,76,5,9,18,31,25,44,13,29,43,6,15,21,7,25,31,65,1,14,73,1,33,23,7,1,4,3,4,22,4,11,6,2,25,40,11,5,12,31,40,16,32,7,11,9,26,8,7,16,3,25,49,24,21,8,12,4,18,16,5,1,56,5,71,11,39,14,35,4,4,17,2,33,8,31,14,18,18,4,29,15,8,24,9,23,17,17,10,23,5,24,1,10,19,6,17,2,6,16,0,17,34,1,2,6,11,13,17,9,11,7,18,8,6,19,9,5,5,7,6,5,15,4,4,1,14,15,8,3,20,19,12,13,12,15,5,0,8,37,12,16,5,58,5,31,13,23,24,9,3,1,17,24,21,25,28,5,5,28,14,5,14,32,10,5,8,13,10,4,14,17,11,1,12,0,10,18,1,10,17,4,10,28,34,1,8,11,2,0,4,2,18,6,3,0,31,7,23,8,16,12,3,3,13,4,20,9,4,19,9,4,6,4,7,5,11,5,5,17,8,11,13,15,11,6,3,8,9,0,15,19,7,4,5,8,6,15,7,3,18,4,12,13,3,10,36,9,12,12,4,10,6,14,8,14,11,8,14,6,7,17,32,7,5,6,16,6,2,18,3,3,25,7,5,13,18,10,2,6,11,1,14,23,14,18,10,22,1,8,5,15,23,29,2,9,0,5,18,8,30,21,7,19,30,12,1,21,3,9,3,1,7,13,0,3,17,2,2,1,10,8,24,5,15,6,19,5,6,6,9,8,8,14,6,8,7,2,13,3,12,21,63,4,5,1,12,1,11,14,15,3,3,10,2,0,2,5,3,0,4,3,6,6,4,5,43,4,5,5,0,1,3,3,22,5,4,6,2,12,6,0,0,8,31,11,2,5,13,5,5,8,5,58,4,4,5,4,12,12,5,3,2,3,6,2,26,8,26,14,3,8,18,3,2,1,23,3,4,2,12,4,12,1,11,2,8,4,3,7,1,1,3,18,1,1,3,2,9,8,13,4,8,6,0,0,5,4,14,4,7,7,7,2,9,0,4,12,8,4,10,2,0,17,4,3,13,2,2,11,6,7,0,1,4,10,5,8,5,5,1,4,6,10,4,1,3,9,27,5,6,5,26,5,4,6,17,20,5,4,5,11,8,2,2,2,2,0,3,3,19,1,7,1,2,3,4,1,4,16,12,5,2,13,8,19,3,13,12,4,16,1,5,2,10,10,3,3,0,0,6,7,2,34,13,7,0,2,3,2,5,2,7,1,1,1,14,0,4,3,3,4,19,4,2,1,27,17,2,3,0,6,1,0,2,8,0,9,2,6,3,4,3,13,2,12,2,1,3,1,5,8,10,6,0,8,3,14,0,2,5,5,12,13,42,13,5,7,3,3,0,6,1,4,2,4,7,2,1,4,7,1,1,5,27,2,2,3,2,0,1,3,12,4,7,4,8,3,11,9,4,4,2,2,12,6,5,0,3,1,0,0,7,4,0,11,1,1,1,1,10,9,1,4,3,14,21,1,1,12,0,0,2,2,7,2,0,5,11,3,25,18,13,6,6,2,12,7,11,11,1,6,30
like,6,31,28,153,26,44,4,60,8,3,14,19,32,145,10,19,25,34,21,6,4,80,94,101,45,54,78,77,44,86,16,324,240,70,91,243,40,9,22,15,23,41,16,38,72,9,37,22,288,180,109,29,26,145,43,8,40,21,85,41,21,27,4,27,83,29,214,16,10,26,47,3,16,13,211,41,67,8,126,105,76,3,19,34,217,42,16,5,26,3,26,24,15,69,62,29,33,6,65,29,10,47,31,60,25,43,5,33,39,8,46,7,46,56,71,65,3,17,78,219,81,133,72,166,26,16,12,5,7,6,91,14,23,66,88,188,11,6,24,17,21,82,24,11,6,186,31,46,29,21,82,19,24,12,13,30,101,22,15,143,31,18,38,5,12,91,22,50,32,7,28,224,50,19,54,18,182,10,18,141,42,10,45,75,6,63,67,48,44,68,8,15,12,14,22,8,20,15,15,35,82,16,16,15,34,37,10,48,26,20,139,54,43,16,31,97,26,30,42,7,5,35,9,32,41,197,59,46,26,21,20,29,43,27,84,17,50,14,9,28,109,56,16,31,41,8,14,103,57,30,12,28,33,5,4,29,8,5,5,27,13,79,9,2,10,52,42,65,40,11,148,9,18,14,5,17,42,18,7,2,165,15,9,25,24,7,42,49,36,13,3,20,14,12,7,7,51,5,21,44,51,15,2,3,11,8,31,6,16,10,0,39,53,26,67,22,36,36,18,4,53,16,78,51,111,5,18,136,4,37,39,21,8,7,6,13,47,5,4,9,17,44,53,5,11,14,51,57,27,54,11,29,7,81,33,7,12,4,18,65,39,12,17,28,7,24,41,29,56,1,13,131,11,75,24,34,12,6,32,8,52,9,53,14,53,41,21,45,40,6,39,18,24,22,18,25,32,2,25,6,34,31,5,25,12,6,16,5,32,24,6,13,1,27,16,44,25,19,24,46,10,16,31,24,9,3,4,20,14,17,8,7,0,19,25,12,12,31,47,6,32,14,8,24,5,15,82,34,39,21,64,13,51,5,70,17,25,12,25,28,37,55,43,97,13,16,71,26,12,22,77,33,6,21,4,50,10,20,56,28,23,19,4,19,11,12,9,32,23,5,113,49,6,23,31,7,7,9,5,16,33,13,4,20,21,27,14,25,8,17,7,8,11,15,10,15,5,18,44,23,2,21,8,28,11,6,69,20,26,24,26,20,22,20,7,22,9,38,66,40,5,7,12,18,11,4,7,24,20,12,75,14,10,53,12,10,34,14,15,6,9,9,14,7,12,18,14,8,28,56,16,4,10,22,9,4,9,12,13,38,5,12,25,50,11,26,7,14,6,25,37,33,37,19,36,7,12,20,28,18,17,8,6,5,3,26,10,19,6,5,57,18,14,7,55,8,12,7,13,3,10,1,4,30,7,9,4,9,9,26,11,15,36,48,23,8,25,12,14,7,31,18,20,17,12,14,7,10,12,143,8,8,17,13,3,27,24,21,17,15,3,9,6,11,6,6,3,11,20,13,15,10,19,29,17,11,5,5,5,14,8,40,20,6,8,7,13,7,3,12,20,54,7,4,7,18,18,3,29,6,40,3,1,16,6,9,23,14,10,1,12,2,4,19,8,39,40,2,10,10,7,10,8,34,18,9,23,9,4,21,6,10,4,9,2,8,27,10,19,9,21,9,7,10,11,5,22,15,9,12,19,5,4,5,4,7,6,7,4,23,22,25,2,12,24,21,24,8,7,6,32,6,8,20,8,13,8,11,10,13,5,7,11,10,17,5,7,9,13,33,10,5,4,2,24,51,23,16,2,6,3,6,10,6,41,15,8,14,20,6,3,5,12,8,5,4,3,36,8,10,1,3,6,11,4,9,34,8,13,5,15,3,20,11,21,8,12,22,7,8,2,11,10,21,3,8,11,20,6,21,25,20,16,2,3,13,11,2,5,2,5,11,9,6,5,5,10,2,16,5,4,5,8,9,5,6,5,13,19,6,3,5,3,6,6,0,9,5,9,5,30,8,13,2,9,0,3,12,11,41,4,2,23,5,13,2,1,8,3,17,9,11,11,4,15,3,10,4,7,2,10,6,5,8,6,9,10,5,3,1,7,8,7,8,4,6,4,3,8,5,3,28,4,1,10,9,19,10,25,5,7,24,6,9,2,4,1,6,8,6,0,1,2,6,0,7,5,10,14,11,8,8,28,30,3,3,29,12,10,10,2,13,2,2,7,13,7,32,7,16,3,8,3,16,5,14,17,3,8,32
strongly,0,1,2,79,5,4,0,3,4,1,9,5,7,25,3,2,5,4,2,2,5,17,13,13,6,2,11,6,4,13,6,73,47,10,16,31,13,1,4,2,2,7,5,5,20,7,11,10,96,18,17,3,7,23,5,2,24,18,7,6,5,3,1,3,13,2,32,1,2,5,11,3,2,0,30,9,7,3,21,8,22,1,6,1,62,8,3,2,16,1,4,5,2,13,22,5,4,4,12,4,8,16,11,9,3,10,6,0,8,0,10,1,13,5,3,10,3,1,25,52,6,14,7,38,6,4,2,1,2,2,7,2,5,25,11,30,2,1,5,1,3,13,12,0,0,39,2,10,5,4,18,2,9,4,1,14,7,1,4,17,2,1,1,1,3,5,0,12,6,4,9,34,12,3,5,4,67,1,1,24,2,5,8,8,1,9,8,6,17,18,0,3,5,1,1,0,7,3,4,0,16,0,7,2,5,6,2,12,7,17,28,6,7,9,3,1,0,2,6,4,0,3,2,5,11,37,6,3,4,5,9,4,6,9,9,7,10,11,4,4,32,15,3,1,8,4,1,10,24,4,41,10,12,3,2,4,2,2,2,9,1,15,12,0,1,11,4,9,7,1,41,5,5,3,2,2,5,12,5,1,18,3,3,3,5,7,7,3,3,0,1,4,10,1,0,3,14,3,2,3,9,39,1,2,7,1,9,0,1,0,3,5,13,11,6,7,7,10,5,6,12,4,9,3,23,1,5,18,2,6,3,0,4,3,0,8,8,6,0,7,5,2,7,1,3,2,18,11,9,7,6,8,2,7,5,8,1,1,8,14,17,6,6,7,2,2,12,5,5,13,1,30,2,7,2,19,5,2,7,1,20,1,14,5,4,6,0,10,8,0,11,2,9,4,15,6,25,1,7,3,8,6,1,4,0,0,4,1,8,6,1,5,2,9,0,5,3,4,1,7,0,4,4,5,1,3,1,2,2,5,5,1,0,7,4,1,1,8,13,2,9,8,4,6,3,1,14,4,12,4,18,1,7,6,12,0,3,4,2,7,5,9,5,6,1,10,10,2,5,1,7,4,3,0,1,4,0,4,10,4,1,4,2,4,7,6,3,3,3,4,24,13,3,3,9,1,1,4,7,2,1,3,1,1,2,7,0,11,2,1,1,4,1,3,5,5,3,2,4,6,0,1,3,5,4,0,10,8,9,14,6,3,4,0,3,2,3,4,13,12,3,1,1,1,6,6,1,8,5,6,13,0,4,13,10,3,12,4,4,10,11,5,9,1,5,6,2,1,16,15,6,2,9,2,1,3,10,1,0,9,5,2,4,5,4,1,3,3,2,6,12,11,7,2,11,1,2,2,5,4,7,0,2,1,4,5,8,11,0,1,10,8,4,1,12,5,11,5,4,2,4,4,1,7,3,0,1,4,3,7,8,10,5,1,3,0,2,10,2,1,2,2,5,11,1,14,5,3,3,53,17,3,1,3,1,10,10,4,1,13,4,0,7,4,2,2,1,3,3,2,5,1,10,10,4,4,10,2,3,0,4,11,4,11,5,3,6,2,0,9,5,5,4,2,3,8,3,2,8,3,1,1,4,3,7,4,3,1,1,1,3,8,1,8,11,5,7,2,0,7,4,4,2,9,0,0,1,0,3,5,3,5,0,2,0,0,12,1,4,4,3,1,0,6,5,4,6,8,2,1,5,1,2,9,3,4,1,9,7,4,3,5,2,4,7,9,9,2,5,4,3,2,1,1,2,7,5,1,5,2,2,2,5,1,3,3,3,1,2,5,2,6,1,1,1,6,6,3,2,3,1,1,5,4,4,3,2,1,8,1,0,4,4,0,1,2,0,9,0,3,2,0,0,1,1,0,4,2,5,1,1,0,5,3,2,4,4,9,2,2,2,3,3,3,1,7,3,1,5,2,5,7,7,0,2,3,2,2,4,0,0,2,3,0,1,2,1,4,3,10,4,2,2,9,4,2,2,3,11,4,0,2,1,1,4,0,4,2,4,0,1,3,0,6,3,0,3,1,2,2,1,2,4,3,1,0,5,1,2,3,5,1,3,2,3,2,1,1,3,3,2,2,2,2,0,1,2,5,2,0,2,2,3,0,3,0,1,5,2,2,1,2,3,1,2,8,3,7,8,0,2,1,0,3,3,2,5,2,10,3,2,2,1,0,3,8,4,0,1,3,0,1,1,4,1,0,2,3,4,0,11,2,1,9,5,0,6,7,4,1,1,2,1,1,2,4,0,0,0,6
support,11,56,26,299,32,48,12,85,13,5,25,21,38,181,15,19,36,44,34,21,11,76,98,96,31,86,101,78,41,97,27,330,294,90,120,244,102,21,52,33,45,84,15,37,91,32,62,57,413,219,130,40,46,200,65,17,133,35,83,55,17,20,11,57,54,27,277,21,16,33,81,7,22,9,268,22,72,6,117,88,140,5,22,27,415,62,43,5,53,4,19,19,13,107,72,41,40,9,161,31,18,55,36,55,21,77,19,25,53,11,54,14,43,47,47,89,4,2,110,220,62,147,71,219,8,23,15,12,9,15,70,23,23,152,91,227,12,12,36,14,24,84,32,7,6,194,28,37,15,23,136,3,34,23,10,72,105,22,10,190,20,5,22,6,38,60,22,73,51,26,43,238,61,10,59,7,213,16,17,199,32,23,84,62,8,61,61,27,42,64,7,14,18,17,6,14,33,28,26,20,49,6,22,30,49,44,15,74,39,55,227,59,52,59,30,41,7,38,61,11,11,28,8,28,104,181,44,53,25,48,25,16,48,27,87,94,46,38,27,29,146,73,23,23,52,18,7,121,130,30,26,39,39,12,20,21,6,8,5,42,8,119,22,2,15,64,41,77,68,27,223,39,52,11,8,25,76,34,8,5,186,15,19,37,17,16,47,52,27,6,4,30,30,28,10,16,83,17,35,36,49,61,3,7,16,10,51,10,33,17,23,32,80,56,70,33,58,64,24,17,72,12,68,51,140,4,22,127,3,50,52,21,19,8,12,24,72,16,13,10,11,45,74,19,10,21,66,77,45,79,20,28,9,79,18,6,24,6,18,96,49,24,36,30,10,28,54,25,71,131,30,1,11,91,25,63,10,14,41,14,102,7,77,26,68,86,23,52,51,20,41,28,22,16,47,26,48,9,47,8,48,46,8,40,7,3,18,2,36,53,8,20,27,31,12,62,34,36,21,73,9,22,34,20,9,12,12,27,10,32,17,10,6,36,28,9,27,43,71,14,39,50,11,35,16,23,102,41,33,28,107,11,60,15,51,19,37,26,16,26,51,55,57,93,20,15,112,27,15,9,78,25,10,7,7,31,10,26,38,18,24,39,8,15,16,8,17,47,9,8,153,60,8,31,45,10,9,20,13,6,20,5,5,14,13,50,27,19,12,11,14,7,10,9,28,20,9,21,4,31,9,24,9,36,9,9,50,15,22,40,24,19,21,18,22,26,9,24,64,27,14,16,17,24,27,5,7,21,28,15,89,9,8,94,27,11,42,7,9,8,30,7,40,6,18,17,15,13,54,57,29,19,29,18,7,3,17,11,10,69,21,28,33,53,12,4,3,12,12,36,56,42,45,14,44,14,21,16,30,31,37,15,13,4,8,22,14,27,14,18,42,22,17,12,46,8,28,11,11,13,19,12,7,51,13,8,10,17,23,51,22,30,52,34,12,10,14,21,30,20,31,16,12,41,7,41,12,14,13,253,22,6,6,21,16,38,42,30,14,19,14,6,6,15,3,11,3,12,9,20,30,18,22,48,35,11,5,9,7,5,13,46,10,15,15,16,31,15,9,10,14,76,24,13,11,23,25,3,57,21,28,7,7,7,8,13,29,18,12,4,6,7,16,50,26,61,68,7,7,17,20,5,5,44,14,19,22,15,6,22,8,22,12,8,10,7,40,4,34,18,12,5,20,7,19,8,34,30,11,10,28,9,16,19,22,25,16,21,13,54,43,22,4,17,41,46,18,19,45,9,37,19,5,29,14,22,26,5,35,11,8,9,21,2,13,9,17,2,18,25,7,13,4,8,10,54,5,10,4,8,15,8,17,9,36,3,29,13,23,13,15,11,10,12,6,4,10,35,7,14,3,4,9,21,1,12,28,14,23,9,21,5,30,15,33,22,15,46,13,12,4,12,2,16,7,8,13,44,8,23,32,36,17,18,9,16,14,9,7,8,5,14,17,15,10,16,11,10,21,18,11,14,14,13,16,8,2,8,30,17,0,5,11,4,12,4,12,9,12,5,27,12,15,4,9,5,6,5,18,60,13,6,35,17,21,6,15,7,4,21,10,18,7,16,15,10,5,4,18,5,6,9,3,43,3,13,16,15,9,14,10,12,10,10,8,7,7,13,3,23,1,46,15,9,13,31,12,39,62,5,9,18,19,18,7,6,4,10,25,8,18,6,16,5,9,16,5,25,14,6,20,7,24,44,2,4,31,10,16,6,15,7,9,6,12,26,13,60,10,29,6,19,2,22,8,18,7,3,12,62
sound,2,7,5,63,2,10,1,14,2,4,1,3,7,40,6,11,2,17,6,1,6,12,7,14,11,8,8,9,0,13,1,94,67,6,33,23,15,13,20,4,6,5,1,5,17,13,17,15,112,17,25,4,7,34,9,2,16,8,4,13,8,0,5,4,19,1,51,8,3,5,16,4,6,1,89,12,13,0,39,13,30,4,3,6,129,14,12,4,8,1,5,5,7,17,18,7,17,3,25,19,7,13,17,6,11,13,6,2,16,7,6,6,19,7,1,26,0,2,34,95,11,13,22,51,13,5,3,5,6,3,11,0,3,28,8,28,0,0,4,5,2,14,10,5,3,34,5,9,9,5,23,2,6,10,4,19,23,1,6,16,8,2,7,2,6,7,1,13,9,4,12,60,16,7,4,1,63,5,10,29,7,11,8,9,4,15,20,5,17,30,2,4,8,1,2,8,8,6,7,4,22,7,5,8,16,5,2,35,12,47,31,5,12,2,2,4,1,6,6,10,6,10,1,6,12,56,16,11,12,10,5,14,15,15,18,14,21,7,13,1,27,12,7,3,11,13,5,27,29,5,7,14,10,5,14,8,4,2,3,6,2,13,22,0,6,10,2,13,3,4,66,8,19,2,1,0,15,4,2,1,36,5,1,9,5,5,9,5,5,2,0,2,8,9,2,8,14,6,6,14,10,11,3,1,13,22,13,2,6,3,3,7,20,5,21,7,16,21,2,6,15,2,9,0,50,3,18,18,5,15,4,3,3,5,2,1,11,4,3,9,4,1,17,6,4,1,14,32,17,7,12,6,3,19,9,4,0,2,8,10,16,15,6,10,3,3,17,5,11,11,2,11,1,5,7,9,3,6,5,3,39,4,24,6,5,32,0,15,8,2,9,10,6,4,15,7,19,5,6,2,9,4,4,0,5,4,3,0,18,5,1,4,2,9,1,2,2,0,2,2,7,4,8,8,2,3,7,7,1,10,18,1,2,2,3,3,0,4,3,1,4,11,3,17,3,2,9,1,9,8,30,3,3,2,29,7,0,1,3,8,6,10,18,9,7,1,15,5,14,1,9,2,2,3,7,16,2,1,10,3,2,7,1,1,3,2,14,3,3,0,23,22,2,0,6,1,2,15,4,2,15,2,6,4,14,19,10,7,5,5,4,7,4,1,8,6,4,4,0,2,3,12,4,5,2,0,4,3,5,10,4,12,2,5,10,3,5,3,18,11,5,0,3,13,6,1,0,16,9,3,14,1,5,19,1,5,16,6,6,3,22,3,10,3,14,7,3,4,23,12,6,4,2,3,7,14,2,8,1,15,0,3,7,3,7,3,2,2,3,2,26,18,8,0,10,1,8,7,26,6,13,4,2,0,8,14,0,14,7,5,12,9,4,2,13,4,8,2,4,1,11,8,0,13,3,3,1,8,10,18,15,7,16,11,6,4,10,8,2,8,5,0,19,5,2,7,5,1,9,70,6,3,6,5,7,3,14,7,0,5,1,9,12,10,5,0,0,7,8,7,5,5,11,7,10,2,2,2,0,4,5,9,4,9,5,0,7,6,3,11,7,6,6,16,7,6,1,1,3,6,0,1,2,2,3,4,7,0,4,0,1,4,1,9,6,2,0,3,9,1,3,8,2,4,2,5,4,1,1,4,4,9,5,2,1,2,6,4,21,7,5,3,8,8,9,3,9,11,3,5,5,5,1,4,1,9,3,4,2,9,5,5,0,1,11,14,7,5,22,7,11,4,6,5,5,16,13,6,3,2,3,6,6,6,10,4,5,4,7,4,3,4,4,4,1,9,3,5,2,2,2,0,7,3,7,2,4,3,8,1,0,2,0,3,4,1,3,5,1,8,1,4,3,7,16,2,4,6,19,3,3,1,8,1,7,3,3,9,6,1,0,4,1,8,7,4,7,4,3,4,5,4,3,2,4,0,4,7,3,2,7,0,4,6,1,9,3,2,6,13,0,2,0,19,5,3,1,3,9,1,2,3,1,5,2,2,6,3,1,7,4,8,1,0,4,3,1,3,5,0,3,2,0,2,3,0,0,11,0,14,1,3,2,6,6,0,0,11,2,5,6,3,0,5,2,2,1,1,3,0,3,3,3,6,1,3,6,0,5,6,1,4,0,1,7,12,7,10,16,1,2,1,0,2,1,0,14,5,9,2,7,3,1,5,2,7,1,4,5,7,2,4,6,5,0,0,3,5,6,1,3,2,4,11,2,4,2,3,0,4,2,5,0,2,3,4,5,0,1,1
community,3,22,29,118,12,31,5,54,8,7,16,24,31,116,6,12,17,26,15,8,6,64,68,64,34,34,61,56,28,49,5,239,185,56,75,162,31,5,16,12,16,29,7,22,64,9,33,26,220,138,48,20,34,92,76,9,46,23,60,40,9,13,7,23,31,22,179,16,18,29,30,3,24,9,175,20,53,6,74,56,58,7,11,20,190,31,17,2,20,1,16,10,15,44,58,23,27,11,52,30,10,35,24,24,25,49,7,26,22,10,32,8,18,44,51,42,3,8,45,103,56,100,37,111,16,13,11,6,4,6,53,13,36,67,50,184,9,15,13,14,17,71,17,3,9,138,21,42,21,12,57,14,17,25,15,40,80,12,7,139,24,4,22,8,19,69,12,31,43,20,32,178,50,4,39,8,139,9,6,122,30,20,43,54,4,44,34,31,36,46,5,8,8,11,1,8,32,15,17,35,117,5,6,11,17,35,1,44,18,34,136,58,25,24,19,39,5,13,19,11,4,22,10,14,55,126,31,38,9,9,16,8,34,22,54,24,35,24,18,19,89,73,11,15,26,7,8,79,69,17,14,32,30,8,8,15,5,4,2,22,11,45,7,2,6,35,34,49,35,8,116,16,16,11,5,17,41,3,5,0,171,8,2,39,15,11,43,34,14,13,1,13,21,13,11,6,29,8,13,26,35,19,1,3,14,2,34,8,38,6,4,16,50,36,39,21,39,33,28,16,58,10,54,68,91,3,26,74,6,35,16,20,15,8,13,12,32,5,9,7,10,26,49,10,5,12,37,64,38,68,13,16,13,54,26,12,12,7,13,45,31,15,19,17,6,31,31,11,39,75,7,91,5,1,20,34,9,7,40,5,66,4,33,24,27,26,49,28,28,5,22,17,13,5,19,20,39,2,26,6,31,23,10,28,11,20,17,3,29,36,25,8,2,32,3,38,15,16,10,30,16,14,22,17,8,11,8,11,3,14,22,0,1,12,30,10,12,22,30,4,25,14,5,20,7,7,65,24,27,20,48,6,38,3,32,8,21,0,18,17,36,51,49,71,4,8,64,7,11,7,53,15,1,9,7,70,3,11,34,16,10,20,6,13,16,5,11,19,6,3,52,30,11,7,31,5,5,11,12,18,23,11,5,12,18,98,9,11,5,10,9,10,5,7,23,13,9,14,6,12,5,37,7,26,13,7,34,14,18,39,12,25,8,18,7,12,4,16,56,20,8,3,8,19,12,2,1,27,15,14,13,1,5,45,18,9,18,5,10,7,20,3,17,2,10,20,20,5,28,44,11,3,3,7,3,2,11,4,4,23,5,5,17,39,6,17,10,10,10,11,29,24,24,8,48,12,21,11,16,16,14,3,6,1,1,18,5,8,8,5,34,9,10,5,31,4,20,7,6,11,27,12,7,31,8,10,3,11,14,39,20,14,43,36,9,11,20,11,13,12,39,21,7,12,3,11,4,4,6,95,19,9,4,4,9,24,23,29,6,5,6,8,0,4,3,0,2,4,6,7,23,8,9,23,18,6,1,4,1,3,6,28,13,4,14,3,23,5,3,6,6,54,14,4,5,10,16,0,19,8,4,10,1,8,7,11,13,17,1,0,2,0,5,23,8,11,21,6,7,5,4,11,8,24,16,13,4,6,6,13,3,12,2,16,5,0,3,6,8,19,11,3,9,1,1,7,12,48,6,2,18,5,0,2,2,9,3,5,8,7,3,13,0,6,27,37,53,11,13,8,24,2,14,14,3,13,19,5,15,14,7,6,19,9,11,6,4,1,4,11,8,11,5,6,15,26,2,5,5,0,6,5,7,3,27,5,13,5,10,3,3,2,2,8,8,2,6,18,6,7,2,1,2,2,1,8,21,1,19,1,16,2,30,7,13,12,9,21,8,9,2,8,0,7,8,8,4,7,8,31,6,14,14,5,0,10,15,6,6,7,3,8,10,8,6,6,11,0,10,7,4,12,4,29,4,6,2,2,10,9,1,2,1,2,4,4,8,4,6,2,26,6,35,2,7,1,3,1,9,22,10,4,13,9,9,1,0,18,1,10,7,13,5,3,3,1,8,0,8,4,4,2,4,3,4,4,4,6,1,8,5,12,6,5,7,0,13,5,5,11,5,23,3,2,7,19,11,3,16,9,6,10,3,7,5,2,3,16,5,6,4,5,8,2,7,0,0,4,8,1,7,4,15,23,3,12,25,7,12,3,7,9,3,13,7,2,11,35,6,24,9,18,2,9,10,9,11,2,8,19
often,3,17,9,77,10,11,9,38,1,3,10,8,16,86,4,23,8,20,9,7,3,27,15,32,51,15,14,10,12,15,7,143,104,18,54,36,27,11,16,4,9,19,4,2,28,18,14,12,184,26,46,13,12,30,14,4,35,13,5,17,8,4,1,7,22,12,89,7,7,17,11,4,5,6,110,21,28,4,50,41,39,4,6,6,170,21,17,2,19,0,2,12,7,10,53,17,13,5,21,13,4,23,31,18,19,29,9,11,13,13,17,3,7,12,6,27,2,4,61,123,51,26,28,44,10,3,5,6,7,2,16,1,7,40,26,91,10,3,3,7,12,32,23,4,13,47,13,25,15,12,58,2,9,4,8,45,38,10,3,19,17,6,14,1,2,16,7,35,34,9,11,98,38,4,7,12,143,4,8,50,19,12,9,34,5,36,51,29,48,33,15,15,9,2,3,5,23,10,14,24,49,7,3,6,18,9,5,49,9,19,70,4,24,17,8,15,3,8,11,0,2,20,5,8,29,126,35,31,6,2,14,11,13,25,35,19,40,11,12,28,76,46,8,10,35,10,4,30,29,9,6,22,10,6,6,25,14,0,0,24,17,18,15,0,7,20,5,8,5,5,122,2,20,5,5,3,15,5,3,3,59,20,7,26,10,8,1,13,20,0,1,5,15,8,5,8,23,7,4,36,39,16,1,1,22,6,17,8,10,5,4,31,21,6,36,20,17,45,29,2,21,10,46,8,75,7,28,30,2,33,17,19,13,10,11,11,13,4,2,11,6,9,12,11,7,7,28,32,6,18,9,22,8,44,16,4,5,5,23,25,28,5,16,22,6,2,26,18,14,24,2,25,7,20,1,30,8,10,25,4,42,4,44,5,10,33,11,18,23,7,32,4,13,7,15,6,47,5,42,4,19,8,6,1,14,16,20,1,12,13,7,10,3,27,10,5,2,9,5,4,13,9,27,14,8,6,2,13,12,11,3,4,0,5,10,1,3,3,8,8,12,16,8,5,2,1,7,10,43,6,14,2,2,1,38,11,2,8,30,31,24,17,30,50,11,0,17,18,11,6,24,14,4,6,4,24,4,18,25,9,9,7,2,5,15,6,8,6,13,3,38,31,7,11,10,7,3,11,5,21,14,7,1,1,5,20,12,17,6,15,5,6,7,17,17,10,4,21,48,12,3,28,9,29,10,7,35,37,20,32,10,15,11,15,21,11,11,16,44,37,7,5,9,20,12,9,7,13,18,7,31,6,17,29,25,10,28,8,6,4,17,14,13,4,7,14,11,13,21,48,7,6,7,8,6,4,7,9,6,12,6,13,12,21,7,7,8,11,5,12,17,41,12,9,95,6,2,13,7,14,15,2,4,0,5,18,2,36,11,3,48,14,5,7,55,11,17,12,7,4,10,5,2,15,5,3,1,7,13,22,4,23,49,40,20,5,23,7,5,14,20,9,36,15,5,9,5,3,9,80,1,4,7,3,10,12,19,13,13,9,5,5,3,5,2,0,1,6,15,10,15,12,15,59,13,10,2,4,2,6,3,22,15,12,8,6,7,6,1,3,7,10,9,9,3,4,16,2,10,5,1,7,4,16,7,4,7,7,3,1,6,2,3,12,8,9,1,2,5,9,9,8,2,12,5,5,12,8,3,21,9,5,6,10,5,5,11,9,18,3,18,4,4,13,8,3,12,5,2,7,13,4,1,3,3,9,3,3,1,8,10,10,0,5,10,17,10,15,14,6,5,5,3,15,4,10,3,5,0,7,1,2,17,8,14,7,5,1,8,7,4,10,5,5,20,22,15,7,2,7,5,1,8,3,7,6,2,8,19,2,8,2,5,4,5,4,2,1,1,7,5,3,3,4,1,7,3,5,6,5,11,5,7,2,7,10,6,40,7,5,1,11,10,15,7,7,8,8,6,16,19,23,9,6,2,6,16,5,6,4,8,9,6,2,2,8,6,5,7,4,3,5,7,8,10,5,1,1,17,2,0,1,5,4,1,2,4,3,4,3,5,11,0,1,9,8,3,1,4,4,5,3,7,3,7,0,2,5,8,16,2,7,3,6,5,2,3,1,6,1,4,3,3,9,5,8,2,4,4,8,5,2,5,3,4,3,3,1,5,2,6,11,0,1,7,9,7,11,19,2,0,9,3,3,6,2,0,3,4,3,1,2,5,7,5,7,1,10,16,8,4,1,19,6,3,5,1,11,9,1,5,9,8,3,15,12,12,5,5,2,8,4,1,0,3,4,5,0,4,3
service,4,46,29,408,39,10,9,50,8,5,29,15,25,101,5,5,13,26,12,7,13,115,24,51,53,46,28,31,17,49,69,573,263,108,181,99,81,14,11,22,15,11,5,25,86,34,57,100,478,58,111,7,12,71,39,10,168,200,19,34,24,4,7,16,59,23,135,32,7,93,91,21,6,13,146,14,49,13,174,33,282,3,31,16,389,36,52,3,142,8,22,16,23,60,96,46,27,40,65,30,54,101,57,9,62,109,48,11,38,15,45,17,52,32,25,57,16,16,245,292,90,47,12,337,30,6,9,10,21,7,14,9,15,179,29,191,7,23,11,12,4,74,93,24,5,125,19,34,51,60,75,7,39,22,8,74,75,29,5,44,56,3,33,10,14,37,30,54,68,11,63,177,57,8,8,23,411,27,20,153,81,21,26,79,11,78,101,36,51,107,1,10,10,5,4,16,38,28,52,23,61,21,5,19,97,31,9,144,25,51,202,14,76,37,10,6,8,14,69,10,25,43,22,39,196,289,100,58,41,62,63,82,78,38,77,75,58,28,20,18,179,71,27,8,26,23,10,68,249,12,34,44,27,28,34,35,31,10,17,142,78,106,44,11,16,333,27,13,10,18,310,30,109,24,17,3,46,121,35,12,137,28,3,61,25,13,72,44,27,5,4,9,40,35,10,28,115,9,12,43,38,164,21,10,24,14,33,38,15,1,16,60,103,19,144,132,83,120,13,37,72,12,58,13,67,14,22,60,9,56,4,52,13,35,8,33,39,19,14,28,8,34,57,20,24,12,130,71,50,33,40,15,17,80,45,69,21,31,25,111,70,94,33,35,5,6,53,22,35,34,19,63,9,34,30,1,97,12,25,13,137,7,121,35,39,72,25,55,58,5,37,18,20,6,78,22,110,54,108,28,25,9,10,5,21,10,18,2,50,57,4,39,8,63,14,15,10,9,4,5,8,42,37,17,5,10,14,35,27,31,12,26,33,52,13,8,4,5,45,16,50,47,20,6,8,5,33,13,102,25,43,20,12,0,109,62,0,13,17,92,27,49,60,257,63,41,33,33,23,1,64,1,9,7,17,54,5,29,79,19,14,17,7,15,17,11,40,4,11,108,328,103,8,1,18,17,18,57,23,17,26,26,16,13,34,31,15,34,24,17,16,13,18,43,43,29,4,13,12,17,7,26,19,42,9,12,56,13,31,65,19,8,13,37,36,26,22,15,78,78,8,3,9,11,8,14,3,34,16,36,40,18,22,82,44,58,67,20,9,28,57,19,105,22,39,51,28,25,93,101,29,31,93,12,29,8,8,15,9,74,7,50,28,36,15,6,16,24,15,46,66,69,24,25,59,4,16,17,34,34,44,13,7,4,8,42,21,87,49,10,58,122,45,15,70,11,36,20,17,18,40,5,25,33,33,33,15,26,60,110,7,103,40,21,49,13,23,41,26,74,43,2,20,62,15,167,41,21,20,262,43,10,15,31,7,39,80,12,7,41,18,9,14,20,5,8,1,11,20,14,110,15,44,29,37,16,34,41,13,14,11,91,28,28,47,63,20,18,12,47,31,34,27,39,15,46,18,8,19,31,9,15,19,17,136,27,44,34,6,14,8,34,6,61,45,258,79,11,26,126,54,22,13,264,33,24,9,23,47,38,31,62,6,16,4,38,210,23,48,23,24,10,12,71,57,19,46,30,39,30,24,40,54,99,59,57,11,64,28,46,40,31,20,24,73,27,36,24,14,10,33,5,10,63,32,45,21,14,35,24,10,9,39,4,28,30,12,18,28,57,32,19,8,20,58,41,43,28,25,56,12,7,22,9,8,10,6,26,33,28,6,11,19,19,17,18,9,23,11,30,10,26,6,85,25,2,12,18,6,8,32,30,22,11,8,7,39,47,18,31,13,9,7,13,15,51,28,6,33,19,15,57,13,13,13,28,31,7,12,19,9,7,23,6,10,25,5,8,9,70,43,13,12,9,14,6,6,3,29,9,10,20,20,9,24,20,15,18,18,20,17,36,6,7,9,14,22,12,29,17,12,16,20,9,8,10,5,13,19,46,26,16,13,36,20,12,27,15,24,12,10,16,20,6,6,25,0,21,13,9,16,6,7,17,18,22,28,23,12,69,27,27,71,6,22,43,15,95,108,6,93,14,37,42,26,30,49,21,91,6,1,10,21,59,7,77,14,51,6,16,26,8,22,13,11,10,81,8,25,10,139,15,16,6,12,1,22,34,6,3,23,24,26,2,5,12,9,23,12,0
perform,1,26,18,100,8,0,4,26,4,5,11,6,4,43,4,9,6,20,5,2,1,34,8,15,18,10,7,7,7,17,22,134,93,9,53,49,49,3,3,4,3,13,3,3,37,15,9,15,197,21,37,12,12,21,16,6,158,30,2,10,11,6,6,6,16,2,54,13,3,29,7,5,3,7,68,2,12,3,81,14,52,0,13,7,162,13,8,1,24,1,7,4,0,13,27,14,8,4,26,8,5,22,16,10,19,23,6,3,8,3,16,2,8,16,2,26,4,3,64,135,30,16,12,55,8,6,1,2,2,2,11,5,7,41,18,39,5,4,10,2,5,29,19,2,0,43,8,8,13,12,43,1,11,6,5,24,22,7,4,11,10,1,9,4,1,6,11,11,23,10,14,71,20,3,2,8,93,10,8,30,18,14,1,17,1,15,26,18,25,40,2,4,3,0,7,5,10,2,6,12,18,5,0,4,23,11,3,21,5,18,67,3,20,8,4,0,1,2,10,0,2,20,9,9,54,91,18,19,10,7,13,18,17,10,25,22,10,5,7,14,64,22,4,7,11,1,7,23,41,3,10,5,14,4,8,15,10,0,5,22,3,24,15,6,7,53,8,1,9,4,105,3,28,5,4,2,10,5,7,2,57,2,4,12,7,0,4,4,24,5,1,7,16,5,3,7,20,2,4,20,19,43,3,5,5,2,25,13,12,1,1,13,27,2,21,16,8,35,5,5,32,4,27,7,56,4,7,11,3,19,1,12,7,10,8,5,20,6,2,5,9,7,14,8,4,9,24,41,9,1,8,9,9,22,26,7,7,8,9,18,7,17,6,15,6,1,25,7,4,12,5,10,3,9,8,97,1,8,16,4,87,1,36,10,5,18,9,19,16,5,19,1,14,12,24,4,32,12,31,11,19,2,4,1,5,7,5,5,8,13,6,9,2,19,10,6,3,2,3,1,9,7,9,6,4,5,2,17,11,11,1,2,2,8,4,1,0,0,9,6,6,17,6,4,5,5,6,3,28,7,15,11,3,2,35,19,6,3,12,25,15,27,22,52,24,9,5,8,6,1,17,2,5,3,9,19,3,15,24,8,6,10,1,4,6,8,9,2,5,9,79,39,1,3,2,4,1,11,4,16,6,11,0,0,3,30,4,10,6,4,5,5,2,6,11,18,2,15,3,10,7,14,4,31,4,4,25,11,7,30,9,2,1,14,8,6,7,14,36,11,2,5,2,10,4,6,2,18,10,8,37,14,11,28,13,17,18,2,2,11,14,2,23,3,17,13,10,8,18,28,6,13,17,1,7,5,12,8,6,5,3,10,8,4,6,8,4,10,5,11,14,29,10,3,18,4,10,5,36,11,12,4,5,7,3,23,4,26,5,5,22,23,14,5,36,8,9,1,8,7,9,6,2,15,7,6,1,7,13,37,2,16,13,21,10,2,7,3,6,23,20,3,19,18,3,24,3,10,2,115,11,6,4,1,5,8,33,5,8,9,7,4,5,6,6,4,0,4,8,9,26,5,31,34,24,11,11,6,2,4,2,27,12,12,8,10,13,2,7,20,10,13,8,21,8,10,7,0,18,17,4,8,4,5,17,10,13,7,1,3,4,2,4,23,9,70,23,8,4,29,14,3,3,95,9,5,8,7,9,13,6,18,0,7,0,5,47,15,20,12,7,6,2,19,15,1,11,7,11,16,8,2,0,9,3,24,5,10,2,7,6,18,2,3,13,7,7,9,5,9,5,2,2,9,7,11,1,6,17,14,4,8,7,3,3,4,3,2,7,16,11,15,3,6,5,15,3,4,2,0,5,5,14,4,4,21,2,9,13,3,1,0,7,4,6,3,5,3,3,10,1,3,5,18,1,6,5,11,10,4,9,1,17,6,7,5,12,18,14,8,2,8,6,8,3,8,7,3,6,15,19,15,11,2,4,4,6,1,8,3,6,2,12,11,10,8,2,8,5,13,4,2,4,5,8,5,1,6,10,2,3,4,4,1,12,1,7,4,7,5,1,3,2,3,4,4,1,6,4,5,5,8,8,10,9,3,3,8,7,17,5,4,7,5,7,0,7,3,5,3,5,2,4,6,3,6,1,4,6,8,6,1,6,6,8,3,3,1,6,12,4,11,6,1,2,14,4,9,18,4,14,5,8,7,4,0,18,9,20,1,0,1,5,14,0,8,9,0,3,5,11,4,7,1,3,2,1,5,5,7,22,11,7,2,7,2,8,0,15,2,6,6,3,0,0,3,4,4,1,2
profit,2,3,2,36,5,3,6,9,0,4,3,2,8,31,2,5,1,13,1,1,0,10,15,6,15,6,4,7,3,9,3,66,62,2,31,23,15,9,26,0,8,1,2,4,27,7,8,13,63,11,20,2,21,15,5,2,31,10,0,6,5,2,2,12,17,4,42,6,1,10,9,3,1,3,36,8,14,2,34,6,53,11,3,5,73,18,11,0,10,3,2,3,14,8,44,26,9,5,8,18,3,6,16,8,5,10,4,7,10,4,9,2,5,21,9,16,0,0,24,106,16,10,50,34,6,1,2,1,2,5,0,7,3,28,8,16,3,3,5,7,3,20,7,1,3,26,10,8,14,11,32,3,8,5,2,12,26,9,2,15,18,2,9,3,15,7,1,13,13,1,8,34,19,1,3,6,72,2,4,38,10,5,3,5,2,23,18,9,9,16,1,3,10,0,0,5,10,3,10,9,40,2,6,6,9,5,7,26,6,8,34,5,12,8,4,1,1,1,2,0,5,10,2,7,18,44,9,17,2,9,3,7,19,14,17,30,8,7,16,1,23,22,8,2,8,1,1,11,15,6,9,24,7,2,8,9,4,3,1,11,3,4,5,1,4,17,6,6,9,5,60,8,23,0,0,0,11,9,3,0,26,3,2,10,12,2,0,3,7,1,0,1,8,4,1,6,26,6,0,12,8,8,1,3,10,0,6,0,1,1,3,8,13,6,39,14,21,30,18,1,6,4,10,6,21,2,6,11,1,8,0,10,4,3,7,3,13,0,3,6,5,2,6,9,2,4,16,18,8,11,5,4,0,28,7,3,5,0,10,21,10,8,7,10,4,0,15,5,4,6,2,14,6,7,10,12,8,1,10,6,24,0,21,4,3,6,2,7,12,1,9,2,3,2,7,7,16,4,12,1,5,2,1,0,8,12,5,1,22,5,4,13,10,2,3,2,2,2,2,2,6,1,6,4,2,4,1,8,5,10,5,2,0,2,1,0,0,1,2,2,10,9,3,9,5,1,8,1,11,7,4,2,3,1,21,6,0,0,6,11,7,13,18,13,1,3,11,3,8,0,5,4,0,2,2,16,0,1,13,4,4,5,0,2,8,1,7,1,0,1,27,6,1,1,8,1,8,3,2,6,12,3,0,1,10,23,9,9,8,3,9,1,3,11,9,5,1,6,5,9,1,9,9,13,4,1,19,10,7,15,6,2,0,7,3,1,1,6,21,13,0,1,0,25,13,1,1,16,2,3,4,2,3,8,10,9,15,3,1,5,7,3,5,5,8,11,5,1,21,13,7,3,1,2,5,2,17,7,3,4,18,3,13,5,3,4,8,4,1,7,6,8,14,3,28,5,3,26,0,7,6,2,4,0,2,17,2,3,12,8,11,9,4,5,10,3,15,13,2,2,8,4,2,5,5,6,0,5,9,10,7,3,15,13,8,4,12,8,2,6,9,5,4,9,2,8,5,1,5,26,5,9,6,1,6,2,23,7,1,9,4,5,1,2,0,1,0,2,2,3,7,3,3,4,4,5,0,1,0,4,1,15,1,3,3,1,5,1,0,2,2,3,0,4,4,1,2,1,12,7,3,0,0,5,5,2,10,2,6,0,1,0,1,9,10,5,0,1,2,2,2,3,1,3,3,3,3,5,1,7,2,6,12,8,4,2,5,2,5,4,10,3,2,5,2,4,15,6,2,3,3,3,2,2,9,3,4,5,0,8,22,10,0,3,6,25,2,7,11,4,3,2,4,5,1,5,2,3,8,7,3,3,8,9,8,4,3,0,3,8,1,1,1,3,15,7,10,0,2,1,3,2,4,1,0,0,2,2,7,3,9,1,2,5,5,1,0,1,1,7,1,1,0,3,0,3,1,1,5,4,5,2,5,1,2,8,5,14,4,0,1,0,0,2,11,13,8,0,0,1,0,7,2,9,4,4,2,6,0,0,4,2,2,3,3,4,6,3,1,10,1,2,1,16,5,2,0,0,2,1,0,7,1,0,4,1,1,2,0,0,1,6,1,4,2,1,1,3,1,2,5,0,2,2,1,0,0,12,0,7,1,1,2,4,0,1,1,12,5,2,2,0,3,15,0,2,0,0,2,4,0,0,3,1,3,2,2,5,4,6,4,7,2,2,4,12,4,4,17,0,3,1,0,0,1,2,3,2,5,0,0,2,2,8,3,0,0,1,3,0,2,1,6,3,1,0,1,2,6,1,14,3,1,3,2,3,8,1,2,0,6,0,1,0,0,15,8,2,1,0
spirit,4,21,16,115,19,16,18,99,5,9,48,17,15,150,5,36,7,16,30,12,11,48,47,47,38,27,40,42,20,33,17,199,188,29,72,163,75,3,8,22,9,42,12,10,51,31,23,16,402,92,76,20,29,81,23,21,81,18,24,40,26,18,3,20,29,23,200,17,22,15,19,3,10,8,128,23,30,9,97,58,41,3,10,18,268,13,12,3,22,0,11,13,2,38,110,9,17,10,56,17,12,41,46,17,29,35,7,6,14,8,20,10,9,21,5,40,3,5,100,244,60,64,26,68,12,15,8,6,1,2,35,4,30,45,56,89,26,6,10,20,15,56,34,6,11,98,16,37,15,6,102,5,26,9,13,27,60,10,35,40,7,2,12,2,1,20,5,39,35,11,15,129,40,3,11,21,233,8,25,57,47,22,11,31,7,49,49,26,58,73,2,11,8,2,5,5,15,22,10,39,46,1,5,12,40,16,4,46,20,45,101,27,26,16,15,10,1,5,13,3,2,35,12,17,53,135,44,28,6,6,18,12,14,32,54,25,52,17,12,21,93,51,11,23,50,9,11,44,32,7,10,41,29,6,13,24,14,4,9,17,5,40,19,0,18,21,4,30,37,8,166,5,20,10,7,9,22,2,12,2,111,22,2,49,14,2,9,6,34,8,5,9,12,9,3,10,42,4,8,59,38,20,0,2,15,5,67,9,24,2,9,14,35,13,38,23,21,71,23,11,71,17,30,9,128,4,18,65,2,34,12,12,20,9,18,16,20,10,3,13,19,19,35,16,8,14,48,96,22,19,14,19,23,27,36,5,11,10,22,53,32,12,16,47,20,7,45,30,17,32,7,41,5,40,25,25,16,10,1,8,114,8,52,25,19,35,15,38,37,10,64,13,12,10,38,29,72,5,39,9,36,8,17,7,7,36,10,13,30,22,24,28,7,12,11,18,11,21,9,18,25,8,37,26,4,8,2,35,18,21,4,6,8,11,15,7,3,29,10,5,28,27,14,21,5,5,25,17,40,11,35,14,17,9,76,16,13,15,14,58,25,63,54,108,16,7,35,11,6,9,47,9,10,7,7,83,16,20,29,6,14,33,8,12,23,23,16,13,8,7,104,45,16,18,15,8,8,17,27,18,26,6,6,4,8,31,5,29,5,11,7,9,12,8,23,24,10,19,6,23,12,37,10,45,7,6,35,30,21,37,30,23,9,21,10,10,23,23,62,24,4,4,7,7,9,11,10,27,26,6,65,7,12,46,9,23,35,7,6,8,32,9,18,4,27,23,27,4,45,45,21,14,4,4,8,15,10,6,8,16,7,14,17,43,15,39,7,17,3,25,44,52,14,2,56,15,25,8,75,40,37,1,9,14,8,22,9,42,5,9,33,13,9,15,25,6,32,8,8,6,17,5,4,16,1,8,5,8,22,20,11,10,50,33,10,9,24,9,6,11,30,13,19,26,11,14,6,7,14,212,20,8,11,8,13,23,45,41,8,19,12,12,35,24,8,9,4,14,10,8,23,17,73,17,45,12,3,10,7,6,8,41,19,12,11,9,23,9,5,9,15,33,15,18,5,9,12,4,26,17,11,16,8,8,10,11,35,20,11,2,5,6,13,49,15,15,12,20,10,5,8,22,16,15,4,5,5,3,9,17,8,23,4,14,7,1,17,10,29,23,15,15,4,10,14,3,13,8,5,7,24,0,1,4,2,9,12,14,3,8,8,19,2,0,22,37,15,8,10,5,8,5,2,24,8,16,11,4,3,18,6,7,20,4,18,12,10,34,10,15,12,6,5,19,28,24,7,4,4,5,6,4,26,5,24,8,22,6,21,7,16,12,13,4,9,8,9,10,8,14,8,6,11,7,1,6,15,6,5,13,4,12,34,12,18,28,19,39,12,9,3,12,7,8,7,10,9,8,9,26,38,27,13,9,2,5,23,6,7,1,4,7,7,14,9,10,4,2,18,9,2,15,3,13,6,20,5,18,20,4,7,5,4,8,4,4,10,7,7,5,10,8,0,14,8,15,7,4,3,15,11,9,11,13,25,0,7,12,5,33,7,5,14,10,14,6,1,4,8,4,14,14,4,15,4,3,5,13,6,9,4,10,11,16,5,4,2,3,13,16,4,16,3,2,8,12,11,6,16,10,4,9,14,5,2,0,5,7,10,7,2,4,3,3,0,10,4,0,6,11,17,17,12,19,6,7,7,14,8,4,1,11,3,6,14,8,26,6,25,7,8,10,7,4,0,1,6,12,1,19
source,4,5,6,99,2,2,3,19,2,3,9,1,6,37,5,9,4,19,7,6,1,27,4,17,11,4,6,2,4,5,2,109,82,8,36,33,31,12,15,11,3,5,1,2,21,14,13,10,160,12,28,3,23,21,11,5,47,35,1,11,9,5,4,7,10,3,74,6,2,6,30,2,9,7,65,12,16,1,45,19,51,2,11,5,147,16,13,0,38,0,3,1,0,33,39,8,15,5,26,12,6,12,28,6,4,20,14,2,11,8,13,5,8,15,4,18,6,1,40,88,19,8,19,93,6,3,5,1,2,0,10,5,3,40,23,20,3,4,0,6,1,18,19,0,0,31,3,9,19,16,36,3,8,4,3,17,24,17,3,9,4,2,5,4,3,4,11,12,17,6,15,47,8,2,3,1,122,5,12,29,15,12,6,9,1,14,27,7,19,28,3,3,11,1,0,5,14,4,7,18,26,0,5,7,13,6,5,22,13,22,53,3,24,6,3,5,8,9,10,2,38,13,1,11,36,63,29,18,2,18,6,18,24,12,31,75,30,10,6,6,40,14,10,1,11,8,5,12,35,2,7,21,12,26,14,10,10,0,3,8,1,9,14,1,6,40,2,4,14,3,93,21,98,2,3,2,12,56,8,0,37,10,2,14,7,2,7,8,8,2,1,2,4,15,0,7,32,10,5,14,22,25,5,3,10,4,9,7,6,1,2,6,25,7,26,18,8,17,10,5,29,3,19,1,20,7,5,20,2,13,1,12,5,5,7,11,9,5,5,13,10,3,8,8,3,3,28,25,17,7,10,7,3,19,17,1,4,4,11,70,19,8,6,7,0,3,21,2,2,8,1,14,3,5,4,13,4,6,8,1,39,4,35,5,0,56,2,19,51,6,17,5,8,7,20,9,45,6,15,7,12,0,1,2,5,5,5,2,9,14,2,4,3,15,5,5,1,9,0,1,4,5,11,5,2,5,5,8,3,15,10,14,16,8,0,1,1,5,6,4,12,18,7,8,2,2,6,6,22,14,14,6,2,4,39,3,2,5,4,20,4,17,16,7,4,1,13,18,14,1,7,5,0,2,3,5,3,13,13,4,8,10,3,3,4,4,8,4,1,5,46,42,3,3,10,6,3,13,5,9,11,3,6,1,2,14,9,5,3,0,12,2,9,2,6,20,5,8,6,9,1,8,8,15,7,4,15,8,8,18,4,3,3,5,7,7,7,6,31,25,6,2,0,6,16,4,5,15,10,6,21,2,1,28,1,0,18,1,10,6,16,1,11,4,12,13,15,4,28,26,12,12,17,3,1,1,12,4,3,38,7,12,9,18,8,2,6,7,2,3,17,23,2,6,11,10,2,2,29,18,17,1,5,3,1,15,3,8,4,13,12,7,8,9,12,9,15,2,3,3,5,4,3,13,6,4,6,8,9,18,5,17,23,14,5,0,5,11,2,4,8,0,1,12,2,38,1,2,1,68,7,8,4,4,2,5,23,10,1,11,5,2,7,16,2,3,4,3,9,16,17,9,35,5,16,10,5,3,1,7,0,16,8,11,7,14,9,3,4,2,6,5,14,6,5,6,5,2,14,12,1,0,2,3,6,5,20,5,2,6,0,15,8,17,21,7,4,5,5,6,2,6,5,12,0,14,6,1,3,11,11,7,13,5,11,2,6,8,19,7,6,1,0,3,7,7,12,3,5,4,15,78,38,49,36,13,9,8,4,9,5,14,3,3,12,15,6,7,8,9,3,6,1,6,5,7,6,3,8,7,3,5,7,4,7,6,4,19,8,10,3,9,4,2,5,19,0,3,4,4,3,3,11,5,4,2,14,3,11,4,7,1,3,5,2,3,1,6,4,15,5,15,0,3,7,9,6,3,4,10,19,14,16,2,10,9,6,24,5,9,6,5,1,3,5,12,5,5,5,4,4,9,2,24,4,1,4,18,4,1,0,3,7,1,1,3,4,0,4,6,4,5,2,5,4,5,1,3,6,1,1,3,2,0,8,3,6,4,6,4,5,21,3,1,4,2,3,1,5,4,6,3,4,7,2,6,1,4,26,17,2,26,4,28,14,6,0,8,4,3,9,3,3,4,1,3,1,2,3,7,5,0,4,9,5,6,2,15,2,11,4,7,38,27,32,31,19,57,100,4,3,0,1,2,8,22,0,1,15,9,18,5,4,2,0,5,9,6,5,2,5,3,6,2,6,4,0,8,5,11,4,4,6,3,4,10,7,3,3,1,4,1,9,0,1,18,2,8,1,4
shall,22,251,87,971,63,22,16,305,27,19,113,45,57,428,28,88,32,96,34,28,30,200,65,228,117,103,77,66,40,127,70,921,589,40,249,336,283,46,48,25,54,90,12,10,199,112,183,65,1774,96,154,44,104,182,28,46,404,101,15,86,86,56,17,97,113,29,643,40,46,68,49,34,23,14,509,66,105,21,486,137,209,9,116,50,1113,98,46,3,157,11,37,23,10,193,314,96,91,13,264,55,70,164,189,56,63,161,74,11,57,29,113,44,43,65,9,144,28,28,434,689,229,63,89,280,37,23,14,23,36,10,86,20,52,285,117,211,70,13,38,27,27,193,108,10,15,351,51,73,73,61,453,15,110,47,31,173,158,35,57,50,54,18,43,24,16,36,15,114,113,64,90,485,106,9,20,51,955,19,84,183,156,92,47,101,37,128,179,131,273,248,11,39,30,7,10,36,90,41,46,81,106,13,13,79,190,75,31,168,61,129,461,26,195,44,15,0,11,30,66,7,21,121,18,87,340,709,98,138,20,49,64,73,118,148,196,139,175,35,47,40,459,188,34,48,76,35,41,126,372,38,71,106,121,67,50,110,46,21,25,96,30,143,159,24,52,171,28,33,86,24,960,25,151,56,21,16,105,99,78,17,333,29,6,91,38,17,30,57,120,10,13,39,143,50,27,59,215,40,59,125,142,258,7,22,57,2,163,38,52,7,27,73,143,34,222,69,77,169,57,38,265,44,135,18,457,61,68,122,25,185,54,62,72,35,79,121,75,34,37,81,50,61,77,68,40,31,263,299,101,19,101,65,45,142,134,35,39,36,97,175,138,44,57,116,35,13,154,48,33,52,20,102,39,66,42,137,87,24,114,39,1,25,319,75,12,165,75,127,137,24,169,38,127,127,159,79,400,40,181,16,154,8,33,9,28,44,34,25,135,57,30,60,21,57,87,56,22,51,29,12,43,38,127,84,17,32,18,53,91,104,76,42,29,61,24,23,5,50,71,31,75,140,62,73,13,23,48,26,176,31,105,43,30,42,242,92,8,111,45,164,99,137,175,180,36,30,71,75,45,6,119,36,22,5,32,154,32,120,108,32,43,78,27,34,49,64,49,38,53,24,398,263,17,24,51,36,18,97,35,57,85,27,31,10,48,116,19,103,50,27,32,28,65,58,95,116,49,63,32,49,31,176,51,184,59,28,116,53,98,179,108,30,32,52,105,32,92,81,228,114,42,29,25,35,42,60,21,92,117,37,521,43,71,307,32,53,123,18,24,69,156,30,134,23,79,71,69,35,229,235,74,56,79,19,41,44,59,22,46,77,40,106,84,88,70,50,33,50,19,84,163,184,57,25,143,21,53,28,291,141,159,21,25,39,38,116,27,177,32,29,107,144,69,67,225,53,114,18,79,25,53,53,31,128,22,47,65,46,79,182,84,125,237,161,51,34,77,41,11,62,75,18,87,92,37,126,32,19,43,906,206,41,21,45,24,68,181,96,37,88,39,50,136,82,54,47,16,47,60,40,105,42,151,220,151,37,21,45,23,55,59,141,80,52,42,65,69,55,36,47,106,85,79,78,34,64,40,53,102,139,40,54,31,25,52,38,80,67,44,32,37,27,47,175,109,90,40,43,64,37,56,30,25,123,6,37,46,10,52,71,40,84,24,39,50,30,80,34,238,67,58,36,22,49,69,28,64,39,33,66,72,46,18,55,24,60,44,93,23,64,77,65,12,18,111,64,46,37,31,53,40,20,11,127,45,79,36,8,50,53,23,35,51,30,35,19,45,58,52,61,60,37,11,28,79,117,23,59,20,32,19,26,76,64,26,31,48,26,90,28,43,20,43,62,31,35,36,67,26,119,22,4,46,70,13,24,28,86,31,28,38,35,60,26,60,40,51,124,84,49,42,66,31,60,22,81,57,46,43,69,149,157,58,32,19,31,37,37,46,15,49,47,47,32,41,29,18,64,51,86,30,33,54,51,21,39,42,71,97,25,16,32,21,26,45,25,21,19,26,40,23,35,4,21,44,21,22,42,37,21,37,31,30,59,104,18,45,63,23,127,37,30,49,78,72,19,23,35,21,23,41,30,27,76,29,41,16,64,41,54,36,23,68,36,30,24,22,44,35,58,31,78,54,58,59,88,63,79,180,42,4,15,29,34,32,27,24,37,124,34,13,29,23,32,10,107,19,6,69,45,37,56,31,21,37,25,10,44,38,56,37,45,39,57,52,35,47,19,72,7,14,36,23,13,4,19,7,26,7,6
guarantee,2,20,2,32,1,8,3,18,1,1,5,2,7,20,1,9,2,3,6,2,3,9,7,15,5,13,7,3,2,4,6,62,28,5,22,27,31,2,0,3,1,7,0,4,7,3,6,7,128,31,7,7,3,21,6,2,9,4,6,7,6,2,1,4,7,1,45,1,1,7,19,0,1,1,62,3,12,5,31,5,7,0,1,7,72,7,5,0,10,0,4,3,8,10,12,6,3,6,14,6,7,10,5,6,4,7,0,1,1,3,4,0,6,12,13,4,1,0,40,16,4,12,3,29,4,0,0,1,1,3,8,2,4,17,4,34,4,1,5,5,6,9,8,4,2,30,5,6,3,0,22,3,5,3,1,12,11,3,3,18,11,0,9,2,8,8,1,8,5,4,21,32,10,2,3,2,42,3,6,17,7,8,11,7,0,12,11,6,9,10,7,1,1,2,7,3,9,9,4,10,10,1,6,2,17,8,4,9,4,11,27,2,9,5,2,17,0,1,3,3,1,10,2,6,13,32,12,4,4,7,2,10,10,11,11,0,6,9,2,1,18,10,5,7,10,1,2,11,16,1,2,2,10,1,2,4,1,1,0,5,4,13,3,0,1,4,1,4,5,2,29,7,1,7,0,0,19,3,1,3,34,6,2,10,9,1,13,18,6,5,0,2,8,2,0,5,9,0,3,10,15,8,2,0,2,5,13,2,3,1,3,5,5,5,15,6,5,8,7,2,21,3,17,3,55,5,4,9,0,8,3,4,3,0,1,11,5,0,4,3,3,4,14,6,0,1,12,13,5,2,4,6,2,16,11,0,5,1,4,4,10,6,6,4,4,2,9,6,8,9,1,7,4,4,4,7,1,0,8,4,25,1,18,2,6,12,2,4,13,1,13,1,5,7,13,0,15,0,9,1,8,4,3,1,3,1,3,0,12,9,2,7,3,7,0,4,5,2,1,5,6,5,3,5,1,1,4,8,1,7,1,0,0,2,3,4,3,4,4,3,6,15,2,4,1,2,7,2,11,1,26,1,2,1,13,5,0,1,8,8,11,5,13,12,2,6,9,13,1,2,6,2,0,1,4,7,2,5,6,6,4,3,1,4,7,8,2,2,3,1,19,1,1,0,4,4,1,2,0,2,1,1,1,4,4,5,3,3,2,5,4,1,1,1,2,3,3,3,3,4,3,18,2,12,2,5,14,12,2,5,3,3,3,2,3,4,1,3,14,2,3,1,0,1,3,0,2,1,0,2,29,3,2,19,2,2,4,0,2,1,1,5,16,1,3,6,1,2,8,21,5,2,0,0,2,2,0,1,0,12,3,3,5,11,3,3,2,2,2,2,6,3,2,1,18,0,1,1,33,5,5,0,2,5,0,3,0,8,4,2,7,0,1,1,14,1,7,2,0,1,3,0,0,3,1,2,2,1,4,7,0,4,11,10,6,2,7,3,1,1,3,7,3,3,1,6,0,1,5,59,11,4,0,3,1,3,8,6,4,5,0,3,3,5,3,1,0,1,2,5,2,2,0,2,4,3,2,0,26,3,15,8,3,2,9,2,10,2,0,0,2,9,1,5,2,4,1,0,2,3,4,1,1,2,2,2,3,6,2,2,5,0,4,9,8,8,3,0,2,0,1,6,3,6,3,2,1,3,3,3,2,3,0,6,0,0,10,0,17,4,2,2,7,5,5,6,3,5,2,0,2,0,4,1,1,2,3,3,3,1,0,8,0,0,9,4,6,0,2,2,5,3,1,5,3,3,4,0,9,6,5,1,3,1,2,1,1,1,3,2,2,2,1,2,3,2,3,5,1,1,1,1,6,1,1,1,1,1,8,1,2,2,0,2,2,1,3,2,2,4,2,0,3,2,1,1,1,5,1,4,1,3,5,4,3,3,3,4,6,0,0,5,3,5,0,3,2,7,2,2,6,17,3,1,2,1,1,1,3,4,0,3,0,2,2,1,1,2,5,1,0,3,0,1,1,2,1,0,4,1,0,2,0,0,0,0,1,2,1,4,10,2,7,0,1,2,2,0,1,2,1,1,0,1,3,0,6,2,2,8,2,16,4,0,4,0,1,0,0,0,0,0,2,2,4,5,0,1,1,1,1,4,1,4,1,0,0,1,1,1,0,1,0,0,1,0,1,3,2,0,2,0,2,4,0,0,1,3,1,0,0,3,5,3,0,2,1,1,0,4,0,5,2,3,0,1,5,1,4,2,1,2,1,0,2,2,1,5,0,0,2,1,1,2,2,1,6,0,0,2
necessary,18,88,24,618,25,19,17,113,8,13,59,33,38,241,21,43,15,48,25,10,16,146,25,87,80,40,54,56,34,58,44,685,417,43,181,210,164,48,78,23,44,19,10,15,126,55,88,54,907,58,141,16,46,119,21,22,269,111,12,68,65,28,20,81,78,15,303,28,28,69,80,28,29,10,330,53,76,25,331,71,219,7,59,25,734,112,80,2,129,10,40,18,3,83,190,68,61,21,124,72,64,112,119,51,28,123,27,14,53,24,54,20,54,57,11,86,17,19,238,520,165,54,56,228,24,10,13,8,25,7,48,10,20,195,76,194,29,23,29,19,12,121,85,11,10,242,13,35,60,79,248,6,68,44,20,97,110,28,19,40,56,17,47,12,16,30,24,75,85,38,54,273,76,10,28,26,606,15,55,182,78,72,34,73,39,84,128,89,112,155,13,19,39,7,11,10,60,20,24,60,94,12,15,43,119,32,35,139,29,88,275,22,87,44,14,10,7,12,55,20,12,80,12,61,206,398,92,97,33,41,53,72,76,89,143,123,108,36,47,31,232,176,22,14,65,33,16,108,224,23,59,93,65,36,39,79,28,14,10,83,29,142,96,18,29,182,28,28,35,20,629,48,104,26,19,5,104,104,45,19,210,32,14,53,27,6,14,47,48,14,17,15,60,42,9,35,127,28,18,92,89,175,6,6,50,8,81,17,34,17,12,75,142,26,142,83,66,133,48,30,146,32,93,15,206,24,34,86,14,83,20,53,25,21,23,63,65,27,27,53,48,39,67,36,35,41,174,181,77,22,63,34,30,142,81,24,6,10,78,142,119,37,40,78,22,5,123,28,31,53,14,77,24,33,44,121,36,21,52,35,319,18,1,41,11,120,19,70,91,11,95,15,46,39,126,40,212,29,144,13,85,15,22,3,24,35,27,12,73,35,7,19,20,69,37,39,27,22,18,17,25,36,96,40,8,22,16,48,36,55,39,25,22,45,23,14,3,44,37,23,51,98,36,35,9,12,53,19,147,49,70,30,18,29,184,30,6,39,31,116,45,77,108,106,28,12,54,47,55,4,95,10,27,7,9,49,14,53,93,23,26,58,6,15,27,29,29,21,25,7,370,157,11,12,50,21,27,51,33,58,38,17,15,9,40,84,28,44,43,27,23,27,32,40,53,65,25,34,32,35,16,84,34,96,48,30,83,39,68,127,50,31,22,42,49,31,62,31,208,95,17,9,6,42,48,49,6,52,52,34,154,33,23,165,50,50,133,20,29,38,98,21,92,25,73,69,54,47,147,141,53,42,117,14,37,14,58,17,33,43,52,81,40,58,43,17,24,25,18,36,79,113,29,25,112,24,22,32,153,80,91,16,31,17,28,101,26,83,35,37,82,117,62,27,117,31,101,13,31,17,59,33,24,78,31,31,28,41,51,112,61,95,92,65,35,15,44,35,17,72,42,5,45,80,33,112,24,24,36,467,62,24,22,25,28,47,128,45,29,47,33,15,44,44,35,24,7,28,38,29,131,37,116,86,64,27,20,43,25,25,47,141,56,34,46,46,51,37,15,53,42,34,59,44,32,71,27,18,57,93,24,19,24,25,29,32,58,41,20,18,17,36,21,121,79,115,45,26,18,38,34,19,28,88,13,15,42,8,18,33,40,77,31,23,24,32,120,24,124,34,50,25,27,44,61,32,68,48,24,33,29,34,20,65,29,45,29,47,23,33,36,40,10,19,68,78,38,24,45,30,34,19,19,54,22,60,44,15,66,35,23,16,33,21,43,25,27,29,21,55,28,37,12,20,56,60,44,34,21,28,33,23,43,34,21,14,35,23,63,29,42,8,37,42,27,23,26,37,30,52,22,9,30,66,35,30,19,36,25,20,35,32,44,34,33,24,38,104,48,42,27,20,16,33,28,57,32,36,23,37,58,112,31,39,25,24,31,28,15,14,26,21,24,19,28,27,9,13,38,44,22,22,42,53,19,19,16,19,39,14,7,30,21,16,64,11,36,24,23,28,15,55,13,13,23,17,33,9,27,23,23,17,13,41,22,11,24,69,19,77,33,58,28,50,27,17,14,37,15,26,35,17,26,56,17,42,13,34,22,29,29,13,17,27,22,22,36,35,11,54,17,46,30,26,55,61,57,114,159,20,18,13,8,33,26,21,17,24,110,25,10,20,20,21,10,87,17,12,13,20,34,19,20,21,17,19,14,29,30,20,28,29,27,37,16,44,25,11,33,9,13,21,13,4,7,15,8,28,11,4
concern,1,20,12,133,3,6,7,33,13,5,43,11,11,78,6,20,9,15,5,6,6,29,6,25,43,5,19,16,9,16,11,171,161,13,68,79,54,5,16,12,4,23,5,5,28,15,23,20,333,60,55,9,25,51,15,11,66,41,6,23,29,13,3,13,19,8,111,9,19,24,2,3,8,6,123,18,16,13,97,23,38,2,9,9,260,9,15,0,36,5,7,4,4,27,86,12,29,13,53,17,16,32,44,10,20,38,2,2,8,4,20,6,16,11,5,27,7,6,68,165,83,31,4,60,5,4,4,7,5,3,15,0,18,53,24,59,6,4,5,12,4,37,27,3,5,83,4,30,21,7,77,2,14,9,15,47,35,7,17,14,6,2,10,6,1,12,4,35,17,6,17,112,33,3,7,16,164,6,13,61,26,11,15,33,7,27,38,30,68,67,1,4,7,4,0,6,14,10,8,14,49,5,6,12,20,16,13,21,6,38,74,7,22,3,5,3,2,3,25,9,8,29,15,12,34,113,23,37,3,2,19,19,17,32,37,10,33,12,10,19,81,39,5,8,25,9,7,25,52,3,9,17,27,9,11,25,10,5,5,13,9,32,31,7,4,52,5,9,13,12,103,11,16,3,1,4,22,7,18,9,63,12,5,24,12,9,26,17,15,3,8,6,10,5,4,11,24,11,4,17,17,18,2,4,24,9,41,8,19,9,9,19,37,8,30,13,38,45,7,12,42,13,34,12,66,6,27,29,7,35,3,13,7,5,11,11,25,13,1,17,12,12,14,12,6,7,60,59,13,16,10,14,13,34,15,7,5,8,13,25,34,14,17,17,5,2,47,16,14,14,5,26,6,24,5,35,10,4,25,5,75,2,41,1,14,31,11,16,16,7,14,3,9,14,52,15,64,12,23,4,21,9,9,5,9,5,9,2,39,14,18,25,21,39,26,9,5,12,2,4,14,20,19,12,4,3,5,12,12,19,8,5,3,5,7,6,1,27,5,11,19,27,12,26,3,12,12,14,47,5,20,12,7,4,76,16,2,12,10,21,13,15,48,39,5,3,18,20,12,1,23,8,12,5,6,44,6,10,23,6,9,14,11,7,11,7,23,5,7,4,77,36,2,3,16,5,9,11,6,12,16,5,2,12,14,14,22,14,3,2,3,6,3,17,12,19,6,7,1,10,6,19,13,25,6,2,38,8,19,34,14,10,5,12,7,11,11,8,31,25,3,15,4,13,11,9,4,16,19,13,24,3,7,40,12,9,28,3,20,9,24,4,18,4,15,13,20,9,42,47,10,11,8,7,8,5,12,5,5,16,7,11,11,21,7,15,6,8,6,10,37,48,7,1,35,7,20,7,62,29,24,5,9,7,10,34,5,29,10,2,26,19,16,9,44,7,18,4,14,3,9,2,1,15,6,5,10,8,10,23,14,32,27,34,7,9,25,7,4,16,20,5,8,24,11,34,5,5,11,211,34,10,10,6,1,14,23,23,5,18,7,10,30,48,11,9,12,15,8,5,9,13,33,22,27,4,9,6,13,3,13,22,14,10,16,7,16,5,2,14,16,16,24,14,4,10,9,6,9,8,25,7,6,10,12,8,12,8,1,5,3,15,3,44,16,14,1,7,9,8,5,7,11,22,2,9,10,3,5,15,9,13,3,13,6,4,30,8,33,9,15,6,3,19,10,7,19,27,13,12,10,3,2,7,3,17,8,12,8,11,10,17,5,2,13,9,21,12,21,14,13,7,10,15,7,19,8,6,5,12,0,7,12,3,16,10,3,12,8,19,11,13,6,13,12,14,7,10,5,6,7,5,20,6,4,7,4,6,20,7,17,13,15,16,9,9,11,9,4,15,7,1,32,12,3,5,1,9,2,4,9,4,11,0,3,9,12,27,7,8,7,10,3,10,6,12,9,23,7,13,37,30,11,0,7,5,12,2,7,10,14,3,7,10,4,8,5,1,17,15,7,5,4,6,5,7,7,11,19,1,3,8,4,6,17,4,10,6,8,5,5,7,3,4,6,5,4,3,4,7,9,4,1,22,4,3,9,12,3,30,12,7,9,3,14,6,9,12,4,5,5,12,4,20,7,8,4,8,12,3,7,6,8,9,3,2,5,3,8,14,3,11,0,0,1,15,6,2,8,2,0,2,3,6,1,1,1,7,8,3,0,2,1,3,2,23,6,3,3,10,9,9,11,12,6,5,5,6,11,7,3,6,2,1,10,4,17,4,26,4,2,10,5,0,4,5,1,4,3,3
woman,2,16,7,71,28,40,5,9,3,8,2,11,27,98,2,12,14,18,8,11,1,16,41,44,17,25,35,23,20,49,5,139,95,63,57,85,30,0,7,7,6,37,4,15,29,5,10,10,84,104,33,17,8,79,81,9,15,6,46,18,5,3,1,12,17,12,73,2,3,7,55,0,13,8,106,10,35,2,49,43,33,0,2,16,71,12,4,2,7,2,8,11,6,37,8,11,12,0,39,21,0,11,7,14,12,23,3,3,13,9,20,2,19,16,33,33,6,9,36,50,26,60,11,76,11,9,4,5,4,3,24,4,25,38,25,142,6,5,7,21,9,31,10,5,2,62,14,23,6,4,16,9,12,9,3,25,53,2,0,72,7,8,7,5,7,31,9,26,16,4,5,92,8,10,20,7,35,6,3,74,17,2,26,20,0,29,26,11,15,30,0,5,6,5,3,0,7,15,11,10,23,4,2,7,6,23,4,10,3,6,65,32,28,10,19,17,0,13,7,3,2,18,4,3,7,57,24,20,8,16,13,5,19,14,30,0,19,9,7,8,41,18,10,9,17,1,3,52,50,15,7,12,16,2,0,15,2,3,0,25,10,54,2,1,3,13,15,32,28,5,30,5,2,7,6,8,28,0,0,6,96,3,6,11,8,8,30,34,6,3,1,10,4,5,3,1,11,5,7,12,14,9,2,3,11,8,14,3,9,2,1,26,24,21,16,9,23,10,4,7,21,4,27,25,43,1,18,53,3,11,21,4,1,2,1,2,18,5,5,2,3,20,37,2,6,4,7,18,9,47,5,9,4,33,4,4,7,0,5,31,25,7,8,9,1,9,7,15,18,53,4,68,5,27,10,39,5,3,19,0,12,6,11,14,1,20,5,19,16,11,16,4,12,11,4,10,13,1,12,6,10,22,0,8,2,6,8,1,3,11,8,1,0,22,0,18,9,7,8,22,4,9,18,2,15,2,4,3,3,4,0,0,0,9,11,2,5,9,24,3,18,8,1,4,1,4,37,10,36,5,28,0,21,2,15,4,14,4,5,4,21,18,17,191,5,3,51,4,3,3,57,17,2,9,3,51,3,1,13,6,4,11,1,7,8,6,2,24,2,3,63,10,5,9,14,4,0,3,2,9,9,3,4,13,3,6,11,0,2,3,2,4,2,3,1,0,3,4,1,5,5,7,0,3,2,6,15,5,6,6,14,11,10,15,3,11,1,15,12,10,1,3,5,8,8,4,2,8,1,4,4,1,5,15,3,5,12,1,7,2,2,2,5,4,3,4,6,4,4,13,5,0,4,13,2,0,3,2,5,23,1,6,8,17,0,6,2,3,0,26,8,13,11,5,44,2,3,15,1,4,7,4,1,3,2,5,3,1,0,1,16,0,8,2,15,1,1,3,0,2,7,1,1,17,4,2,1,2,16,15,7,5,17,14,2,5,7,5,27,3,11,13,6,0,1,4,28,7,12,45,1,5,6,2,5,8,3,5,2,8,1,4,5,0,0,0,0,2,4,0,7,2,0,7,2,5,0,0,1,3,3,17,2,0,1,2,5,5,2,1,6,32,2,2,0,7,5,0,7,0,0,1,1,2,1,7,5,10,1,0,0,2,4,4,4,9,28,1,0,1,0,6,2,6,7,0,1,12,1,4,2,5,1,2,0,6,6,0,10,9,14,0,3,1,1,0,8,5,7,1,6,0,2,1,3,18,1,2,2,4,8,11,4,1,9,13,24,3,1,2,15,12,10,10,0,3,4,4,5,1,1,2,6,5,3,3,4,1,6,7,6,23,14,2,11,10,2,4,0,0,0,5,0,4,16,9,3,6,6,3,0,1,1,3,0,0,3,16,3,0,0,0,1,4,0,0,13,1,3,0,7,0,3,4,5,2,3,11,1,1,0,4,1,5,4,6,2,5,1,5,3,0,5,0,1,3,1,0,1,0,1,7,1,4,1,1,5,1,3,2,5,1,0,1,5,2,0,0,3,1,0,1,1,0,1,0,1,3,2,1,11,2,1,5,0,0,1,2,4,23,3,0,24,4,1,1,1,0,0,3,6,3,2,0,0,1,2,0,6,0,1,5,1,1,2,0,1,1,3,1,7,2,2,0,0,1,2,1,4,3,0,11,1,0,1,2,0,1,1,1,4,1,7,0,1,0,1,1,4,0,0,1,3,3,5,0,0,7,1,2,8,1,8,20,0,0,24,0,3,2,0,1,0,3,1,1,2,14,0,9,2,7,0,16,6,4,8,1,2,14
land,12,39,23,491,13,16,17,86,11,28,38,18,45,221,43,24,15,86,12,9,22,104,27,73,73,41,30,37,26,63,19,578,314,20,129,128,86,157,175,12,13,27,10,14,89,35,100,51,1055,62,131,16,51,108,51,19,73,143,16,57,53,12,25,56,77,17,273,15,20,61,86,8,8,27,192,66,62,8,265,77,162,3,79,27,621,74,75,0,125,9,18,11,5,180,149,77,70,44,106,36,80,114,123,23,69,95,33,22,70,22,61,33,12,57,7,88,22,24,253,488,136,55,19,263,35,18,5,8,5,6,62,16,35,150,52,161,14,18,26,28,10,158,104,20,23,194,33,63,99,78,120,8,49,53,30,85,107,22,31,43,57,61,33,16,9,38,32,63,89,27,78,291,55,26,4,16,574,13,46,125,95,51,20,64,35,46,160,66,97,141,12,29,24,1,10,27,56,18,21,59,62,6,5,32,64,29,74,186,67,164,229,22,109,32,8,9,1,3,157,14,23,63,7,38,119,491,115,61,23,29,59,71,99,126,108,55,118,46,30,22,198,154,26,8,31,11,12,60,121,24,34,86,53,37,43,44,25,12,9,73,9,109,54,14,29,123,28,14,45,20,438,48,126,9,21,3,95,34,42,21,173,21,12,41,50,37,6,47,38,5,25,11,17,17,19,50,88,15,20,82,100,110,8,25,25,13,49,8,26,7,5,97,75,8,95,70,65,117,48,23,130,16,70,36,226,27,15,65,5,99,2,32,16,26,20,162,66,10,17,50,17,36,53,41,36,25,99,141,64,68,39,24,32,222,64,26,12,27,48,69,86,29,72,75,27,8,86,41,18,41,6,86,32,26,33,72,18,6,35,56,165,12,120,31,20,1,15,72,106,7,52,17,28,23,87,44,200,18,108,26,46,9,16,7,36,28,30,12,19,45,7,31,9,61,24,20,19,30,25,6,16,16,47,37,15,13,25,37,19,75,20,43,15,72,14,12,0,24,24,22,34,62,21,25,4,13,55,29,166,29,31,25,10,17,167,19,10,29,15,84,44,49,108,89,14,11,109,88,128,7,62,21,6,28,5,46,12,35,57,54,31,55,22,11,23,13,46,19,16,12,178,134,9,10,16,91,5,42,22,26,59,13,13,1,58,51,77,46,34,45,8,15,21,29,61,71,11,61,15,24,46,59,35,42,20,5,107,33,43,75,28,16,9,15,32,16,51,37,131,281,27,2,12,34,104,23,74,58,26,35,60,20,26,222,18,35,50,32,22,24,70,26,75,6,59,37,30,14,137,148,42,27,49,13,25,16,8,20,18,60,12,68,41,36,26,28,39,26,13,27,58,95,40,32,55,60,7,13,100,38,105,11,25,14,40,66,25,43,30,22,116,71,41,35,82,47,45,30,29,14,49,11,14,53,39,23,60,28,43,159,17,94,80,56,31,5,49,47,19,22,22,7,16,184,19,154,14,27,26,630,66,62,34,17,22,29,119,45,16,67,13,21,21,35,19,15,1,85,33,21,66,15,79,64,93,18,19,29,29,60,21,74,20,25,44,8,17,11,40,36,54,45,53,47,46,41,41,17,36,42,9,7,15,35,35,27,67,29,22,11,9,62,17,48,122,43,40,25,26,20,50,16,11,41,9,75,51,12,6,43,30,86,153,21,126,1,53,12,209,52,51,48,28,43,78,8,45,56,13,29,44,30,18,59,15,33,25,35,29,47,38,34,14,17,101,80,47,29,46,144,21,51,17,61,11,35,37,29,196,50,70,20,25,18,26,44,35,61,22,67,14,56,16,22,62,94,29,33,11,13,14,22,36,8,14,8,12,23,47,16,9,7,27,35,9,14,24,24,39,27,7,14,17,25,104,18,14,39,6,23,17,28,24,10,13,20,20,66,38,14,12,19,11,30,12,20,47,42,24,19,46,66,26,29,20,20,15,222,17,4,12,22,21,15,12,27,30,4,34,65,32,34,20,12,13,22,6,29,27,47,2,14,20,5,76,10,29,19,30,17,22,55,14,15,19,57,19,11,30,21,24,7,8,20,8,31,9,25,30,62,21,39,24,50,36,25,9,13,6,12,15,20,25,12,5,22,8,10,11,10,19,3,20,57,21,30,30,27,12,62,4,41,45,16,25,48,23,58,109,12,12,22,17,10,19,28,37,22,46,57,406,38,15,3,13,54,101,8,4,35,16,11,31,4,14,8,1,11,48,17,4,12,20,16,15,19,15,12,31,4,14,13,19,7,5,11,5,25,9,4
crime,3,14,16,101,7,9,2,15,2,1,5,8,17,64,4,7,12,9,6,4,3,26,30,41,29,19,15,9,6,5,4,133,81,13,43,49,16,1,1,3,0,13,2,16,20,11,11,16,218,37,24,2,4,18,9,11,34,15,14,13,4,5,3,4,6,7,67,3,6,3,7,4,12,12,89,11,31,1,36,17,34,7,6,9,124,8,4,0,10,0,16,10,36,12,13,57,5,2,13,4,1,24,18,7,16,38,0,22,11,11,15,1,4,8,6,20,2,2,62,83,28,19,2,69,21,5,0,6,7,0,13,4,8,51,14,61,6,10,7,9,10,41,18,0,6,64,11,11,14,1,47,1,17,1,12,51,28,1,5,34,7,1,8,8,0,27,0,18,17,8,16,114,15,1,0,14,84,1,25,52,27,1,4,34,0,16,24,15,31,33,2,3,2,2,5,3,5,1,5,20,33,0,4,6,9,5,0,19,2,14,54,19,27,2,7,10,1,5,11,1,0,24,2,4,24,163,15,12,1,2,7,10,25,17,24,4,20,10,1,4,47,19,4,27,22,2,2,14,53,2,8,4,15,0,2,12,5,0,1,11,4,21,12,2,2,27,26,5,16,3,76,6,13,7,9,1,35,3,4,1,55,10,1,21,7,4,6,6,7,7,3,2,25,3,4,4,14,0,5,11,10,30,0,0,12,1,7,9,19,12,10,10,8,8,15,4,12,19,20,2,76,5,35,29,66,25,9,39,4,21,5,12,6,0,10,11,11,9,0,2,0,8,3,5,4,4,34,27,6,6,4,8,0,36,26,8,1,3,5,19,31,6,6,11,8,8,22,12,4,21,0,23,0,49,11,25,9,2,15,2,75,2,19,11,5,15,1,10,17,9,34,6,5,2,9,11,41,5,19,0,27,1,4,6,11,3,7,0,7,8,3,11,0,13,4,9,0,4,0,0,13,4,10,7,10,4,1,5,3,18,1,0,0,5,4,0,0,0,5,4,10,14,1,1,1,9,7,12,23,9,13,2,4,1,35,10,1,18,14,10,9,14,24,28,2,2,15,13,9,3,33,11,3,0,0,49,5,10,7,6,13,7,0,3,5,16,7,0,6,9,50,6,5,2,6,2,1,7,7,7,22,3,0,0,5,5,4,10,8,4,7,2,4,0,6,18,4,7,1,22,1,26,4,21,5,1,43,10,20,29,3,7,13,7,8,8,3,8,24,14,2,1,8,6,0,9,1,11,16,12,26,7,13,22,1,15,3,3,3,6,16,2,7,6,5,11,5,8,15,26,4,7,0,26,3,0,4,2,0,12,1,11,7,8,6,9,2,10,1,5,7,29,7,9,19,8,0,3,52,11,2,1,2,0,2,16,1,28,3,2,14,20,8,4,47,6,3,1,3,4,7,0,1,6,1,3,0,5,5,31,0,20,35,25,33,3,29,4,8,5,17,25,4,11,2,5,4,3,10,128,4,18,5,11,5,3,15,25,5,11,3,7,0,2,0,0,0,3,5,7,12,2,26,68,15,5,1,3,3,3,2,28,8,0,9,2,10,2,0,1,3,8,2,0,4,2,10,0,9,0,31,3,2,11,16,1,9,1,1,2,2,0,1,11,7,4,1,4,3,7,1,9,4,43,8,8,3,5,2,4,3,13,2,11,1,1,9,5,32,5,3,3,1,4,3,1,14,6,0,2,3,0,0,0,6,5,5,4,2,0,3,7,2,2,10,11,40,4,7,0,3,2,2,31,4,17,1,0,1,5,0,1,14,3,6,0,6,9,3,24,7,15,6,2,13,9,0,10,1,1,5,3,12,0,13,3,3,6,14,4,2,1,9,5,10,4,6,5,6,6,4,1,2,1,0,4,5,2,0,1,4,8,11,2,4,3,9,25,5,5,2,9,3,4,1,17,2,0,8,84,9,23,26,1,4,3,12,2,20,2,0,9,5,1,3,13,2,2,3,11,3,16,0,0,6,3,0,1,5,0,0,3,1,0,3,0,5,1,8,1,5,1,1,1,3,3,1,11,7,11,5,0,8,8,6,0,0,0,3,6,1,1,7,5,2,1,8,0,1,4,1,1,3,4,0,12,0,1,0,2,4,4,6,2,1,1,3,3,6,5,0,3,0,0,2,9,10,1,7,2,1,6,2,1,3,0,0,0,4,3,0,4,1,2,0,10,0,1,2,0,5,4,10,3,2,0,0,2,3,2,0,12,5,0,5,4,6,4,0,4,2,8,3,0,2,2,1,1,1,0
demand,11,49,9,222,30,23,9,57,7,13,38,22,21,126,9,13,10,23,15,7,16,63,30,54,38,31,30,29,19,30,19,365,236,25,73,109,91,22,55,17,14,19,3,13,61,32,51,22,579,52,93,11,28,105,37,16,101,41,16,28,52,15,5,27,40,24,165,19,10,32,57,8,13,14,190,24,27,19,182,40,132,11,35,20,462,36,62,2,91,6,22,6,5,62,106,28,31,10,76,34,18,48,90,16,41,53,17,3,33,11,40,7,28,36,18,83,28,7,124,280,56,41,22,156,22,9,11,15,11,4,49,9,15,71,50,88,38,17,4,11,13,68,53,8,7,122,8,41,29,20,119,6,33,13,14,27,60,22,24,39,14,8,12,13,9,23,8,30,38,11,45,154,40,9,20,31,340,13,22,77,48,25,18,31,0,41,50,44,58,112,10,17,21,3,6,7,24,15,25,28,63,2,6,17,59,24,20,45,37,48,147,12,57,23,5,10,4,8,18,6,9,38,10,25,91,161,55,49,15,28,28,31,46,50,66,36,58,19,51,12,91,66,13,14,45,11,13,48,106,10,21,51,22,23,22,20,29,12,7,27,11,65,23,8,6,64,12,21,26,11,234,13,76,18,6,2,50,29,21,9,102,16,13,24,28,8,18,21,42,6,27,13,20,14,10,23,86,18,10,50,53,49,8,13,18,4,35,8,14,9,6,27,89,16,83,23,31,77,33,28,128,21,79,18,166,12,26,52,18,63,15,21,22,9,21,45,33,17,5,30,21,22,47,21,16,11,85,94,15,25,22,18,14,78,53,16,15,6,16,49,55,17,24,38,9,10,70,12,29,45,10,52,15,28,18,55,19,7,38,19,127,4,70,16,19,72,10,1,72,9,76,15,17,16,47,20,94,8,68,15,48,5,8,10,4,10,15,5,45,17,3,16,34,31,29,24,11,13,15,14,15,11,33,24,9,14,9,35,27,37,75,37,12,38,8,16,4,21,17,6,25,49,14,22,9,8,18,14,95,26,48,6,16,15,87,12,4,11,17,50,23,55,61,47,20,5,52,33,11,6,60,11,4,6,9,30,4,30,22,14,15,14,18,5,10,19,18,12,5,12,169,83,3,15,25,10,7,42,25,18,23,12,18,4,28,83,28,31,10,13,8,16,13,12,22,31,12,17,8,19,12,53,18,46,13,10,48,15,67,57,31,18,15,15,14,17,13,16,61,47,18,3,10,25,31,25,59,49,24,22,60,6,11,71,10,23,60,5,18,25,55,9,53,16,32,27,28,12,49,63,18,23,19,7,12,10,24,15,8,31,26,30,14,33,14,7,14,17,5,15,48,49,16,3,66,13,14,20,100,50,51,5,9,6,10,41,7,40,12,12,41,22,13,7,86,9,22,11,10,7,22,37,6,57,6,16,24,16,28,44,94,44,38,27,18,10,17,8,9,24,23,7,16,34,11,36,22,23,15,392,42,16,13,5,16,20,79,33,33,23,8,14,23,43,15,7,3,10,19,32,32,15,111,39,99,13,9,7,21,9,14,48,21,12,20,21,32,21,15,25,29,29,36,20,23,11,24,8,27,29,15,10,14,22,15,15,36,16,13,9,4,38,15,38,38,28,26,16,18,19,10,8,8,43,4,8,27,4,10,26,13,24,17,13,11,5,48,18,50,15,38,18,9,38,22,8,20,13,17,15,26,19,11,28,5,17,26,16,14,23,20,16,9,4,23,27,16,22,26,19,14,11,7,37,9,25,18,8,14,13,5,9,20,5,15,18,12,11,28,37,12,22,8,20,24,42,14,20,10,14,8,15,23,6,12,7,11,15,29,10,31,7,20,10,7,9,14,18,15,18,13,6,8,24,3,5,9,20,29,10,14,8,11,11,14,14,19,42,16,5,16,9,4,8,19,11,7,9,8,30,40,52,12,8,3,10,15,10,14,3,11,26,5,9,15,7,20,4,12,21,4,6,18,40,15,14,12,33,26,6,8,12,8,17,11,8,14,8,5,17,12,13,6,16,42,59,1,4,10,15,12,19,9,19,6,29,25,24,6,29,9,25,14,20,30,17,3,6,6,10,11,17,9,23,5,6,9,57,16,25,9,2,10,11,11,12,12,21,12,15,5,37,8,12,14,44,21,14,86,21,7,17,6,15,6,11,4,12,40,12,2,5,15,8,5,43,8,7,7,10,4,8,20,9,12,18,5,15,22,8,12,16,6,38,16,14,18,14,41,8,9,4,9,2,5,17,10,5,6,10
leave,22,60,24,283,28,27,22,76,10,14,50,36,29,149,9,21,23,53,14,22,10,124,53,64,51,24,22,37,14,59,35,448,315,25,101,178,122,24,32,16,11,18,16,6,63,48,69,33,696,86,130,16,36,73,80,24,134,68,12,25,35,15,6,23,63,14,271,13,19,30,109,22,23,10,202,36,82,10,239,66,129,5,37,15,488,50,45,5,124,10,28,23,7,94,139,28,53,18,91,27,33,58,81,47,30,72,27,19,44,15,52,14,25,38,28,95,14,10,165,424,82,46,59,258,22,6,11,12,9,12,44,13,20,98,70,142,35,14,19,38,7,82,100,12,15,186,22,27,43,32,165,9,36,20,6,35,82,19,25,37,24,13,29,12,17,27,19,36,57,31,40,229,61,11,3,19,390,6,23,83,69,33,8,61,19,53,74,52,94,122,12,29,13,8,11,6,39,9,35,45,62,7,6,23,53,22,16,84,26,67,159,20,66,25,12,33,13,30,33,10,90,42,12,36,89,228,82,62,13,32,35,58,62,64,88,93,78,25,20,17,207,102,29,17,27,10,18,58,86,18,23,62,48,39,25,49,30,10,16,42,8,82,51,18,16,106,12,19,59,14,328,36,239,19,7,2,67,118,28,10,143,18,7,41,33,14,29,52,52,20,18,13,27,39,7,17,93,10,22,59,76,61,20,16,22,12,53,26,21,2,3,27,60,14,153,36,52,93,35,13,98,24,73,15,135,21,19,78,9,69,18,24,33,11,21,42,40,18,15,29,25,31,46,20,11,18,115,120,42,53,42,32,14,93,52,14,19,16,43,161,42,22,22,39,14,7,73,27,15,40,8,51,8,28,23,58,16,12,37,51,137,13,91,16,16,106,17,72,1,18,61,10,25,26,68,39,133,10,66,10,44,13,9,3,27,17,24,5,49,29,13,31,22,30,28,25,7,25,14,4,17,15,49,33,36,15,5,30,37,54,43,44,53,40,7,13,0,29,18,12,34,59,13,22,7,6,20,15,95,28,41,13,18,13,115,21,5,34,24,73,30,67,69,75,16,3,63,33,18,5,43,12,4,16,10,43,22,31,40,19,26,45,20,13,14,48,17,16,8,6,179,101,13,15,27,15,11,37,22,23,34,18,16,6,31,76,13,53,27,13,14,12,39,24,26,54,18,37,14,27,8,49,30,63,19,20,55,22,42,77,25,19,12,34,24,19,30,21,98,45,20,5,7,22,25,20,14,40,31,10,126,13,12,114,11,23,66,6,19,17,55,10,45,16,40,44,25,23,81,64,37,19,46,3,19,21,24,14,15,88,23,39,29,29,27,12,14,20,17,34,46,76,24,21,52,22,4,19,97,48,53,6,18,14,15,62,13,83,8,9,56,40,31,17,70,28,49,14,28,9,26,25,4,53,14,19,26,17,32,64,20,54,68,59,25,4,21,31,11,21,24,17,34,74,14,82,13,12,21,379,65,18,29,11,11,44,103,26,19,36,9,19,40,44,24,14,5,40,34,23,37,33,139,78,75,10,6,18,6,17,6,66,35,16,19,23,26,15,17,32,33,31,39,24,14,31,21,12,34,37,17,11,16,19,22,14,34,26,11,12,12,66,19,58,50,62,30,19,18,15,28,17,23,57,10,26,28,9,9,32,20,37,14,19,25,11,44,12,105,21,38,22,9,18,33,11,32,12,11,14,23,111,78,129,92,22,14,24,7,38,41,43,23,36,41,43,26,17,13,27,18,15,4,37,3,19,26,8,38,38,6,14,29,16,21,21,17,54,13,37,15,36,13,12,15,36,14,20,13,12,8,18,30,11,12,13,14,11,35,16,34,11,38,27,10,12,10,20,24,30,16,19,24,36,14,22,7,10,28,11,42,30,26,11,19,27,30,61,30,8,20,15,17,28,20,19,23,13,15,34,41,48,22,25,4,12,10,29,13,9,5,14,18,9,15,23,25,6,16,16,7,9,18,31,13,20,8,25,29,2,17,13,12,19,19,14,20,21,27,10,10,39,4,15,18,29,12,18,6,17,20,18,11,19,24,17,8,25,20,36,10,41,14,81,25,26,9,13,12,9,24,15,27,22,5,19,15,34,15,24,12,6,16,15,15,24,12,25,8,19,9,29,79,55,63,73,34,157,231,3,14,17,11,7,15,61,12,11,34,12,38,16,16,9,7,34,16,24,16,14,24,15,13,7,17,14,4,14,14,17,13,17,19,17,15,16,18,13,35,11,6,11,16,10,2,6,24,26,5,6
society,10,10,5,38,0,8,1,25,2,1,7,1,9,42,2,10,0,20,11,6,2,20,7,5,3,5,8,9,1,5,6,57,62,2,22,32,18,3,1,4,6,15,3,2,19,9,11,5,79,17,28,3,7,23,29,12,29,7,8,8,4,0,5,5,11,3,68,5,1,4,7,0,3,0,43,12,12,3,29,15,15,2,4,6,109,9,6,2,11,1,0,4,4,6,29,6,12,1,13,15,2,7,17,6,6,14,3,1,10,2,4,6,7,9,3,17,6,0,27,74,22,14,7,30,1,5,2,0,1,0,5,3,11,33,8,41,0,1,1,5,3,14,7,1,4,12,2,7,3,8,24,0,4,4,4,9,13,5,2,32,10,0,6,1,1,6,2,10,18,3,5,32,19,2,1,2,76,3,6,23,12,5,4,4,5,13,25,10,22,10,1,0,3,1,2,0,2,9,2,28,11,5,1,14,16,17,1,23,10,13,39,2,10,4,0,3,0,3,3,2,2,12,2,8,16,39,9,14,1,1,7,5,5,15,11,7,14,3,4,2,20,12,2,5,15,11,2,4,22,2,2,9,13,2,3,9,3,2,1,6,4,10,11,0,3,3,8,6,12,4,46,2,10,2,1,2,13,0,1,2,51,7,0,8,4,2,11,16,17,5,0,0,4,3,2,3,18,1,3,6,4,3,0,1,5,8,7,7,9,1,1,10,14,5,15,8,11,24,9,7,29,4,8,4,23,0,4,15,2,20,1,5,3,3,4,2,9,1,1,11,0,13,10,6,6,2,15,9,7,12,2,6,5,5,6,0,4,2,9,17,7,3,10,6,1,4,17,6,8,6,0,20,2,5,7,5,5,1,10,6,24,1,11,7,11,7,9,9,18,1,10,3,1,0,14,12,17,2,12,1,7,4,0,1,3,11,4,2,10,6,1,1,0,5,4,10,1,2,2,1,7,4,9,4,3,1,3,10,7,6,10,0,0,1,1,6,1,2,5,0,10,10,9,4,2,4,12,6,13,5,6,0,7,3,32,0,2,0,7,7,6,10,24,20,4,0,8,7,0,0,31,3,5,0,2,6,4,5,13,6,2,5,2,2,1,1,4,4,2,0,27,11,1,3,2,5,0,8,7,6,2,1,0,0,0,16,4,10,8,1,0,4,5,3,8,10,2,16,3,7,6,7,8,10,5,6,7,11,4,9,8,11,2,4,2,6,4,11,35,9,3,3,1,5,3,1,1,7,4,5,14,0,2,15,5,3,14,3,1,2,14,0,12,2,11,4,9,3,6,12,3,3,0,2,3,6,3,3,4,3,2,2,5,11,6,3,4,2,2,6,10,20,5,0,15,1,4,10,2,11,10,1,6,0,1,5,1,5,2,0,7,0,2,8,8,7,10,0,3,1,16,3,0,12,2,0,2,1,7,15,10,5,21,13,3,0,7,0,4,5,9,5,8,3,3,2,2,0,3,34,3,3,6,2,0,3,13,3,1,9,2,1,0,5,1,0,0,1,5,8,5,3,5,2,4,3,0,1,0,5,0,14,20,2,4,6,7,8,1,9,5,10,11,2,2,1,1,1,5,8,5,1,0,0,1,0,9,1,2,5,1,0,3,12,6,11,8,6,2,1,0,2,4,11,1,3,1,2,4,11,2,1,2,7,1,0,6,5,4,4,2,1,1,0,4,4,2,4,4,3,3,0,0,0,0,6,5,3,0,6,0,14,0,0,7,18,9,3,1,0,4,1,6,7,3,8,1,5,16,11,2,7,2,3,3,3,10,0,8,6,2,0,0,4,1,16,3,1,0,0,1,4,8,0,4,9,4,3,4,5,2,0,1,0,1,0,3,13,1,11,0,4,1,5,2,1,1,0,12,2,0,2,14,2,3,7,0,16,6,0,5,2,0,1,1,3,1,12,5,2,0,7,0,4,3,1,3,1,1,1,5,2,17,4,1,10,3,7,5,5,1,3,0,11,2,4,0,1,1,2,1,0,0,0,4,3,0,3,2,5,2,3,0,0,2,0,3,0,0,3,4,1,0,5,2,0,0,8,1,8,2,2,2,5,3,5,0,1,1,2,9,1,4,2,0,10,3,1,0,0,0,0,2,0,2,2,3,0,2,4,3,8,0,1,0,5,8,0,9,1,1,7,6,2,0,0,0,0,1,8,0,0,0,1,2,0,1,0,0,0,4,5,4,7,1,0,0,2,5,7,0,3,6,11,5,5,2,4,0,4,2,2,0,2,1,1,4,0,0,4
justice,20,42,28,258,32,19,16,64,5,6,57,12,14,269,13,53,18,35,16,12,14,71,47,69,45,41,41,22,19,34,22,329,238,34,133,151,195,11,14,15,12,54,13,7,65,43,33,44,586,79,98,20,32,107,11,38,118,32,10,25,39,34,12,25,25,21,176,11,13,21,4,10,10,15,211,23,35,8,147,69,61,1,26,15,491,17,13,0,69,5,13,18,0,73,141,9,34,13,63,11,11,49,59,23,28,54,7,7,14,6,32,9,9,26,5,52,18,9,168,264,68,62,15,80,14,18,14,5,11,2,33,16,13,79,58,66,53,9,16,10,14,115,58,6,9,136,17,36,22,24,151,7,25,15,10,82,75,13,28,21,7,6,15,8,1,13,12,54,59,13,33,175,65,2,15,26,399,6,35,67,70,34,8,30,13,52,62,68,108,123,6,9,6,1,1,5,21,26,15,50,46,0,3,26,63,30,8,52,15,46,132,10,53,17,9,4,0,1,22,5,3,37,12,32,79,334,60,47,5,5,9,19,17,44,86,16,59,14,8,33,135,56,13,25,53,14,10,45,97,9,43,34,68,5,18,22,21,1,8,22,20,85,36,12,16,135,6,27,37,13,314,7,35,10,16,8,63,7,27,10,153,23,4,53,18,3,7,15,49,5,6,11,22,6,6,22,58,19,15,61,70,63,0,2,18,13,96,9,14,4,9,41,45,25,47,20,25,85,32,15,140,24,69,7,217,27,17,47,4,64,20,13,30,11,24,29,38,15,3,18,31,16,31,27,6,13,102,105,35,14,32,25,14,67,44,4,6,10,45,65,33,7,21,48,10,6,54,23,24,39,11,41,9,22,32,37,19,9,64,17,169,13,95,14,16,52,34,76,61,10,1,9,11,36,57,37,124,14,71,6,50,5,9,9,12,18,27,25,27,28,14,24,6,33,25,34,9,16,20,12,20,16,43,30,5,13,7,52,18,30,5,8,2,17,12,14,2,37,16,8,34,37,4,11,2,2,12,18,80,12,37,23,14,12,97,32,13,26,30,59,40,70,74,76,13,18,40,23,14,1,36,14,5,5,8,53,21,13,36,16,15,27,11,29,13,33,16,16,15,19,152,85,6,11,13,13,8,49,28,25,34,12,7,1,13,7,4,36,9,10,10,29,25,15,19,30,13,23,38,21,18,52,17,61,16,19,68,33,69,66,31,25,8,29,26,12,27,36,84,55,7,20,8,3,7,35,13,30,46,19,86,22,23,98,15,28,63,11,18,21,47,16,41,16,41,34,28,33,71,98,13,18,26,40,17,8,15,12,9,24,4,18,20,40,34,33,11,11,9,21,81,79,22,4,59,7,15,4,107,63,48,12,12,5,23,38,12,48,9,12,61,58,44,12,137,21,38,8,32,8,9,0,1,28,4,17,6,22,36,71,1,48,79,61,18,10,31,6,14,20,37,18,60,34,20,18,8,9,16,373,46,16,12,16,27,20,68,59,27,24,8,9,37,37,15,6,20,21,38,30,55,8,86,262,121,14,9,9,2,18,7,48,31,12,19,20,40,16,2,14,31,35,25,17,18,17,16,19,30,34,19,16,14,18,16,12,51,21,6,6,20,13,14,48,41,33,11,16,18,7,14,19,18,54,6,14,12,5,15,30,16,30,6,12,19,3,14,10,74,23,25,10,5,8,23,12,26,12,15,23,18,2,1,15,3,21,23,29,13,17,11,35,3,2,40,16,18,18,6,41,18,7,2,53,7,29,2,2,36,23,21,10,29,4,26,15,13,37,16,23,21,41,8,13,33,48,15,22,8,14,15,8,39,6,17,6,32,10,41,14,17,1,23,9,8,10,13,17,3,24,18,4,19,7,3,6,16,11,2,10,13,7,21,12,12,23,23,78,32,10,9,19,49,31,7,8,14,13,10,46,64,60,39,5,2,9,30,2,22,4,16,21,11,4,15,14,8,6,27,26,6,9,3,1,21,14,9,41,23,7,10,6,18,10,17,9,10,8,22,5,12,12,0,6,37,5,14,7,5,20,7,7,5,24,11,3,4,7,10,34,16,2,18,13,27,14,3,11,4,6,17,17,11,17,10,19,7,39,11,0,20,13,12,12,8,6,1,20,22,17,11,24,3,3,4,32,16,4,27,14,0,13,7,10,7,3,4,6,26,12,8,9,9,13,1,37,11,13,17,13,15,15,9,20,11,10,8,16,8,14,8,11,11,0,17,7,24,6,48,6,12,7,7,2,3,7,2,8,1,11
forward,2,15,4,80,7,16,2,36,7,4,5,6,12,59,1,5,2,11,9,6,15,13,48,17,7,14,16,40,7,21,7,78,59,21,35,83,33,4,3,7,2,24,2,9,28,7,15,12,102,77,27,10,17,40,13,0,11,13,15,31,7,8,5,10,19,19,75,6,3,8,9,0,5,5,81,71,97,5,62,27,40,4,4,10,80,8,6,0,20,1,5,4,1,25,13,8,18,1,37,1,15,13,10,8,12,25,6,3,11,5,14,6,18,16,9,17,1,3,23,56,14,29,5,72,7,12,5,1,2,3,27,2,10,37,16,76,3,10,6,12,4,19,12,4,7,45,3,11,8,3,32,8,7,8,8,19,47,8,3,29,9,4,3,5,5,11,1,20,13,4,17,71,19,7,9,1,42,1,7,35,7,7,30,24,6,13,12,11,15,22,3,10,4,3,2,3,21,6,7,6,8,1,2,2,11,8,6,15,8,17,42,32,15,8,5,13,2,3,7,0,3,14,2,12,14,30,10,11,5,6,6,5,10,13,11,3,16,6,7,2,29,21,3,11,11,6,4,21,34,7,8,8,19,1,2,5,4,2,4,10,5,25,6,2,4,9,13,20,13,3,49,6,4,0,7,7,6,2,2,0,31,3,1,6,5,3,13,10,4,1,2,8,4,6,4,6,14,4,4,7,16,15,0,0,1,6,29,2,0,0,3,11,35,13,17,5,12,14,5,2,27,3,16,4,35,1,19,32,3,12,10,6,1,1,3,8,14,3,2,7,2,8,17,5,6,7,16,21,12,9,4,7,0,21,6,1,5,0,9,17,10,22,12,11,4,15,10,7,9,18,2,28,10,17,4,18,1,2,13,5,38,1,15,3,4,17,6,15,10,3,9,1,9,9,9,7,12,1,12,7,7,6,0,9,3,2,8,3,5,5,4,5,6,5,0,9,6,8,1,13,1,3,14,5,3,4,7,8,6,5,1,5,2,5,6,2,12,8,15,2,7,16,6,15,1,8,29,9,15,6,19,0,56,2,35,9,10,1,4,6,6,22,17,24,5,3,18,6,4,4,21,8,4,6,7,6,2,4,11,4,6,15,1,5,6,2,4,6,3,2,54,11,2,1,10,2,7,6,5,2,3,5,1,4,2,5,10,2,2,3,0,1,5,0,10,4,8,5,4,5,9,1,4,9,2,0,11,2,7,12,7,6,3,5,6,3,3,6,13,9,2,0,3,3,6,5,3,5,6,2,11,2,1,22,5,5,9,1,0,3,9,1,3,4,9,4,4,2,14,18,5,4,4,4,4,3,1,2,1,10,3,5,5,16,2,3,3,0,1,7,11,12,7,4,8,2,6,2,14,3,6,1,1,1,2,10,6,11,6,3,9,19,8,6,12,2,9,3,2,2,7,0,2,8,3,4,2,2,9,20,1,10,17,4,5,2,14,1,5,5,5,4,1,13,0,14,5,5,5,44,5,4,4,0,0,7,24,6,3,1,3,0,0,3,1,2,2,3,5,2,10,3,8,2,6,1,0,5,1,3,3,54,5,4,2,0,3,7,2,1,7,23,6,2,1,12,3,0,5,6,2,2,1,6,6,5,11,8,0,2,4,3,3,10,6,15,6,7,3,5,3,4,2,10,1,2,1,4,1,5,2,11,2,6,1,0,18,4,7,5,4,4,8,11,3,3,7,22,4,4,8,0,2,4,0,12,0,5,2,3,3,2,0,3,6,13,7,4,9,1,9,3,6,5,1,4,5,1,4,3,9,1,6,5,3,3,3,0,6,2,7,5,4,1,4,7,2,5,1,2,4,1,6,5,5,9,18,0,8,2,0,5,1,4,1,2,5,4,2,1,4,1,2,2,1,1,6,3,1,2,3,3,2,2,6,6,3,16,3,5,4,3,0,5,1,5,3,4,6,6,9,12,3,4,5,6,3,7,0,1,1,1,0,12,2,1,3,0,3,8,4,4,1,1,2,1,0,2,5,2,0,1,4,2,3,4,1,0,0,5,6,4,1,3,2,2,4,2,5,8,2,1,3,5,8,2,0,1,0,10,0,3,5,1,4,1,2,2,1,2,4,3,2,4,0,3,1,2,1,1,3,5,4,2,2,2,3,6,4,5,8,8,4,1,7,3,3,2,3,1,3,3,10,7,2,1,3,1,6,0,2,5,2,0,1,3,1,1,2,0,9,1,7,8,1,1,5,0,3,4,1,2,2,0,3,0,1,10,1,4,4,7,0,6,8,4,3,2,3,11
house,37,164,110,425,22,11,4,56,31,1,26,29,26,54,9,5,11,24,13,7,7,44,26,64,28,28,15,32,24,25,11,231,104,19,63,57,24,16,3,7,7,6,8,20,54,32,43,27,379,42,44,7,13,18,20,5,70,59,32,9,22,5,3,17,30,20,159,10,11,13,23,14,6,13,98,17,34,0,131,33,52,0,16,10,185,29,7,1,48,8,6,3,5,27,41,20,15,1,28,10,19,45,22,7,14,43,11,10,20,11,23,8,6,22,17,30,22,6,109,173,27,32,10,91,14,8,2,4,2,3,8,6,25,70,26,96,12,2,11,12,5,38,41,3,5,89,11,22,12,12,81,6,37,4,4,38,44,5,13,24,23,7,12,4,5,16,9,18,39,10,17,116,19,2,6,12,223,4,9,45,28,15,22,29,13,26,51,11,59,119,35,6,6,4,6,2,25,2,8,5,45,1,3,13,16,19,8,34,23,18,103,14,189,6,7,16,10,14,37,4,5,23,10,18,74,169,33,34,5,12,21,24,16,22,34,32,56,13,7,7,92,33,13,12,9,8,4,32,59,6,27,24,42,16,11,23,16,3,4,30,4,20,21,18,11,54,8,12,20,13,171,4,35,10,8,2,17,13,32,58,67,15,3,22,21,4,10,11,17,8,7,13,160,16,1,8,56,12,28,13,14,58,2,5,18,10,29,7,8,1,2,10,31,9,36,7,14,31,16,6,44,5,41,14,64,8,25,64,17,28,70,7,11,10,17,31,23,9,7,19,6,19,33,14,3,10,44,55,21,27,17,8,4,34,29,4,13,2,16,32,48,12,10,24,3,4,69,7,23,24,9,22,6,13,13,20,14,3,12,8,127,5,46,9,12,28,5,17,25,1,11,9,1,328,56,6,79,6,34,1,15,1,1,16,11,5,6,7,25,13,2,14,0,13,6,11,7,6,3,1,5,13,43,14,5,3,3,11,11,22,18,10,5,15,13,7,0,10,6,6,18,11,10,7,1,4,14,4,20,7,13,6,5,10,31,7,2,22,5,26,16,24,20,18,9,2,9,22,3,0,25,7,13,5,4,12,5,374,16,5,6,17,3,12,10,19,11,9,8,3,42,70,3,5,6,7,2,19,10,13,14,14,3,2,9,17,2,24,10,22,2,6,12,4,29,34,12,7,3,13,0,19,4,35,8,6,25,10,18,33,12,5,3,12,13,7,11,15,53,13,1,2,11,3,11,13,3,16,14,4,135,16,6,45,10,10,27,1,6,15,36,24,34,6,17,10,21,12,53,39,12,14,41,1,9,10,7,1,8,18,6,23,8,16,12,4,10,7,5,17,31,30,17,7,25,1,2,3,42,18,18,3,6,7,18,24,9,87,7,5,48,25,23,2,47,13,23,2,15,3,13,2,5,25,5,11,11,13,20,35,3,29,25,41,9,6,10,12,12,5,11,5,18,17,6,33,2,13,19,170,19,2,7,22,13,16,29,12,10,16,21,4,8,3,8,9,2,6,7,12,23,2,28,32,29,9,5,37,5,8,9,40,11,13,22,10,12,5,1,5,15,28,14,3,6,24,11,17,12,22,11,5,8,7,24,15,18,8,5,9,7,7,7,57,11,12,2,6,12,8,12,25,4,19,3,14,5,5,8,12,11,30,6,11,9,3,12,3,39,18,18,7,13,8,6,6,12,7,1,12,11,1,4,13,4,11,12,22,7,18,15,11,5,17,22,10,13,11,9,6,3,4,5,20,5,12,3,4,9,7,6,7,13,11,44,4,7,25,8,15,11,34,19,8,9,22,7,24,3,8,4,7,30,31,7,1,5,3,16,6,3,2,14,12,5,4,6,19,7,15,7,4,33,18,7,4,7,61,5,9,11,7,11,10,18,17,15,7,8,15,17,23,7,12,6,3,8,5,14,9,36,30,10,4,11,2,2,6,11,0,7,8,8,18,8,14,3,34,11,19,3,8,16,5,8,8,2,7,38,6,1,5,8,3,7,4,8,6,6,9,3,13,7,7,5,12,1,17,11,7,2,10,2,12,41,2,0,11,15,24,14,3,8,5,22,4,10,6,4,7,8,5,22,15,0,4,1,12,3,8,7,10,7,8,6,7,7,8,6,19,3,7,2,0,4,6,4,12,36,3,1,5,6,5,18,2,7,2,34,3,6,12,5,5,5,13,5,2,74,4,2,15,1,6,5,3,2,7,6,19,13,2,9,1,6,4,4,6,12,4,10,5,3,3,15,10,3,9,3,3
senate,34,126,65,285,15,9,9,44,8,4,86,17,10,59,2,6,13,12,6,1,3,48,13,60,30,32,12,17,8,29,9,168,129,18,58,52,39,7,3,2,5,3,2,14,54,32,44,9,489,45,57,4,5,30,3,1,62,33,18,17,36,9,2,53,19,10,92,5,14,15,7,3,2,8,60,21,32,3,94,28,23,0,20,9,221,11,10,0,67,6,7,2,2,33,47,3,17,1,28,7,17,33,43,3,9,35,8,3,11,4,14,5,4,21,13,41,25,4,107,139,32,39,4,78,9,9,0,3,2,3,8,5,3,48,21,29,5,7,10,6,3,34,45,7,1,69,11,18,15,17,77,2,17,5,3,27,24,2,15,7,7,1,4,7,2,10,7,18,20,9,27,91,17,3,1,7,199,2,5,21,22,7,5,15,3,14,27,23,71,117,8,2,11,3,3,4,12,7,10,3,16,0,1,30,17,20,12,24,26,17,102,4,112,2,2,6,1,1,35,3,8,15,8,13,52,92,24,23,2,2,11,18,4,21,20,22,57,11,4,11,68,33,4,8,14,2,6,8,74,9,28,9,46,6,3,26,7,2,7,19,5,17,99,20,4,30,4,6,16,3,161,2,13,6,6,1,10,4,23,26,49,1,1,27,11,0,2,1,16,5,18,57,66,5,5,11,76,19,18,19,23,35,1,3,17,3,32,6,1,0,7,8,30,7,26,10,12,43,12,1,55,11,34,2,58,12,14,36,3,24,45,14,16,3,16,11,17,13,7,11,7,11,17,20,2,4,35,90,3,3,10,15,6,18,21,1,12,2,26,27,26,9,7,18,2,2,34,7,17,22,4,16,4,5,7,6,12,2,10,7,127,7,39,14,11,23,2,16,26,0,36,9,328,1,47,6,77,2,31,2,42,2,4,18,4,1,3,9,18,7,4,8,3,14,7,7,49,4,5,1,7,6,56,6,0,3,4,15,10,27,3,13,1,38,14,8,4,60,9,5,18,14,12,16,4,9,5,3,28,2,14,10,6,3,80,24,1,21,6,49,10,21,22,14,1,4,9,22,5,1,14,1,4,4,2,4,1,254,21,2,4,24,5,6,3,21,11,2,9,2,39,34,1,4,5,6,3,6,5,4,10,4,1,1,5,7,0,20,8,7,5,0,17,8,12,18,6,4,1,7,2,8,5,24,7,5,19,1,20,33,11,1,0,11,15,5,14,10,43,8,4,20,6,1,2,30,3,8,31,7,89,13,10,37,13,9,46,1,7,13,39,18,44,2,14,18,8,15,44,48,11,9,10,2,6,15,9,5,3,21,0,20,14,10,8,10,9,15,6,6,33,36,8,5,15,1,0,1,328,17,28,0,4,74,39,20,4,78,11,10,32,37,44,4,38,20,15,5,13,6,3,0,5,12,2,13,5,8,15,47,0,24,29,21,7,5,12,4,3,5,5,1,18,12,14,11,1,11,13,328,47,6,8,30,10,23,43,25,16,28,10,13,120,60,69,97,31,13,18,17,17,5,49,70,69,7,10,27,18,9,20,32,14,14,7,3,11,7,1,12,30,14,10,12,16,23,8,67,12,27,18,15,13,4,16,8,18,7,3,17,12,17,2,30,14,6,0,4,20,6,7,27,2,23,0,30,6,2,1,7,5,15,3,6,8,7,4,1,48,17,17,6,9,10,9,2,16,4,2,12,6,2,0,14,2,10,11,20,10,6,6,16,8,7,40,3,12,8,3,30,4,2,1,10,5,14,2,3,15,7,6,5,8,0,36,5,5,56,8,13,11,20,18,5,2,19,2,23,0,23,12,7,22,16,1,0,8,14,19,13,7,13,15,21,3,8,5,36,6,4,10,2,28,8,4,8,7,41,1,8,7,7,3,4,14,13,6,18,9,13,20,13,7,19,0,2,3,32,7,4,44,21,6,4,5,10,3,4,4,4,18,7,2,6,2,5,1,47,3,16,2,3,4,2,8,7,22,17,33,8,11,17,7,5,26,15,9,7,0,6,10,14,5,2,7,18,2,14,4,2,14,11,3,8,15,5,24,40,14,29,0,4,8,8,19,15,7,22,2,5,6,14,11,28,7,8,12,43,17,4,13,11,8,9,2,1,3,1,7,10,8,10,1,2,2,13,3,1,8,6,2,5,2,0,6,3,2,6,17,3,4,3,14,10,3,10,4,0,35,5,2,13,1,5,13,6,0,4,4,22,0,13,5,2,5,4,7,4,22,0,3,1,1,0,2,1,0,7,3,4
view,21,62,23,499,35,7,13,96,19,6,63,30,25,149,17,21,18,23,23,3,20,84,24,64,64,21,25,31,12,36,30,481,311,29,146,129,99,33,22,18,19,21,9,15,95,53,95,43,835,46,109,5,42,61,9,17,175,103,2,46,74,15,14,55,73,11,238,16,32,48,33,20,6,10,150,42,33,19,220,73,101,1,31,17,595,47,21,0,113,12,20,18,3,77,155,25,57,14,70,25,51,86,98,31,22,69,26,15,37,3,35,17,28,28,4,73,24,8,191,419,122,42,24,103,9,11,8,16,18,12,35,11,14,112,46,114,23,9,11,20,3,77,80,8,8,202,22,30,37,35,165,3,46,17,14,60,55,12,31,8,36,7,22,7,2,12,15,42,47,23,47,218,42,1,7,18,462,5,38,76,45,32,16,34,17,49,78,63,145,142,4,20,11,1,3,11,51,8,18,29,59,3,4,49,62,23,20,85,33,83,164,10,70,21,4,5,11,8,43,13,11,43,19,66,121,242,55,67,19,24,51,37,51,51,81,71,85,25,11,17,190,90,18,7,39,13,11,43,94,12,35,53,47,15,41,59,30,4,18,44,4,51,94,18,20,100,11,10,28,16,421,22,86,20,13,2,43,41,52,19,142,26,4,36,22,5,8,28,21,6,13,13,39,17,16,35,120,29,27,59,69,139,6,9,49,7,69,17,9,3,0,38,77,9,79,46,48,127,30,13,86,30,59,8,193,14,22,71,13,83,7,26,14,18,20,49,42,20,18,32,27,37,40,43,16,16,129,159,47,18,38,34,20,56,48,16,13,15,47,68,55,20,25,38,13,2,143,21,17,18,15,47,15,19,15,78,24,7,38,20,159,13,126,52,4,87,9,47,68,14,57,9,56,47,1,33,268,18,72,17,108,8,22,0,12,16,16,10,63,56,5,28,24,62,34,35,20,17,8,8,9,31,59,48,2,11,8,27,39,37,30,20,16,37,8,20,1,67,26,8,27,55,16,43,9,9,10,11,75,14,38,18,6,17,124,28,0,32,11,93,27,57,71,49,17,6,26,39,30,0,29,4,9,7,6,21,9,49,51,13,11,42,22,26,21,35,41,8,17,17,219,149,5,15,23,19,12,43,33,33,38,9,13,0,19,59,4,52,20,12,15,21,24,30,55,74,26,21,6,18,10,48,25,63,28,17,54,17,50,77,17,19,13,26,34,22,40,25,98,47,13,16,4,14,22,25,9,62,44,36,98,22,11,122,23,24,82,15,23,23,119,20,83,11,58,40,52,27,97,86,33,45,53,11,21,23,40,20,24,32,22,52,34,50,35,10,20,24,15,37,67,128,12,10,41,12,14,7,170,64,80,9,7,15,29,75,17,92,29,21,101,68,45,24,69,31,90,8,43,15,35,25,16,52,10,31,41,47,37,84,38,97,73,54,22,8,19,15,12,28,20,5,28,51,30,106,19,12,18,462,61,19,28,24,30,29,96,46,15,33,24,18,57,60,25,21,17,26,29,33,50,34,130,96,101,24,18,45,14,19,51,76,44,46,48,30,43,18,10,27,39,20,48,28,15,38,19,12,39,70,37,20,26,16,27,15,37,18,22,25,9,30,17,114,56,64,13,21,37,30,28,11,19,60,6,35,31,0,14,21,22,35,10,12,28,12,56,15,100,40,29,18,18,33,39,10,33,15,14,20,26,20,11,31,10,47,24,39,14,48,42,32,10,19,47,45,23,20,25,41,15,13,10,33,10,44,17,7,53,29,20,14,32,8,31,18,20,58,19,24,27,43,15,24,17,41,10,21,19,19,28,20,30,20,11,8,19,17,65,24,29,10,23,28,7,18,13,29,19,24,27,10,44,38,35,16,9,25,26,9,19,23,32,11,17,31,47,68,35,20,31,26,18,27,13,24,20,28,36,25,75,71,17,21,13,10,26,21,17,3,29,11,23,11,12,29,12,8,36,51,8,23,20,27,15,28,20,28,57,10,18,17,12,11,44,17,31,10,20,20,16,42,0,13,25,31,14,10,14,3,20,30,12,35,31,13,20,36,19,78,21,18,17,30,35,19,11,20,11,20,43,27,17,33,12,28,10,72,25,16,33,11,22,26,15,15,14,10,12,45,11,20,16,17,21,43,38,47,87,13,16,11,9,13,25,15,19,15,67,19,13,16,19,11,4,46,17,4,19,23,31,22,15,9,19,21,6,19,36,21,21,12,23,27,18,15,27,7,62,5,9,10,18,0,2,4,3,24,4,2
rest,4,24,5,119,15,11,7,46,3,3,15,12,11,98,5,9,11,16,10,10,10,74,30,28,20,10,25,22,13,33,7,156,149,27,56,112,67,13,18,9,4,31,7,5,32,27,42,9,287,81,49,5,32,117,23,7,76,13,18,18,21,25,17,18,27,4,146,5,9,8,13,1,10,7,138,27,30,6,99,42,33,4,8,14,209,14,19,2,21,3,7,13,2,35,63,12,20,4,33,23,10,16,26,24,11,22,7,6,23,8,24,9,13,26,5,28,2,6,38,160,40,25,6,79,9,8,5,3,5,2,17,9,11,39,39,56,5,7,9,11,9,40,30,1,7,70,13,23,10,8,75,4,14,9,9,19,33,10,14,23,6,4,10,6,5,17,2,26,36,16,13,91,21,8,9,11,228,7,21,43,21,10,6,30,2,34,36,26,36,50,2,13,9,5,5,7,29,12,8,22,25,5,0,10,31,33,3,16,14,35,77,17,28,7,8,20,7,10,17,3,5,8,7,26,37,95,27,29,9,10,18,19,13,27,39,18,30,9,6,3,67,41,15,14,20,11,8,50,33,10,21,21,32,18,7,28,14,7,1,15,0,34,26,0,11,31,9,28,25,6,138,10,26,4,4,3,17,5,7,2,73,4,0,14,9,2,7,8,16,7,4,6,27,4,3,12,32,4,6,12,32,11,1,2,12,7,17,16,9,1,4,18,29,11,30,29,14,39,9,11,37,12,30,9,66,11,10,40,12,32,10,12,7,10,3,15,24,4,7,11,11,9,24,7,8,14,54,48,14,16,9,15,4,27,23,1,10,5,17,34,28,8,14,23,4,5,30,9,10,25,6,26,7,20,6,22,4,7,29,9,79,0,40,15,10,44,11,20,39,12,37,7,6,6,33,1,54,13,41,2,23,14,7,8,12,16,6,6,28,13,5,8,11,13,7,16,5,12,3,11,4,8,13,17,6,8,4,12,11,15,33,4,0,15,8,7,1,18,10,0,10,25,4,22,6,2,22,9,41,18,21,1,4,13,60,9,10,21,5,26,24,33,15,36,7,16,23,7,4,2,27,4,3,8,2,30,7,14,25,11,8,21,9,8,6,7,18,10,5,5,83,40,5,14,17,8,9,13,18,12,12,6,4,1,8,28,2,11,6,4,8,6,6,5,17,28,9,13,4,21,7,13,13,29,8,7,16,7,17,26,7,16,8,14,8,6,8,9,40,14,10,6,6,3,8,5,9,30,10,5,45,12,6,43,7,15,31,5,8,5,29,0,11,4,23,16,9,3,31,40,6,10,10,2,5,9,12,7,5,13,7,13,16,17,19,6,7,7,3,18,39,29,7,7,18,8,6,8,22,26,12,1,14,3,8,20,5,39,7,9,35,9,5,8,18,12,15,5,4,2,25,17,4,35,10,6,7,4,12,28,28,16,22,27,2,10,10,8,4,5,6,4,18,25,5,21,4,5,6,134,25,5,7,4,12,19,39,17,5,13,4,11,11,19,5,3,3,8,8,7,19,9,37,33,26,7,3,1,3,2,7,23,8,8,10,12,20,12,3,10,7,11,17,15,7,5,14,6,13,6,3,2,4,8,4,9,18,10,4,2,8,0,9,31,20,20,7,9,6,7,6,5,5,20,2,5,7,6,3,10,16,9,11,5,6,3,11,4,22,13,9,9,3,9,11,8,12,12,13,3,14,4,0,1,1,18,5,17,1,8,8,18,3,5,16,18,10,3,7,15,10,8,3,14,2,13,10,8,9,17,2,3,15,3,4,3,16,18,8,14,7,15,10,9,7,28,4,7,4,0,12,4,14,3,9,2,14,3,14,6,8,8,3,4,1,2,16,11,1,10,2,7,4,14,5,6,4,4,23,5,7,2,20,11,4,13,7,26,5,4,2,20,9,9,6,18,3,1,7,4,11,30,6,8,6,3,9,8,2,3,7,5,9,6,3,18,1,4,14,14,7,5,2,21,8,11,3,11,22,1,1,2,10,6,9,2,8,3,11,7,6,6,6,3,7,4,0,2,4,14,9,2,6,12,6,1,12,35,3,15,12,6,8,9,17,2,3,10,4,1,13,11,11,4,1,5,5,8,6,18,5,3,4,3,4,5,10,3,2,12,7,10,0,1,7,17,7,4,47,3,3,3,8,3,1,3,7,5,15,6,6,2,12,1,1,3,0,2,7,12,6,10,6,10,2,7,4,8,5,7,1,8,6,24,6,2,14,6,8,4,3,5,5,1,5,1,2,1,1,7
subject,35,115,30,1053,43,2,25,144,33,18,88,57,23,234,22,35,23,51,19,17,39,195,16,93,135,48,50,42,18,66,38,845,516,31,226,140,157,40,60,17,28,26,27,16,144,99,157,53,1654,39,227,3,52,60,21,25,366,213,3,55,114,49,10,106,100,9,348,23,65,48,33,23,21,17,248,53,56,23,346,91,182,4,64,15,1055,78,56,1,198,10,23,20,0,173,264,77,78,18,111,72,79,110,194,45,42,190,34,6,65,17,66,23,24,70,2,164,28,26,369,651,199,54,61,234,20,18,10,30,21,5,47,13,21,211,80,144,35,16,25,21,11,171,153,11,17,309,28,64,59,58,332,5,73,24,11,138,107,17,48,9,49,16,15,11,1,9,14,68,102,31,81,349,62,3,8,51,1056,20,69,101,69,63,5,79,29,58,162,124,307,296,12,23,38,1,3,15,80,23,27,61,121,5,6,72,87,21,33,162,64,140,382,15,125,21,4,6,3,3,57,16,22,74,32,72,246,597,94,112,18,16,85,55,72,131,135,117,150,39,40,34,374,150,32,19,45,37,28,59,195,22,69,101,106,41,73,100,64,14,26,60,25,97,173,35,34,233,12,22,76,20,771,45,150,24,28,4,77,54,113,38,201,37,5,91,38,17,19,30,57,5,27,25,105,38,16,55,230,42,36,79,118,213,2,10,76,5,83,26,17,3,9,67,87,25,155,85,59,225,55,32,266,34,99,4,299,69,22,97,20,115,14,59,38,35,48,101,84,51,19,58,46,33,51,48,25,19,266,262,100,21,59,76,36,159,103,36,17,25,81,110,161,35,27,91,21,3,198,36,23,32,25,48,19,39,47,110,32,16,72,45,400,15,212,64,13,200,41,94,133,17,124,12,79,77,268,54,1,36,130,11,156,12,28,1,20,17,24,16,146,51,5,42,15,88,43,58,34,29,22,6,19,36,118,74,8,22,10,81,48,68,55,46,20,67,8,25,3,105,35,20,89,107,33,55,4,11,7,24,125,40,54,27,4,25,291,47,2,64,25,199,48,79,112,56,20,6,69,85,67,1,64,6,25,3,10,37,16,74,50,22,33,57,23,28,39,51,51,15,21,33,247,259,8,21,38,48,19,84,40,42,51,20,24,2,61,94,14,61,40,28,24,32,43,51,64,170,35,49,26,45,15,73,67,133,49,24,129,28,98,140,30,23,11,40,63,27,84,27,176,92,31,12,4,16,46,61,9,88,93,48,222,35,38,225,37,48,142,19,38,52,228,27,146,23,94,107,72,41,178,206,57,83,97,40,43,61,62,30,33,68,24,97,45,65,64,34,37,41,32,49,114,227,46,12,82,16,16,15,339,103,145,12,26,36,56,125,51,180,45,41,128,165,77,37,157,47,124,32,51,42,76,17,19,93,17,50,73,72,76,142,51,275,137,101,46,13,51,31,19,54,39,11,51,116,61,201,43,32,52,948,83,33,42,31,43,68,170,71,24,80,43,27,136,153,66,42,30,60,70,64,93,46,210,207,223,30,47,88,8,26,36,142,87,82,106,42,58,13,23,56,84,44,86,64,41,61,58,39,71,123,45,22,65,34,53,39,96,20,28,44,23,60,36,177,104,66,21,44,55,24,33,24,31,143,13,29,29,14,14,56,34,74,25,29,48,12,67,23,212,32,52,34,12,31,54,18,62,23,19,53,62,31,14,58,28,83,37,90,18,54,48,55,19,35,90,62,36,53,39,69,21,14,14,90,21,89,51,25,118,76,30,43,54,21,44,37,28,80,24,65,49,85,36,39,58,83,30,65,16,36,32,19,44,58,16,7,28,18,107,30,66,15,98,69,28,49,29,43,26,52,43,20,55,63,42,40,15,52,38,22,43,39,65,11,34,49,58,108,56,36,70,50,34,85,50,68,40,52,59,68,89,137,46,43,25,30,36,47,44,10,63,36,52,14,27,56,9,38,48,92,37,19,38,66,24,27,51,119,88,17,21,31,18,41,92,31,52,32,40,33,13,68,3,33,31,33,38,21,30,2,33,56,20,51,35,14,30,47,21,123,26,25,40,54,52,22,19,51,14,22,67,55,24,69,13,46,29,112,39,35,64,21,44,55,37,33,28,27,33,54,22,51,29,27,34,96,47,47,178,34,10,20,10,18,26,23,19,24,111,40,47,30,32,37,6,110,53,6,21,38,13,42,31,4,48,37,9,50,65,33,58,39,38,39,44,39,59,9,113,5,20,11,14,4,1,13,2,37,9,0
detail,1,11,6,86,2,7,3,17,3,2,4,1,3,13,2,3,1,8,2,1,5,25,4,18,14,2,7,7,6,5,5,98,56,6,25,17,17,7,6,1,6,3,3,2,19,9,19,11,97,5,25,2,8,14,2,0,44,72,3,11,5,1,4,6,19,3,31,2,2,26,7,3,2,2,33,9,12,1,44,14,24,1,5,2,93,14,14,0,28,2,5,1,0,18,20,5,3,4,10,4,5,22,16,3,5,17,3,2,4,1,9,10,4,5,2,21,3,2,39,97,25,6,8,41,3,2,3,2,6,0,5,0,1,25,9,20,1,0,3,4,1,15,20,1,0,18,3,4,6,8,34,0,3,2,1,14,15,6,2,2,10,2,5,3,1,9,2,6,15,2,2,37,11,3,3,6,84,5,2,22,16,5,8,6,1,9,16,6,16,13,3,3,4,0,0,2,34,4,4,2,20,2,2,5,10,3,5,23,3,15,56,2,12,2,2,3,1,5,17,0,8,9,3,12,31,57,13,13,1,5,7,15,15,22,8,25,9,5,2,4,29,15,4,1,2,5,7,9,38,6,9,3,8,10,8,17,6,4,3,9,7,16,24,3,7,66,1,4,4,4,79,7,22,3,2,2,15,14,18,2,32,0,1,12,3,1,8,7,6,0,5,5,15,3,2,5,24,6,5,8,4,28,0,3,5,3,6,4,4,2,1,13,20,2,11,29,6,21,6,4,4,4,16,1,10,0,4,9,3,18,2,8,3,9,3,6,12,4,4,8,8,3,7,5,6,7,25,19,4,1,9,9,2,13,13,6,2,3,9,14,10,8,6,13,1,2,18,2,5,2,1,9,5,2,5,54,12,4,5,6,40,0,29,12,1,18,5,8,10,2,14,1,6,2,18,13,36,1,19,5,13,2,4,1,6,3,2,1,8,4,0,5,4,9,7,9,2,3,3,0,0,2,9,7,0,2,2,9,8,15,20,6,3,8,0,4,0,6,2,2,10,6,5,1,0,1,0,2,23,5,13,4,4,4,14,2,1,4,7,16,14,7,9,17,8,6,4,5,3,1,4,2,0,1,3,5,0,4,12,3,0,2,0,2,3,2,8,3,1,2,49,40,4,4,1,5,1,9,4,2,2,4,3,4,9,16,2,8,1,2,5,0,6,4,8,12,4,6,4,1,2,3,6,19,2,1,12,10,4,12,4,2,5,5,6,3,9,6,20,10,5,0,0,2,4,2,3,11,9,7,21,2,2,10,15,10,11,4,2,5,11,4,12,1,10,10,9,5,21,14,2,6,9,0,7,2,5,3,1,12,2,18,9,12,8,1,2,5,2,4,10,17,6,3,6,2,2,2,7,6,8,8,3,0,3,15,4,14,6,4,15,22,6,5,17,4,10,4,7,3,14,4,4,23,2,4,8,13,5,16,13,20,12,9,6,1,6,7,2,8,2,1,5,17,5,64,1,4,2,28,3,0,5,5,2,4,23,6,1,9,3,3,4,3,1,1,0,3,7,5,14,5,11,9,4,2,9,3,1,3,6,12,4,4,13,4,3,7,3,8,10,3,12,3,2,9,7,4,6,5,0,2,9,1,18,4,10,7,1,5,0,7,1,15,5,32,9,2,3,5,7,1,3,32,2,4,2,4,2,5,7,10,3,0,3,9,27,2,10,2,7,5,0,10,3,3,3,2,3,4,9,9,3,10,7,14,4,9,4,0,0,6,2,6,5,7,2,2,2,4,3,0,1,9,2,10,4,6,18,6,1,1,8,7,1,4,5,4,10,7,3,2,0,8,14,7,4,4,2,10,4,1,6,2,3,1,3,2,12,8,4,1,2,4,2,3,6,2,2,5,2,6,3,9,2,2,5,2,8,0,10,4,4,7,8,3,2,7,2,5,3,2,3,2,3,2,1,6,7,3,4,16,1,5,1,8,5,4,3,2,7,3,5,3,0,7,1,4,5,16,3,2,6,12,1,2,0,3,8,0,0,4,9,3,11,0,4,8,3,4,0,2,0,1,0,0,2,9,1,2,6,2,2,6,7,2,1,13,3,6,8,3,2,10,4,2,0,0,2,1,8,0,2,1,0,6,0,2,2,10,7,2,5,3,2,4,7,3,6,9,1,5,10,3,1,8,1,17,63,1,6,2,4,3,1,4,4,2,17,5,0,2,4,0,2,6,10,3,0,1,13,3,0,1,2,3,2,4,6,1,11,0,6,10,6,4,4,3,6,0,3,3,13,0,0,6,0,8,1,0
order,26,79,31,388,24,14,21,62,21,6,78,22,34,168,16,36,32,27,18,11,16,160,18,49,54,38,15,26,13,49,53,525,336,33,129,125,175,17,37,9,16,25,16,12,99,39,102,42,805,43,132,19,33,92,13,18,151,92,9,40,41,13,15,38,48,23,254,14,9,47,33,20,23,13,241,22,44,25,222,65,110,5,53,23,635,42,60,5,115,8,28,25,10,81,113,27,53,13,95,30,33,87,70,34,35,92,16,21,33,14,38,19,17,39,6,58,27,20,183,393,114,81,48,179,20,10,6,21,12,9,32,13,11,142,40,127,30,9,14,14,12,99,61,13,8,256,32,47,33,45,208,10,34,14,10,94,86,21,41,28,27,10,24,11,10,22,13,71,40,66,34,204,63,12,4,17,416,11,23,106,81,55,27,84,11,64,62,61,104,143,12,28,15,3,9,13,59,17,24,37,68,11,6,41,103,33,13,99,44,55,253,11,62,20,4,8,16,14,57,8,4,45,22,38,125,288,52,72,12,27,38,56,37,78,60,51,72,37,22,10,206,84,15,34,65,22,34,82,121,22,32,53,56,29,16,28,30,13,5,60,17,137,61,18,21,149,14,15,22,18,377,18,69,19,10,8,108,26,33,9,125,17,12,71,15,10,10,24,47,6,41,22,76,18,9,20,129,24,23,48,67,89,5,19,37,13,65,11,28,2,12,38,99,18,84,56,64,134,32,11,148,28,63,6,150,17,26,66,18,72,7,34,17,17,24,45,37,33,5,36,40,55,18,31,13,31,110,141,43,23,37,22,16,86,55,17,18,19,25,77,58,31,18,63,9,3,137,22,24,25,7,47,6,26,42,108,31,12,39,15,181,9,144,23,12,108,19,68,66,12,71,12,34,31,72,41,130,19,1,14,59,5,6,14,21,25,13,12,86,35,7,33,7,45,77,27,6,29,10,2,7,66,53,50,9,14,16,45,29,61,42,39,10,56,20,22,1,33,28,29,50,55,24,30,5,20,24,23,103,20,42,15,14,11,131,38,3,36,21,125,52,41,82,102,15,24,44,39,24,8,76,18,6,4,10,42,4,50,66,14,14,41,19,8,14,18,30,14,16,16,228,82,10,16,26,37,8,43,14,21,22,17,3,4,36,56,13,31,24,17,8,9,39,21,31,41,22,22,18,18,9,95,21,84,14,23,91,32,56,74,65,25,15,25,23,13,40,37,130,59,8,7,18,20,26,31,68,55,28,19,74,39,37,145,49,34,80,15,11,28,46,16,55,10,31,48,32,23,122,120,32,15,49,27,28,7,15,20,16,60,15,77,37,47,17,14,13,25,14,34,43,89,15,21,93,9,10,13,107,51,75,11,11,9,22,52,22,98,14,23,78,72,33,17,100,20,43,8,22,22,53,31,16,155,18,24,34,25,42,97,20,51,78,64,40,16,43,20,9,23,20,3,22,101,22,104,25,39,27,491,122,28,29,19,37,25,119,57,45,49,15,10,41,54,23,20,12,23,16,24,53,14,221,98,68,14,11,20,40,13,26,94,60,21,29,22,24,31,11,36,58,50,56,30,26,30,19,13,21,50,22,17,19,17,36,24,31,24,13,24,18,36,21,76,56,132,72,30,30,27,54,22,32,107,16,34,18,1,19,34,29,44,14,14,17,27,86,18,105,12,39,16,9,40,36,31,37,23,12,21,32,12,7,49,15,36,33,61,15,15,17,42,18,12,48,29,54,17,25,25,16,6,9,43,22,31,22,17,30,20,7,20,42,16,25,20,26,158,10,46,23,24,10,22,34,54,17,25,10,20,17,28,24,11,17,10,19,14,42,17,25,13,42,41,14,17,14,31,28,40,20,6,30,57,22,9,10,20,31,13,16,16,20,33,14,17,25,78,22,20,18,14,10,35,24,12,19,32,25,53,55,142,26,14,11,13,24,16,28,5,24,16,29,15,24,23,17,29,20,47,13,9,12,21,21,23,17,26,30,8,3,35,23,11,37,15,27,15,35,20,15,47,2,12,35,73,22,51,10,16,18,26,49,18,38,33,19,57,26,43,32,30,8,29,32,32,6,20,9,13,25,18,18,22,7,31,5,78,12,21,14,7,18,12,17,9,22,19,26,44,22,26,20,6,21,36,17,41,76,20,9,22,13,16,15,13,10,15,61,13,11,23,24,21,7,81,15,9,5,21,22,17,12,17,26,11,10,22,27,22,25,12,12,20,16,4,20,15,55,1,8,8,9,1,0,14,6,18,4,1
the past year,6,5,4,49,4,9,6,21,4,5,10,5,3,30,4,3,5,3,6,1,2,13,3,8,11,5,7,5,4,10,4,83,65,4,20,31,28,2,5,3,2,7,3,4,12,4,6,6,126,4,16,7,8,27,3,2,14,49,3,26,18,3,3,6,11,2,38,10,4,4,9,2,0,2,23,6,7,3,36,3,48,1,3,6,59,7,11,1,19,1,7,3,6,16,17,6,7,5,25,14,8,12,19,1,9,11,4,4,2,4,8,2,3,13,0,16,1,3,25,29,13,14,6,64,2,1,2,2,1,2,9,3,7,20,2,48,2,8,1,8,0,17,12,3,2,21,5,13,4,6,12,2,7,1,8,7,12,1,5,9,9,0,2,6,4,1,9,16,12,5,13,28,7,3,1,1,69,4,2,17,11,5,0,8,3,11,17,8,10,14,1,2,6,0,2,1,6,4,7,1,18,4,1,3,23,2,10,10,9,10,33,3,10,5,0,1,0,0,8,3,3,5,3,4,19,27,23,9,2,2,7,9,17,6,19,18,15,5,17,3,19,23,4,0,7,3,4,2,21,1,6,3,9,4,3,2,6,3,2,16,2,14,3,0,4,62,3,4,7,2,42,3,22,4,2,1,9,13,13,2,11,3,8,10,7,6,5,5,6,1,5,3,1,2,1,6,22,1,3,10,6,8,0,3,6,1,17,4,1,3,0,3,16,4,8,30,9,28,7,4,17,2,7,0,18,1,11,8,0,10,0,4,1,1,2,2,7,5,2,5,3,9,4,5,9,4,22,18,4,4,6,3,0,12,6,5,1,2,8,14,9,13,13,4,2,1,6,1,1,6,3,8,2,6,4,28,11,1,9,7,16,1,13,4,6,26,0,15,10,1,6,7,1,2,17,2,11,5,14,1,10,2,6,5,3,4,2,6,13,3,2,9,15,11,7,3,2,3,0,4,0,3,6,1,3,4,5,10,12,3,2,3,5,2,2,3,7,6,3,1,13,15,5,10,1,1,5,5,20,8,3,2,3,5,25,0,0,4,6,9,2,16,14,17,4,3,13,3,9,1,6,3,0,0,1,2,4,2,3,2,4,14,1,1,7,0,4,2,2,2,45,16,3,3,11,5,5,7,0,3,1,2,7,2,2,2,3,6,1,3,3,4,2,3,5,12,4,7,4,9,8,9,4,7,3,2,11,6,5,3,2,4,1,2,5,4,3,4,13,12,3,2,4,10,7,4,4,9,13,3,6,2,2,23,3,2,13,2,3,7,8,2,7,4,7,9,10,1,15,20,8,5,8,1,5,2,16,4,1,11,1,1,2,5,5,1,2,3,2,4,5,12,3,1,11,4,4,4,17,2,4,4,3,5,3,4,2,5,7,3,11,11,5,7,6,2,4,1,3,1,9,0,3,6,2,4,3,7,4,16,2,16,5,4,8,0,2,6,2,8,4,4,2,12,3,32,2,3,2,77,11,1,5,1,4,5,12,3,0,7,0,6,2,9,4,0,2,4,6,4,7,5,11,7,15,2,0,3,4,0,3,13,8,2,5,6,5,9,3,8,6,7,3,9,4,8,2,0,3,1,13,2,7,6,7,6,2,5,1,4,1,8,1,9,4,16,12,6,3,6,5,2,6,14,1,5,2,1,3,8,2,7,5,1,3,4,19,6,12,6,3,3,6,4,6,1,6,6,5,1,5,4,5,11,4,9,1,7,2,26,22,7,2,3,16,8,6,3,18,8,3,6,4,5,5,10,4,3,6,2,4,1,8,3,3,5,0,5,3,3,2,2,1,7,4,3,3,6,12,3,4,5,0,0,4,5,1,6,13,9,3,2,2,2,3,3,3,4,1,3,3,8,7,2,8,1,2,2,1,2,3,4,4,3,4,4,8,11,6,7,1,0,3,3,7,5,1,4,7,7,2,10,1,7,8,2,3,8,1,1,3,4,2,5,3,5,2,3,4,9,5,3,0,2,2,3,1,2,9,7,2,2,2,4,6,2,2,12,1,1,8,4,0,2,3,4,3,0,5,3,5,1,0,6,8,3,6,5,1,5,2,0,2,10,3,4,1,1,2,1,1,3,2,1,4,2,4,3,3,3,1,1,1,5,0,3,4,3,1,7,4,1,7,0,6,4,4,6,14,2,0,4,3,5,3,6,12,2,8,4,12,1,0,5,9,9,4,0,1,2,3,0,7,4,1,2,0,1,3,2,14,2,4,0,2,0,0,4,8,0,1,2,14,2,1,2,1,5,1,1
respect,16,48,17,246,27,6,11,65,15,5,52,23,11,178,15,25,10,22,14,12,8,89,28,57,49,27,40,26,22,17,10,313,262,15,94,129,78,6,17,12,12,32,14,2,47,31,42,30,610,64,65,11,21,107,13,14,137,53,18,46,52,22,8,29,35,10,148,7,40,20,11,10,9,7,112,23,23,4,128,44,90,1,29,11,448,17,14,0,61,5,7,13,1,46,90,28,26,14,66,21,32,53,85,18,19,57,14,2,14,8,42,11,13,25,3,43,10,5,131,227,73,25,31,79,9,11,8,10,4,4,29,8,12,116,48,52,23,6,14,18,15,39,51,6,5,117,12,27,18,11,177,3,24,11,8,70,42,9,21,21,21,3,10,6,2,4,3,33,43,19,21,184,31,3,9,16,291,3,25,47,29,28,8,25,7,34,63,35,91,92,6,11,11,7,2,6,26,8,16,33,31,1,7,35,45,24,11,70,28,65,140,6,44,14,8,10,3,0,41,5,8,39,13,24,72,244,60,54,14,17,31,24,17,36,56,30,63,13,17,15,113,67,10,13,24,8,14,45,74,16,23,32,33,8,26,29,16,4,10,15,15,40,45,11,8,83,15,24,36,8,219,9,36,20,9,8,41,22,34,10,130,14,4,50,17,2,11,14,36,2,8,10,22,10,6,30,91,20,19,48,58,46,0,5,21,5,39,12,7,4,8,38,31,15,35,35,19,74,24,16,117,26,39,9,206,14,8,43,7,63,9,20,17,14,13,26,28,13,9,18,21,12,30,22,14,8,101,122,27,20,20,35,25,36,51,9,17,7,22,47,50,13,10,36,4,8,71,20,10,34,8,48,9,31,19,25,19,5,36,12,154,8,85,21,10,46,27,48,44,7,50,7,15,42,108,23,156,13,59,10,1,7,8,10,12,17,16,12,54,16,24,21,6,38,18,20,14,9,12,10,16,26,50,23,6,10,6,42,15,24,25,5,3,21,9,14,5,43,26,7,33,48,13,40,4,11,15,14,62,11,36,17,10,15,111,34,2,34,14,56,20,44,68,36,18,5,27,22,12,6,32,8,3,7,5,26,6,29,27,3,9,25,12,23,20,14,20,11,11,9,100,70,2,10,23,22,5,43,18,22,23,10,15,9,15,42,4,27,16,6,9,19,18,21,33,55,11,33,34,11,15,41,18,77,16,15,53,9,35,57,24,18,7,9,9,11,27,19,49,33,8,10,5,4,8,20,12,34,40,10,68,14,15,73,8,20,72,4,14,14,56,6,49,11,27,27,26,11,62,76,15,23,27,11,14,13,31,14,4,20,17,43,17,32,26,23,12,13,7,9,54,79,12,4,27,7,15,2,163,32,47,2,6,20,17,48,13,67,7,8,55,35,33,21,69,14,31,2,18,5,24,13,16,34,4,16,13,12,37,61,16,48,58,50,13,6,17,15,17,20,16,11,43,33,25,61,5,10,16,372,45,8,19,15,21,24,60,44,16,27,11,14,33,61,22,16,6,15,20,30,30,15,40,71,64,4,12,17,13,14,17,60,28,17,20,14,25,18,10,25,26,23,34,22,21,14,22,13,34,40,14,6,11,28,18,11,33,7,16,10,5,13,13,49,29,23,8,13,22,20,19,10,13,60,6,15,16,5,7,24,15,26,6,6,14,16,50,9,58,21,14,13,9,28,29,9,22,13,13,21,20,9,4,14,9,23,19,37,15,21,21,28,6,6,35,25,18,25,12,17,13,11,10,33,14,25,11,6,24,31,3,10,17,4,16,15,8,12,21,23,15,33,19,16,12,26,14,21,10,25,13,10,14,8,4,5,22,11,29,16,7,17,25,16,9,11,12,15,5,25,17,7,10,22,7,11,8,17,14,7,25,11,33,9,17,15,29,52,16,17,33,19,10,31,9,16,17,22,18,27,35,38,19,15,4,13,9,9,18,5,11,11,17,16,12,14,8,10,14,26,17,17,12,13,11,20,18,34,23,21,14,13,8,11,13,12,15,24,9,10,5,14,2,8,15,13,12,9,5,10,12,16,6,15,22,2,15,23,9,43,9,11,17,16,21,7,2,22,6,8,17,20,11,35,21,22,12,47,14,19,17,9,13,24,10,4,7,10,7,36,4,21,5,6,5,22,13,17,54,5,0,12,11,6,15,2,3,11,30,20,2,14,15,26,2,51,8,1,9,12,13,20,10,8,10,17,4,12,9,5,12,22,7,10,7,17,17,12,36,3,9,8,4,4,1,4,2,11,7,16
around,3,11,5,40,4,18,3,15,2,3,3,14,18,51,2,3,13,9,12,8,1,17,31,25,4,14,32,24,14,25,4,76,67,21,36,80,34,1,4,6,6,25,10,13,23,6,12,4,81,94,21,8,11,147,25,1,11,6,24,16,3,8,0,9,17,7,50,8,4,8,10,3,6,2,75,14,19,3,42,25,19,1,3,25,49,3,1,1,8,1,4,10,3,35,13,5,11,2,32,11,4,10,8,16,6,15,3,13,16,5,18,2,13,11,7,28,0,6,16,45,18,35,8,65,8,3,5,2,2,1,24,5,11,21,25,67,0,3,7,7,6,26,14,1,3,45,9,13,8,5,28,6,7,3,3,4,40,3,5,38,2,0,5,1,6,22,8,15,11,3,10,55,18,1,17,4,26,4,3,36,9,4,16,15,0,16,9,5,8,20,2,1,0,8,2,3,12,3,9,1,7,1,3,5,11,14,2,7,6,6,50,19,7,5,13,18,7,13,14,2,2,5,3,3,19,19,21,14,7,1,6,7,11,14,10,1,7,8,1,7,31,21,5,5,11,3,3,34,18,9,4,7,10,4,9,7,2,0,0,4,1,38,8,0,1,3,5,28,15,0,39,5,5,5,1,6,13,4,3,0,40,2,0,4,6,3,9,11,10,3,0,9,3,5,7,3,10,3,8,5,14,6,0,4,5,8,10,3,8,3,1,5,18,12,3,5,9,7,1,4,11,2,21,14,25,1,12,48,2,7,10,4,3,4,0,3,19,3,3,2,1,11,17,0,1,8,11,20,14,21,1,5,3,16,6,1,3,0,2,22,3,6,5,6,1,13,9,5,19,31,6,46,4,23,8,9,2,2,8,0,8,4,15,9,22,9,1,5,13,4,5,6,1,2,8,14,12,2,5,2,7,1,6,14,7,4,9,2,9,12,0,12,5,3,1,13,10,8,4,24,2,4,4,1,6,4,3,1,4,4,6,2,0,9,8,0,7,10,19,1,10,11,1,13,10,3,34,9,8,14,30,1,20,9,18,1,13,2,4,6,15,16,19,18,2,5,41,6,8,3,25,5,4,9,2,7,1,3,6,2,5,11,3,6,6,2,1,10,0,0,49,10,3,5,10,2,0,2,6,3,8,2,2,3,4,8,5,3,1,6,4,1,3,4,1,2,5,2,2,3,0,5,2,7,3,4,9,0,3,2,4,6,8,2,4,6,1,5,12,4,6,5,4,7,4,1,0,7,1,1,5,1,0,19,1,5,8,0,3,0,7,0,2,3,3,4,2,1,11,13,5,0,3,0,2,0,2,1,0,17,2,4,3,15,4,2,2,0,4,17,5,10,9,8,4,3,4,1,6,3,2,2,4,2,0,4,3,1,0,7,7,1,6,2,10,2,8,1,1,0,5,3,2,10,1,3,3,1,3,7,5,7,7,8,3,0,9,7,5,3,6,8,2,5,2,14,0,1,1,47,5,3,1,1,3,9,3,6,1,2,3,9,3,2,1,1,0,0,1,2,5,1,8,3,2,1,1,0,0,2,10,6,4,2,0,2,3,1,5,11,3,23,8,4,2,6,8,0,4,1,6,1,0,4,4,8,1,6,1,1,3,4,1,9,6,10,16,0,2,2,2,1,4,6,2,5,0,7,1,5,1,2,2,5,1,1,11,2,6,4,5,1,6,8,13,1,6,5,2,2,12,1,0,3,0,5,2,4,1,4,4,9,1,1,9,7,14,0,4,0,11,4,2,2,2,2,2,0,2,0,6,1,2,0,2,0,1,4,3,0,2,7,2,0,1,3,0,3,2,0,0,2,1,0,12,1,5,2,3,0,2,2,2,1,2,1,1,10,1,5,0,0,2,4,3,1,8,1,3,1,5,0,3,4,5,4,3,9,2,1,0,2,2,2,1,0,4,5,2,2,5,8,0,2,0,3,0,2,0,1,1,3,1,2,0,2,14,1,9,1,2,0,3,1,2,0,0,0,8,3,1,2,3,0,1,0,1,2,3,2,8,6,3,0,0,2,5,2,5,15,1,0,14,1,2,2,1,5,0,6,5,1,3,2,0,2,1,3,2,0,3,1,1,1,0,2,3,1,1,4,1,2,0,4,0,2,3,3,2,6,0,6,0,0,0,2,1,7,11,0,2,5,2,4,0,1,19,7,5,1,3,2,0,1,3,0,2,0,6,6,2,0,13,10,1,1,7,2,4,1,0,4,0,2,1,0,0,12,0,5,0,3,0,7,2,3,1,0,9,19
approach,3,7,4,64,3,4,9,18,5,4,7,7,6,40,5,2,3,0,3,3,2,14,7,11,12,9,9,7,1,18,4,82,55,2,25,34,14,2,9,5,2,1,0,2,19,5,11,4,114,5,22,6,10,15,3,5,28,11,7,10,7,4,1,2,14,7,38,4,6,24,8,7,0,4,37,13,10,1,54,16,21,0,7,1,95,5,8,1,11,1,1,3,2,9,31,7,13,3,15,2,9,14,10,5,14,10,8,4,6,4,7,4,4,7,1,9,3,5,12,76,19,17,8,46,6,0,2,0,6,0,3,6,12,23,8,29,4,0,4,6,1,22,15,0,2,34,4,11,6,4,34,1,4,3,6,5,13,2,10,5,8,2,0,0,2,9,2,6,7,5,14,47,13,4,2,6,61,1,6,17,9,3,6,6,4,15,14,7,30,22,1,2,2,2,2,3,13,8,3,4,16,1,0,18,9,3,2,16,5,23,27,6,22,5,0,11,8,4,3,1,9,10,2,5,20,37,24,15,4,9,6,4,12,7,9,15,12,6,5,6,24,14,3,9,7,2,3,15,16,2,6,12,5,7,5,7,4,2,2,16,1,16,9,2,6,13,5,4,9,3,73,2,4,2,6,3,17,9,6,0,32,4,2,9,5,1,10,10,8,5,1,3,5,4,2,2,16,5,3,9,11,9,0,2,6,1,14,6,5,1,2,15,5,4,15,5,8,17,6,3,19,6,12,5,25,3,16,12,5,18,6,4,9,2,4,3,7,1,4,9,5,6,8,4,9,8,17,35,5,10,5,3,4,20,9,3,1,6,7,15,8,4,3,16,1,3,17,5,6,5,1,8,4,10,6,10,4,1,17,1,33,3,22,9,0,16,4,8,9,0,9,0,1,4,22,7,28,4,6,6,8,6,1,1,0,3,2,4,5,5,9,5,5,7,1,6,2,8,1,3,6,8,17,7,3,2,6,8,4,7,2,8,0,7,3,1,1,9,6,1,1,7,2,5,0,1,4,5,14,12,9,3,2,3,39,0,0,5,5,9,3,18,18,24,6,3,5,6,7,2,10,3,4,1,2,21,4,6,9,4,0,5,1,3,3,2,6,1,6,1,28,14,4,3,8,4,1,9,3,5,10,5,3,7,8,3,1,5,2,0,3,4,2,3,8,4,3,11,2,4,3,4,4,8,2,4,7,3,4,15,7,0,9,1,7,7,4,2,18,8,5,0,0,3,6,3,4,6,8,2,14,0,0,19,2,4,10,3,4,2,17,2,10,2,6,5,14,5,13,14,4,2,4,0,3,1,8,1,2,9,2,5,6,10,6,18,2,3,2,6,15,14,6,5,11,0,13,0,17,9,10,0,1,0,3,5,2,10,4,4,8,15,6,6,9,2,5,2,2,4,8,0,1,6,1,5,2,6,4,15,15,8,6,13,2,0,10,6,3,4,12,4,2,7,2,4,0,3,4,64,11,4,3,5,2,7,15,6,4,3,3,4,6,14,3,4,2,5,5,5,6,5,21,8,12,2,2,4,3,0,12,10,3,7,2,2,4,2,4,13,8,3,8,3,1,5,2,2,3,6,1,5,2,1,4,4,12,3,2,1,3,5,2,8,8,10,6,8,6,4,4,4,6,5,2,6,9,3,6,10,4,4,1,7,3,7,6,4,9,4,5,3,3,5,10,1,4,3,2,7,9,5,2,2,2,2,2,4,0,6,6,4,2,6,5,16,8,4,7,8,3,7,2,5,5,6,4,0,3,9,1,2,5,0,10,2,5,8,5,3,2,0,0,4,2,12,4,3,3,4,4,4,6,5,5,1,3,4,8,2,6,1,4,3,1,3,4,5,4,8,1,1,3,1,3,6,1,0,0,1,4,3,6,4,4,7,5,11,2,3,3,3,3,2,2,5,2,11,3,6,10,10,4,3,3,1,8,0,3,1,3,3,3,3,0,3,2,2,2,0,4,2,5,5,2,0,4,6,4,12,1,3,2,2,3,3,1,2,5,3,0,5,3,1,1,0,1,0,2,2,2,0,3,3,10,2,2,6,1,11,0,0,1,3,2,1,2,3,5,0,4,2,2,5,0,3,0,7,3,2,2,3,2,2,2,2,1,0,1,6,1,6,2,4,3,8,9,3,3,1,1,3,3,4,0,7,6,3,2,2,0,6,3,0,1,7,3,5,3,6,18,3,4,2,3,2,2,2,4,2,2,4,3,9,2,2,1,1,4,1,1,1,4,1,2,6,2,3,1,0
leader,4,12,12,49,5,20,2,14,5,0,4,3,8,50,0,5,11,6,9,7,4,13,17,26,3,21,25,19,15,20,4,50,53,16,14,59,28,0,5,6,3,10,2,10,17,2,10,10,55,59,21,19,8,49,5,0,7,3,29,10,2,8,1,5,12,11,50,3,3,10,4,1,2,4,48,10,16,1,35,22,12,1,2,12,39,1,2,1,11,0,4,5,1,21,10,3,12,1,20,4,0,9,5,7,2,17,3,5,9,5,13,0,12,15,17,23,1,1,17,34,7,22,2,53,6,5,4,3,0,0,13,3,9,24,17,51,4,2,5,3,7,19,5,1,0,42,10,12,2,3,29,5,2,1,3,7,30,5,1,42,2,0,3,2,6,19,7,16,7,3,9,45,14,2,11,3,20,4,1,25,14,1,19,14,1,13,9,6,2,10,4,2,1,8,2,0,12,5,3,4,27,0,2,3,7,11,0,4,9,5,31,12,8,3,7,12,7,5,7,0,2,2,0,4,12,16,7,4,9,3,5,4,9,3,9,5,2,7,1,4,16,8,3,6,9,3,3,27,12,5,5,2,14,0,0,3,0,1,0,6,1,27,1,0,3,5,8,22,12,6,14,3,0,0,0,11,9,0,0,0,29,3,0,4,7,2,5,3,9,0,2,4,3,4,0,1,7,10,5,9,13,0,0,0,4,7,9,2,2,3,3,1,18,9,6,4,4,4,5,6,16,5,18,6,21,0,5,36,0,9,11,2,3,0,3,4,16,1,0,1,3,9,15,2,1,7,4,16,6,7,0,2,1,13,4,0,4,1,2,21,4,3,10,5,0,5,4,3,17,25,4,40,0,28,1,5,1,0,7,2,9,1,3,5,8,7,6,10,3,1,9,9,16,18,0,8,1,1,14,5,10,14,1,1,4,6,3,2,1,7,1,3,0,5,3,9,6,4,5,15,0,4,7,2,1,0,2,4,3,8,0,1,0,4,17,1,7,9,11,3,7,3,1,7,1,5,21,9,3,6,26,0,12,7,4,3,6,3,5,3,11,11,14,13,2,7,14,5,0,3,20,5,0,1,2,4,2,5,7,0,0,9,0,2,5,1,1,10,3,0,22,4,3,3,11,1,1,1,1,1,0,1,0,2,0,2,0,1,3,1,0,1,2,0,0,1,3,1,0,5,0,2,1,2,0,0,9,2,4,2,2,3,6,1,3,2,0,4,9,1,0,0,7,1,3,1,1,2,1,0,3,2,0,10,8,2,2,1,0,1,0,0,1,3,4,1,4,0,5,9,0,1,0,7,3,0,0,0,1,15,0,1,3,8,0,2,1,0,0,4,8,5,8,2,14,2,1,8,2,2,3,1,4,1,1,3,4,3,0,2,4,6,2,0,8,1,0,0,0,0,1,0,0,8,1,1,1,1,1,6,2,2,2,2,2,4,7,0,2,0,3,3,3,2,0,0,0,4,5,32,12,1,0,1,0,6,7,10,2,0,0,2,1,0,1,1,1,0,0,0,2,1,6,2,0,0,0,0,0,0,2,6,3,0,4,2,8,3,0,0,0,17,3,1,0,3,6,0,5,0,7,0,0,0,2,4,3,3,0,0,3,0,1,4,1,2,14,1,0,0,2,2,1,5,1,3,0,0,0,0,0,0,0,2,0,0,1,1,7,3,0,2,3,2,1,2,5,3,3,1,4,0,0,0,2,2,4,0,0,0,0,5,0,4,3,2,8,1,2,1,7,6,0,1,0,5,0,0,0,1,0,0,3,0,3,2,0,1,1,3,1,0,0,0,1,1,0,0,0,1,0,1,3,0,12,5,4,4,1,4,0,1,0,1,0,1,2,15,1,0,0,0,7,1,0,0,7,1,2,0,2,0,2,4,3,4,1,5,0,2,0,0,0,0,1,0,2,8,0,6,14,4,2,0,5,2,0,0,1,0,2,2,4,2,1,0,4,1,6,1,0,0,0,0,1,0,2,0,5,1,0,1,0,0,0,0,1,0,1,0,10,0,0,1,1,0,0,2,4,18,1,0,6,4,2,0,2,0,0,3,3,0,1,0,3,3,2,0,0,1,1,0,0,0,0,1,3,1,0,0,0,2,1,0,0,0,1,2,0,1,0,6,2,0,0,0,0,0,0,2,0,2,1,2,0,1,0,1,4,2,0,1,0,0,0,0,1,1,9,0,3,0,3,11,0,2,4,2,1,1,0,1,0,0,2,0,2,9,1,9,1,6,0,11,4,0,1,0,2,11
little,2,9,10,64,5,8,3,11,3,8,11,3,5,45,5,12,6,12,6,9,1,23,3,21,16,8,8,6,11,15,5,129,89,7,36,46,33,11,6,2,3,3,4,4,28,6,14,10,122,17,20,6,6,25,5,2,16,17,1,9,13,9,3,4,12,6,59,2,8,5,10,3,4,9,51,8,10,1,40,25,21,5,8,8,117,6,8,1,24,5,8,2,13,13,38,8,13,5,21,18,3,16,23,8,6,14,3,8,12,4,11,1,10,14,1,20,2,3,51,77,25,14,12,59,10,2,1,4,1,5,2,1,8,24,16,24,1,2,3,4,3,20,25,3,3,28,10,8,9,11,33,1,3,5,4,15,23,6,4,13,5,3,19,3,3,6,2,10,15,11,6,67,13,1,2,8,96,1,6,18,18,6,5,12,3,17,26,13,14,26,6,5,6,3,4,1,20,2,6,12,31,4,1,8,19,2,5,34,5,20,42,3,25,4,1,10,4,7,10,4,7,13,4,6,27,46,18,27,5,4,9,3,21,11,20,13,28,4,7,6,39,17,5,3,13,5,8,16,23,2,13,10,25,11,4,7,14,6,4,17,2,16,14,3,5,21,10,3,10,7,66,2,31,6,4,1,6,13,4,1,36,1,1,11,10,0,2,7,12,2,3,2,6,6,1,3,13,4,1,12,18,8,5,5,8,4,9,2,3,3,2,11,18,1,35,18,18,19,7,2,18,8,33,7,25,3,8,17,2,15,12,4,4,8,10,2,11,3,5,4,3,3,10,4,5,6,20,26,9,3,4,8,1,24,19,6,0,3,11,21,9,4,7,10,2,0,21,8,2,12,0,7,5,11,14,21,5,8,7,5,28,3,24,9,2,36,11,4,27,3,12,3,11,4,12,12,20,6,21,3,12,7,0,4,1,5,6,6,12,3,8,14,1,5,3,3,1,4,6,2,5,2,6,16,3,5,2,1,3,10,11,10,2,5,2,3,0,3,6,3,8,7,6,8,3,3,6,5,16,10,10,3,2,10,28,5,2,3,5,17,17,22,14,20,5,1,13,6,6,1,12,3,1,4,0,12,5,6,28,10,7,2,2,0,8,3,7,10,2,0,37,22,2,2,3,4,4,7,1,9,16,3,5,6,10,27,4,6,6,6,4,5,10,7,14,9,3,5,4,5,2,20,6,7,4,3,16,8,7,15,3,2,0,9,4,5,3,11,16,12,2,2,3,4,6,4,2,13,4,7,20,3,5,40,10,9,17,2,4,3,9,5,17,4,7,8,12,4,18,21,7,7,8,2,4,3,6,6,4,11,3,6,6,5,1,2,7,4,1,8,8,13,4,7,11,2,2,5,12,13,14,5,1,2,0,10,1,9,2,1,16,10,3,6,17,5,11,2,6,4,9,4,4,14,3,7,3,9,5,21,12,10,20,19,2,0,17,4,2,8,6,6,4,18,3,15,4,1,5,54,4,2,4,7,5,12,14,7,6,8,3,8,1,4,0,2,1,4,9,3,11,5,26,14,7,4,0,4,1,6,1,11,4,11,4,11,6,1,3,3,5,7,10,4,5,6,7,1,7,3,7,2,1,4,10,3,10,6,1,0,6,7,2,13,11,14,2,1,0,5,1,1,0,5,3,3,3,3,2,4,4,11,9,2,2,1,17,7,13,5,3,1,2,5,2,2,12,5,1,3,8,9,4,5,4,6,1,7,1,15,12,7,0,4,13,8,5,6,6,5,6,2,0,9,3,7,5,3,9,13,5,2,6,8,6,2,2,1,3,10,0,8,2,1,5,8,5,3,1,0,3,4,3,5,0,4,4,9,11,2,5,1,4,9,5,2,2,4,8,10,4,1,0,1,5,5,6,5,7,2,7,4,10,3,1,3,10,4,2,2,5,5,1,3,6,11,8,6,4,9,15,19,7,3,1,3,6,9,3,0,4,1,4,3,4,5,6,1,3,4,2,9,16,16,4,4,0,6,2,0,1,6,0,0,5,4,4,4,1,4,5,9,1,1,3,6,2,2,7,3,1,2,1,6,1,1,0,17,3,11,5,16,1,20,7,4,1,1,3,4,5,3,7,4,2,2,1,1,1,10,2,1,1,3,0,4,5,2,1,6,5,10,5,6,5,14,11,12,33,4,2,4,3,4,3,7,3,3,9,4,10,3,0,6,5,10,0,3,8,1,2,1,3,9,1,9,1,2,1,8,2,4,2,7,6,9,6,3,5,1,0,2,3,1,1,3,3,6,2,0
wealth,4,14,5,40,4,7,6,26,0,5,14,13,7,81,2,13,4,23,4,2,1,19,18,15,22,6,6,9,8,8,0,90,103,4,42,62,13,8,5,9,12,13,2,4,40,22,16,12,134,11,10,18,38,32,10,3,30,5,3,22,9,4,3,4,10,2,132,8,2,11,8,1,6,3,84,16,18,2,49,22,64,2,7,15,126,13,7,0,11,2,2,7,4,8,43,7,9,5,18,26,7,18,13,7,10,13,3,1,12,8,20,3,4,18,4,24,3,5,29,93,31,20,18,24,2,0,2,0,0,1,12,2,18,26,24,38,20,1,2,7,5,29,14,1,6,31,23,25,16,20,70,0,8,16,25,7,31,13,5,14,6,3,7,0,2,6,5,48,22,7,11,71,28,1,6,2,106,1,6,14,23,7,2,14,1,42,22,10,11,13,3,1,6,2,1,6,15,7,9,23,65,8,4,0,7,7,3,31,6,19,47,7,4,4,4,3,0,2,2,2,4,17,6,13,20,58,23,15,4,6,8,6,7,50,30,14,26,14,15,12,45,29,7,12,29,8,5,25,29,9,6,32,14,8,11,5,5,0,1,18,1,11,11,0,6,15,11,10,17,7,70,7,17,3,2,1,13,9,1,1,42,22,1,17,5,3,7,11,18,1,0,0,4,5,0,9,14,3,1,32,18,10,1,1,13,8,19,4,16,0,1,20,7,3,16,14,20,27,24,5,18,9,9,6,36,2,14,16,1,23,1,13,8,5,6,8,15,3,8,6,6,1,10,4,12,9,30,31,9,8,8,9,10,31,19,4,7,2,11,25,14,4,17,21,6,1,9,9,6,6,0,3,4,20,16,10,7,12,36,5,44,1,35,5,6,28,3,10,17,11,18,2,5,1,16,16,17,3,25,4,17,4,3,6,5,1,5,2,22,8,5,7,6,20,0,4,0,8,2,2,9,8,27,4,4,7,3,19,4,8,8,1,2,3,9,2,0,0,3,3,18,12,5,9,2,1,15,0,28,12,11,1,1,9,55,1,2,8,5,20,13,28,33,75,4,0,22,17,7,6,16,6,4,4,1,68,3,4,11,4,10,19,1,5,13,0,7,1,11,2,24,23,1,2,8,5,10,8,6,33,24,10,8,2,2,10,10,22,7,10,7,6,8,15,12,11,11,12,17,23,6,40,11,39,9,8,25,54,15,25,14,19,5,25,3,13,7,20,39,32,12,6,8,33,10,4,4,17,5,4,18,1,1,25,2,11,28,9,9,9,12,0,6,3,7,11,14,2,11,42,11,5,7,0,5,2,4,7,2,3,9,6,11,16,8,8,7,3,4,4,16,14,6,8,41,11,10,7,12,10,8,6,4,2,4,8,3,4,7,7,20,3,2,5,13,6,13,9,0,2,11,3,1,12,5,6,2,7,14,10,11,9,31,12,5,4,29,3,1,7,21,9,7,6,4,17,6,0,6,36,1,9,6,1,7,6,15,21,3,8,1,8,2,8,4,0,0,3,2,3,10,6,7,0,6,5,4,1,1,9,3,13,3,5,9,7,4,1,8,7,6,9,10,15,1,3,6,0,3,12,1,5,1,0,6,3,2,3,3,0,1,0,2,18,12,6,2,4,4,1,4,13,3,5,1,3,8,6,3,15,6,11,5,14,4,0,12,4,14,47,6,3,4,9,10,6,17,9,4,6,11,8,3,3,2,4,4,6,2,13,10,7,0,1,22,11,24,3,14,5,5,5,1,7,2,8,7,9,10,8,3,2,7,8,20,4,2,1,0,4,4,11,7,5,26,11,11,3,1,1,2,4,4,0,8,2,2,6,10,4,8,1,1,3,7,1,3,1,2,10,0,3,0,3,5,0,7,3,0,5,14,3,9,6,2,14,5,26,8,1,1,6,4,1,3,10,4,2,1,10,1,12,4,8,1,4,11,10,0,1,2,10,3,3,4,6,9,4,0,7,1,3,3,7,13,8,0,2,5,3,1,3,0,1,0,1,0,3,8,7,2,6,1,2,1,2,8,0,0,2,5,0,0,1,6,1,0,11,0,8,8,3,7,6,4,1,4,11,0,1,2,3,4,8,2,3,0,0,0,6,3,5,4,2,2,2,5,10,11,10,0,11,3,1,9,13,16,11,21,2,3,2,5,0,1,1,4,8,10,0,3,10,2,1,0,3,6,2,4,6,5,4,16,6,0,6,1,4,4,4,0,7,1,9,6,9,7,3,3,1,5,4,4,2,2,3,3,0,3,3
instead,2,17,5,67,4,5,0,19,2,5,9,1,9,44,1,3,4,9,3,0,3,36,29,19,14,8,13,10,4,21,4,127,82,12,36,56,14,8,13,4,10,8,4,5,21,11,18,11,132,23,39,5,8,32,20,4,29,13,3,12,6,5,1,9,27,4,61,5,7,8,9,0,2,3,54,11,17,4,58,23,45,4,8,11,107,20,8,2,29,2,13,4,3,9,35,10,4,3,28,7,17,19,23,5,7,25,5,7,3,5,17,6,7,16,4,18,2,1,37,131,30,21,10,62,11,3,1,2,5,1,14,9,9,34,14,53,6,0,6,4,2,35,16,1,4,45,16,16,17,10,37,5,12,9,2,12,19,2,4,31,14,3,14,2,1,18,6,17,27,5,18,67,18,3,8,9,120,4,2,31,27,10,7,23,2,20,14,30,10,21,7,11,1,3,1,4,8,1,10,8,42,1,2,10,26,9,7,40,8,13,39,12,15,12,7,11,3,7,13,0,7,7,1,12,36,93,45,18,3,8,6,3,19,19,42,23,16,9,6,10,39,19,12,7,13,7,5,31,28,9,11,21,11,5,4,10,8,0,5,15,9,25,11,2,7,36,4,4,10,4,67,6,27,4,3,3,15,14,6,2,33,14,4,17,11,0,4,12,16,6,2,4,14,4,5,13,20,3,7,12,14,18,2,1,9,5,20,5,10,10,5,21,20,7,41,14,21,47,14,3,44,2,31,17,28,5,6,23,2,17,2,13,8,13,11,8,18,5,2,10,11,19,8,9,5,11,36,29,12,13,9,7,2,30,10,8,7,3,8,19,13,10,5,18,2,6,28,5,16,16,4,18,3,17,20,18,5,5,10,5,34,3,27,9,8,30,7,15,24,4,27,8,6,3,16,6,24,2,13,2,16,9,2,3,6,5,1,6,8,12,4,8,0,9,7,1,0,9,4,3,5,4,10,14,4,1,2,12,4,10,17,8,1,4,1,2,3,4,3,1,16,13,7,13,3,5,15,9,25,12,21,3,6,5,26,7,1,1,11,13,9,17,16,24,3,2,15,7,9,0,9,7,4,1,6,18,3,2,19,1,18,8,3,6,11,8,10,0,4,2,39,26,1,5,9,3,2,14,2,10,7,1,5,1,7,47,6,10,6,9,6,5,7,4,17,9,8,4,45,7,7,13,3,14,9,1,28,6,16,25,4,4,3,12,10,6,3,6,37,30,5,2,2,7,8,5,4,26,13,3,21,2,8,30,5,10,23,5,6,2,3,5,6,7,15,7,12,7,26,31,9,7,19,4,6,2,8,6,8,19,7,6,17,10,4,3,5,10,3,11,15,16,8,7,29,9,6,3,25,10,13,2,7,1,2,11,4,15,7,8,32,14,8,3,42,6,6,3,4,2,7,11,5,14,1,0,4,5,2,16,12,11,16,21,10,2,6,6,1,13,13,2,14,10,2,13,11,2,8,79,9,5,1,5,2,13,24,7,7,10,6,6,4,3,1,0,0,9,11,10,13,5,17,17,20,6,3,1,4,3,7,15,9,2,7,4,12,3,7,2,4,13,11,6,5,6,13,4,11,10,4,3,2,5,4,8,9,5,8,2,3,5,6,13,7,10,5,4,3,4,5,7,2,16,8,6,8,13,1,11,8,3,6,4,5,1,19,6,24,12,10,5,3,10,7,4,16,9,1,3,9,5,0,9,6,9,4,4,6,7,4,11,1,5,19,15,5,8,12,7,12,5,4,13,4,9,12,4,10,5,6,3,7,4,2,2,4,3,15,8,1,8,1,4,17,24,14,6,2,7,6,2,8,8,7,3,5,5,10,5,6,4,6,0,2,6,5,3,3,5,1,2,1,3,1,5,5,7,5,3,3,5,8,5,6,11,3,17,3,6,2,6,5,12,6,3,7,5,5,8,13,14,9,4,3,6,14,5,6,2,6,6,4,5,11,4,13,2,0,4,0,0,11,13,11,6,2,7,0,0,2,6,3,1,5,4,4,4,1,1,2,11,8,6,10,2,3,3,7,4,7,2,4,3,2,2,7,5,4,21,10,10,7,9,7,1,4,4,5,6,6,2,6,7,2,3,1,11,5,12,3,3,3,1,3,0,4,5,2,9,2,8,5,0,15,12,8,7,18,6,1,8,0,1,2,4,4,2,5,6,0,7,1,1,1,12,6,3,2,2,4,0,4,10,6,3,0,5,2,0,4,9,6,10,4,3,8,5,4,1,3,2,5,0,0,5,8,4,3,2
friendship,0,6,5,19,10,2,5,10,0,2,25,2,4,67,0,3,3,5,2,4,4,20,5,8,4,1,5,3,8,2,3,55,74,7,15,55,78,1,1,9,1,1,13,0,15,8,10,2,142,22,14,1,8,35,4,4,10,3,1,13,39,7,4,7,4,0,46,3,3,2,2,2,0,5,11,2,1,2,32,8,18,0,9,2,98,1,2,0,11,0,0,2,0,24,38,0,8,1,20,4,0,11,10,1,4,7,1,1,5,2,7,2,0,1,0,9,1,0,19,36,18,18,1,21,3,3,3,2,1,0,2,6,4,19,11,6,5,0,3,4,1,13,11,0,1,19,5,5,6,3,22,1,7,2,2,0,9,3,10,7,0,0,2,1,1,2,2,5,10,6,8,31,3,0,0,7,64,1,2,13,4,15,1,2,1,9,12,4,16,37,0,1,3,1,0,0,1,5,0,5,2,0,0,7,21,3,3,4,7,13,27,1,5,2,2,2,0,0,1,2,1,11,2,4,11,15,18,3,0,1,5,2,2,1,16,2,11,1,4,1,16,6,3,3,7,0,4,5,8,2,4,9,15,1,1,5,4,1,2,4,0,6,2,3,3,1,1,2,7,4,41,0,1,1,1,0,3,0,3,0,26,1,0,20,4,0,3,1,8,1,2,1,0,1,2,6,20,9,1,13,10,8,0,0,3,3,24,0,4,0,1,3,11,8,9,0,2,14,6,1,25,10,8,2,30,1,2,6,1,10,0,2,1,0,5,2,6,3,1,4,3,11,9,5,3,1,16,26,5,2,2,3,2,6,6,1,1,1,4,8,1,5,5,6,2,0,9,3,0,5,1,2,0,3,1,2,5,1,13,2,25,0,12,2,1,12,0,5,5,2,25,3,7,9,10,6,16,1,12,6,12,2,4,2,6,2,6,1,10,12,6,11,5,10,10,3,3,6,2,1,3,3,8,2,0,1,0,1,8,8,1,1,2,2,3,6,1,8,5,1,3,6,0,11,4,6,3,8,12,1,2,3,2,0,37,2,2,3,3,5,5,12,14,6,2,0,7,5,4,0,5,0,1,0,2,4,3,7,5,0,0,6,2,2,4,1,2,6,4,0,22,13,0,3,2,3,0,11,2,3,2,0,0,0,0,0,0,6,0,1,1,0,2,1,6,3,2,5,1,7,5,9,0,6,3,5,9,0,6,4,4,4,0,6,0,3,3,11,15,2,0,3,0,0,2,4,1,6,5,0,3,0,0,16,3,7,41,1,1,5,4,1,4,2,1,1,4,2,10,12,8,2,4,0,1,2,0,2,2,4,9,6,4,4,4,9,3,5,2,5,10,17,4,3,2,1,0,0,43,18,10,1,1,0,2,5,0,1,0,0,7,1,3,3,5,1,4,0,1,1,2,0,1,5,2,1,3,1,10,23,0,3,4,3,0,2,7,0,4,2,0,0,4,3,4,5,1,1,0,109,6,2,0,1,5,1,9,5,1,6,1,3,13,15,5,7,1,4,4,0,6,1,25,3,9,4,1,6,6,5,2,17,5,7,7,1,8,5,3,8,7,16,4,8,2,2,4,5,3,6,4,3,0,5,1,0,7,2,1,1,0,4,4,16,6,3,2,10,10,4,0,2,7,2,1,2,1,4,3,5,4,2,0,4,6,0,2,6,11,2,1,3,2,3,6,2,4,6,0,3,4,0,0,2,1,2,2,6,1,4,2,3,0,1,13,4,4,6,4,9,1,1,0,3,4,3,1,2,8,2,9,1,3,0,7,5,1,0,1,3,3,3,0,1,0,1,2,2,4,2,4,8,5,0,3,0,6,4,10,2,2,4,3,3,1,3,2,2,0,1,3,0,10,0,1,0,1,0,1,1,1,6,5,0,11,4,11,16,8,3,4,0,2,3,2,1,1,2,2,8,14,2,3,1,2,1,3,1,5,2,5,6,3,1,2,7,1,0,5,0,3,2,0,1,1,3,8,12,6,19,1,4,2,5,4,2,5,4,3,0,2,1,2,9,2,4,5,0,0,5,1,2,2,11,1,1,2,5,1,14,2,0,1,1,3,0,1,8,4,1,3,4,2,4,3,2,6,14,6,0,1,1,1,0,0,0,0,2,0,5,1,2,0,0,0,3,3,1,0,2,0,3,1,2,0,0,1,2,4,10,0,7,0,0,0,8,0,0,0,1,3,0,3,4,4,9,0,1,0,2,1,1,2,0,1,1,1,1,15,1,0,2,2,0,0,1,1,0,2,1
trade,7,25,12,255,10,28,8,40,7,9,32,21,36,168,7,13,5,34,14,14,20,105,28,41,41,41,26,26,18,25,14,367,356,20,111,187,86,23,47,9,23,20,15,13,75,31,58,19,633,125,88,20,59,260,8,18,120,47,9,39,64,47,5,28,45,7,176,8,18,48,20,8,15,3,236,38,34,9,140,57,188,10,39,12,330,44,65,1,71,4,17,20,5,48,133,32,23,26,123,81,12,52,67,24,24,49,12,10,44,9,34,20,21,53,33,59,12,15,159,298,65,90,11,127,11,4,10,12,9,5,30,9,9,130,42,94,11,15,20,15,9,92,90,8,4,138,15,32,44,19,110,3,39,24,25,14,69,22,17,58,26,5,15,14,21,18,14,74,53,26,49,167,42,3,11,17,297,3,36,83,32,23,12,26,7,78,85,58,60,119,2,14,67,4,2,9,29,21,18,19,85,4,29,40,60,15,13,75,27,82,153,11,60,16,6,6,12,7,10,1,24,43,18,20,90,195,50,49,11,29,36,26,37,65,82,44,60,34,43,13,144,91,27,5,58,23,16,36,98,13,26,65,52,20,22,54,19,12,11,20,4,65,32,5,22,79,11,26,44,20,272,22,56,4,6,4,51,16,23,0,110,17,23,55,29,12,5,26,19,10,12,10,35,18,15,41,73,15,16,51,48,61,2,11,39,5,37,2,9,10,13,26,67,34,73,48,67,68,41,16,86,15,58,6,91,8,19,52,13,66,0,20,28,10,15,20,49,24,10,21,15,23,28,25,13,24,126,95,53,10,32,35,8,75,37,28,8,15,39,40,44,24,51,37,23,7,72,22,17,32,8,36,18,29,12,50,8,22,30,9,135,12,73,39,3,19,7,45,49,10,27,5,25,18,63,28,146,8,86,13,54,9,5,1,12,22,8,10,1,60,9,61,138,47,42,26,38,22,9,7,9,22,32,13,5,6,6,28,12,43,29,12,7,22,24,13,4,69,15,19,55,48,18,82,31,22,56,18,64,16,27,6,7,8,167,12,1,22,21,75,28,58,85,37,27,15,69,95,8,5,18,12,8,4,7,25,13,31,37,18,16,40,18,10,21,5,45,10,8,3,129,62,3,7,68,12,16,35,21,20,21,12,10,3,10,89,19,41,8,10,15,9,9,21,25,17,15,13,28,17,12,27,21,25,11,8,60,21,31,59,13,13,6,25,15,10,19,21,74,30,17,37,5,16,86,9,5,51,25,11,16,9,26,76,58,29,204,17,20,25,43,7,67,13,29,38,46,12,79,100,26,17,16,12,27,9,75,27,14,41,36,43,34,37,22,9,15,20,22,12,26,51,13,7,62,7,22,8,122,47,32,4,20,10,14,53,5,30,16,14,46,40,11,23,67,12,35,29,5,7,36,35,15,57,5,15,16,19,16,73,43,36,30,26,7,25,17,8,10,37,19,4,6,21,32,37,20,10,11,442,61,18,28,8,19,38,94,26,8,38,22,22,42,91,23,9,0,14,15,18,27,27,65,23,39,10,11,25,11,20,30,154,34,29,31,7,21,30,8,76,22,47,19,74,15,22,13,5,28,43,61,6,21,7,17,8,39,19,2,9,5,28,10,42,21,11,2,25,20,7,30,8,11,35,2,45,7,8,9,29,9,33,32,18,8,4,19,5,35,17,21,18,17,59,53,12,27,54,27,9,17,3,5,27,17,31,8,23,18,46,63,24,8,14,53,68,14,6,23,15,28,12,13,20,1,38,54,7,7,28,12,16,17,6,23,21,22,7,12,22,15,3,5,15,22,37,5,11,18,6,10,8,18,7,10,8,22,5,24,13,65,16,65,16,42,7,5,16,10,31,13,10,35,29,11,8,14,15,44,9,12,16,42,5,20,33,20,47,12,18,19,5,5,9,21,35,23,75,13,15,63,41,25,16,9,8,15,18,13,6,50,11,12,20,15,24,1,11,9,16,11,13,20,74,13,15,10,29,27,39,1,21,3,12,12,9,10,13,18,12,19,23,0,2,21,12,3,3,10,8,24,20,7,17,0,14,12,68,17,45,16,17,12,10,26,10,13,45,13,7,19,21,4,40,14,20,9,26,19,16,18,13,13,18,9,8,31,16,8,21,12,32,12,5,22,47,24,14,56,8,2,13,8,9,9,10,6,34,31,7,0,12,19,3,3,118,11,0,2,34,13,17,18,21,16,37,1,21,24,6,10,14,3,33,10,8,21,80,45,2,3,18,11,1,0,5,29,8,6,7
promote,4,18,12,151,13,15,6,46,7,4,18,9,14,100,5,15,9,17,7,20,9,37,38,23,20,24,27,29,14,20,10,221,170,24,75,114,120,13,21,15,12,30,10,4,53,18,41,31,301,96,45,20,39,95,14,7,80,27,12,38,33,19,9,16,35,14,156,8,7,16,14,9,7,6,150,15,20,8,68,26,85,4,7,6,241,17,16,4,23,0,5,19,6,33,71,11,18,15,65,21,12,39,23,15,11,25,9,12,10,6,22,14,29,32,9,33,3,2,62,178,44,38,30,67,5,4,5,2,3,1,26,7,12,67,26,111,4,2,9,11,7,44,22,6,0,70,10,19,15,14,93,3,10,19,15,39,38,30,16,49,15,6,11,5,9,17,3,42,28,11,24,88,27,3,12,4,167,11,10,65,18,32,34,27,9,47,37,18,29,44,3,2,18,5,1,4,26,10,8,25,41,6,8,17,40,26,12,52,13,49,95,8,19,15,10,13,8,14,37,8,6,21,13,8,53,105,29,28,7,13,27,12,25,23,56,24,28,23,16,15,67,50,12,9,32,11,10,43,46,5,16,24,15,5,3,23,12,2,2,20,3,37,18,3,7,53,28,26,22,13,168,12,18,6,8,7,50,10,4,0,101,7,9,31,10,15,32,25,21,4,3,13,15,6,3,22,37,6,11,29,28,37,0,2,11,9,42,8,28,8,8,23,42,29,26,17,25,52,7,7,48,14,23,23,62,5,4,37,4,34,6,6,8,9,7,16,21,9,7,9,8,17,32,12,10,15,43,63,31,19,13,16,4,52,18,17,12,15,17,49,38,33,36,20,15,6,29,10,34,24,6,53,5,36,13,57,13,5,22,14,57,9,35,14,11,45,8,17,29,6,28,5,13,7,56,13,51,4,35,3,16,12,5,7,3,8,12,12,60,1,7,21,19,24,3,21,13,15,5,21,6,12,32,13,6,4,6,16,6,14,7,5,2,14,10,2,6,18,23,8,16,27,11,20,9,14,30,9,31,6,45,5,15,4,47,9,7,5,6,37,11,21,49,48,16,4,47,24,7,3,30,8,3,3,5,12,12,24,27,8,9,19,8,8,10,5,26,14,9,6,65,40,5,8,20,10,1,10,11,10,11,7,4,6,12,25,22,21,10,6,6,8,3,8,20,19,7,13,6,11,8,36,17,23,9,0,29,4,13,29,8,10,8,6,12,12,11,6,38,23,4,19,2,18,21,7,5,31,10,6,57,1,2,53,18,12,68,3,8,10,29,5,31,5,33,15,12,8,36,80,13,7,19,3,9,4,11,4,7,34,12,22,20,32,13,7,11,2,1,36,33,34,10,5,19,10,7,9,28,24,34,6,6,3,4,16,6,30,17,7,20,15,8,9,23,18,36,8,8,6,13,5,4,12,2,6,7,14,13,45,15,23,23,30,11,8,8,5,11,14,10,5,2,33,11,37,12,5,8,164,5,2,4,6,7,20,48,15,6,16,13,9,13,9,14,3,1,7,8,11,22,10,27,9,18,8,3,8,4,10,16,38,15,14,18,10,14,11,4,11,14,29,12,17,5,10,9,2,18,17,23,5,7,6,15,11,20,9,7,2,2,9,2,37,22,33,15,6,7,42,7,4,3,44,3,11,7,5,8,13,9,24,13,11,12,5,36,9,47,15,11,4,11,10,9,6,12,31,5,14,12,4,2,6,5,15,5,23,5,11,12,18,4,6,33,28,9,11,26,14,16,14,2,19,5,8,13,6,23,10,11,6,6,6,13,8,7,1,6,15,11,9,7,4,22,20,6,8,7,9,5,3,14,3,15,7,20,3,23,11,10,10,12,4,8,2,9,8,1,10,5,4,9,11,7,2,11,5,5,3,7,10,31,4,7,27,23,32,6,13,7,14,4,5,11,8,10,22,10,12,18,20,10,7,7,8,12,9,2,2,8,5,7,20,7,13,6,8,13,19,11,8,9,7,8,7,1,5,16,3,1,3,2,5,4,5,6,4,10,2,7,15,1,7,5,3,6,3,6,12,10,3,12,11,6,2,7,9,6,27,6,10,4,6,12,5,4,9,4,3,10,9,4,10,8,10,5,10,9,3,8,9,8,7,10,0,10,4,4,22,5,9,2,3,9,15,9,11,16,6,5,5,8,3,7,1,3,6,21,8,12,11,8,4,3,16,7,5,4,5,4,3,10,9,6,16,6,6,8,2,8,9,4,18,6,1,19,24,7,9,10,18,9,5,4,2,7,7,9,18
neighbor,1,3,5,7,2,6,2,15,3,3,33,2,3,62,0,8,2,9,6,12,2,10,9,11,9,4,6,8,4,8,4,62,47,6,23,44,37,2,4,3,1,11,0,1,14,9,6,3,78,34,23,8,8,32,5,7,14,2,6,10,18,6,1,2,6,3,50,3,4,16,6,0,2,2,57,10,10,3,19,12,8,0,4,6,75,3,3,0,5,0,1,4,0,10,17,1,2,1,26,5,0,9,6,5,17,5,0,2,2,1,8,0,2,5,5,6,0,4,20,41,11,13,2,18,2,3,1,3,0,0,8,0,23,9,14,17,5,2,4,3,11,33,9,2,3,30,4,12,6,5,22,3,4,4,10,3,29,3,14,23,0,1,4,1,2,10,3,8,11,4,7,53,11,2,2,7,53,0,9,20,8,3,2,7,1,11,14,9,22,25,1,4,1,1,0,2,4,7,1,12,8,0,2,6,10,2,0,2,1,20,20,6,4,6,4,9,0,0,2,1,0,19,4,4,6,29,14,6,3,3,4,2,2,4,15,2,6,7,0,11,21,7,3,10,21,1,2,10,7,0,4,4,17,0,1,9,4,0,2,7,3,5,3,0,5,0,6,7,14,5,41,2,0,3,1,2,5,0,0,0,33,2,3,9,3,1,0,6,13,1,0,2,1,1,0,1,10,0,1,24,7,2,0,1,8,1,31,2,10,2,0,1,3,8,6,1,6,5,5,4,18,7,17,9,37,2,14,13,1,8,0,4,14,3,7,1,10,2,0,3,1,1,7,1,0,5,13,16,3,9,3,2,10,10,7,2,3,5,4,11,2,6,4,9,4,2,7,9,1,6,1,8,1,25,7,4,6,4,24,2,30,2,7,18,8,7,3,3,13,1,14,4,2,4,5,5,5,0,7,2,24,0,9,1,8,5,4,6,9,7,1,12,2,12,4,5,0,5,2,1,13,6,9,8,1,1,1,13,3,6,0,0,0,6,10,0,4,3,1,1,8,5,4,3,0,6,8,7,12,4,8,4,3,1,17,5,1,4,6,8,12,17,24,42,4,0,7,1,2,2,22,0,2,2,0,47,5,3,11,3,3,8,3,5,3,3,4,3,6,0,28,3,3,5,3,2,1,6,5,4,12,0,1,0,2,1,0,8,1,1,1,0,1,0,2,2,2,3,1,2,1,9,0,4,3,0,8,8,1,9,5,1,2,2,1,2,1,6,20,4,2,4,1,5,1,2,5,5,12,3,1,1,1,12,2,4,9,2,1,1,2,0,1,2,3,2,15,1,5,10,2,2,1,1,2,1,0,1,1,3,2,2,3,10,4,28,1,6,0,7,14,13,7,1,17,0,23,2,17,9,7,1,4,3,1,8,1,13,4,0,11,4,5,3,11,3,2,2,1,2,1,1,1,1,1,2,0,1,4,12,4,3,13,16,4,2,14,8,3,2,28,4,2,3,5,3,4,1,1,55,4,1,4,0,1,10,7,6,1,5,2,6,3,4,2,2,0,3,1,2,1,3,53,2,7,4,0,0,3,2,5,3,5,5,3,1,8,0,2,5,6,4,8,4,2,4,5,1,5,2,2,8,0,4,1,2,3,2,0,0,1,1,2,2,6,1,2,9,0,0,0,4,3,1,3,3,2,0,8,7,0,1,1,5,1,1,0,1,18,7,2,0,4,2,2,1,1,10,1,7,3,0,0,1,0,1,2,4,1,1,0,6,0,0,8,13,3,1,3,3,3,8,4,5,2,5,0,1,6,6,6,2,6,0,5,4,2,18,2,1,1,1,0,6,3,1,1,0,5,2,2,6,5,3,6,3,4,7,2,3,1,8,3,2,1,0,4,1,1,0,2,1,4,1,0,1,3,1,0,0,0,2,3,2,3,7,2,9,1,1,1,0,0,0,1,0,2,6,1,8,3,3,4,0,0,0,6,1,0,0,0,2,1,5,3,5,3,1,4,1,0,1,0,0,0,2,1,1,3,4,0,0,3,1,3,2,2,1,5,0,3,1,4,2,1,0,4,1,0,6,1,0,2,6,0,0,1,0,0,3,0,2,0,0,4,1,3,1,3,0,3,2,1,0,4,0,5,3,1,1,0,1,0,1,5,1,2,0,5,2,0,5,0,0,2,2,2,2,0,0,1,3,3,0,0,0,4,1,1,1,0,3,0,0,0,3,2,0,4,2,10,3,7,2,0,3,0,1,4,2,1,5,0,3,2,1,4,1,6,5,0,5,2,1,1,1,2,0,0,4
south,11,18,5,106,7,7,6,66,2,6,76,18,13,80,3,12,5,12,3,9,8,45,13,26,12,19,23,11,12,25,11,201,149,11,52,93,51,6,5,6,3,28,14,6,25,10,21,11,383,155,34,4,25,39,13,3,32,34,3,32,22,1,1,7,12,6,123,3,7,60,7,16,6,6,92,20,19,4,69,26,47,0,29,8,164,3,14,0,25,2,8,4,2,32,54,7,25,10,42,10,9,47,24,4,10,22,4,6,24,10,19,9,5,10,7,34,0,16,51,150,48,27,0,52,15,4,2,3,4,2,12,5,8,58,24,41,7,5,9,15,5,40,16,2,9,73,17,22,13,12,46,3,10,6,6,18,39,5,21,13,10,2,13,6,2,3,3,31,22,8,56,120,30,4,3,11,152,1,13,32,30,12,3,19,6,33,24,28,38,49,0,5,20,1,1,2,10,3,6,6,16,2,1,11,45,6,1,16,23,23,72,5,32,4,4,0,0,0,9,3,3,25,0,17,30,61,22,25,10,2,23,20,8,14,35,3,40,13,13,14,70,34,11,10,17,5,12,18,27,8,7,21,26,5,14,12,8,0,2,21,0,22,21,2,5,23,1,4,29,9,101,4,17,3,2,7,20,5,16,2,32,1,10,42,22,9,2,8,14,1,6,6,9,3,4,7,50,7,8,20,29,29,1,6,9,1,41,5,4,3,4,13,31,8,26,10,21,37,15,3,34,10,43,7,53,0,5,27,1,30,5,8,9,9,7,10,13,15,0,11,0,17,13,10,9,13,46,76,15,5,9,11,8,30,31,7,9,8,10,23,9,7,11,14,13,1,31,17,2,13,5,20,4,8,10,39,9,13,28,4,60,7,19,25,1,31,11,16,31,1,24,5,14,8,28,8,42,5,33,9,21,12,5,3,14,7,8,11,61,21,12,1,13,21,22,11,6,9,6,8,7,7,20,13,0,1,4,7,18,21,1,3,1,7,9,3,1,18,4,4,11,19,17,24,27,41,13,10,22,6,11,9,6,4,86,11,4,13,2,23,11,16,40,18,10,9,15,26,15,2,15,6,5,5,3,13,4,12,23,5,7,4,32,7,16,10,11,11,4,6,55,21,7,9,5,10,11,8,8,9,19,3,7,0,7,8,14,9,13,3,5,5,15,5,2,14,5,8,1,13,1,27,6,18,7,8,26,1,12,25,10,3,7,9,4,4,6,18,45,3,6,2,0,20,15,6,7,19,12,16,37,4,12,32,3,3,44,5,2,7,23,7,23,3,12,10,18,4,22,29,8,9,6,2,15,32,5,8,8,24,8,11,16,22,5,16,21,9,11,15,14,29,11,9,11,7,4,4,24,32,13,1,7,6,5,28,4,9,12,8,28,15,10,10,17,8,16,5,3,4,13,2,5,5,2,8,13,12,9,37,2,15,17,13,10,4,12,12,4,8,14,10,4,14,7,19,5,10,2,192,28,9,10,3,7,11,33,12,8,18,9,123,15,34,6,3,8,14,11,9,12,5,55,12,21,6,4,7,11,16,16,44,12,12,9,3,21,6,11,42,8,10,13,57,2,8,9,4,10,11,30,2,3,4,7,10,19,10,6,4,3,10,11,16,21,6,3,8,15,2,11,3,6,18,6,63,8,1,3,25,2,11,2,10,2,3,12,4,69,11,11,10,10,22,26,7,11,15,9,4,14,0,1,6,5,12,14,21,12,15,10,5,4,4,33,20,20,11,12,14,6,14,3,18,1,12,1,2,12,12,3,10,14,0,13,13,5,8,7,8,11,13,18,8,16,14,3,7,1,7,9,7,8,6,8,10,7,4,15,6,11,48,45,9,12,3,7,3,5,14,11,8,13,9,10,6,5,8,0,11,5,3,9,0,14,12,8,21,8,7,8,3,7,3,6,17,8,15,4,5,18,18,12,4,1,5,3,4,3,3,8,4,4,2,7,11,11,3,8,12,1,7,4,2,6,6,6,4,14,18,4,3,1,10,5,3,2,4,10,4,16,48,0,12,1,6,3,3,6,12,5,3,3,10,23,3,5,15,3,9,3,1,8,4,6,6,23,8,4,3,10,12,4,8,8,13,12,12,1,2,1,5,7,9,7,1,1,5,1,7,2,7,0,1,8,13,3,12,5,0,3,7,4,3,3,0,34,29,15,3,4,25,2,7,3,23,3,1,4,21,7,7,5,10,4,7,2,4,20,4,28,7,3,1,7,2,7,5,25,1,4,4,0,2,0,2,2,6,4,9
export,1,6,3,48,1,4,8,7,0,2,3,2,9,35,1,0,1,8,2,3,3,22,10,6,5,7,1,4,3,2,3,85,178,4,29,64,17,14,51,2,8,5,1,9,16,4,2,22,174,56,43,2,4,56,4,0,58,23,8,7,16,9,1,5,21,4,51,12,4,8,23,0,1,0,103,5,19,10,58,17,214,5,12,10,92,17,18,1,52,2,22,3,11,17,35,18,14,25,52,30,2,19,13,3,9,10,1,7,32,7,18,4,16,24,22,21,7,9,40,80,12,23,8,179,4,3,6,8,4,2,9,1,9,31,6,29,2,11,6,33,1,26,29,0,2,52,1,27,35,6,13,2,20,8,11,3,24,5,1,34,11,0,7,1,18,5,2,18,18,1,15,40,20,1,11,8,83,0,9,26,10,4,8,14,5,43,22,14,5,47,4,1,85,6,1,2,5,1,13,3,35,2,11,15,15,2,7,16,5,20,39,7,17,9,0,7,1,3,1,0,25,7,2,7,27,42,66,18,6,23,4,21,12,15,21,23,17,9,40,0,21,34,5,0,6,6,0,8,25,1,7,41,10,52,11,15,2,1,1,14,1,27,2,4,6,12,3,13,20,5,78,5,103,1,0,11,13,20,9,0,25,0,10,13,13,6,2,7,0,3,14,5,3,5,4,2,14,1,2,9,20,13,13,3,7,0,12,12,1,8,3,9,31,5,47,14,14,34,11,3,14,2,11,7,15,1,13,14,0,26,0,12,2,2,4,7,9,7,11,15,2,3,13,3,3,1,25,23,11,2,9,3,1,21,7,15,1,1,4,58,18,6,17,6,6,2,11,1,6,1,2,27,2,2,3,8,2,10,7,3,21,3,20,21,0,9,0,34,22,0,6,6,0,3,24,11,15,4,7,15,6,5,5,0,1,6,0,5,138,19,2,13,1,12,12,5,7,3,1,2,1,20,9,0,1,0,3,3,4,7,4,2,17,6,1,2,1,11,1,0,7,11,8,43,4,6,14,2,38,26,5,4,5,9,52,3,0,0,2,20,14,17,29,7,9,1,45,17,2,1,5,3,7,0,0,5,2,1,7,5,1,13,1,2,2,0,32,1,2,0,34,22,0,1,63,1,9,14,2,0,2,5,18,6,2,24,39,13,4,2,4,0,2,1,7,4,0,3,1,16,0,5,5,5,3,1,32,8,9,27,6,0,0,3,13,8,2,1,12,9,6,11,2,26,48,8,2,8,5,1,0,1,0,6,5,3,33,3,13,4,11,0,10,1,8,11,4,0,8,26,1,9,5,2,1,2,41,8,7,18,36,9,16,6,1,3,4,5,11,3,8,2,4,1,23,12,1,8,14,9,6,6,2,2,4,20,0,1,1,13,26,5,4,4,10,3,6,2,2,4,4,16,5,9,4,6,2,3,1,19,45,6,6,4,5,4,7,3,5,5,4,0,1,2,7,44,3,2,1,135,16,0,4,1,2,8,22,4,0,10,2,1,13,21,6,2,0,10,3,1,4,4,11,0,27,8,0,0,1,3,2,31,5,7,9,2,3,11,2,7,3,6,3,1,2,0,1,2,13,6,8,2,6,2,0,10,12,2,5,0,1,24,4,14,3,1,0,3,5,1,6,0,3,3,0,9,6,6,0,1,2,19,29,2,6,6,2,4,4,8,11,5,1,12,3,1,9,8,8,5,4,8,38,60,38,8,1,6,1,113,126,9,3,6,11,152,4,9,23,6,3,3,2,1,1,6,21,3,1,7,3,2,4,3,0,6,1,1,9,13,6,0,0,11,7,6,2,6,11,1,3,3,3,0,0,8,3,2,6,4,138,3,35,6,6,0,5,6,0,11,2,34,1,7,2,3,1,5,14,3,7,5,2,4,7,5,1,18,4,8,3,0,0,0,4,6,7,28,1,7,12,12,0,10,7,8,7,13,1,10,13,2,2,6,3,4,0,0,0,5,2,6,2,12,0,2,0,4,3,12,3,4,2,2,2,1,4,2,2,6,5,2,0,4,3,3,0,4,7,3,6,5,2,8,0,11,1,13,12,10,1,14,0,9,9,12,5,7,9,1,2,9,12,34,13,1,1,11,4,2,0,6,0,3,4,12,12,6,1,9,2,10,43,8,14,19,10,5,25,5,3,6,3,2,2,9,2,2,10,5,0,2,4,0,9,18,2,0,0,7,2,2,9,1,0,4,0,1,2,1,0,3,0,27,3,0,2,28,11,1,0,4,8,6,3,3,5,5,1,1
especially,12,18,11,224,7,13,8,36,2,7,22,21,18,94,7,6,9,28,11,4,7,43,12,27,63,26,25,18,20,11,17,261,221,17,95,90,53,11,10,8,11,16,8,10,49,26,30,22,319,44,49,18,10,55,31,6,92,64,7,24,26,12,2,17,33,16,136,10,11,26,25,10,7,8,163,18,33,7,105,35,120,0,10,14,285,28,27,0,36,5,8,10,2,33,73,17,31,15,46,33,22,38,38,14,20,41,9,6,17,9,17,9,17,20,18,34,6,4,59,181,79,16,69,75,12,4,3,6,6,4,18,9,13,76,40,95,13,7,14,8,11,51,39,6,7,91,12,28,41,17,91,8,9,15,15,52,47,7,15,26,16,6,17,5,3,17,15,49,43,14,50,137,49,3,7,16,240,6,26,101,43,23,12,34,10,43,71,50,66,64,3,9,11,1,7,12,30,12,14,39,73,4,7,8,30,11,13,52,16,44,105,14,46,11,6,11,1,4,39,5,5,32,5,30,44,178,56,43,21,11,47,14,22,41,49,29,42,18,19,11,90,41,9,15,25,6,12,51,77,7,27,25,21,11,11,17,24,3,5,48,11,44,18,5,8,102,17,14,12,11,189,14,31,11,12,2,28,10,15,7,72,14,9,34,16,5,17,19,14,4,6,4,10,7,2,10,43,10,7,23,30,48,3,3,31,3,21,10,21,4,6,53,30,13,47,21,29,62,22,13,49,8,66,8,76,12,23,38,2,46,8,19,13,7,12,20,25,16,15,6,13,13,18,17,10,14,53,63,40,20,18,11,11,69,26,12,6,17,20,21,46,24,21,39,8,8,37,29,11,27,9,31,9,32,27,63,19,2,12,15,57,7,69,39,22,61,13,31,30,5,33,5,13,14,62,13,88,9,45,11,38,3,7,5,5,20,9,10,47,24,12,21,12,1,10,12,2,18,4,5,10,15,30,20,8,10,9,22,16,15,4,6,0,12,12,5,5,11,12,9,20,37,15,16,5,13,26,9,65,6,18,16,5,2,78,7,2,17,16,36,19,28,49,69,22,14,36,25,8,6,43,7,8,9,6,39,9,12,30,10,8,20,16,4,8,11,18,3,15,15,125,67,5,6,17,11,10,23,11,23,22,10,11,6,11,13,18,34,10,7,14,13,10,20,27,25,12,17,12,12,6,30,9,49,12,7,32,36,35,46,13,17,6,28,22,17,17,13,48,44,13,9,4,37,16,8,7,34,27,18,48,5,9,60,24,19,62,10,15,12,34,6,26,8,17,28,24,21,31,59,18,12,29,15,25,15,14,12,3,21,21,26,19,20,19,9,6,10,3,18,26,54,12,8,57,8,4,12,24,31,21,4,9,5,8,40,10,28,13,7,40,45,14,10,58,12,18,6,17,11,10,7,11,7,17,24,15,23,19,42,9,64,37,37,23,4,34,23,5,15,28,13,16,29,9,62,11,11,10,178,49,10,9,13,8,12,42,24,14,16,8,16,11,28,9,4,1,14,14,15,31,15,69,48,28,8,25,4,6,7,9,42,18,23,23,8,25,8,17,32,15,22,20,25,8,12,13,10,29,17,6,7,8,8,19,12,28,10,14,5,5,5,8,31,21,55,15,7,9,22,12,12,12,57,13,26,7,6,8,13,19,10,5,7,6,10,75,10,44,22,26,9,19,26,16,5,16,26,10,17,7,13,2,7,10,22,9,27,21,30,24,20,1,3,29,22,44,18,29,27,9,12,5,27,8,19,8,11,13,24,6,8,13,2,14,14,9,18,9,20,17,34,16,7,15,32,10,10,8,12,7,11,12,6,2,4,8,11,33,11,7,13,14,13,12,5,10,10,8,8,3,6,8,7,22,6,10,6,3,4,5,7,12,7,5,11,10,33,7,9,8,9,9,2,15,8,14,1,19,18,26,28,16,12,14,8,14,3,7,7,6,3,5,5,7,15,11,1,12,44,21,6,7,12,9,6,5,13,13,3,2,5,13,2,18,4,7,4,12,8,11,23,1,2,8,5,4,6,9,14,6,8,6,10,7,1,5,3,7,28,8,2,10,2,11,5,19,14,6,5,10,12,11,7,4,7,6,7,7,6,16,15,3,5,5,8,11,5,7,26,5,19,5,4,8,7,4,14,32,4,19,15,7,3,10,3,8,9,11,6,4,3,3,10,4,27,16,5,7,12,10,10,11,11,8,6,8,7,12,6,17,18,7,6,8,23,14,9,10,6,5,5,15,1,12,12,5,2,6,3
cuba,6,34,8,88,14,1,4,7,5,1,26,14,10,83,0,11,17,23,11,5,2,29,0,30,15,27,17,4,11,14,27,149,82,0,48,59,81,11,0,8,20,14,9,0,19,52,29,23,422,15,68,11,10,34,1,45,73,6,1,16,55,19,0,9,16,14,132,3,0,7,0,8,0,0,79,5,19,32,90,20,11,0,31,16,254,6,14,0,42,3,8,2,1,43,71,1,37,1,57,6,0,13,28,10,16,28,1,3,4,4,8,4,0,8,0,44,10,8,98,250,56,17,0,52,9,1,1,11,6,0,17,0,4,23,7,28,5,0,1,4,3,39,36,0,1,86,1,21,18,2,67,10,13,7,1,2,46,3,28,11,3,4,7,2,3,3,6,29,20,22,16,64,19,0,0,11,211,6,15,27,22,12,1,33,0,16,26,20,65,56,1,8,15,2,1,6,3,1,3,6,1,0,1,30,32,22,4,8,14,36,86,14,22,5,2,3,3,0,10,1,0,17,3,17,36,46,26,24,9,1,15,5,2,37,28,2,32,7,7,10,70,36,2,12,7,18,13,12,43,25,22,18,32,0,5,5,13,2,4,11,0,32,14,4,13,8,1,8,22,7,114,2,12,4,2,0,13,0,32,0,57,21,1,8,20,5,4,3,8,4,17,5,1,6,5,8,40,10,7,17,30,19,1,1,43,1,49,0,7,0,2,9,19,2,24,0,8,55,2,3,83,7,38,0,149,9,10,9,3,35,6,13,11,11,9,12,52,3,2,9,26,37,12,32,0,0,62,66,35,1,22,7,1,23,24,2,8,6,21,62,13,3,9,13,3,0,67,5,13,16,0,12,1,3,10,14,10,3,11,5,87,0,37,26,0,24,4,29,28,4,25,0,6,7,34,7,43,7,77,7,18,1,1,3,3,0,7,10,42,3,4,22,12,10,1,8,2,7,1,1,3,3,22,10,0,5,5,13,11,21,6,7,5,10,4,23,2,31,10,4,8,14,11,15,1,6,10,9,46,6,10,18,5,9,40,19,0,11,6,26,19,15,25,17,2,13,28,10,22,3,35,24,5,0,10,1,2,9,21,2,5,13,3,26,9,5,7,6,10,3,159,37,3,20,3,11,3,20,0,12,2,0,2,0,1,0,3,12,7,15,1,5,18,1,9,20,21,8,1,6,20,34,1,38,19,17,26,0,12,16,25,0,3,4,15,5,4,10,37,4,4,5,4,1,22,4,4,13,13,6,18,7,1,59,3,4,50,6,7,12,30,0,14,1,12,13,24,11,24,45,3,9,5,2,22,9,8,4,11,14,0,17,13,24,9,6,7,5,0,2,14,57,7,2,15,14,0,0,46,41,21,0,15,0,25,31,3,27,6,0,25,14,12,1,40,10,12,0,10,7,10,0,3,18,0,7,18,11,15,27,6,12,20,20,7,2,12,3,1,3,5,1,9,25,17,26,6,4,8,348,275,10,18,5,19,20,64,47,9,8,11,7,22,18,14,1,3,22,19,7,8,2,12,11,41,36,1,2,8,21,7,33,20,6,11,3,17,13,0,19,10,10,19,10,13,10,9,11,17,4,5,24,14,2,3,5,17,9,9,4,16,9,3,51,4,19,22,18,12,13,13,3,13,26,2,19,5,1,2,8,10,6,3,1,6,12,34,6,25,5,3,14,1,14,10,8,6,4,3,10,12,4,0,4,3,7,23,11,2,8,6,23,7,1,13,6,10,3,0,7,3,1,1,21,5,16,0,0,0,1,1,3,17,0,2,12,2,6,5,9,9,3,0,3,5,8,0,5,1,8,7,11,31,1,4,10,5,11,23,15,16,2,28,23,10,13,8,13,12,23,13,4,2,14,1,7,2,4,2,1,2,0,0,3,10,2,21,30,32,5,8,0,0,8,2,0,3,16,8,13,103,33,10,4,0,14,2,0,3,0,14,7,6,0,11,11,5,2,31,9,0,2,3,0,6,6,11,15,11,1,7,8,13,15,1,1,7,7,6,2,2,4,2,5,25,37,0,12,0,5,9,6,12,28,16,11,4,4,9,41,10,0,2,10,10,5,4,3,5,2,12,7,0,8,2,2,3,29,13,0,6,6,7,6,3,0,6,6,23,1,11,1,0,0,1,11,10,2,3,3,2,10,0,1,2,8,4,11,19,6,0,6,5,0,5,59,0,0,0,11,2,21,25,3,7,8,0,13,6,15,3,4,10,0,16,0,6,2,264,9,2,4,5,1,0,0,0,1,0,2
pursue,5,20,2,113,14,19,2,36,3,2,12,12,16,95,2,13,11,14,11,7,8,35,26,28,9,14,39,23,19,33,11,160,127,21,49,105,77,3,2,12,12,23,11,11,40,13,14,22,231,70,59,17,22,81,6,12,39,22,21,28,17,19,3,18,28,15,72,3,7,47,3,10,8,6,112,16,19,4,73,34,24,2,17,11,203,11,8,0,18,0,10,15,1,55,51,3,16,5,81,13,2,38,21,19,8,27,3,7,16,3,24,5,6,16,8,50,2,1,43,172,43,42,3,58,7,9,23,4,2,5,29,10,3,37,43,76,3,2,14,5,7,43,23,4,4,86,8,19,14,13,60,3,16,5,1,16,37,12,11,41,7,2,10,0,0,16,6,27,11,10,17,105,22,2,24,7,125,6,21,42,17,15,19,25,3,24,19,61,25,42,4,4,5,6,0,3,11,8,9,12,16,0,3,6,29,13,6,22,13,87,92,23,10,3,10,8,3,6,17,1,5,11,3,14,42,78,15,28,12,3,10,7,22,18,30,12,17,10,2,13,77,29,8,12,23,1,13,39,44,5,10,13,19,3,5,15,8,1,5,14,2,58,17,2,7,23,5,38,28,0,104,4,16,7,3,8,24,2,6,3,66,7,2,15,6,5,9,12,17,0,3,10,4,4,4,13,33,7,14,20,27,13,0,0,7,2,40,3,3,0,3,16,25,20,11,16,17,30,9,3,55,6,32,7,59,3,4,60,6,36,14,15,9,3,11,5,21,8,2,6,15,17,18,11,6,10,39,58,22,13,14,15,5,31,20,3,4,5,11,42,9,4,11,19,0,6,35,9,17,44,5,62,2,38,5,15,6,2,18,5,56,4,39,9,18,20,9,24,25,10,34,9,11,7,35,16,58,9,27,3,20,13,6,9,3,4,1,3,26,21,5,11,5,12,8,1,16,17,9,29,5,11,19,12,2,7,7,19,14,12,0,2,0,12,11,4,8,22,27,2,37,16,3,30,5,9,39,18,28,9,39,2,17,3,53,10,13,11,5,23,16,22,28,24,11,5,34,26,11,2,28,9,3,6,3,9,5,7,15,9,5,18,6,7,12,5,12,18,5,4,93,26,9,13,16,8,3,12,11,7,8,4,4,4,3,15,0,12,5,3,7,4,6,2,10,29,8,15,1,14,6,11,9,26,3,8,28,3,27,22,11,11,24,7,16,10,10,6,36,11,11,4,5,2,5,9,6,21,11,5,29,4,8,46,3,6,42,5,5,1,12,4,11,2,19,15,14,8,44,24,10,14,6,3,8,5,4,3,6,17,0,22,24,19,14,4,9,7,4,13,17,28,21,5,10,8,1,2,41,14,27,5,9,5,3,10,9,22,11,4,13,15,18,10,28,3,19,3,16,6,9,0,3,18,2,5,3,11,9,30,13,17,26,25,5,5,11,1,9,10,11,12,6,14,9,19,2,3,4,155,8,7,9,4,5,13,26,13,6,19,2,11,17,25,11,6,1,8,4,12,12,7,42,17,25,2,0,7,2,12,5,31,24,11,12,9,14,5,4,11,7,27,9,15,4,15,16,11,15,6,20,4,5,7,3,11,20,8,4,5,10,1,9,32,13,37,24,10,7,2,12,4,8,28,6,6,8,0,3,9,5,14,8,3,4,17,10,7,23,7,13,11,2,7,8,1,7,12,8,5,14,1,0,3,3,5,6,10,6,2,1,10,4,1,24,9,12,4,0,10,14,5,1,14,4,15,9,3,40,12,4,8,11,2,7,7,6,2,7,13,5,7,2,3,10,20,4,6,2,2,2,3,7,2,19,0,15,6,18,2,5,3,19,4,8,5,8,18,7,7,8,1,2,14,2,2,5,7,7,3,14,7,8,14,8,8,8,30,7,8,3,11,1,6,6,8,7,18,4,8,22,25,4,3,2,8,9,2,12,2,10,4,6,8,7,10,4,3,10,9,3,1,8,4,6,5,0,9,9,11,4,3,2,4,6,7,2,7,5,4,7,9,2,4,8,8,8,4,1,12,7,7,13,11,5,3,6,8,7,15,9,3,0,8,6,2,3,10,6,6,7,5,6,1,4,12,10,19,2,2,0,5,6,8,6,2,2,1,5,13,7,10,1,0,4,9,12,6,13,6,2,5,4,5,3,0,2,7,15,13,2,10,6,7,2,23,13,0,4,7,44,3,4,11,9,11,8,6,6,5,4,5,2,2,4,2,6,17,22,6,4,9,8,10,2,1,1,14,8,15
negotiate,4,10,2,98,6,6,3,14,3,0,18,1,7,43,0,1,8,7,5,0,2,28,22,18,8,14,19,20,11,29,7,91,75,17,20,55,25,7,6,8,3,5,3,8,26,8,12,3,183,57,37,8,11,45,1,0,28,6,14,17,16,14,0,17,13,3,35,2,7,9,17,2,4,2,27,5,6,1,34,22,13,0,9,6,99,9,2,0,29,4,6,7,0,34,30,3,13,0,27,4,16,17,14,13,4,12,12,0,10,2,18,1,9,5,4,21,9,3,32,46,20,27,1,37,1,4,3,1,0,0,15,3,0,28,25,40,1,1,5,1,4,24,23,0,2,54,3,6,7,3,32,2,11,3,2,0,21,0,6,27,3,1,3,4,1,10,1,23,4,6,5,62,12,0,16,3,78,4,2,20,8,4,11,13,1,12,10,12,37,49,1,2,7,4,0,1,8,5,3,4,1,3,1,11,10,8,0,9,15,17,46,10,8,2,8,4,0,7,7,4,6,7,3,4,14,26,8,9,6,12,6,7,13,4,13,3,15,1,2,7,32,12,2,6,6,3,5,24,24,4,9,5,12,4,4,5,4,2,4,10,1,27,34,5,6,9,0,19,17,2,52,5,23,0,1,5,9,8,8,2,36,0,0,7,3,1,10,5,7,0,0,12,3,4,2,7,41,9,10,11,13,11,4,1,3,0,19,0,1,2,2,1,19,11,14,9,6,10,5,5,16,1,12,3,40,1,4,37,2,12,9,6,3,4,1,11,18,5,7,6,9,6,8,11,1,4,11,48,10,6,4,9,2,14,10,1,2,2,9,30,5,2,8,7,3,4,19,6,9,25,3,34,2,15,2,10,3,2,11,1,22,5,27,5,9,19,0,11,7,1,9,6,7,49,20,5,34,2,6,2,14,10,2,6,1,0,0,3,38,13,0,6,7,2,2,16,1,7,8,20,3,9,16,10,0,1,1,5,3,7,8,5,4,14,7,3,12,37,15,3,9,3,3,10,3,3,21,9,11,10,22,5,14,2,51,2,9,10,1,14,11,13,23,12,5,3,15,16,3,0,11,4,0,1,1,2,3,11,12,1,1,10,4,4,3,8,4,11,1,0,38,19,0,5,13,8,1,2,3,1,6,0,0,5,2,41,0,7,3,0,4,2,1,7,3,5,2,2,1,4,4,6,2,6,1,2,16,3,10,3,4,4,3,2,8,3,3,7,14,10,2,6,4,1,2,8,1,8,5,2,4,1,1,22,2,1,24,2,7,4,13,3,12,4,5,5,4,1,12,25,6,2,3,0,4,2,2,1,2,17,1,2,7,11,4,4,2,2,2,9,12,9,11,6,7,1,0,3,142,9,11,0,1,18,11,8,6,24,3,4,11,18,12,4,7,4,6,4,3,5,5,4,1,11,2,2,4,3,2,12,5,7,5,13,8,3,4,1,3,2,4,3,2,4,7,7,1,7,2,122,3,5,5,2,3,14,15,7,7,9,1,9,23,34,12,30,13,6,7,2,8,1,33,4,19,0,0,11,5,3,7,18,10,4,3,2,14,10,2,3,14,12,1,6,6,8,7,11,11,3,12,2,4,4,6,1,8,4,0,5,2,11,0,11,11,3,13,3,9,0,1,2,2,5,1,3,8,1,1,1,0,5,2,9,2,1,0,3,16,1,4,2,0,1,2,1,7,9,4,0,6,2,11,8,2,5,0,2,4,3,3,12,2,1,11,3,1,6,1,24,9,3,0,3,0,6,9,2,17,7,9,1,1,0,11,4,3,10,1,5,4,2,0,3,4,3,0,9,3,7,3,4,11,3,9,1,3,8,10,7,2,14,4,11,0,5,3,11,2,8,7,0,6,4,1,3,4,4,7,4,5,5,3,2,5,4,4,13,2,4,7,1,1,9,1,11,1,28,1,6,8,23,2,2,0,9,0,6,2,2,6,0,1,4,1,3,1,5,6,3,0,3,2,4,2,2,4,16,7,6,1,4,3,5,10,4,4,4,3,3,7,10,0,1,2,3,1,0,4,6,0,15,7,7,0,1,12,24,2,19,3,33,2,10,4,1,2,6,0,1,4,9,2,11,4,4,4,17,3,6,5,1,1,1,0,2,1,2,2,8,0,4,8,4,3,11,9,7,21,2,0,1,2,0,1,5,1,1,18,2,3,6,4,2,1,6,1,0,0,6,0,1,4,7,12,2,6,7,5,2,1,2,4,2,2,0,6,16,8,3,1,6,0,7,0,2,1,0,0,9
side,10,11,7,67,6,14,6,32,3,4,24,8,16,57,1,13,6,14,9,15,3,24,37,23,23,15,24,16,11,13,13,135,103,8,43,89,75,7,6,9,7,14,7,5,36,10,15,6,240,41,44,17,15,56,7,9,49,15,10,20,16,4,5,15,22,21,94,5,11,44,8,3,4,2,76,13,26,9,55,17,19,0,16,9,129,10,10,0,25,0,7,5,2,36,47,4,22,2,30,4,4,31,14,17,16,19,6,11,9,1,19,1,3,9,5,29,0,6,42,126,34,42,3,45,10,5,6,7,4,2,16,3,17,47,18,50,12,2,9,12,3,36,17,6,5,70,14,23,12,5,36,0,15,5,13,16,38,2,4,28,13,0,3,1,0,12,10,17,22,6,5,109,31,1,13,5,93,5,8,31,23,7,4,15,2,27,30,14,39,58,1,7,2,1,1,5,10,4,3,8,10,2,2,15,25,5,2,10,9,20,52,14,16,4,11,9,4,8,7,3,3,10,3,18,21,63,23,22,4,4,10,9,8,19,19,9,20,12,7,9,42,29,10,15,15,6,8,30,29,2,8,15,31,3,7,20,11,0,0,11,2,38,11,1,6,17,0,12,22,6,108,9,9,4,1,5,16,11,7,1,40,2,4,13,12,4,5,8,10,3,1,7,3,6,3,4,33,2,7,17,27,16,3,1,10,0,20,6,8,6,1,11,14,7,10,7,16,28,14,6,38,5,21,2,72,3,16,39,2,26,9,7,12,1,6,3,17,3,0,2,16,17,17,5,5,18,34,48,16,4,4,5,4,31,48,4,8,4,9,19,10,3,9,10,3,1,31,5,11,19,4,36,0,16,9,9,2,2,21,9,51,2,22,12,7,30,4,13,25,2,16,8,6,4,17,12,29,3,29,3,9,8,8,4,4,8,9,6,22,15,5,9,3,18,7,17,7,1,4,16,6,8,14,10,3,5,3,9,9,20,0,4,0,9,8,4,6,25,7,3,11,20,5,11,1,9,18,7,26,4,22,0,9,4,41,8,13,3,13,29,14,22,24,32,4,2,14,14,9,2,27,13,0,3,4,21,3,14,15,6,6,8,4,2,4,2,7,7,7,2,81,20,10,9,4,4,5,12,6,16,14,5,4,4,5,11,2,19,9,4,4,10,11,2,8,7,3,9,5,7,0,20,6,17,6,8,23,4,10,10,14,3,12,8,3,9,5,11,34,6,3,1,3,10,7,5,6,13,7,6,18,1,4,41,6,12,22,8,6,6,11,0,12,2,20,10,11,8,17,17,11,7,4,2,7,7,1,5,6,17,8,12,17,18,5,10,6,9,1,12,17,20,7,8,32,12,8,0,44,24,10,2,8,3,7,19,2,14,3,4,28,21,6,2,23,3,7,7,4,8,5,6,4,12,7,3,5,6,6,18,10,12,18,19,4,7,7,3,3,2,6,13,3,9,13,15,5,5,3,166,9,6,3,3,4,18,28,14,6,8,4,11,13,23,2,4,3,8,5,7,7,6,20,30,26,6,0,2,3,2,15,22,13,9,9,1,8,11,1,16,14,16,10,16,2,5,12,1,7,9,11,5,4,5,2,1,13,4,5,2,6,5,7,18,14,9,14,4,13,2,10,3,7,9,1,7,7,1,2,3,6,11,0,9,5,6,1,9,27,4,9,7,5,13,9,2,10,1,5,3,16,11,2,4,2,12,9,14,0,5,7,14,2,2,29,6,6,4,3,9,5,10,1,8,3,7,3,1,5,8,6,4,6,0,9,3,4,1,8,10,7,9,6,3,9,15,1,6,3,3,4,10,7,2,12,7,13,3,6,4,3,5,20,2,2,5,3,12,6,10,2,4,10,4,2,8,3,2,5,2,8,12,5,6,5,11,10,34,4,1,3,7,6,4,10,7,0,12,4,15,41,24,11,2,1,2,6,3,2,1,12,3,0,1,1,4,12,3,12,14,3,14,3,3,4,5,5,8,14,2,1,4,6,7,4,10,3,6,17,1,10,31,0,6,4,7,8,7,7,29,14,4,3,13,3,7,1,5,6,15,0,3,6,4,7,1,1,5,11,3,4,10,4,4,1,2,14,11,8,1,9,5,3,8,3,7,2,0,2,4,3,5,1,0,5,6,0,8,13,4,1,7,4,0,3,2,6,9,7,8,3,9,6,2,1,13,4,9,9,5,24,4,4,6,4,13,5,9,9,6,1,10,4,7,10,2,8,5,26,1,3,2,6,1,0,3,3,1,0,8
willing,4,6,2,47,6,8,2,12,1,4,7,2,5,55,4,3,3,8,5,6,1,10,13,19,10,14,10,12,9,11,2,94,61,10,26,43,41,5,7,3,5,6,3,5,21,7,6,1,98,31,35,5,10,28,9,4,11,5,9,8,3,9,0,6,4,3,50,4,7,3,6,1,2,9,40,8,21,1,30,23,8,0,4,6,71,9,4,0,9,0,5,3,1,19,24,6,9,1,19,2,0,9,13,7,2,9,1,7,8,2,17,2,4,6,7,17,2,0,25,79,13,20,6,21,4,4,2,4,0,2,14,5,5,20,18,55,6,1,5,6,4,18,3,2,1,40,4,9,7,7,21,2,8,3,5,4,21,3,2,32,5,7,4,2,0,9,0,14,10,11,4,42,14,7,5,3,55,4,1,30,9,5,7,18,0,12,12,11,6,17,0,4,4,3,1,3,10,3,1,8,15,2,2,6,10,8,4,10,10,10,34,10,6,3,7,8,2,2,5,1,1,8,1,4,11,49,22,5,3,3,4,6,7,2,20,0,15,6,4,6,28,19,2,8,6,4,1,15,23,3,1,6,10,0,1,9,2,0,1,3,2,18,3,1,5,4,9,8,13,3,29,4,7,0,1,1,14,3,0,3,34,2,1,7,4,2,6,10,7,1,4,7,1,3,3,3,18,1,2,17,16,10,1,0,1,2,16,1,2,2,2,13,18,3,19,4,7,15,5,2,23,6,17,5,29,2,4,21,4,12,16,4,4,2,5,11,10,2,3,3,6,5,7,7,2,2,8,23,5,6,2,3,0,24,6,3,3,1,5,14,8,4,11,18,1,2,13,5,7,24,1,21,2,10,5,4,3,2,9,0,29,1,18,2,8,25,0,15,14,2,20,1,3,5,8,3,22,3,10,0,12,4,1,5,6,2,4,2,9,5,2,6,1,4,1,9,8,4,1,8,3,3,9,2,2,4,3,8,3,7,2,1,1,7,4,3,5,8,6,3,9,5,7,5,2,4,15,5,12,7,11,5,8,1,18,3,6,5,8,7,9,13,14,15,5,3,11,6,2,4,14,4,0,3,2,16,3,3,17,6,5,3,1,3,5,4,2,8,2,0,23,16,3,3,7,2,1,5,4,2,5,4,0,4,8,1,8,9,3,4,0,2,5,3,2,13,3,2,21,2,5,5,4,5,2,6,15,6,5,14,16,6,3,5,2,3,8,11,20,11,1,1,2,3,3,4,0,9,3,1,2,2,3,14,2,6,5,2,2,4,7,2,4,1,6,5,4,4,16,21,3,0,7,3,1,0,2,3,3,12,1,7,6,16,3,8,2,4,0,3,7,9,8,6,8,1,5,1,12,10,12,1,3,1,2,8,3,3,1,1,13,11,7,0,10,2,5,2,2,0,3,1,4,4,2,2,6,9,2,12,4,8,16,7,1,1,5,1,3,4,4,4,11,5,5,8,3,4,5,70,7,7,4,1,4,4,10,9,2,4,1,0,2,5,7,3,1,5,2,3,2,0,25,9,8,2,1,1,1,3,3,18,7,0,3,2,3,2,4,2,8,15,8,3,2,3,4,10,3,5,3,1,3,5,3,5,6,19,1,2,1,6,2,4,5,11,4,3,17,3,1,9,3,6,1,1,7,1,1,1,1,4,4,1,3,1,6,4,5,0,9,1,1,1,0,2,4,11,2,2,4,2,1,3,2,9,3,2,1,3,2,10,3,0,11,4,7,4,2,7,4,3,1,11,2,1,2,0,13,2,2,0,5,4,1,6,2,4,5,4,7,0,0,0,10,9,7,5,1,2,1,4,3,0,3,0,2,2,6,4,0,6,1,3,0,3,2,8,0,2,4,0,2,3,0,1,6,5,2,1,2,3,2,6,2,4,3,8,4,2,2,0,2,5,2,5,2,12,0,5,8,9,3,0,0,1,7,2,0,1,3,4,0,3,0,1,1,1,5,6,0,0,9,2,2,1,6,4,6,13,1,1,0,0,2,0,4,3,2,5,4,1,3,1,6,1,2,1,1,10,2,1,3,1,0,1,5,1,1,10,0,1,4,2,2,1,1,0,2,1,3,5,1,0,2,0,4,10,1,0,0,4,1,1,2,2,1,3,1,1,1,5,0,0,1,3,4,2,4,1,1,3,3,0,0,1,0,2,3,2,4,0,1,0,3,3,5,3,0,2,0,1,3,7,2,0,2,0,0,1,7,1,1,0,3,2,0,7,3,6,1,3,0,2,0,0,2,0,2,3
ally,6,4,2,48,6,24,1,26,2,0,7,1,16,70,0,3,13,5,15,44,4,19,34,23,0,16,49,33,20,39,8,75,58,37,29,109,49,3,2,19,9,48,6,16,35,3,6,9,79,126,53,21,14,102,5,1,3,6,25,28,4,12,2,10,7,16,47,3,3,6,9,3,6,2,72,11,23,2,27,31,17,1,1,16,45,1,11,3,9,1,8,6,3,40,6,0,12,0,54,1,0,10,5,25,9,26,3,4,11,4,28,0,13,8,6,33,1,1,26,32,10,49,6,49,5,10,5,2,0,2,28,8,9,34,34,69,3,1,16,7,6,17,13,2,2,64,11,18,5,1,21,2,8,4,0,6,37,10,6,61,1,0,2,2,3,19,5,21,14,2,7,67,14,3,25,0,12,6,1,50,4,9,27,28,0,23,7,5,4,23,3,8,2,8,1,6,8,14,1,2,5,0,3,1,16,11,3,6,7,4,38,25,1,3,14,10,0,10,12,0,3,5,1,3,8,15,12,13,6,3,7,4,14,7,18,0,11,5,7,13,33,15,3,7,14,3,10,42,20,6,8,6,13,0,2,5,2,2,0,7,0,69,4,2,2,3,2,46,18,1,29,1,1,3,0,9,14,0,2,1,44,0,4,4,8,5,10,5,8,1,1,13,0,2,2,3,14,3,8,2,14,2,0,2,0,3,14,1,2,0,4,2,26,22,3,9,7,7,2,6,13,1,23,8,34,0,9,56,0,12,16,2,5,0,2,0,27,7,0,2,3,16,21,2,3,12,9,20,14,13,3,8,2,24,6,0,4,0,2,33,3,5,19,7,0,10,9,7,18,46,7,73,2,30,4,5,1,2,18,1,12,5,17,4,22,6,0,14,4,1,12,13,1,1,8,11,6,0,2,4,10,24,3,15,2,2,3,1,7,21,1,8,2,5,1,29,20,16,8,1,4,9,7,6,3,2,3,5,2,3,0,2,0,12,13,2,27,20,34,0,16,2,4,29,12,15,48,21,2,5,55,2,28,7,8,1,17,6,4,3,13,13,11,35,4,5,28,4,0,1,24,15,2,2,1,3,3,4,10,4,4,10,2,7,4,0,1,21,1,0,68,2,1,8,17,3,2,2,3,7,0,1,1,5,0,6,2,5,0,1,2,2,2,2,4,2,7,2,2,16,0,3,1,8,0,0,13,1,5,6,7,9,17,0,3,7,0,8,9,2,3,0,9,4,3,0,3,2,0,0,1,0,0,15,1,3,7,1,1,3,2,2,4,1,5,1,3,2,7,11,4,0,0,1,2,0,0,1,2,21,0,10,10,15,1,0,1,2,0,6,9,9,14,5,2,1,2,1,7,2,1,0,6,0,0,7,6,0,0,0,15,3,5,1,4,4,5,0,0,2,1,0,1,10,0,0,0,2,1,9,6,3,1,2,0,1,5,5,7,2,5,6,0,3,0,5,0,0,0,60,0,0,1,0,4,12,6,4,2,5,0,6,0,2,1,1,0,5,0,5,1,0,2,1,2,0,0,0,1,1,5,14,1,4,2,2,7,5,0,1,2,29,1,5,0,7,7,1,10,3,1,1,0,0,0,5,6,9,0,2,1,1,2,4,5,7,27,0,5,0,0,1,1,5,5,5,1,1,0,7,1,1,1,2,1,0,2,0,4,0,5,0,2,2,5,5,2,7,4,0,11,1,0,2,0,6,0,0,1,2,0,4,2,1,9,9,0,1,2,1,12,6,2,3,0,1,0,2,1,3,0,1,3,0,2,4,0,0,4,2,4,0,0,1,2,0,0,0,2,0,1,1,2,0,28,6,2,1,2,3,1,3,0,2,1,1,1,12,2,0,4,1,7,0,1,0,8,1,5,1,5,0,1,12,6,1,1,8,2,2,2,0,0,3,1,1,2,21,0,4,3,1,0,1,2,5,0,0,0,5,0,4,0,4,1,0,6,1,10,2,0,0,1,1,1,3,0,11,7,3,0,2,2,0,0,0,4,0,1,1,10,0,0,0,0,0,0,0,4,32,2,0,21,1,1,1,0,1,0,3,0,0,3,0,0,6,0,1,2,0,1,2,0,0,6,0,6,5,1,0,4,2,2,1,2,0,1,0,2,0,1,9,0,0,0,1,3,2,0,1,0,2,4,0,2,2,0,3,1,3,0,0,0,0,3,0,0,0,1,1,18,0,10,17,1,2,10,1,1,0,0,2,0,3,0,1,1,18,6,5,2,7,1,12,0,1,0,0,0,23
alike,3,10,7,38,9,1,3,37,3,2,10,1,7,51,0,7,4,7,4,2,0,20,4,21,18,13,9,15,4,5,4,73,76,5,35,31,20,4,3,2,1,5,4,2,14,8,4,8,105,15,21,4,7,26,5,7,31,2,1,8,12,3,0,4,4,4,48,12,5,12,4,0,2,5,80,10,14,0,35,19,19,4,4,1,107,6,11,1,9,0,8,2,0,5,51,8,6,6,15,10,1,6,13,7,15,14,0,0,3,1,5,2,3,8,1,12,1,2,29,57,23,8,3,19,5,5,3,1,2,0,9,8,8,19,14,27,5,1,2,5,13,33,13,2,4,31,5,15,11,4,40,1,8,0,10,4,33,3,11,9,2,3,6,0,0,6,2,12,14,4,3,60,10,1,1,6,77,2,19,19,20,4,0,16,2,22,25,11,22,27,0,4,1,0,0,4,4,7,1,23,24,0,0,7,9,6,0,23,4,32,38,1,16,5,1,1,0,1,8,0,1,16,1,4,11,49,13,21,2,2,5,5,7,7,22,6,17,6,4,8,31,11,4,8,9,2,2,16,22,2,5,17,14,2,3,10,0,1,4,11,12,12,7,0,6,16,3,5,5,4,54,5,9,2,1,2,7,4,4,0,58,6,2,9,6,0,2,1,16,2,3,2,2,2,0,4,10,3,1,23,20,1,0,1,5,1,24,7,13,2,2,13,13,4,12,5,18,24,16,8,20,4,17,6,49,3,11,9,1,16,2,2,9,3,8,2,14,4,2,6,1,4,6,4,1,5,21,24,6,2,4,5,12,13,17,4,2,6,13,21,17,3,6,12,1,1,9,10,8,10,0,9,7,16,13,8,9,6,25,4,43,6,25,14,4,16,13,15,17,7,20,1,5,7,9,4,19,0,7,0,16,2,6,0,5,9,5,3,9,6,13,7,1,10,3,5,3,6,3,4,1,9,9,6,2,1,2,18,1,6,5,0,0,1,9,4,0,6,1,4,7,15,1,11,3,4,6,1,19,3,10,4,2,2,31,11,1,5,20,10,10,18,22,48,4,0,7,10,2,0,13,5,3,2,2,62,5,10,10,3,6,1,1,1,8,1,7,5,7,3,32,8,2,4,5,6,0,6,4,17,14,1,1,0,2,14,7,14,3,8,2,5,5,2,8,12,3,6,8,8,2,14,5,10,2,4,9,27,6,22,3,7,8,10,5,7,7,6,27,17,1,2,6,17,4,0,0,6,8,1,14,1,5,10,6,7,10,3,2,3,7,1,4,1,6,9,11,3,14,23,6,5,5,1,4,2,3,3,1,4,4,4,8,4,12,18,3,9,2,4,24,16,1,2,54,4,15,7,10,11,10,2,2,0,2,6,3,15,2,2,15,7,4,1,17,1,7,5,2,1,4,0,1,6,2,1,0,0,6,17,1,5,29,18,9,6,23,6,5,6,32,10,15,17,3,1,2,2,8,57,4,1,4,3,3,10,14,13,6,9,4,8,2,9,1,0,2,6,3,3,10,4,18,9,7,2,1,1,2,6,0,9,3,5,5,4,5,1,2,3,7,5,4,4,2,3,2,3,3,5,8,7,3,6,1,1,10,6,6,0,4,3,5,9,5,10,7,3,1,5,5,7,9,21,2,6,1,5,7,7,4,8,0,4,2,0,9,4,13,2,7,4,0,9,3,3,3,3,3,3,7,0,0,1,0,3,5,5,2,0,1,10,0,0,10,3,5,6,10,10,1,1,4,3,5,8,10,4,6,5,1,3,6,4,4,1,2,11,2,3,4,1,0,7,15,6,6,3,4,9,7,2,4,1,3,0,6,8,7,2,4,2,0,3,5,3,2,4,3,2,1,2,0,1,2,2,0,2,2,3,4,2,4,0,5,10,5,16,3,3,3,1,3,1,2,3,5,5,2,9,7,7,3,2,2,1,6,4,4,2,2,2,1,4,1,5,5,1,2,2,1,7,1,7,0,2,0,10,4,0,2,1,0,0,0,4,2,3,2,1,2,3,0,3,0,0,1,1,3,0,3,0,4,7,3,0,1,4,2,5,2,6,9,1,5,3,0,4,5,2,1,2,3,2,2,2,0,3,1,1,3,1,6,3,0,1,4,1,6,6,2,4,0,2,0,6,4,2,8,1,1,3,2,4,1,0,1,3,5,4,1,3,5,2,0,3,2,1,0,2,8,2,3,9,0,1,2,3,1,1,1,7,1,2,5,1,4,1,6,1,4,1,0,1,2,1,2,1,2,0
position,7,24,4,91,6,16,3,30,3,8,28,8,9,74,1,3,8,15,5,5,4,55,7,17,28,14,16,12,7,17,10,183,115,21,57,67,36,2,5,10,11,12,1,5,18,8,24,9,210,40,34,9,9,49,2,4,40,10,4,23,19,8,3,9,18,12,60,4,9,12,7,7,5,2,87,5,20,6,68,22,45,3,17,11,182,3,6,4,35,1,8,5,2,29,29,3,24,10,25,21,14,19,24,5,15,24,1,10,15,2,18,2,19,13,8,17,10,2,29,97,44,25,6,68,7,2,10,5,2,2,11,4,9,41,28,77,10,2,6,3,2,36,21,3,4,85,10,11,14,6,48,2,14,7,12,20,33,4,12,16,4,2,10,2,8,15,6,21,14,13,23,80,22,4,7,5,94,10,6,31,21,5,6,31,2,19,23,10,29,49,1,8,4,3,3,2,6,10,8,12,20,3,4,8,28,14,3,29,19,19,66,9,20,3,3,2,0,4,20,3,10,11,8,16,34,53,16,30,10,7,6,15,10,12,18,7,27,8,8,11,59,29,9,8,7,4,6,25,41,1,9,5,14,1,6,5,5,3,3,21,13,50,14,3,4,67,6,11,16,3,83,2,7,5,2,3,32,7,13,3,51,5,1,20,9,1,5,12,10,1,9,3,6,4,4,5,35,14,13,24,17,17,6,8,5,2,32,8,10,4,4,21,24,13,23,15,10,33,12,9,36,3,25,12,45,5,14,31,3,32,3,9,8,9,4,1,16,9,3,12,6,25,13,20,4,4,26,40,13,12,7,6,5,24,14,3,13,16,11,22,14,9,10,14,0,5,37,17,6,16,4,22,4,14,9,42,7,1,8,5,38,5,36,20,9,16,4,11,15,4,16,3,13,6,31,8,36,2,66,3,26,4,8,4,2,8,4,3,22,12,6,7,20,15,3,11,9,8,3,9,9,1,14,19,1,5,3,17,3,6,2,4,0,19,6,6,3,22,30,1,9,16,11,15,1,3,17,8,25,9,12,5,12,0,28,9,3,14,6,23,9,13,29,50,19,3,15,13,4,1,28,6,3,0,5,35,2,13,15,7,4,17,4,4,4,6,13,11,3,7,75,33,2,2,16,32,6,5,5,5,15,4,3,3,6,5,8,11,7,5,2,2,7,5,11,13,9,6,1,5,2,21,4,23,2,8,32,13,9,31,18,7,6,12,6,5,17,9,58,21,3,9,5,4,10,4,2,12,7,4,18,6,2,31,3,9,31,5,4,9,20,4,13,4,10,9,13,11,38,29,3,7,4,3,6,4,5,5,6,16,1,11,14,12,4,10,0,3,6,17,20,29,7,3,19,6,8,4,23,20,14,2,2,0,6,14,3,30,10,9,30,13,10,1,42,7,13,4,8,11,6,0,5,27,3,1,7,5,19,22,8,12,25,20,8,3,16,3,3,6,12,1,5,38,4,25,5,7,5,137,14,3,3,3,15,9,25,25,17,17,4,4,14,6,6,1,6,6,7,5,23,15,81,9,10,5,1,7,10,8,3,13,11,12,7,12,16,9,3,19,22,16,6,8,3,9,11,0,8,25,5,5,8,8,5,3,6,2,1,6,1,8,4,12,15,65,23,4,16,20,18,9,13,39,6,9,6,6,6,7,8,11,6,8,4,10,32,7,42,2,10,9,4,10,10,11,3,10,7,2,7,4,1,8,3,12,4,5,4,6,4,7,2,2,10,9,10,8,14,8,12,3,3,24,11,10,10,4,14,9,1,3,14,1,14,2,2,72,7,6,3,5,4,6,11,13,4,6,7,22,3,11,8,1,12,3,5,8,14,6,5,7,13,3,4,2,1,8,5,5,4,4,12,15,3,2,3,1,1,3,9,9,2,11,9,8,6,3,9,3,1,3,2,6,3,3,4,11,1,13,13,23,9,3,1,9,10,3,5,0,5,2,8,2,1,4,8,3,9,9,4,5,1,1,1,2,0,13,13,2,1,11,12,2,7,6,11,5,10,5,12,14,0,0,4,12,10,6,2,7,4,4,6,8,0,1,4,1,11,12,6,6,5,4,10,5,5,7,9,3,10,5,4,3,8,2,5,18,4,3,3,1,3,4,1,2,2,9,8,6,2,7,4,2,2,11,6,5,24,1,2,2,7,5,6,3,7,4,8,7,0,13,6,11,1,5,5,2,2,16,12,6,7,7,8,3,4,4,4,7,1,8,2,3,1,1,2,7,7,1,4,4,2,1,0,1,2,7,4,4
action,11,75,14,374,19,14,12,53,8,8,37,22,24,184,6,19,9,35,15,8,11,50,46,58,64,42,29,29,21,28,15,322,162,18,80,112,81,6,26,14,11,38,3,14,63,36,76,45,503,69,66,30,29,81,19,11,82,47,24,32,25,20,8,23,60,16,180,9,17,27,27,6,9,8,177,43,59,20,122,61,53,6,21,12,398,34,22,3,35,3,9,11,6,37,64,19,35,13,74,27,31,66,49,21,26,74,2,17,26,5,37,6,32,28,11,42,10,15,112,211,76,46,14,114,22,10,16,8,10,5,24,8,8,82,34,114,40,9,17,13,6,60,53,12,10,214,16,34,19,15,113,7,23,17,12,115,66,19,21,34,27,13,27,13,9,29,9,60,49,22,28,146,52,8,7,16,285,4,23,95,38,24,44,39,12,46,57,48,61,71,5,7,14,3,11,10,55,22,15,44,82,11,9,18,62,23,12,42,17,55,135,18,59,27,10,12,4,14,27,13,5,41,6,30,77,184,66,49,13,19,35,37,32,63,59,16,54,23,20,8,117,43,17,24,28,34,16,55,112,10,44,35,40,10,13,33,17,8,8,36,20,52,47,12,17,43,33,24,15,9,204,22,27,19,10,8,34,19,22,12,86,21,2,40,28,14,6,20,19,3,1,12,53,10,8,13,51,25,8,47,39,58,1,9,28,7,61,10,12,11,7,60,61,30,31,22,27,83,21,12,45,13,48,13,101,13,29,46,9,55,13,22,11,6,11,33,30,15,10,16,25,24,32,20,8,12,65,73,31,13,16,29,9,47,35,8,10,4,33,46,73,18,16,33,13,15,45,19,19,31,4,34,8,22,27,37,9,6,37,11,127,3,96,19,18,47,10,33,49,9,43,14,43,56,59,13,118,9,53,6,50,4,17,7,6,27,10,8,32,32,9,20,9,30,22,19,16,14,9,7,9,14,1,30,4,18,11,27,21,42,16,7,2,23,17,7,7,15,5,16,24,31,21,25,9,9,31,22,64,22,21,14,17,7,87,32,2,23,23,39,21,32,55,53,11,8,29,19,28,8,47,16,10,12,8,24,7,53,37,15,15,26,11,16,12,19,23,9,17,12,99,72,2,7,15,12,8,18,14,34,33,11,9,9,15,36,35,32,15,17,11,24,16,26,33,30,25,34,14,24,10,41,29,69,13,11,62,33,32,43,23,17,11,23,25,12,24,26,56,47,8,12,9,33,23,28,7,17,25,10,79,10,21,72,18,13,53,13,15,23,46,26,30,14,34,26,28,22,66,77,20,14,28,13,20,11,19,15,16,26,10,35,14,23,25,9,17,13,1,6,30,60,11,11,31,6,10,15,68,32,26,9,12,11,25,43,18,55,23,11,79,70,20,6,57,16,27,5,17,5,33,6,8,36,3,14,9,17,24,57,20,37,47,35,17,5,39,11,7,15,15,6,16,49,10,50,19,12,17,239,29,5,18,17,10,20,61,39,13,14,9,10,17,14,10,16,5,13,15,19,25,11,56,104,39,6,6,19,8,7,16,41,20,20,13,10,22,15,6,11,21,24,13,17,10,28,13,9,22,30,12,6,13,11,15,23,22,11,6,10,11,9,7,50,28,23,6,13,19,10,12,13,12,30,6,3,9,4,6,16,16,43,6,13,8,6,34,8,48,14,28,7,9,11,12,8,14,24,9,10,18,3,4,9,5,15,10,14,9,19,16,15,11,14,32,22,14,14,17,14,16,9,6,27,12,18,12,9,8,14,5,3,22,8,16,13,16,17,8,10,11,15,6,18,36,17,21,14,3,15,4,8,12,16,7,15,24,13,24,10,6,12,10,22,4,4,17,20,7,4,3,6,22,42,5,6,6,11,7,6,14,8,13,9,11,16,19,42,16,10,6,18,20,23,8,7,20,26,13,19,19,57,19,5,11,5,20,10,12,5,8,9,5,19,7,14,11,12,13,36,5,12,3,16,17,5,6,8,18,14,5,11,10,6,16,4,10,9,8,12,8,10,11,7,9,11,4,8,13,11,13,11,12,11,26,10,10,18,6,32,10,15,13,13,8,6,4,12,14,11,13,8,10,7,7,7,3,15,8,5,11,14,5,5,12,6,8,7,5,15,8,9,6,2,6,11,10,15,33,5,3,10,6,26,6,4,9,3,29,9,8,6,9,8,5,27,8,3,8,10,12,13,14,10,7,5,3,13,10,8,4,16,5,25,15,5,19,13,20,9,5,18,6,4,9,5,7,7,17,13
attempt,12,31,8,140,8,6,4,58,6,9,23,7,14,84,3,12,6,18,10,6,8,41,6,28,28,17,12,9,12,15,16,204,116,7,54,45,48,10,11,4,6,7,1,2,39,27,26,16,442,19,56,8,17,49,8,8,59,20,0,17,21,14,2,16,35,8,122,5,4,25,0,6,5,10,103,17,14,8,85,36,23,0,17,8,265,21,9,1,29,0,3,9,1,29,36,15,29,8,28,4,7,30,52,16,11,30,2,8,12,3,9,10,3,8,0,31,14,7,63,194,46,22,16,56,9,11,2,2,5,1,13,5,8,40,39,32,13,0,10,5,4,32,39,4,12,80,6,14,10,6,108,0,19,7,7,43,21,7,32,6,11,6,3,7,1,3,8,27,18,12,13,102,26,3,1,14,211,4,22,36,25,16,3,28,3,26,37,36,54,65,7,12,2,0,4,3,14,8,11,22,32,0,0,10,34,7,2,34,8,48,87,11,27,10,1,1,4,7,10,5,6,27,9,15,45,138,18,33,2,11,7,13,18,45,41,29,31,10,12,10,70,32,8,8,36,3,5,27,29,4,12,19,22,4,1,20,15,2,7,20,3,47,23,5,8,18,2,8,15,7,175,4,14,13,2,0,31,8,6,2,46,9,1,30,16,4,3,6,25,5,13,5,16,3,8,14,37,10,12,20,25,13,0,7,12,0,21,8,3,1,2,10,25,8,23,12,18,39,12,10,47,10,40,3,88,8,16,39,4,32,7,10,7,7,10,18,27,9,0,17,18,13,6,26,6,13,59,76,22,5,17,29,4,31,23,11,6,9,21,16,36,9,10,30,5,1,45,15,9,24,5,20,8,17,14,17,6,4,26,5,84,5,40,12,2,37,7,24,33,4,30,5,14,6,48,17,74,7,50,1,23,1,7,2,16,4,14,2,13,13,8,13,0,20,10,12,10,10,2,6,6,19,30,1,3,13,5,21,17,32,7,9,0,20,2,8,3,9,11,4,23,24,17,20,8,5,5,9,36,10,9,10,2,5,59,9,0,23,11,33,23,31,42,20,8,5,6,14,13,0,22,11,4,2,4,14,12,11,22,7,19,12,18,8,13,15,6,10,18,7,114,49,2,8,2,8,1,6,17,26,20,1,0,1,29,26,3,17,6,11,5,12,11,11,15,26,13,10,22,17,9,23,14,34,13,9,40,12,23,41,23,7,9,21,11,8,18,15,56,29,14,3,6,6,8,10,42,14,9,10,89,6,17,62,6,11,21,8,10,4,29,3,24,8,16,14,18,12,57,48,17,9,10,14,11,6,12,7,14,13,4,36,12,15,11,18,5,8,5,16,36,48,5,6,13,1,5,3,37,26,24,12,3,4,9,21,7,41,15,3,35,20,5,7,34,14,33,11,22,5,4,10,2,23,5,7,4,7,14,44,15,22,24,34,8,3,16,7,3,15,7,2,9,28,10,24,4,6,11,243,24,10,6,9,10,9,53,36,16,14,2,12,14,22,8,9,3,14,23,21,17,16,97,34,19,12,1,4,10,4,9,27,16,13,5,10,16,5,5,15,24,7,20,14,6,7,15,5,22,28,4,6,6,14,9,9,20,6,7,4,5,17,12,31,24,20,17,10,9,5,9,11,24,20,1,5,5,4,7,15,10,13,0,5,6,0,17,9,50,11,19,10,3,9,13,6,9,9,1,5,12,3,0,15,1,19,19,5,3,3,7,8,7,0,18,18,10,7,5,10,5,4,4,24,4,19,3,3,23,23,5,17,22,4,10,5,7,58,3,10,4,9,5,8,11,25,3,5,1,2,3,7,4,8,8,7,8,3,32,9,5,4,4,9,1,3,2,6,9,18,9,0,14,12,1,11,9,7,6,9,6,12,21,10,4,9,10,42,11,7,7,10,11,17,6,3,9,15,4,12,32,48,16,9,4,4,6,6,18,0,0,6,12,12,4,12,4,6,8,1,0,8,8,6,4,11,6,16,20,5,1,2,6,9,5,6,13,5,17,5,12,18,0,8,11,28,8,11,5,6,8,9,5,13,7,17,7,3,7,22,6,2,6,5,7,7,2,4,5,8,15,10,10,8,7,11,5,18,0,7,3,3,10,7,9,1,0,9,4,3,3,5,0,0,3,7,3,3,16,5,0,10,3,4,5,1,4,4,13,9,0,10,8,2,4,22,1,1,6,10,11,9,5,4,10,12,0,15,6,17,1,14,3,19,14,7,20,2,17,4,3,7,1,0,0,2,2,7,0,10
behind,0,3,9,26,5,7,1,11,1,3,2,3,11,37,0,7,2,5,3,6,1,5,21,15,12,8,15,16,2,11,1,60,42,7,16,39,12,1,3,2,1,6,0,6,11,7,16,2,52,41,10,13,7,25,59,2,5,7,10,11,1,5,1,4,9,5,37,5,2,5,11,0,2,1,58,9,16,0,19,13,18,1,1,6,33,3,2,0,8,0,3,3,1,9,10,2,7,3,16,14,2,4,15,7,6,13,1,4,7,7,2,0,9,9,11,9,1,3,32,41,16,16,4,38,8,3,0,1,4,1,3,9,5,15,8,40,3,5,4,7,3,13,8,0,3,17,4,6,1,1,17,5,3,1,4,11,20,5,3,24,1,6,11,3,2,10,4,6,13,3,8,40,15,3,1,0,26,2,3,29,7,10,4,17,1,4,10,12,10,10,5,4,3,3,2,0,2,4,6,0,17,6,1,0,12,0,4,9,3,2,35,14,14,4,5,18,3,2,5,1,1,5,2,3,12,31,10,9,1,11,10,3,6,12,18,2,17,7,4,1,22,5,5,1,10,2,1,17,12,2,1,4,12,0,2,4,1,1,0,10,5,14,2,0,2,13,10,7,7,2,24,5,7,0,1,0,8,0,0,1,26,2,7,6,6,3,8,3,5,3,0,2,4,5,0,3,4,2,2,6,14,4,1,1,6,1,3,2,5,2,1,4,6,10,6,2,1,21,8,1,5,2,26,15,21,0,6,31,0,16,1,3,5,0,6,2,9,2,0,1,1,7,8,1,0,4,7,10,4,9,6,7,0,15,6,2,1,5,9,7,9,5,9,5,2,4,3,7,5,9,1,9,2,8,8,5,4,2,4,2,17,1,8,4,15,15,10,9,36,3,5,3,5,0,2,6,8,0,9,3,6,6,3,1,3,4,4,0,5,6,1,0,1,8,0,2,0,3,2,3,2,1,4,3,1,3,3,2,2,4,8,1,0,5,3,1,3,2,5,1,3,2,2,7,2,0,8,4,11,15,12,0,4,3,13,3,1,2,5,2,5,8,9,23,3,4,9,10,4,4,16,6,1,3,6,12,4,4,6,4,3,5,2,2,3,3,2,9,3,1,19,2,2,7,0,6,0,3,1,0,3,5,2,0,2,18,5,2,0,2,1,1,1,0,2,3,0,3,0,3,2,4,1,9,0,1,15,1,1,9,3,3,4,4,4,4,1,4,3,7,3,2,1,10,4,2,0,7,2,0,3,0,0,10,7,3,3,2,2,1,2,0,2,2,3,2,3,1,4,12,7,1,1,2,2,0,0,0,2,4,2,2,6,7,1,0,1,1,0,6,4,7,6,1,21,3,11,1,0,3,5,2,0,0,0,4,1,2,2,0,6,0,0,2,8,0,3,2,0,0,3,11,1,8,3,2,0,0,4,9,9,3,25,6,3,1,3,3,2,0,6,7,1,3,0,2,5,2,6,21,8,6,2,1,3,6,5,8,8,5,0,0,0,2,2,0,0,3,7,3,2,0,4,6,3,0,0,1,0,1,0,5,6,0,1,0,0,2,2,0,2,8,1,2,0,1,2,0,2,4,3,0,0,1,1,5,5,2,0,0,3,0,0,2,4,1,4,0,2,4,2,2,2,4,6,4,3,2,1,7,3,2,2,1,0,2,9,3,7,3,1,1,1,5,7,2,3,8,2,2,6,0,0,0,1,2,0,1,0,3,3,3,0,1,2,6,4,1,4,2,4,2,1,4,0,3,9,1,1,2,0,1,8,4,6,2,0,3,7,4,3,12,8,1,2,8,0,1,0,0,0,2,3,1,7,3,3,3,3,1,0,1,1,0,3,0,2,1,0,4,0,0,2,1,0,1,5,1,3,0,5,1,1,4,3,1,1,7,2,1,0,2,0,3,2,1,4,1,1,7,1,7,2,1,3,1,1,0,0,1,0,4,0,1,3,1,1,0,1,1,2,1,0,4,0,3,0,1,1,3,0,1,0,0,0,0,3,1,0,0,6,0,6,2,2,1,2,0,5,13,2,1,2,1,4,0,0,1,0,2,1,0,1,1,1,1,0,0,3,0,0,1,0,0,5,1,1,0,2,11,3,1,1,1,0,1,1,1,0,3,0,2,2,0,0,3,1,0,2,0,1,1,0,1,0,0,0,1,3,0,1,0,0,2,1,1,2,4,3,1,6,0,11,3,2,2,0,0,1,0,1,1,0,5,0,0,2,7,2,4,2,5,0,3,0,2,6,0,9,5
clearly,1,17,7,59,7,4,4,18,2,1,13,5,7,56,4,1,5,7,3,5,2,16,4,8,8,5,9,7,4,6,1,82,39,6,25,38,26,3,8,4,3,6,0,1,15,6,10,7,133,9,25,10,3,18,8,1,31,10,2,8,10,7,2,6,7,11,56,6,3,12,2,5,4,7,55,3,10,2,33,26,32,1,4,5,97,10,1,0,10,1,2,3,3,12,21,9,9,0,13,7,5,13,19,7,7,12,0,0,2,2,8,2,5,7,1,8,0,3,24,71,18,8,12,24,2,4,2,1,4,0,6,1,4,22,9,30,9,4,5,6,1,22,4,4,2,33,6,8,9,5,55,0,5,5,5,25,16,2,4,2,4,2,5,1,7,4,0,11,16,5,13,45,17,1,1,2,68,3,3,33,16,2,6,12,6,6,14,10,21,19,2,3,4,1,2,3,10,3,10,7,20,0,3,4,10,12,1,20,10,26,36,4,4,7,1,1,0,3,0,4,1,9,5,11,17,63,22,13,4,0,3,8,11,15,14,4,17,5,6,1,23,13,5,6,7,0,2,9,31,1,10,5,4,5,6,5,7,0,3,13,6,13,7,2,3,23,0,4,9,2,62,2,5,6,2,2,12,10,6,2,22,5,2,13,3,3,2,5,18,2,1,2,4,2,4,2,8,3,8,4,11,13,0,2,7,1,5,4,3,2,3,7,12,4,13,9,17,19,8,5,21,1,14,1,29,0,14,9,3,8,7,8,0,3,6,18,12,2,7,3,13,4,11,8,3,4,13,24,6,2,4,5,7,17,11,8,7,0,9,13,14,8,9,5,1,1,8,4,5,3,3,12,3,11,6,10,5,4,8,5,32,1,22,3,2,13,4,14,15,1,13,4,3,3,11,8,22,2,14,4,10,4,2,0,5,7,1,1,6,4,1,1,0,10,5,7,1,5,4,2,1,5,18,13,3,1,13,12,8,11,1,2,2,4,0,1,5,5,1,2,4,13,3,8,0,4,4,3,16,5,5,1,0,1,21,2,0,5,8,13,15,14,21,16,1,2,8,5,10,0,6,4,3,4,1,9,0,3,9,3,5,4,4,2,1,3,3,1,6,1,39,25,0,3,11,3,1,5,5,10,6,2,2,2,6,4,2,6,5,0,2,4,2,7,12,8,4,10,8,9,1,10,7,15,7,7,17,10,8,9,5,7,4,4,7,5,5,11,18,15,3,5,5,9,3,2,2,8,10,4,18,2,6,27,3,2,11,3,3,8,12,2,12,3,7,9,8,5,14,21,6,2,8,0,5,3,1,3,3,5,0,4,7,5,6,3,0,4,2,7,17,16,11,3,9,2,3,4,11,11,6,6,3,1,3,13,3,15,2,5,11,5,4,1,15,5,9,3,7,1,6,0,5,7,4,5,3,6,9,15,0,8,17,6,1,3,6,2,3,9,3,3,6,10,3,15,1,1,4,63,10,3,3,2,0,4,9,13,5,1,4,2,4,3,3,1,2,3,7,4,9,3,13,24,4,3,3,0,2,3,4,16,5,4,2,6,5,3,2,5,5,6,10,3,4,3,2,1,7,4,2,2,0,7,5,1,8,4,2,1,2,2,4,9,10,6,2,5,1,7,6,3,1,7,2,3,5,1,1,3,3,5,0,2,3,0,10,3,6,2,6,2,1,4,4,1,12,4,3,1,3,3,2,4,2,14,5,1,1,1,8,10,1,1,4,4,10,3,5,2,4,2,0,5,2,8,4,1,8,3,3,4,5,3,7,2,1,3,1,7,0,5,4,0,12,8,4,3,0,1,2,3,6,0,2,5,5,3,8,2,1,1,2,7,1,5,2,3,0,3,2,0,5,4,0,3,4,1,0,1,5,4,6,3,2,9,4,12,4,3,2,6,5,10,2,7,8,3,3,3,9,21,5,3,4,0,4,2,7,0,2,4,6,4,2,2,3,0,5,4,0,2,1,0,3,1,1,4,9,0,1,2,1,3,4,1,6,1,2,0,2,4,0,1,0,2,1,0,4,4,3,2,1,10,3,5,5,1,3,6,6,1,1,1,9,3,2,5,2,3,2,5,1,0,1,4,0,2,5,1,3,8,4,6,8,0,1,0,5,4,4,2,1,3,8,3,2,4,8,3,0,2,0,0,1,2,3,1,7,4,0,2,1,1,0,5,2,0,5,5,2,3,1,8,1,2,2,1,6,0,1,4,3,0,2,2,5,2,6,1,1,3,0,0,1,2,3,3,1,0
demonstrate,6,8,3,49,5,3,0,14,3,2,10,3,2,37,1,6,1,3,3,3,3,12,6,5,3,3,10,14,0,4,5,65,55,5,28,33,28,4,4,11,2,9,0,4,9,10,10,11,100,16,13,11,6,35,4,5,18,13,0,19,8,6,0,7,8,6,50,3,4,7,6,0,1,2,25,4,9,3,41,11,28,0,7,4,59,5,6,1,12,0,5,3,3,8,16,11,10,1,20,5,8,20,7,4,10,8,5,3,2,2,7,4,6,5,1,8,0,0,16,41,12,11,6,44,9,4,4,0,0,1,8,0,2,18,4,36,3,7,1,8,1,12,8,6,1,19,0,11,4,2,20,4,4,1,3,17,9,5,6,13,5,0,4,2,4,1,5,17,9,6,8,28,11,1,1,0,48,5,6,19,5,5,9,4,3,9,8,11,8,14,0,1,4,0,0,5,5,3,4,3,7,1,2,8,19,5,2,16,4,25,26,2,5,4,2,2,2,3,7,1,2,9,3,8,12,24,20,7,3,4,5,7,8,9,6,7,6,5,9,1,23,16,5,2,11,2,5,7,27,1,3,11,8,4,6,4,4,0,1,12,3,16,6,2,4,23,1,5,4,6,44,5,6,3,1,2,6,4,4,1,17,6,1,3,5,2,6,4,6,2,2,0,4,6,3,3,10,4,8,5,12,9,3,4,2,1,10,1,11,1,4,5,9,6,5,10,13,29,6,3,26,2,12,0,21,2,9,6,2,12,4,5,1,3,3,9,4,3,6,5,3,5,2,4,4,0,14,15,9,1,1,1,1,17,9,3,0,4,8,7,9,6,8,6,4,1,7,3,7,4,1,12,7,8,2,14,2,1,2,5,18,4,16,5,4,25,1,9,5,3,7,7,3,4,8,4,10,2,16,5,6,3,6,2,2,3,2,0,6,6,1,4,3,9,5,7,1,3,3,3,2,3,11,5,3,13,1,7,7,5,1,1,0,5,3,3,4,2,5,1,3,12,3,14,10,5,5,4,16,2,15,1,5,0,13,2,1,4,1,5,3,7,15,13,10,3,11,6,1,0,8,1,2,0,7,2,2,1,4,2,1,7,3,1,5,0,8,0,2,2,33,12,2,4,9,5,0,3,3,2,5,3,1,1,5,4,5,3,1,0,2,3,5,5,27,8,2,3,2,1,6,5,3,8,1,1,5,3,5,7,2,5,1,1,6,4,2,0,8,6,5,4,1,6,9,0,4,7,3,2,10,1,3,15,8,3,8,1,7,4,5,1,8,4,7,15,11,2,14,17,1,4,4,0,2,2,6,2,2,9,2,8,8,9,12,1,1,1,3,7,11,15,2,1,17,4,1,9,9,7,13,2,2,1,0,10,2,5,6,1,8,5,4,3,9,2,5,5,3,3,6,1,1,5,2,1,6,1,1,14,4,7,5,2,7,3,4,6,4,2,7,3,2,7,3,10,2,4,3,64,0,3,3,3,1,0,13,5,0,5,2,3,3,5,0,0,1,7,2,2,5,2,7,5,3,2,1,1,2,1,3,8,4,5,2,2,2,1,0,1,3,7,4,1,3,2,2,0,6,2,5,2,3,4,4,3,7,3,0,0,2,4,4,19,6,20,4,1,0,6,3,1,1,10,2,2,0,0,0,7,2,5,1,0,2,5,13,2,7,7,7,1,2,5,5,1,7,4,16,2,2,3,2,6,5,12,1,4,3,1,1,6,0,1,6,5,1,1,8,4,0,8,2,2,2,6,3,2,13,5,7,2,1,2,3,5,4,2,6,7,5,2,2,2,4,6,1,4,3,2,1,1,3,0,2,0,7,4,3,2,6,1,1,3,2,2,5,2,2,3,0,0,1,10,2,3,1,3,1,2,1,1,4,3,2,5,2,8,4,3,0,1,1,3,4,3,3,5,1,2,6,9,5,1,1,7,4,4,0,2,0,2,0,6,1,1,1,0,7,8,5,3,2,1,1,2,0,7,3,3,1,1,4,1,3,1,1,1,0,4,4,6,0,5,0,3,2,0,4,5,2,1,0,4,4,2,3,1,4,9,5,1,4,1,2,6,0,3,5,2,2,0,2,0,0,4,3,2,5,4,3,2,4,2,0,1,5,0,0,2,6,1,5,1,3,1,5,3,7,4,3,2,4,4,1,0,4,1,8,1,1,4,3,0,2,2,0,0,2,3,5,1,2,1,2,0,4,3,7,2,1,3,3,4,2,1,1,1,7,0,3,3,1,7,0,3,0,1,4,4
conduct,15,30,14,124,15,3,9,54,6,7,15,14,10,105,5,20,4,13,11,6,7,41,11,44,38,22,11,12,4,20,15,201,143,7,63,71,55,3,2,4,9,14,7,2,41,29,20,23,391,9,68,10,13,44,8,10,67,42,2,21,22,13,5,15,27,8,92,10,10,15,8,4,6,6,110,21,22,5,70,38,37,0,15,3,309,26,8,0,31,1,10,6,1,28,82,14,15,4,31,3,23,31,32,11,14,29,3,5,17,4,23,7,16,14,5,21,8,10,72,145,57,16,4,82,9,4,8,10,5,0,9,3,14,49,17,71,14,10,10,10,16,43,30,3,6,94,6,18,22,12,87,1,15,8,5,42,36,10,7,5,7,1,18,4,0,9,8,30,27,11,20,89,30,2,3,14,196,9,16,46,48,21,3,21,6,44,35,35,37,59,2,6,10,1,4,5,18,10,9,44,62,0,3,15,28,8,3,51,16,31,113,7,18,6,6,1,0,2,13,2,4,23,13,13,62,162,50,27,10,7,17,12,7,46,47,18,36,10,8,22,89,39,4,5,21,4,5,28,59,5,12,21,19,7,13,25,18,4,11,15,14,17,28,4,13,61,5,11,20,6,147,7,14,3,4,1,21,8,10,7,76,10,5,23,14,0,3,13,48,3,8,9,2,7,6,13,45,6,7,31,34,23,0,1,13,8,46,10,16,1,6,37,26,13,29,29,8,50,20,9,63,11,29,5,120,7,17,25,4,43,4,12,15,12,7,10,22,10,4,11,17,19,15,14,1,5,50,75,21,3,13,14,7,34,22,4,7,7,26,30,26,9,12,22,2,2,33,17,6,20,2,27,7,11,13,35,17,8,35,8,53,8,48,12,3,37,5,35,30,10,52,8,11,15,27,12,81,9,45,10,42,1,8,4,1,19,12,1,28,16,13,7,3,22,13,19,5,9,8,5,18,17,27,21,2,12,7,1,15,24,9,7,1,11,14,8,6,24,9,6,22,19,7,8,0,2,9,10,34,7,16,15,3,3,65,17,2,18,22,39,24,22,38,60,7,6,13,16,11,5,28,5,1,1,9,53,8,18,19,10,14,12,5,8,16,12,12,5,9,14,130,43,3,8,8,7,6,16,5,14,16,6,4,1,5,46,6,16,7,17,8,4,12,11,16,20,13,12,14,16,9,35,21,48,8,5,32,43,15,37,8,5,5,18,9,13,14,20,73,33,9,2,0,4,4,6,4,21,17,19,28,8,9,50,19,14,48,5,5,4,23,1,19,5,18,24,27,14,58,62,12,12,15,6,17,4,3,10,5,11,7,23,5,28,12,27,4,7,3,12,36,52,11,7,58,5,19,6,67,25,31,4,10,6,6,20,11,40,11,5,39,34,16,9,40,11,19,3,13,6,30,7,8,21,4,5,5,11,26,22,15,21,48,32,24,11,31,8,3,16,17,7,19,40,13,46,6,11,8,217,19,4,10,5,18,15,40,25,18,21,3,5,12,23,16,14,4,4,10,14,25,10,56,32,29,3,2,9,3,6,10,28,29,10,11,14,11,5,6,13,18,17,15,16,9,8,17,6,8,15,8,10,8,7,17,14,24,2,3,6,10,9,9,29,17,32,19,21,13,18,18,15,22,69,4,9,3,10,9,25,7,14,8,9,8,5,39,9,40,12,15,7,10,24,14,11,16,6,15,18,9,3,1,5,1,25,14,12,4,9,6,18,4,2,27,11,9,20,8,12,9,7,4,17,4,20,18,14,41,7,12,14,19,3,11,9,6,25,6,34,8,3,2,12,32,23,6,8,7,10,3,7,16,0,11,5,20,10,25,10,7,2,13,11,8,8,9,11,9,8,9,6,4,24,12,9,7,7,20,3,12,12,21,4,5,23,14,43,13,3,7,5,9,11,12,6,13,13,6,14,21,42,24,13,10,13,8,6,11,1,7,15,23,7,10,14,6,2,5,12,8,9,8,25,4,8,12,12,16,9,2,11,5,6,12,7,5,10,7,6,3,12,0,13,7,7,11,3,5,3,7,14,4,28,23,8,2,22,5,17,4,4,6,8,13,5,7,11,10,11,12,7,6,4,5,8,6,30,5,6,19,7,14,5,9,5,3,5,10,9,10,14,5,1,4,15,16,8,26,12,3,7,6,4,8,3,10,5,22,20,3,7,13,8,1,14,4,2,1,4,18,9,8,2,5,17,3,9,11,6,7,11,6,7,9,1,20,1,36,0,7,4,12,0,0,2,3,9,4,1
event,13,44,4,158,21,7,7,54,5,4,28,12,7,76,10,5,9,14,9,5,4,39,6,26,11,14,17,13,5,24,16,160,109,11,48,77,72,9,8,13,4,6,7,3,33,26,24,5,340,19,57,6,9,40,5,7,51,25,1,25,20,12,1,21,19,4,93,7,12,9,11,4,1,5,78,13,13,5,91,18,41,3,21,5,198,15,9,0,51,2,15,2,2,29,57,4,19,2,29,8,6,40,26,7,17,28,3,4,21,8,28,2,8,13,6,23,9,4,87,156,43,16,9,69,8,4,9,8,3,6,22,6,6,31,17,26,7,3,4,17,2,33,46,9,7,66,4,10,14,11,74,4,13,7,3,16,27,12,25,6,7,5,4,5,2,4,6,20,19,3,26,99,13,4,1,11,174,3,13,32,16,11,6,22,11,13,34,33,52,58,3,10,0,0,3,4,12,9,13,14,12,2,2,9,33,14,5,17,10,17,70,2,41,10,4,6,2,2,8,2,4,25,6,11,41,73,24,29,6,1,8,16,10,27,28,10,35,9,5,4,77,29,5,4,15,3,9,20,51,6,8,23,22,8,12,18,31,1,7,23,6,51,22,8,9,21,0,4,17,4,154,6,38,4,7,1,25,5,19,1,64,2,1,20,13,2,0,11,15,3,8,4,7,4,11,10,39,3,7,11,23,25,1,9,12,1,14,4,6,0,3,12,28,10,16,13,7,33,12,9,38,11,33,1,43,5,8,20,3,19,8,14,15,4,7,9,17,10,2,11,18,22,12,10,8,6,45,51,8,9,9,5,5,35,20,1,8,3,18,27,15,8,11,17,1,3,39,7,5,14,2,10,1,3,12,27,11,5,18,3,91,1,36,12,3,19,3,27,37,7,18,6,11,10,39,11,48,8,29,12,15,4,4,3,3,4,4,8,12,6,3,18,4,16,11,14,3,9,3,2,1,3,21,17,2,8,7,15,1,26,14,5,3,23,4,8,0,22,13,2,15,17,12,23,6,6,17,7,43,9,10,14,9,4,44,6,2,13,5,28,7,33,31,37,7,8,12,11,9,0,13,4,3,2,2,16,6,15,25,5,8,21,5,5,11,22,8,5,8,2,131,46,2,9,9,6,5,20,10,9,12,6,3,0,6,11,3,19,5,7,3,9,12,3,15,24,8,10,0,8,3,15,6,24,11,4,25,2,25,33,19,8,10,8,7,11,16,9,36,9,6,1,5,2,2,13,27,17,13,6,66,7,3,36,7,12,32,5,6,11,17,5,17,2,13,23,22,9,33,24,18,11,16,3,2,14,0,5,10,10,0,16,12,21,13,7,10,6,2,5,23,36,12,4,6,4,4,5,44,25,25,2,9,10,8,24,3,29,2,5,25,12,15,5,26,5,25,5,11,6,18,5,3,21,2,13,5,8,16,20,8,16,28,29,4,1,5,3,4,12,4,1,9,28,18,33,4,2,8,197,27,6,8,9,1,15,38,19,7,16,7,14,21,17,13,10,5,18,17,10,17,7,64,17,38,10,5,7,12,9,8,26,26,9,9,14,14,10,3,16,16,10,17,26,7,11,6,3,12,17,9,7,8,8,6,13,16,12,3,9,1,13,6,31,11,44,15,11,14,7,24,4,19,39,7,5,8,2,1,14,7,23,1,2,3,3,27,9,39,8,11,6,2,18,13,4,15,4,9,8,11,3,3,20,5,10,10,14,3,16,14,6,7,4,21,3,17,6,0,10,3,3,1,10,6,12,5,4,8,11,9,7,13,1,5,8,6,36,12,11,6,8,5,2,7,20,0,5,4,0,8,11,13,7,4,4,4,2,15,5,4,4,4,12,2,7,4,10,4,9,12,3,2,8,1,5,5,11,2,7,2,10,8,5,6,14,13,37,12,12,14,12,4,8,7,4,12,4,6,6,30,29,8,6,1,4,4,13,4,1,8,5,5,2,4,7,9,5,10,7,0,5,7,6,9,6,6,16,15,3,2,9,7,9,15,6,4,5,9,9,9,6,0,10,6,16,13,5,5,3,5,17,5,18,14,11,6,7,1,24,11,8,3,16,9,10,5,5,5,2,9,7,9,8,3,11,5,22,6,12,4,3,8,9,6,4,3,5,8,12,7,6,7,0,4,17,6,9,18,6,6,11,4,9,5,0,5,10,33,6,1,4,3,14,2,22,3,1,14,8,15,11,8,2,6,9,1,15,5,8,1,4,8,12,7,4,12,4,34,1,2,3,5,0,1,1,0,13,2,2
follow,15,48,14,170,18,13,13,53,4,7,48,20,23,117,4,14,9,35,8,10,8,53,18,44,27,22,12,20,17,29,15,220,167,18,68,102,94,20,28,9,8,18,8,12,43,34,39,22,436,61,81,14,24,71,18,9,80,39,9,29,28,11,6,26,19,8,128,10,17,34,22,7,8,9,141,20,27,7,110,26,73,7,27,13,336,28,23,2,68,5,15,38,9,55,73,21,34,8,48,22,17,36,59,18,25,31,18,9,19,16,37,5,12,15,3,40,20,8,89,274,53,27,12,163,20,6,7,13,12,9,17,8,10,49,33,51,16,6,15,22,9,47,48,11,13,116,9,17,18,11,103,2,25,9,6,47,58,4,25,11,15,3,19,12,11,19,9,38,23,17,36,147,37,3,7,23,240,5,21,37,31,21,8,22,19,41,55,36,56,84,8,9,10,4,2,9,14,13,24,24,48,0,2,18,39,15,7,61,19,60,112,15,43,23,6,8,3,4,18,7,11,39,13,23,57,135,38,40,21,14,14,46,17,44,49,63,46,16,9,9,77,56,9,15,29,11,11,30,50,6,18,40,30,14,16,21,22,7,4,32,12,43,29,11,17,31,8,12,19,9,185,12,66,9,7,0,33,29,12,3,72,10,5,20,19,1,3,10,35,5,31,16,30,15,12,12,62,19,10,49,26,31,5,19,22,5,29,15,6,2,7,6,41,16,55,24,21,70,23,15,55,12,34,6,82,8,15,55,5,45,12,15,19,8,16,20,46,12,4,21,25,18,10,17,8,7,58,78,23,18,20,17,11,43,40,11,12,10,20,53,29,7,14,36,7,1,55,22,15,17,5,32,10,14,11,31,11,10,21,15,104,7,55,19,4,75,18,37,54,6,30,5,22,27,37,15,68,15,61,3,24,4,7,8,10,8,10,8,43,14,6,21,7,15,21,12,7,20,7,3,6,6,42,32,4,11,5,24,26,1,38,22,5,38,1,11,1,18,12,10,17,36,17,23,6,5,24,16,48,12,23,11,11,4,83,26,6,13,14,40,34,22,51,44,8,12,30,18,17,3,30,9,6,13,6,30,7,18,30,6,12,28,7,7,12,15,23,19,6,7,134,53,5,12,10,7,3,19,12,17,13,6,14,4,15,54,9,16,5,12,17,11,11,9,25,21,13,19,6,11,9,26,8,46,14,10,38,9,18,46,14,10,8,18,23,11,17,19,61,20,9,6,3,5,15,4,42,22,11,10,57,6,14,60,10,15,28,5,5,13,23,5,32,9,24,18,24,7,48,52,13,16,15,6,15,2,14,6,8,26,7,17,16,21,6,9,9,7,2,22,41,38,14,7,27,10,12,5,82,25,32,6,14,8,12,30,7,30,18,7,31,24,18,8,33,18,26,4,16,9,22,17,7,41,5,2,11,7,15,45,34,22,38,20,6,10,12,13,5,10,18,11,6,30,11,37,10,18,7,256,46,16,15,5,11,17,56,35,11,23,9,15,39,30,12,19,6,18,6,22,25,18,46,46,35,10,4,5,26,8,17,34,14,11,15,15,21,2,1,20,24,19,25,26,8,8,11,2,17,12,18,7,6,9,13,16,26,10,8,11,15,46,16,31,19,25,16,9,14,9,12,10,10,21,6,16,17,7,4,19,12,23,7,8,6,1,17,5,41,10,24,9,9,18,16,9,14,13,8,7,21,22,13,41,29,24,10,18,10,47,46,18,20,22,27,30,17,3,9,24,13,13,9,26,5,26,11,7,21,8,11,2,30,6,11,11,15,27,7,26,16,5,3,7,5,13,10,10,8,14,9,7,29,5,7,9,16,7,17,13,12,7,2,19,5,5,13,9,6,20,9,14,19,15,13,11,6,11,30,11,6,23,18,17,10,23,19,50,12,12,8,8,10,17,13,11,14,8,9,16,21,39,22,14,4,3,16,23,14,2,9,8,11,10,9,9,13,6,20,18,9,14,13,29,14,8,7,17,18,9,9,11,9,10,24,15,14,5,16,4,15,15,8,7,8,39,6,6,15,17,15,8,3,10,14,27,10,38,21,24,5,13,7,21,13,21,12,6,11,2,7,24,8,28,13,16,9,27,5,20,4,4,7,8,6,12,4,9,4,9,7,15,27,7,19,40,32,48,48,3,4,4,8,0,4,16,5,13,17,9,6,11,9,15,5,19,8,9,9,10,20,14,5,4,5,6,2,9,16,7,4,3,10,18,10,7,15,4,31,0,8,2,7,2,0,6,2,15,2,6
note,23,38,4,133,2,2,6,29,25,2,11,15,12,27,2,2,4,48,2,3,16,59,8,32,14,7,5,16,16,43,1,224,147,9,60,43,27,49,25,1,7,2,3,3,17,11,66,9,458,8,60,2,12,7,0,2,42,34,3,9,10,2,2,2,24,6,108,5,7,7,59,0,10,1,53,11,16,5,123,22,86,4,15,1,372,48,41,0,72,7,11,1,0,33,81,7,7,14,45,22,13,22,48,9,3,35,13,5,29,28,20,13,9,21,1,45,23,10,93,230,36,9,19,116,7,4,3,5,10,3,10,4,7,44,9,17,4,4,1,5,2,19,60,5,3,60,7,1,20,37,62,0,38,14,3,15,11,6,5,2,7,1,7,8,5,11,0,11,19,14,14,113,17,0,10,6,224,12,6,31,18,13,1,24,0,27,35,21,25,53,3,14,5,0,3,7,62,9,24,12,56,11,2,10,57,8,24,39,3,19,100,15,39,5,1,1,3,2,18,3,32,27,1,9,84,146,36,46,23,67,12,24,25,35,44,38,38,8,9,3,112,39,6,2,12,17,11,71,67,9,22,27,25,40,31,29,27,14,17,10,2,19,32,16,11,52,0,3,10,3,167,54,202,16,6,0,17,35,10,2,56,8,2,16,27,0,0,4,25,1,11,7,44,15,5,24,99,12,7,8,26,32,6,9,17,0,12,2,3,1,3,16,60,9,120,28,9,53,44,9,19,9,27,0,27,3,3,42,14,58,1,20,3,8,15,11,20,11,16,19,11,15,25,7,9,4,73,56,20,1,20,12,4,62,19,2,1,4,23,51,13,1,6,41,4,0,56,10,4,8,5,17,18,22,3,12,1,5,4,10,76,1,39,8,0,20,1,75,43,10,5,1,18,3,30,33,55,20,42,2,25,6,2,0,11,8,17,1,29,7,0,1,4,4,6,0,8,0,2,0,5,2,16,7,8,1,1,9,14,38,1,59,16,34,5,8,2,7,3,3,2,10,8,14,1,3,5,1,48,18,47,9,0,30,46,11,0,8,18,27,18,17,32,16,9,1,8,8,4,0,11,4,1,1,2,9,1,21,24,5,8,6,10,1,3,3,20,4,4,3,41,91,0,3,13,5,0,43,5,22,17,11,33,0,2,345,6,14,12,5,7,11,9,1,20,20,10,1,1,10,2,11,22,32,9,6,35,13,20,41,5,7,0,6,5,19,8,3,33,40,6,2,3,6,15,2,24,40,17,10,35,9,10,61,5,16,26,7,13,8,36,16,24,1,15,21,16,9,47,55,14,11,22,1,5,15,9,10,13,57,4,15,9,20,10,11,4,5,10,9,22,39,22,6,7,1,7,2,14,25,12,1,5,1,3,25,3,15,0,12,41,8,6,0,35,19,20,1,4,3,50,208,4,265,10,0,5,11,9,26,290,15,18,26,5,5,6,15,4,17,12,0,8,16,1,86,6,9,1,299,13,3,11,3,7,16,89,3,12,9,7,6,7,14,5,2,6,7,21,26,23,14,37,6,25,10,2,7,7,1,7,17,17,5,10,8,29,8,15,2,15,5,41,1,23,13,18,1,14,14,3,5,13,7,11,15,6,9,15,3,2,60,6,27,23,15,7,10,10,7,6,2,5,12,0,11,14,0,1,22,22,14,13,0,8,0,5,4,27,2,5,6,0,4,6,20,24,4,2,2,15,54,24,57,40,11,7,10,3,74,69,16,26,41,17,45,7,7,7,9,6,4,7,4,6,3,48,8,9,7,0,4,26,31,4,3,20,19,75,19,5,3,2,14,5,33,3,6,16,1,6,9,16,0,5,1,20,14,24,5,5,0,1,30,8,9,8,5,18,32,6,5,11,17,0,4,1,11,95,3,32,15,23,2,7,12,8,23,7,5,5,9,3,4,11,11,10,5,16,3,8,56,5,7,1,14,5,20,5,4,8,7,11,4,21,23,0,10,10,28,1,3,78,135,7,12,2,10,13,13,0,33,3,5,6,7,13,7,1,31,2,10,2,7,3,13,1,8,14,1,9,8,3,12,1,30,0,96,5,13,25,47,10,53,8,9,1,1,3,3,19,5,9,2,1,5,4,29,6,131,5,2,13,6,7,18,14,16,1,6,4,21,34,40,11,116,36,42,415,9,0,2,3,14,2,67,4,1,65,2,0,0,5,0,3,15,1,0,0,0,0,4,7,2,8,7,0,13,17,2,2,2,9,175,7,13,11,5,11,0,2,1,5,0,0,4,1,6,2,0
january,6,16,10,103,4,6,5,11,5,1,15,7,10,25,0,1,3,8,4,0,4,11,1,12,9,12,3,8,8,46,4,119,47,3,14,19,15,15,20,4,4,1,2,8,15,6,19,13,250,5,20,2,4,12,1,0,42,58,1,6,7,2,1,10,5,8,27,8,2,18,90,2,0,0,28,3,11,4,58,9,41,0,13,1,142,23,11,4,93,10,12,2,3,33,71,9,7,6,17,3,11,17,34,2,5,14,9,3,26,15,42,5,9,9,0,20,25,7,67,63,19,16,7,162,9,2,2,1,11,6,7,1,1,28,10,16,4,2,3,5,1,14,41,1,4,51,1,5,14,10,26,1,8,5,4,13,8,5,11,1,16,0,4,16,6,10,4,4,7,3,16,40,7,0,2,7,86,1,3,15,11,7,21,11,1,4,15,7,21,50,6,4,3,2,0,3,12,4,15,5,12,3,3,5,21,3,5,19,10,10,44,0,15,4,0,3,4,5,8,0,61,11,9,8,29,41,23,26,2,12,3,37,28,8,28,44,27,3,6,1,28,15,3,0,6,1,5,20,44,3,6,20,6,53,9,7,13,15,13,28,7,30,22,14,8,35,0,0,1,2,80,25,137,2,1,0,11,62,9,5,20,0,1,9,5,1,7,3,5,0,24,12,7,41,21,4,50,16,1,1,18,24,8,13,3,1,16,3,2,2,1,1,37,3,54,13,7,21,14,3,16,1,14,0,19,1,2,13,5,18,4,6,3,1,5,8,4,1,10,18,1,7,5,6,7,2,24,26,10,1,29,4,3,17,7,3,4,2,7,21,14,7,2,10,3,1,13,12,4,7,1,10,1,0,4,26,2,2,6,14,42,0,25,5,0,43,0,37,44,0,8,5,10,13,20,4,46,6,39,3,5,2,8,1,10,1,8,1,12,5,0,3,2,6,7,2,5,4,1,2,0,4,7,9,1,2,1,7,5,22,59,1,35,53,3,3,0,9,1,1,7,6,2,3,0,1,5,2,23,27,4,0,3,6,33,0,0,6,2,31,9,9,12,6,3,0,5,8,2,0,12,0,1,0,4,2,0,8,13,2,1,9,2,0,6,11,2,0,1,8,47,37,0,1,3,2,3,34,2,2,13,2,5,10,9,40,4,13,13,2,4,3,5,4,8,5,0,0,0,4,0,12,3,10,2,2,9,1,8,15,5,0,1,2,10,2,9,0,17,17,1,5,3,6,13,7,69,7,5,6,9,1,7,39,3,3,17,2,2,3,7,7,27,6,4,2,9,2,18,26,7,6,17,1,3,6,4,2,1,38,8,10,2,4,1,0,9,5,0,4,15,15,3,5,6,1,1,4,44,8,14,0,4,7,1,17,7,10,3,7,16,18,12,1,13,10,17,0,2,4,5,14,4,46,3,2,6,1,6,18,27,17,11,18,2,3,1,9,1,6,3,0,1,19,11,40,2,19,1,183,9,4,6,5,1,7,27,10,12,17,5,4,33,19,15,8,4,3,10,13,10,3,43,16,24,1,2,7,23,6,14,26,6,6,7,25,5,5,6,12,16,5,11,15,7,13,12,6,8,7,7,3,5,2,5,8,30,3,2,8,1,47,5,18,8,20,13,3,8,6,5,5,1,7,1,3,17,0,4,4,2,10,6,1,5,7,16,2,16,5,10,2,0,9,4,6,11,2,2,5,3,73,9,43,10,7,4,8,0,14,15,6,17,53,12,26,11,0,10,7,0,0,1,2,2,5,7,3,3,11,1,1,12,19,3,4,0,14,15,7,8,5,3,7,9,5,13,10,8,3,6,13,18,5,1,3,1,3,5,2,3,5,6,14,2,7,5,6,9,4,0,3,11,14,4,5,2,3,8,6,28,13,4,1,0,2,1,14,1,6,5,5,1,6,11,4,3,8,1,3,17,15,1,5,3,5,1,14,4,3,1,3,1,1,3,5,0,2,6,15,1,3,16,15,6,7,1,19,7,1,12,31,3,6,15,2,7,2,1,4,5,4,0,4,5,64,1,5,9,1,2,4,6,5,5,37,3,10,15,14,2,26,3,66,7,37,1,4,2,1,3,3,2,11,3,3,4,11,3,23,2,1,4,3,1,6,3,9,5,7,2,7,11,44,7,47,28,101,203,3,3,0,0,8,0,157,1,3,18,3,6,1,2,6,7,22,2,1,4,2,0,3,2,0,7,3,1,4,7,2,11,0,8,15,1,0,1,1,6,0,1,0,9,0,1,6,1,3,1,0
30th,0,9,0,77,1,0,8,5,3,0,13,5,2,11,1,0,1,4,0,0,1,13,1,10,1,11,2,14,2,27,2,124,33,2,12,12,17,5,8,5,2,1,0,2,11,5,12,3,106,0,13,0,1,4,0,0,34,38,0,5,7,1,0,6,3,4,17,0,2,1,70,6,0,0,9,0,7,0,35,7,39,0,5,1,72,9,5,0,113,5,9,0,0,32,57,5,14,1,11,0,3,10,21,1,4,9,25,0,12,7,16,3,0,6,0,17,18,4,68,42,6,4,3,138,4,2,0,1,5,1,1,0,0,22,0,5,10,1,1,0,0,4,21,2,1,10,3,5,3,17,7,0,4,1,0,2,8,5,0,0,7,0,2,5,0,0,7,0,1,4,9,11,0,0,0,0,66,0,1,1,4,2,0,1,4,1,13,7,7,48,0,0,1,0,0,0,3,0,8,1,4,0,0,3,2,0,0,7,0,6,10,0,10,1,0,0,0,0,6,0,43,5,5,6,43,24,20,14,16,8,2,38,37,6,7,43,9,0,4,0,17,5,0,1,1,2,2,1,25,2,3,7,2,41,9,4,4,2,5,15,0,8,17,5,8,49,0,0,1,0,52,11,150,3,1,0,4,71,7,2,14,0,0,4,2,1,0,0,5,0,12,5,3,31,6,6,39,2,2,7,13,19,5,1,2,0,6,0,0,0,0,0,18,0,47,22,1,7,2,0,19,1,2,0,6,0,0,5,0,6,2,3,2,0,0,4,3,0,11,19,3,4,3,5,2,1,14,11,3,1,18,3,0,5,7,5,3,0,5,126,1,2,0,2,0,0,9,1,1,0,0,6,2,1,0,33,2,0,8,16,29,0,22,3,0,15,0,12,53,0,2,2,5,1,16,0,20,3,10,5,3,0,0,0,2,2,1,2,7,2,0,1,17,0,5,0,4,0,1,0,0,0,2,0,0,2,0,1,3,5,16,35,1,23,2,3,0,3,0,0,9,3,1,1,0,0,0,0,15,6,0,3,0,2,18,0,0,7,0,17,2,10,7,8,0,1,0,1,7,0,3,0,1,0,0,1,1,4,1,0,0,4,0,1,0,12,0,5,1,1,49,49,0,3,1,1,2,40,3,2,4,2,6,0,0,7,0,16,2,0,9,4,3,0,1,6,0,0,0,2,0,4,1,5,4,9,2,0,15,4,0,0,0,2,2,5,4,0,8,12,1,0,0,0,6,4,4,0,5,0,12,0,0,29,1,2,5,0,2,1,4,4,10,0,2,2,4,0,14,11,3,3,15,0,1,1,14,2,1,37,0,2,1,0,2,2,0,0,1,4,1,6,1,9,4,0,0,0,30,0,5,1,0,4,2,2,1,9,0,6,3,14,10,0,8,1,4,0,0,4,3,0,0,12,1,3,4,2,0,7,0,6,4,11,3,0,0,3,4,9,7,0,1,12,5,41,0,13,0,59,12,2,0,1,1,15,14,0,8,14,0,2,31,6,10,5,0,6,8,10,6,2,84,0,16,3,1,10,0,4,15,13,2,6,7,12,4,0,5,2,20,0,4,0,7,9,3,0,12,9,0,1,3,0,4,3,7,1,3,6,0,41,2,5,6,22,0,2,4,3,5,1,3,13,1,2,12,0,1,2,3,10,3,0,5,4,8,6,10,1,5,0,0,0,1,0,14,0,1,4,3,79,52,138,25,9,0,5,0,8,8,2,6,7,11,11,6,0,0,2,2,0,0,4,0,3,3,2,0,1,2,1,6,8,1,0,1,10,7,1,0,2,2,2,2,3,0,7,9,2,4,11,11,5,2,0,0,1,3,3,16,0,10,8,0,0,1,1,5,1,2,16,2,11,32,0,0,8,1,3,19,14,3,0,0,0,0,8,2,3,6,3,0,1,1,3,0,2,4,5,2,12,0,14,0,2,0,9,2,0,5,0,0,0,1,3,0,3,0,2,0,3,0,1,2,2,1,6,5,0,16,13,0,5,13,0,5,2,1,2,2,18,0,0,4,40,1,5,13,0,6,2,4,4,10,16,0,4,8,3,0,45,0,72,3,60,0,2,0,3,4,2,6,3,6,3,0,14,3,1,1,0,2,7,3,10,1,16,1,6,0,3,67,35,10,42,14,109,144,1,6,0,0,2,4,43,14,3,16,0,19,6,2,4,9,18,5,10,1,0,0,4,1,0,3,0,0,0,13,4,16,1,10,0,2,0,3,0,11,0,0,0,5,0,0,1,0,15,0,0
march,13,48,11,281,14,8,5,35,13,4,37,16,7,49,6,8,14,13,3,4,5,52,19,42,13,17,29,19,18,61,12,239,101,23,43,63,32,17,7,8,5,13,7,6,31,13,18,16,474,43,46,16,11,39,0,5,63,85,14,22,31,9,3,15,15,10,77,4,6,23,13,4,3,2,39,9,24,3,80,26,52,1,20,3,205,31,15,0,151,8,25,6,12,46,70,12,27,9,41,7,17,22,39,12,8,39,25,2,33,11,32,4,12,19,6,30,41,10,261,111,39,36,10,156,14,3,5,4,3,4,14,7,2,52,30,47,5,10,4,8,4,35,73,7,9,103,3,14,14,12,48,1,15,5,1,20,26,2,26,22,16,3,6,44,3,11,4,20,14,14,32,85,17,2,10,11,181,8,6,39,16,12,8,20,8,12,27,17,40,84,6,4,1,3,0,4,13,11,20,2,9,0,2,20,34,11,7,11,11,15,89,9,49,11,5,5,1,3,28,3,19,15,7,18,53,89,26,24,10,2,11,34,33,6,35,44,33,4,11,13,71,23,4,4,8,14,1,42,53,6,11,16,14,17,6,22,21,19,5,42,5,59,38,30,2,70,2,21,16,3,158,13,79,0,5,2,32,33,22,10,39,3,3,17,7,2,7,8,11,3,46,24,21,24,77,4,79,17,9,13,26,46,10,53,4,0,17,10,4,2,5,4,40,9,52,31,7,51,16,4,47,7,25,4,55,7,8,39,2,37,11,8,3,6,6,17,16,4,4,32,4,12,10,9,7,9,40,50,12,16,19,9,6,30,15,6,6,5,16,44,14,7,2,15,3,4,38,11,14,19,7,36,2,12,5,52,8,2,11,8,61,2,45,5,9,72,5,38,40,1,17,5,15,38,37,15,67,8,56,2,21,9,7,4,5,3,4,2,22,14,6,7,6,12,10,12,14,9,7,12,1,19,23,20,5,4,5,11,23,38,34,53,23,1,7,13,2,32,13,8,15,16,5,11,1,3,19,8,32,20,22,12,12,6,45,10,6,16,7,67,18,19,23,41,18,5,18,16,7,0,21,7,3,3,8,3,3,28,32,1,5,23,3,8,4,6,3,14,4,16,102,47,2,5,10,9,3,25,8,2,6,6,5,2,8,20,1,10,9,2,5,10,17,7,13,10,4,7,1,5,3,18,6,34,9,12,18,4,23,26,10,5,7,7,10,11,12,9,39,6,2,10,3,4,4,8,107,10,11,15,28,12,10,45,8,9,19,7,7,13,20,15,63,2,11,5,22,2,47,32,12,3,30,3,9,2,12,2,1,35,8,32,4,13,7,3,14,8,3,5,32,29,14,9,15,2,0,3,96,19,22,0,2,15,6,12,14,27,2,10,36,43,50,6,19,16,18,2,2,6,10,10,2,43,3,6,5,7,7,31,8,25,19,25,16,0,3,5,9,7,9,3,5,24,15,60,4,21,6,337,9,2,2,4,5,21,31,11,14,23,3,6,46,21,25,23,3,18,17,11,8,5,75,23,43,6,10,11,35,4,23,38,16,4,11,15,19,5,5,23,33,12,13,17,10,23,21,11,12,19,13,5,9,4,6,9,14,11,8,12,2,75,5,19,17,83,52,7,18,9,12,8,5,50,12,22,5,3,3,19,4,24,7,2,4,9,42,1,55,6,19,5,4,22,11,2,12,4,2,14,9,15,10,86,26,20,9,17,10,32,24,6,39,48,34,10,19,5,7,18,8,8,1,21,3,17,10,4,34,15,13,2,8,12,11,2,5,90,5,27,8,24,11,4,12,15,4,14,6,17,6,10,20,12,7,2,3,5,10,9,14,3,15,22,5,10,5,14,6,16,9,8,13,35,8,5,3,36,8,7,27,7,12,6,4,6,17,33,6,11,19,13,1,1,7,19,3,21,6,11,22,45,10,3,3,5,3,18,7,6,11,2,12,1,3,2,1,7,10,26,3,19,25,2,4,2,8,18,17,3,14,27,11,22,40,9,17,19,6,8,18,11,2,12,3,88,9,14,14,8,3,13,8,19,16,62,7,14,5,28,3,7,19,37,29,41,5,8,3,6,8,13,4,7,6,8,8,28,19,18,9,3,6,14,2,7,3,6,5,6,2,21,16,35,17,29,27,25,75,6,13,4,11,5,10,40,4,6,39,10,14,10,5,5,7,41,5,8,3,3,5,3,6,6,4,6,7,4,12,9,21,4,11,9,6,0,4,8,18,3,2,5,3,3,1,13,2,7,2,11
join,11,16,14,76,10,17,3,19,3,2,8,11,15,72,3,7,8,26,13,4,1,19,34,30,9,48,13,44,9,20,4,85,78,17,30,103,31,3,2,5,4,26,2,9,18,7,19,16,94,62,17,15,14,68,21,7,16,6,42,16,4,13,0,6,18,11,49,7,4,12,13,2,1,0,79,11,21,3,29,21,21,2,1,3,78,0,8,1,7,1,8,5,10,16,15,3,15,1,23,5,3,18,11,6,9,25,4,3,7,4,23,4,4,20,22,13,2,6,30,37,14,30,11,59,13,3,1,3,2,4,19,8,9,31,13,67,4,1,2,8,6,28,12,2,2,46,8,10,3,2,33,6,7,9,9,15,24,8,15,44,2,2,10,5,5,18,4,26,24,10,23,64,16,5,8,4,37,1,7,36,11,9,9,13,3,10,23,9,18,18,1,7,1,5,4,2,11,7,8,8,18,0,3,0,15,8,1,8,5,13,57,9,12,6,2,10,2,6,5,1,1,10,0,4,18,31,11,12,5,1,10,5,10,4,16,5,20,12,2,9,31,18,11,7,20,5,8,20,28,4,9,7,31,1,3,7,0,2,0,11,3,25,6,1,7,9,6,14,11,7,45,6,3,2,0,5,13,4,4,4,41,5,1,6,9,7,12,8,10,6,2,4,9,9,7,2,7,2,3,20,22,15,0,0,4,7,20,3,18,1,3,15,19,9,9,6,5,10,6,4,16,1,19,12,39,2,15,31,0,20,7,2,3,0,4,2,15,1,4,5,4,7,16,8,0,6,6,27,11,12,2,7,4,17,7,1,4,3,4,21,13,2,8,13,3,15,8,3,15,25,4,28,3,30,10,13,4,1,15,0,24,3,23,7,11,14,4,8,7,1,12,6,13,14,8,8,8,0,20,2,9,8,3,17,2,9,1,3,24,10,10,9,1,12,4,11,7,8,4,13,9,6,17,2,3,0,3,14,4,1,5,3,2,7,1,3,10,9,10,6,12,7,3,13,5,7,18,5,10,7,25,2,9,5,32,6,4,4,4,3,14,17,17,40,5,6,15,4,2,6,16,8,0,3,2,16,3,8,4,0,4,7,3,3,11,1,2,6,7,2,53,7,2,6,4,1,2,3,2,3,5,3,3,2,10,8,6,2,3,1,0,2,5,1,1,3,7,5,0,9,1,10,0,3,0,6,13,2,4,9,9,4,4,2,1,3,1,8,13,6,1,5,3,13,5,5,1,5,9,1,7,2,1,16,16,2,13,1,2,2,8,3,3,2,0,2,13,1,20,21,3,1,1,4,1,3,2,2,0,5,8,2,4,9,2,8,1,3,0,8,10,12,7,6,23,1,8,3,16,6,13,2,1,2,1,7,3,9,0,0,9,18,3,5,6,0,0,6,1,1,3,1,1,12,2,1,1,4,5,16,6,4,8,14,6,5,11,3,3,4,12,2,4,21,3,10,0,5,6,72,12,2,2,1,2,14,9,9,7,7,4,8,4,5,4,1,4,3,2,3,4,2,3,5,2,6,1,3,5,2,5,15,9,3,17,0,4,7,2,1,2,15,2,6,1,5,2,0,6,4,20,5,0,1,1,4,6,5,4,1,1,7,3,9,5,16,16,2,6,0,4,2,7,10,7,5,3,4,5,10,1,2,1,5,0,1,4,4,12,1,5,1,4,3,6,3,3,12,1,4,7,0,1,3,2,2,6,9,1,3,2,7,1,2,16,4,10,0,5,3,5,4,4,4,2,6,4,2,12,2,2,2,8,0,4,3,0,3,1,3,9,4,6,2,3,2,1,0,3,1,0,3,3,0,8,3,4,6,9,3,7,1,5,3,2,3,6,8,0,5,2,0,9,2,1,0,8,6,1,3,2,2,1,4,4,3,4,17,0,1,1,2,1,2,2,0,1,8,0,7,12,13,4,0,3,3,4,2,1,5,3,0,1,6,1,4,5,1,2,11,1,0,4,4,3,1,3,6,9,11,3,1,4,1,5,0,1,0,2,2,10,2,5,4,1,2,1,2,2,10,0,0,3,1,5,1,1,1,1,5,2,8,1,0,2,3,1,2,4,0,3,5,2,2,3,0,5,2,2,3,3,8,1,3,0,1,0,1,4,3,0,4,1,0,1,2,1,0,4,2,9,9,4,2,2,1,3,3,2,0,1,3,1,0,2,2,3,1,4,0,4,3,7,9,0,4,6,0,7,1,2,5,1,7,1,1,1,12,2,6,1,1,9,4,4,1,5,1,5,5
announce,7,17,1,61,7,3,3,13,7,1,12,8,3,52,0,3,1,5,6,3,4,28,5,12,11,12,3,6,1,7,8,85,57,5,17,29,31,0,3,3,3,4,5,8,10,12,19,8,178,29,31,4,3,27,5,4,26,8,29,12,14,4,2,12,10,1,43,3,4,12,8,0,2,2,41,6,7,4,48,7,30,0,8,4,112,2,5,0,17,1,8,1,9,16,19,7,7,0,25,1,7,15,16,7,5,8,2,4,6,2,8,3,3,10,7,13,7,3,34,60,14,12,5,39,7,1,1,2,7,5,11,0,7,21,12,15,6,2,3,3,2,15,31,0,3,45,0,7,8,3,37,3,7,0,1,4,11,12,8,9,4,0,5,1,8,6,5,11,3,5,10,44,6,0,1,7,73,1,1,17,9,7,1,6,3,5,8,13,23,43,2,6,0,4,4,1,12,4,5,6,11,3,2,13,16,7,1,10,6,23,43,4,15,5,1,5,3,1,7,1,4,9,3,4,14,27,5,7,0,3,6,5,6,18,17,10,17,5,0,1,28,18,6,2,11,2,4,9,21,9,5,4,12,4,7,4,6,2,4,4,0,21,10,4,6,12,3,3,4,3,51,2,10,3,1,3,13,2,6,2,24,2,0,6,6,3,4,3,11,2,11,14,12,8,5,3,17,6,7,8,11,9,1,3,8,1,19,2,1,3,0,3,12,4,7,4,6,20,6,2,29,10,11,5,44,4,4,13,1,12,1,3,6,2,3,6,16,5,3,6,7,6,5,8,0,1,17,27,3,7,7,3,3,5,10,9,2,3,6,16,4,7,9,9,1,4,25,3,8,12,1,9,3,10,1,8,1,0,7,1,23,4,14,6,2,12,0,16,13,6,14,2,7,8,20,7,25,4,22,3,14,0,1,1,3,2,2,6,13,2,0,3,2,5,23,4,3,4,3,2,4,6,7,8,1,1,3,8,8,11,8,3,3,13,3,1,2,18,8,1,7,12,4,14,1,2,2,1,16,2,7,6,4,3,26,13,1,6,1,14,9,10,14,8,5,2,11,3,1,0,3,3,2,0,1,1,5,11,8,1,2,10,11,8,3,1,4,1,2,0,38,15,0,2,1,2,0,12,3,5,6,7,1,5,8,4,0,8,3,3,0,2,5,2,6,5,7,1,1,7,4,9,3,12,5,4,12,0,5,10,9,3,0,2,5,0,4,5,21,3,8,3,2,1,3,8,2,5,8,2,8,4,1,26,3,3,17,1,2,5,12,2,6,2,6,7,12,5,11,17,6,5,3,1,5,4,3,6,2,3,3,8,6,7,7,3,2,2,0,2,19,28,5,2,3,0,2,2,28,14,7,0,4,3,4,7,3,5,3,0,12,12,6,4,11,3,6,3,4,2,7,2,3,12,1,1,15,1,4,13,2,3,7,7,1,2,2,1,1,3,4,3,2,9,11,13,3,3,2,127,25,1,3,0,9,8,13,12,5,7,2,6,13,17,11,3,1,4,5,6,5,4,16,3,19,2,0,5,2,2,4,18,12,1,5,6,5,9,0,6,20,4,11,7,2,14,5,3,9,5,10,2,7,1,6,2,7,2,0,7,1,10,5,9,6,2,8,7,10,1,3,0,3,4,1,1,2,2,3,6,5,8,1,1,0,1,6,1,16,8,5,2,4,2,5,2,4,7,4,1,1,2,0,6,4,4,4,5,0,2,0,23,2,3,6,1,5,6,0,6,1,3,2,4,3,4,2,3,1,5,2,3,3,1,4,6,4,4,3,19,4,3,0,4,3,5,0,5,9,5,3,3,10,5,2,2,3,5,11,3,0,5,4,6,2,6,2,7,3,9,12,3,3,10,2,1,3,5,5,2,5,9,2,2,2,3,7,18,8,1,7,0,2,3,3,2,0,4,0,3,23,12,5,0,0,0,4,2,3,1,4,8,10,5,1,2,3,1,2,3,0,5,0,0,1,4,12,25,8,2,7,11,2,3,9,2,5,5,9,0,5,8,1,5,8,6,3,8,4,1,3,4,3,4,7,3,2,7,0,10,3,3,2,3,4,3,1,3,2,1,5,6,1,3,3,6,8,20,5,4,1,5,2,3,1,1,2,1,3,1,4,2,0,1,0,5,3,0,4,8,0,5,6,0,3,2,2,4,7,6,0,3,9,2,4,11,0,0,2,4,3,3,2,2,8,8,1,3,8,2,1,2,4,3,3,0,3,3,31,2,1,2,5,3,3,0,4,0,2,3
soviet,0,5,2,17,3,9,0,160,4,0,4,0,6,48,0,1,4,1,8,9,3,6,22,16,2,9,7,12,7,10,12,28,21,13,14,46,37,1,0,7,4,11,3,2,14,1,3,3,50,19,22,9,2,63,3,3,2,2,8,8,6,7,0,3,11,5,24,0,4,3,11,0,1,2,32,2,13,5,10,10,15,0,1,2,16,0,4,1,5,1,3,3,2,22,6,3,9,0,37,0,0,7,6,3,4,5,8,7,6,3,13,1,3,7,1,12,1,3,7,29,12,13,0,25,5,2,4,2,0,0,13,1,6,22,12,19,0,0,4,1,2,9,10,1,4,22,6,8,1,2,15,2,4,4,1,1,8,2,2,16,0,0,2,5,4,5,2,13,1,0,1,23,12,0,5,0,1,2,3,17,1,4,12,5,0,8,3,2,1,15,1,8,0,3,3,3,3,5,1,0,6,0,0,0,9,3,0,5,3,11,10,6,1,0,6,15,0,4,2,3,1,7,1,2,8,3,8,3,1,5,2,4,6,11,4,0,9,4,2,2,14,9,5,6,12,0,2,15,5,4,1,4,5,0,0,2,0,2,2,5,0,25,2,0,5,0,2,13,5,2,9,0,2,0,0,3,5,0,0,5,11,0,0,5,2,9,2,1,3,1,0,9,0,0,4,4,2,2,3,4,4,1,2,1,0,3,11,0,0,3,2,1,10,10,3,1,2,5,0,6,2,0,14,1,6,0,2,16,3,7,3,1,6,1,3,1,6,5,0,3,4,8,6,1,1,1,5,5,2,4,1,2,0,20,2,0,2,0,0,9,1,1,6,8,0,3,6,5,3,12,1,27,0,12,3,4,0,0,3,1,5,3,3,1,5,0,0,4,0,1,2,12,0,4,1,1,3,0,1,7,5,7,1,7,0,0,3,1,4,6,4,1,1,5,2,8,12,6,5,27,0,3,7,3,3,5,4,6,0,1,2,0,0,2,10,2,1,13,21,2,6,3,4,34,9,14,19,11,0,7,11,1,13,3,7,2,3,1,1,2,4,5,6,3,2,1,4,5,0,1,7,2,1,1,1,3,5,0,6,5,2,4,0,1,1,1,0,4,2,0,30,6,3,2,3,2,0,2,4,0,0,0,0,1,0,1,0,0,1,0,3,0,2,0,1,2,1,0,0,4,1,0,0,1,1,0,4,0,1,6,3,1,3,1,5,2,0,1,3,0,3,0,1,1,0,2,1,0,0,0,5,1,0,7,0,2,1,0,2,0,0,0,2,4,1,0,4,1,11,5,8,0,0,0,1,0,0,0,0,8,0,1,2,9,0,0,1,1,0,1,8,1,5,2,0,0,0,0,10,0,0,0,0,0,0,0,2,0,1,0,3,3,1,1,2,0,0,2,0,0,0,0,0,8,0,0,1,1,0,3,1,0,4,0,2,5,1,3,1,0,1,1,0,6,1,3,0,2,3,61,0,4,0,0,0,6,1,5,0,2,0,1,0,5,1,1,0,2,4,1,0,0,0,0,0,0,0,0,0,0,1,6,0,0,1,0,2,4,0,0,4,11,0,0,1,2,1,0,11,1,11,1,0,0,0,1,0,7,0,0,0,1,0,1,6,1,6,0,2,0,1,0,0,1,0,5,1,1,0,5,0,1,0,2,0,0,1,1,2,0,0,0,1,0,1,0,1,6,6,0,2,0,0,0,0,1,0,1,0,0,0,6,0,2,4,2,0,2,0,3,3,4,0,0,0,1,2,0,0,0,0,0,1,0,2,4,0,0,2,0,0,0,0,0,0,0,0,4,1,0,3,1,1,0,4,0,0,0,2,1,0,1,0,0,0,3,2,7,2,3,0,0,1,1,0,0,3,3,1,0,1,1,0,4,3,1,0,4,1,0,0,0,0,6,0,0,0,21,0,3,3,0,0,0,0,2,0,1,0,2,0,0,0,3,0,0,3,1,8,0,0,0,1,0,0,0,0,2,3,3,0,0,0,0,0,0,0,0,3,0,4,0,0,0,0,0,0,0,4,5,0,0,2,0,1,0,1,0,0,0,0,0,0,0,0,1,0,0,1,0,0,0,0,0,1,0,2,2,0,0,0,4,0,0,0,1,0,1,0,2,0,1,0,0,0,0,0,0,0,0,0,0,0,0,0,0,2,2,0,0,0,0,0,0,2,0,0,0,0,0,0,3,1,4,0,0,2,2,0,0,0,0,0,0,0,0,1,12,0,1,0,4,0,7,0,0,0,0,4,4
negotiation,23,22,7,125,11,11,5,25,6,0,44,31,19,96,4,5,24,15,8,4,8,66,16,36,32,15,27,24,12,33,12,270,153,20,41,80,77,5,2,9,12,7,5,9,50,20,55,19,522,60,91,16,15,65,2,4,52,16,14,55,44,9,4,35,11,3,48,1,29,23,3,8,4,5,43,25,19,6,75,31,23,0,30,8,295,4,5,0,73,4,16,9,0,66,64,3,37,2,75,8,18,34,53,24,13,23,6,5,14,3,28,6,5,12,5,61,11,0,99,165,37,52,8,67,7,3,5,10,8,1,21,10,1,61,27,59,13,1,11,5,8,61,52,0,1,96,5,20,7,8,74,0,16,8,3,4,34,5,15,28,2,0,2,7,0,9,0,34,19,5,11,87,23,2,15,11,196,5,14,30,32,8,9,25,2,16,27,26,87,168,1,11,8,6,0,2,9,9,2,2,8,0,3,22,22,12,5,6,45,25,83,14,20,6,7,3,0,4,13,6,0,15,19,21,28,36,13,20,4,1,13,15,17,17,23,14,56,2,5,9,71,48,9,4,17,4,11,27,48,9,9,8,48,0,4,18,11,2,7,18,0,44,66,13,4,28,4,23,29,12,145,7,14,6,1,3,22,2,28,1,42,0,8,16,7,1,8,5,15,3,22,31,9,5,15,12,60,12,10,18,31,27,0,4,10,0,38,4,3,3,7,10,45,16,18,15,12,118,14,5,68,6,22,4,79,5,5,53,6,39,13,8,5,5,4,12,32,15,4,7,10,18,10,18,1,8,58,105,17,7,9,19,9,21,38,3,7,7,25,46,11,5,16,10,4,3,64,7,20,31,8,43,4,22,3,5,0,1,29,5,50,4,44,27,9,24,0,21,29,2,37,8,10,60,67,18,105,6,33,6,43,10,9,9,3,0,4,8,69,18,3,18,11,11,31,22,37,25,8,20,6,22,15,9,2,5,2,24,22,18,7,9,3,32,9,18,13,1,15,12,19,28,18,28,1,9,26,18,25,12,29,14,22,8,123,13,10,7,7,49,21,19,34,17,4,5,20,58,5,0,15,7,4,1,3,0,3,12,19,3,1,23,2,15,15,15,18,16,5,1,76,31,5,10,12,11,8,18,12,2,4,6,2,5,10,8,0,12,9,0,2,2,32,8,2,9,4,11,0,15,1,15,8,18,7,3,27,0,31,23,6,4,8,5,10,5,29,12,37,1,6,7,4,2,5,19,9,23,29,10,5,2,3,49,1,3,69,3,8,4,39,6,39,5,20,4,24,11,51,46,5,12,18,1,10,60,29,10,2,36,3,19,11,19,4,18,3,6,8,9,48,40,16,8,4,0,0,0,187,37,22,0,5,19,74,18,6,40,4,5,22,28,35,12,19,7,31,4,7,8,8,0,2,30,6,9,15,4,18,19,9,16,22,16,8,11,3,8,6,8,4,4,2,36,29,34,2,14,5,407,37,5,6,0,8,27,34,19,9,48,3,21,94,107,55,28,25,40,19,15,19,2,71,11,77,3,2,14,5,6,21,32,18,21,21,7,12,17,1,13,51,24,24,17,14,15,16,21,11,33,44,12,13,7,6,11,23,12,0,8,2,31,4,29,12,18,18,9,41,2,9,6,10,6,3,8,4,1,1,12,3,38,1,10,19,9,3,4,72,8,16,14,5,6,17,3,9,10,12,5,11,4,0,12,2,5,4,22,6,2,1,24,11,4,22,3,12,4,1,56,15,1,1,8,3,14,4,1,32,19,17,11,14,1,11,9,1,35,4,20,23,6,28,6,4,12,6,12,8,6,22,8,9,11,11,1,3,10,24,7,8,20,33,18,3,15,5,34,15,7,16,14,21,5,7,11,3,11,4,13,8,11,1,4,11,9,5,26,4,8,34,7,1,9,8,10,6,56,9,15,53,21,11,4,3,7,7,2,3,5,33,4,1,1,2,8,1,7,14,12,1,20,7,3,6,3,24,47,27,26,14,19,7,36,26,21,25,9,4,3,13,47,0,5,17,23,1,3,6,7,10,19,6,10,0,22,16,18,16,26,1,21,13,8,15,13,0,29,9,3,22,39,4,22,12,4,7,81,18,0,10,16,15,25,3,0,2,3,10,8,2,6,0,2,0,10,8,3,6,10,0,5,2,2,5,10,2,5,23,18,4,7,6,1,3,33,3,0,2,10,7,3,3,12,15,15,6,5,8,4,2,8,10,0,14,0,12,18,74,4,5,6,5,5,0,1,1,21,1,9
defense,2,15,2,161,17,21,1,29,5,6,17,5,24,103,4,8,15,12,10,13,5,51,32,32,15,22,35,31,15,40,32,190,140,25,67,124,90,4,13,23,14,45,4,16,36,12,30,19,206,103,49,23,15,107,6,5,27,36,18,35,17,15,4,16,31,13,82,12,4,12,14,29,12,5,189,9,27,4,99,34,68,7,14,16,133,15,19,40,29,2,15,8,20,45,30,10,16,1,52,6,35,32,25,23,24,41,18,35,17,10,33,6,26,26,11,36,5,3,68,131,33,39,28,149,12,7,4,5,6,12,35,6,6,66,58,94,5,6,12,16,9,32,25,1,4,96,6,19,14,16,64,3,9,34,8,36,42,19,14,42,19,6,14,9,42,20,4,29,22,16,38,110,22,9,18,9,93,6,14,108,25,13,57,25,6,22,28,23,22,44,7,9,5,6,14,10,37,13,17,10,4,8,0,5,56,31,8,38,15,44,75,24,23,15,12,24,12,59,18,3,7,17,4,25,62,68,18,35,9,23,24,11,34,16,48,16,30,4,26,13,81,30,8,8,11,6,7,53,59,14,14,10,19,8,7,17,6,8,0,19,1,86,18,2,4,43,10,50,27,2,106,7,20,9,8,10,48,27,10,2,64,5,2,13,12,6,12,9,15,5,3,10,8,21,13,8,20,5,6,16,27,44,5,5,13,8,29,0,3,8,8,36,68,35,36,11,14,21,7,12,38,8,35,11,72,6,6,43,5,34,13,9,7,4,13,10,22,8,3,9,8,27,28,13,8,8,32,56,26,16,11,12,3,44,16,6,7,6,9,41,7,20,20,14,3,12,42,10,19,47,13,71,3,30,8,45,9,2,10,6,71,4,37,5,24,24,5,17,18,5,16,15,6,9,26,10,35,2,28,3,26,19,6,11,6,3,3,5,15,23,1,4,1,12,10,27,15,7,6,34,1,30,5,11,5,1,5,9,13,12,3,1,0,13,10,8,21,15,1,7,18,30,9,37,10,6,44,20,28,10,81,5,21,15,31,3,12,8,6,14,12,33,35,36,5,10,34,8,8,1,27,9,4,1,8,10,7,4,27,6,8,17,7,14,10,10,11,11,2,9,171,29,10,7,13,11,19,14,17,4,12,5,4,6,4,7,3,8,6,3,9,1,7,1,11,12,5,4,3,18,4,10,3,20,5,7,18,3,11,43,13,8,21,2,10,14,12,9,26,8,7,3,8,5,3,9,4,21,10,5,24,3,5,44,20,1,27,4,6,6,21,2,11,14,9,25,6,3,30,22,13,10,22,1,4,0,3,3,7,36,9,19,8,24,7,2,8,6,3,19,15,32,24,7,7,1,2,11,28,10,27,13,4,1,8,12,9,9,2,10,36,19,9,9,23,13,18,0,7,4,18,0,7,12,5,5,8,12,6,14,4,14,21,21,14,1,2,13,7,13,13,6,7,19,3,54,9,5,4,112,21,5,8,0,6,13,20,17,8,9,11,6,8,4,2,0,0,4,9,8,21,6,31,15,24,8,5,14,5,8,6,18,12,5,8,9,14,15,8,51,4,22,11,19,5,27,14,1,16,10,3,8,7,3,6,16,10,26,0,2,3,2,3,32,15,69,25,10,7,18,13,7,6,30,11,17,7,1,2,15,11,17,1,6,2,6,74,3,32,10,10,8,7,20,24,2,12,30,9,9,24,2,2,2,8,15,7,23,2,1,1,3,1,10,21,9,16,6,4,4,15,8,2,15,16,9,1,6,12,10,3,1,13,2,7,15,4,46,9,12,3,9,1,6,2,17,3,7,6,3,3,7,14,7,12,8,7,3,12,4,2,1,19,7,3,4,3,14,0,8,4,3,0,8,10,2,14,9,4,2,9,7,5,33,14,5,7,12,16,5,4,8,0,2,7,7,3,12,5,16,25,19,3,5,3,4,1,5,1,11,2,2,4,10,7,7,9,2,12,12,2,2,0,0,2,4,3,3,11,2,2,4,3,1,7,0,5,4,7,11,11,14,1,0,9,4,27,6,13,21,5,2,32,8,2,0,1,1,4,17,5,8,1,13,5,3,8,8,9,2,2,7,4,2,0,7,3,3,2,0,5,4,3,5,2,0,8,5,3,8,6,10,7,6,4,6,8,13,6,3,8,5,9,16,10,1,4,17,18,5,1,11,2,2,4,23,5,5,0,11,21,5,20,10,6,2,9,8,8,7,4,4,0,0,8,2,5,22,17,8,3,7,5,15,3,2,3,10,3,18
process,2,6,3,67,3,6,7,12,2,2,0,2,19,54,3,5,7,7,8,3,5,15,9,11,19,10,11,9,3,14,7,96,53,6,26,39,34,4,11,2,5,9,1,3,21,9,17,10,125,11,27,7,4,24,9,4,28,15,5,8,6,5,1,6,10,2,42,2,3,6,4,2,0,3,60,6,18,1,43,16,23,3,8,6,84,12,13,4,10,3,7,4,8,15,24,12,7,3,39,12,15,25,13,5,6,14,7,7,7,6,17,5,3,10,7,12,2,2,31,83,18,6,7,41,6,0,0,3,1,1,6,4,8,29,16,39,9,3,4,5,2,15,22,3,1,35,3,10,5,4,34,2,12,6,3,24,16,5,3,13,9,2,9,4,5,9,8,18,19,4,8,51,13,5,2,4,70,3,10,33,11,4,10,15,6,15,17,30,17,22,2,1,3,5,0,2,8,6,8,8,14,4,2,6,6,8,2,23,6,21,38,6,13,6,6,3,2,21,7,5,6,12,8,12,18,54,16,15,8,5,9,16,10,10,24,10,15,4,10,5,34,15,2,4,17,6,6,8,24,1,5,17,12,2,2,8,6,2,2,19,2,16,9,3,8,13,3,10,6,5,54,4,11,3,1,3,14,9,1,1,28,10,6,2,3,2,0,4,5,3,3,3,16,6,3,2,15,6,0,10,10,13,4,5,9,4,7,3,2,0,7,12,12,7,18,4,10,26,8,9,10,5,23,10,43,3,14,17,0,14,8,5,5,6,3,16,8,3,4,11,2,3,9,4,5,1,15,29,15,2,8,4,3,33,11,3,4,6,10,23,9,10,10,11,1,2,19,11,12,6,2,14,1,4,8,16,6,2,5,4,31,3,23,11,3,22,4,6,12,0,8,2,6,5,8,0,20,2,29,1,7,1,1,3,3,3,1,1,19,8,1,4,0,9,4,2,3,3,3,0,4,1,16,4,1,2,1,6,2,10,3,1,0,8,6,1,2,12,7,1,8,9,5,5,4,9,4,5,15,2,11,2,4,2,18,1,0,3,11,19,7,11,14,27,9,6,12,9,4,0,12,6,1,3,4,6,1,6,14,8,5,6,3,3,3,7,2,4,0,5,36,19,1,4,2,4,4,9,2,9,5,2,5,1,4,16,5,5,5,4,4,2,3,5,5,7,5,10,1,4,2,10,4,13,3,1,17,3,9,20,12,4,3,7,12,5,7,4,20,12,1,0,3,5,7,5,3,5,9,4,20,7,7,24,5,1,7,2,2,13,13,1,7,4,4,7,6,4,14,22,6,7,9,3,2,1,1,8,5,21,2,9,4,12,2,3,5,7,5,3,12,18,5,0,24,5,2,7,15,7,9,6,2,4,3,12,4,17,3,3,21,8,4,2,8,7,5,3,5,2,3,2,3,16,0,4,6,1,7,26,2,11,15,10,6,1,8,8,2,8,5,2,7,7,2,10,2,0,3,63,16,7,0,8,2,6,10,9,1,6,0,5,1,6,6,5,2,3,3,7,12,10,2,51,7,6,3,9,0,3,3,14,2,1,3,7,5,2,5,5,2,9,6,4,6,21,3,1,9,2,2,0,1,6,6,2,8,6,0,1,7,5,2,6,9,19,3,4,4,3,7,4,2,21,3,16,3,4,3,13,1,4,9,6,1,2,12,1,17,8,9,8,2,3,1,0,7,11,3,2,6,2,2,4,4,6,4,4,0,9,9,9,1,4,12,11,4,1,4,6,5,1,5,7,0,3,4,7,10,1,5,2,1,0,3,5,5,1,4,4,1,9,1,1,11,7,8,3,2,1,3,7,1,1,4,3,1,4,16,5,3,2,6,6,0,1,4,7,2,6,0,1,0,11,1,0,4,0,6,1,2,2,1,2,4,4,2,17,2,2,1,4,6,9,2,8,2,3,3,5,11,11,6,2,5,3,4,3,5,0,2,3,2,5,5,1,3,2,3,5,0,6,10,4,4,0,1,8,7,3,2,4,1,0,7,2,6,1,0,6,2,4,0,3,6,1,0,3,2,2,4,2,3,3,10,2,0,1,2,10,10,6,5,3,6,2,2,0,5,1,4,5,3,7,2,8,3,6,4,2,3,2,7,2,2,2,3,2,3,6,5,6,5,5,9,8,5,8,5,3,4,2,6,1,0,1,2,2,8,2,11,0,2,4,2,7,1,1,2,2,3,5,3,2,4,1,2,3,3,4,1,3,1,5,0,3,0,9,5,0,5,1,3,3,1,1,3,5,1,6
engage,6,22,8,183,13,14,11,30,6,9,29,14,9,114,4,16,13,19,11,2,8,40,15,44,36,12,19,15,10,40,24,256,185,16,73,67,90,8,14,9,18,11,18,7,60,28,19,17,400,49,55,12,18,68,12,14,78,48,11,26,16,28,6,22,32,7,81,7,12,21,11,12,8,9,108,14,28,6,96,28,57,5,17,8,318,18,22,2,46,8,23,14,1,54,59,20,18,10,51,24,8,52,50,17,11,45,13,5,27,5,38,8,10,16,9,42,5,3,103,164,52,45,18,85,5,5,9,4,6,3,18,6,7,83,33,98,12,4,6,10,6,43,46,9,2,107,9,9,28,14,77,2,23,4,2,48,57,8,19,19,20,4,14,4,11,19,9,39,41,10,23,147,26,5,12,16,227,5,9,65,41,10,6,42,8,28,48,22,44,82,1,14,14,3,6,10,16,13,6,16,60,3,5,14,39,17,4,32,16,38,97,14,23,8,6,3,2,5,17,11,3,24,5,20,59,192,29,33,15,11,20,19,15,47,42,24,52,16,15,15,86,47,13,11,34,12,4,43,72,13,15,32,30,4,10,10,11,0,5,47,27,46,35,6,4,56,5,18,23,12,179,7,41,13,4,2,37,9,11,6,87,15,5,27,16,2,9,18,26,2,9,7,16,6,2,17,61,10,9,46,44,33,5,2,14,3,29,10,13,2,3,50,30,13,28,34,28,54,37,5,109,10,39,9,99,13,11,42,3,35,8,16,22,10,4,29,29,14,6,21,10,17,23,13,4,14,57,70,28,19,28,15,11,37,35,18,5,9,23,37,29,10,10,32,16,4,41,11,13,32,9,39,4,25,12,50,6,10,28,12,75,6,51,19,18,34,10,25,34,10,34,7,18,18,27,10,89,10,50,13,33,10,1,7,8,18,16,3,55,16,8,11,7,20,8,37,9,11,9,16,7,9,24,23,3,4,3,22,15,17,2,7,9,15,12,7,6,19,18,8,1,62,13,30,1,5,23,8,43,11,27,9,11,2,78,9,8,11,18,48,18,27,46,54,12,3,27,17,17,2,35,7,6,3,3,24,9,18,25,7,11,13,7,8,16,10,13,16,8,9,142,42,1,9,15,5,4,22,9,11,14,7,10,9,32,21,9,16,11,4,6,7,13,22,16,15,6,9,27,18,5,27,19,46,14,10,40,45,32,31,14,10,10,10,20,16,17,10,68,35,10,0,12,14,11,15,11,26,29,11,41,19,17,57,11,15,67,11,15,18,27,9,46,6,22,23,17,10,56,55,17,10,10,21,14,13,18,14,5,26,16,24,24,30,13,5,12,12,8,15,26,45,19,10,44,13,4,6,79,22,39,4,14,5,8,23,4,24,19,7,33,49,14,16,50,15,31,20,18,9,15,2,3,25,4,9,9,15,9,25,7,50,41,26,18,10,22,7,6,42,28,3,8,20,15,34,15,4,17,255,34,12,8,8,4,24,42,32,4,30,8,8,26,42,15,7,0,13,8,13,28,13,46,36,47,14,5,14,12,5,17,50,18,13,10,9,16,6,11,39,15,18,18,22,11,34,8,24,22,20,12,3,6,13,9,11,22,10,7,4,3,16,8,24,30,30,25,10,12,7,14,9,12,40,15,24,10,4,3,9,5,30,4,9,4,3,29,12,35,13,18,9,6,17,32,8,21,8,7,23,17,3,8,27,6,20,16,28,10,11,9,22,1,6,33,15,12,16,26,19,8,10,5,33,8,17,5,3,30,15,13,9,11,4,11,10,4,9,8,21,11,27,13,3,59,25,20,16,5,4,5,7,10,11,10,5,4,10,22,11,8,9,18,18,13,8,11,21,7,13,10,10,5,17,10,4,8,12,8,4,23,8,11,8,13,4,9,34,12,13,14,6,3,6,15,9,8,18,3,22,31,36,19,15,9,6,8,14,18,3,6,11,9,6,15,11,9,5,8,24,9,8,5,2,4,12,9,14,12,6,2,9,4,4,14,3,9,8,8,4,11,17,2,12,14,12,13,2,12,10,13,8,18,5,7,3,15,10,2,29,7,8,10,13,14,2,4,11,3,2,15,14,7,19,6,13,9,22,7,2,4,4,13,15,5,1,8,2,11,16,4,17,7,1,8,18,11,15,25,8,17,7,6,9,0,7,9,11,16,5,3,4,6,19,1,56,12,0,5,14,14,6,6,10,5,4,5,6,14,12,15,8,8,0,9,13,23,10,12,4,8,6,8,4,3,4,4,9,2,10
protection,6,22,11,224,19,4,12,46,5,2,39,16,13,119,35,26,12,27,6,9,5,72,13,22,29,18,23,20,5,10,22,325,244,10,90,108,96,16,12,7,29,15,13,6,52,38,36,31,604,38,64,8,27,53,19,16,204,59,6,35,41,21,4,30,30,9,174,21,16,21,23,21,12,12,145,30,30,15,138,20,120,6,26,17,488,32,28,0,49,2,7,14,4,44,98,42,28,12,72,44,36,40,57,22,19,58,6,1,19,5,28,12,11,34,7,48,7,3,122,276,75,47,37,59,5,6,7,4,9,9,28,3,13,114,47,57,28,19,13,12,5,52,31,9,4,120,11,23,31,26,148,1,25,18,12,59,56,14,13,23,25,1,11,5,2,9,4,40,40,17,36,142,36,2,2,20,301,5,22,86,36,28,17,24,14,31,75,34,58,68,10,9,7,2,2,8,27,17,16,27,30,6,11,19,65,20,10,74,22,55,157,5,48,44,1,3,0,0,13,8,3,30,10,32,108,254,38,38,5,7,41,32,20,31,64,126,48,22,14,10,148,84,15,11,42,15,10,34,81,7,23,46,21,20,20,13,17,0,7,34,18,44,43,3,14,54,10,17,19,14,307,10,47,38,16,1,85,15,22,3,111,14,6,40,20,8,21,38,32,3,2,12,22,6,4,20,78,11,14,50,46,92,0,2,16,2,41,4,12,2,12,24,29,12,36,28,52,68,29,20,166,16,47,6,155,20,15,43,4,46,9,18,21,14,14,41,34,15,9,15,12,16,29,25,14,27,89,83,31,9,26,21,13,62,55,5,4,11,28,28,51,33,22,53,11,2,51,10,12,14,8,50,11,14,16,47,17,9,27,18,140,15,98,27,8,62,14,49,59,10,37,16,11,14,55,25,107,6,55,15,48,11,7,3,7,12,13,6,48,27,5,19,11,37,14,16,3,20,5,2,15,16,31,24,2,13,12,19,17,36,10,6,3,16,7,12,3,28,30,9,62,1,17,31,8,10,22,12,73,13,57,11,4,13,100,21,3,9,13,52,18,42,79,39,14,15,41,21,47,2,49,4,10,5,4,22,12,28,27,12,21,15,14,10,22,19,14,5,13,16,114,62,4,9,33,18,8,35,19,15,10,6,4,17,23,12,6,34,9,6,21,8,12,19,28,24,9,28,13,12,8,104,20,44,18,15,52,13,35,54,16,9,17,23,23,11,26,8,89,22,16,5,3,12,12,4,6,82,27,8,58,13,12,118,9,15,119,15,9,16,45,9,55,8,33,45,29,20,99,86,37,21,36,13,19,9,41,16,6,36,23,47,38,26,11,12,9,18,9,15,51,54,18,10,69,8,26,15,120,37,55,5,12,9,17,56,7,40,12,21,51,31,23,24,88,26,58,10,18,16,23,1,12,27,15,11,16,27,15,58,15,60,56,35,14,11,15,13,10,43,36,8,13,42,16,56,18,7,14,384,70,11,7,13,17,25,82,22,7,37,19,19,38,37,18,9,4,16,20,21,44,17,93,53,58,13,6,23,22,13,16,54,27,22,23,14,24,17,14,57,23,15,44,61,20,19,11,16,52,20,18,7,11,17,16,6,18,23,10,7,15,14,18,63,38,33,19,14,9,10,20,9,19,62,4,35,19,4,10,27,25,30,5,8,11,8,58,15,102,18,20,21,9,20,42,10,26,33,15,44,41,4,2,8,14,21,15,36,18,30,33,19,4,17,76,32,14,17,21,20,16,7,12,52,22,32,8,4,44,18,28,13,28,1,16,13,17,6,15,35,16,15,6,17,29,48,8,19,6,11,8,10,18,13,8,8,10,12,40,15,24,9,17,13,15,15,10,9,16,22,13,6,23,22,8,16,4,9,14,14,14,27,14,12,13,19,18,55,22,15,15,9,9,6,14,22,21,9,7,30,32,45,30,37,5,8,9,17,12,2,19,15,21,5,18,20,8,2,18,27,9,9,5,8,7,8,13,20,14,10,4,12,10,7,13,5,12,12,26,6,18,20,2,8,23,13,34,6,7,3,15,15,3,20,18,7,30,15,8,37,12,10,15,17,13,5,5,42,4,6,18,23,17,48,7,21,5,45,12,8,15,4,10,21,11,3,12,15,12,34,6,40,5,3,5,14,3,11,38,11,2,12,6,15,7,3,8,23,37,8,8,13,8,3,4,53,19,10,15,37,14,9,8,9,9,21,1,20,21,23,3,13,15,6,13,27,31,6,14,2,12,12,7,1,1,2,11,11,3,10
undertake,6,10,5,93,4,4,5,18,4,4,29,7,16,55,2,3,4,21,4,1,2,18,6,17,17,4,16,7,1,6,10,121,70,5,39,48,35,5,11,6,15,8,6,3,19,14,17,20,181,24,46,7,13,28,3,1,44,19,0,9,10,8,0,11,13,13,63,5,4,14,16,5,5,2,75,15,25,7,42,13,32,0,11,11,193,16,15,0,17,0,6,3,2,13,37,24,7,3,25,12,35,27,18,7,10,17,6,2,8,1,14,4,10,17,1,17,1,9,51,137,24,12,10,40,4,3,4,2,3,2,13,6,2,28,13,84,3,1,3,4,3,18,15,2,1,54,2,6,9,7,42,1,7,6,1,22,13,5,8,11,14,5,9,2,5,5,1,17,14,3,16,52,30,3,1,9,133,1,2,37,29,6,5,19,17,23,33,18,21,35,2,4,3,0,4,3,19,4,3,10,27,1,3,8,13,10,5,15,7,28,50,4,19,6,3,2,0,2,8,19,2,5,8,13,36,43,20,6,9,7,12,9,12,22,30,19,30,8,14,9,35,26,2,1,21,11,6,18,37,3,6,9,16,2,8,9,4,7,3,10,6,18,15,3,10,29,11,2,9,4,83,11,8,6,5,0,19,18,8,8,33,9,3,18,6,3,1,10,13,4,6,6,12,7,6,2,24,2,6,12,7,19,2,1,8,1,10,4,5,2,3,18,25,4,20,6,21,35,10,8,37,3,16,6,30,5,3,18,2,15,3,9,9,7,5,19,8,6,6,8,6,8,6,28,3,8,27,32,19,4,6,9,2,24,16,13,0,4,13,14,24,10,18,25,9,0,30,7,15,8,4,11,3,5,8,20,6,3,14,7,62,2,36,12,1,21,1,14,13,9,4,6,10,12,16,4,33,5,24,5,13,1,2,1,6,5,7,0,18,11,4,17,8,15,11,3,3,5,7,4,1,11,21,17,2,3,3,7,12,17,8,2,1,5,3,4,4,18,9,5,13,17,1,8,0,4,11,7,25,6,11,2,1,2,36,6,0,4,12,17,10,11,13,22,6,8,5,13,19,1,7,1,7,2,5,10,2,6,26,5,3,14,5,4,13,9,7,3,8,1,52,24,0,1,5,1,6,7,2,5,6,4,1,2,6,4,8,6,7,3,3,7,12,2,9,15,1,7,7,7,6,8,4,12,8,3,12,13,10,27,16,1,3,7,10,1,5,8,33,19,5,6,1,6,4,3,1,17,5,9,15,3,3,27,7,6,14,5,7,7,7,4,15,1,10,11,13,9,27,23,5,8,6,1,6,0,28,10,4,11,2,18,10,10,3,11,9,6,1,8,22,17,4,5,11,3,2,5,27,18,17,7,0,6,8,19,8,33,9,4,25,21,12,3,28,8,4,1,6,5,13,1,6,7,11,5,7,10,6,16,9,11,13,14,6,6,11,10,4,7,6,0,8,9,3,17,12,2,6,105,19,14,3,1,2,6,23,6,3,15,0,4,10,11,2,6,11,11,4,9,6,3,32,17,21,2,2,5,7,2,13,21,12,14,6,10,14,8,6,11,17,14,11,12,8,9,6,4,17,10,8,9,4,2,5,8,9,8,3,2,1,8,2,18,13,12,4,5,7,7,6,4,2,9,2,7,3,1,0,6,3,13,3,13,4,2,20,4,22,4,6,11,12,6,2,8,11,20,6,5,7,5,3,3,4,6,5,8,6,6,6,9,1,2,10,4,2,6,11,8,5,2,3,7,3,14,5,3,12,5,0,2,6,1,8,5,3,21,3,10,4,7,2,4,16,25,10,4,3,3,1,5,3,5,4,22,3,4,9,5,5,8,7,3,3,4,3,12,5,8,1,0,6,19,10,3,3,10,0,4,2,0,7,3,3,5,3,11,4,5,5,7,1,7,6,6,7,9,4,14,5,19,10,5,7,3,2,3,2,2,9,1,6,6,4,4,3,6,4,6,9,4,8,2,4,3,4,1,6,3,3,4,2,1,6,1,4,4,2,3,8,15,1,5,3,3,4,4,2,3,6,2,0,5,4,1,5,2,13,16,5,11,4,9,6,3,3,6,3,9,8,6,3,4,3,6,3,4,4,2,2,4,4,3,2,0,3,2,9,8,1,6,5,2,2,7,14,10,10,1,2,1,0,4,4,1,1,9,11,1,6,6,1,1,4,11,6,1,1,5,2,2,4,8,2,1,4,3,8,4,5,8,2,0,7,12,10,3,16,0,3,14,3,4,5,0,0,1,2,0
europe,5,10,2,79,11,19,8,63,7,8,34,9,12,173,4,21,12,14,8,17,4,46,32,25,15,21,37,33,12,21,18,173,208,15,59,171,107,11,17,11,17,40,9,7,38,29,38,10,397,118,71,14,31,128,3,10,51,27,8,44,43,22,9,27,47,22,124,2,18,25,19,4,4,5,115,40,37,13,118,53,93,1,33,9,222,19,30,2,34,3,21,21,4,41,77,12,20,14,80,38,3,39,43,12,27,22,4,8,34,14,34,10,10,24,21,45,5,5,45,219,47,44,6,88,26,3,10,5,7,3,33,13,11,69,48,55,9,2,7,25,12,53,42,3,11,81,12,29,38,5,119,1,23,14,7,10,50,12,38,48,11,5,13,5,5,7,5,31,47,9,48,148,34,7,26,12,178,6,13,31,23,23,11,25,3,39,48,36,44,75,6,12,29,6,0,7,19,15,19,11,29,0,3,8,66,10,5,36,23,46,81,21,30,11,7,4,0,2,7,5,31,21,9,18,39,49,27,51,10,23,14,19,22,31,59,15,39,5,21,6,93,51,17,8,30,10,9,23,30,11,14,37,35,12,26,16,7,1,6,12,5,62,26,6,6,21,2,23,28,7,139,5,29,6,1,8,26,4,10,2,84,3,11,43,19,14,2,5,24,6,5,11,5,16,4,14,50,5,3,26,41,20,3,4,12,3,30,5,4,4,8,11,35,18,69,13,34,57,27,7,43,16,34,6,81,3,17,56,2,38,3,12,16,4,16,6,30,15,5,32,14,25,21,15,19,7,55,77,30,10,7,6,11,28,17,9,5,7,10,38,16,5,17,29,10,3,68,10,5,24,6,35,17,20,5,6,4,9,21,8,73,4,35,26,4,25,1,22,22,4,11,15,7,16,43,22,55,1,30,10,40,13,5,7,8,9,13,11,82,20,3,24,43,16,15,30,10,11,5,29,11,15,25,20,7,8,14,8,23,23,14,3,1,11,13,14,34,28,37,5,30,31,8,1,50,36,38,15,48,15,48,16,25,9,130,19,4,14,11,33,16,33,53,30,7,1,25,23,3,1,19,7,14,9,4,11,17,8,20,1,4,20,45,9,18,8,30,9,11,3,176,51,4,16,36,10,4,11,13,11,28,9,9,1,7,38,13,22,6,7,7,3,9,3,14,9,9,13,1,20,12,9,5,28,7,0,39,0,33,43,12,3,7,8,8,15,8,13,68,10,4,11,10,20,37,7,21,25,7,8,10,5,0,38,8,6,75,1,6,8,32,4,12,4,19,11,16,7,45,39,8,17,5,1,4,19,17,2,16,50,17,17,20,25,17,15,5,9,11,13,54,40,8,6,22,3,12,6,65,34,35,7,14,11,8,25,6,17,3,3,28,10,10,23,26,10,13,11,4,1,8,16,6,18,1,9,12,9,6,39,50,17,25,18,7,5,5,14,8,11,8,3,5,25,16,24,8,6,3,281,35,6,11,2,4,22,41,44,5,24,6,29,22,64,22,6,2,14,17,19,16,6,46,7,27,7,1,9,2,7,5,34,9,7,12,0,7,4,15,30,15,23,21,38,14,6,10,15,13,12,18,5,4,8,3,16,29,20,6,3,7,9,3,40,11,16,10,14,20,4,5,0,9,8,4,20,17,2,0,21,6,20,12,8,2,3,14,7,38,33,11,11,8,22,21,6,12,10,13,11,9,0,6,13,3,7,11,21,7,26,27,20,3,7,32,19,9,12,13,4,14,12,4,12,2,21,23,1,1,14,1,6,19,7,14,15,11,33,32,17,16,0,2,6,8,14,3,10,3,0,18,14,14,9,10,2,11,6,24,16,28,17,25,7,19,7,10,11,5,27,9,3,17,12,4,4,6,6,9,4,9,8,16,5,9,10,16,33,21,4,5,6,1,6,13,13,13,13,2,11,41,11,8,7,5,7,10,8,1,2,9,6,10,15,18,11,9,0,8,3,2,2,12,14,14,13,6,64,13,43,0,5,2,2,8,4,9,2,8,9,12,12,4,8,12,5,7,5,4,10,7,6,11,15,0,5,6,13,5,26,4,13,7,14,20,5,16,25,9,5,9,18,5,26,32,3,36,23,11,9,8,4,7,14,1,1,6,1,5,6,6,15,1,2,12,19,16,21,13,8,2,7,8,3,3,1,29,33,15,9,6,7,3,11,7,20,0,0,1,20,19,5,14,15,5,21,2,13,14,4,5,3,8,38,3,5,15,20,29,2,3,6,6,16,0,2,11,5,7,15
asia,4,8,3,12,4,11,6,14,2,2,9,1,3,34,1,4,1,1,2,10,2,8,5,5,5,10,18,4,3,8,5,39,46,6,16,47,26,2,3,6,1,23,4,3,9,3,2,4,63,64,8,9,7,51,2,3,4,4,3,6,11,6,1,1,11,5,54,1,2,6,8,0,3,0,36,2,7,6,22,10,19,0,3,6,33,0,7,0,9,1,1,1,1,4,14,2,3,2,29,3,1,9,10,1,8,8,0,8,2,5,9,3,9,8,5,7,2,1,19,40,11,15,1,35,12,1,3,0,1,2,10,2,2,21,5,12,2,3,3,9,4,14,10,1,7,30,4,10,4,1,14,0,7,5,1,4,19,2,11,26,2,1,3,5,3,0,1,12,12,2,13,26,13,1,3,3,25,1,3,12,9,8,9,6,0,7,14,4,7,13,5,2,5,1,2,2,2,3,6,7,3,0,3,0,9,1,1,3,1,8,23,7,10,1,1,4,1,0,3,1,0,6,0,6,6,7,14,8,4,0,8,4,6,2,6,0,2,0,6,0,11,9,6,6,8,1,1,4,11,2,4,4,13,3,2,1,0,1,0,1,0,13,1,0,3,4,0,9,5,4,19,1,4,1,1,1,10,1,2,0,17,0,3,7,1,10,1,6,2,2,2,3,0,1,3,4,6,4,3,8,10,6,1,7,0,0,6,1,0,2,3,1,13,9,7,5,3,0,3,2,9,3,16,2,3,0,4,18,3,10,1,1,2,0,3,0,7,5,0,2,0,2,13,1,4,7,8,14,3,3,1,2,1,7,5,3,4,2,2,3,1,5,16,12,5,0,2,1,0,5,3,16,3,7,2,8,5,5,5,2,13,1,9,3,1,4,1,9,7,2,2,1,1,4,9,6,4,0,5,1,4,10,0,1,3,2,3,4,31,9,0,27,4,5,1,5,3,1,2,12,3,1,9,8,2,0,10,0,6,6,1,0,0,1,5,1,9,1,10,4,1,8,0,50,1,22,12,9,5,9,25,2,4,0,18,6,0,0,4,5,3,6,12,11,5,17,4,11,5,1,6,4,1,5,0,5,3,1,4,0,2,6,5,1,8,4,1,1,6,2,13,7,1,3,2,3,1,2,1,0,4,1,1,0,0,0,0,2,0,0,1,2,3,3,0,1,4,5,0,3,1,2,0,3,1,3,10,0,6,3,1,0,2,4,0,0,0,4,12,0,5,2,0,1,6,1,3,3,3,0,5,0,2,3,5,0,14,0,2,3,2,1,2,0,3,1,8,1,5,7,4,0,0,1,1,2,1,0,1,15,2,7,3,7,1,2,2,1,2,2,0,5,2,4,3,0,1,1,9,4,3,0,2,1,2,2,2,2,1,0,4,1,0,3,2,2,4,0,0,0,3,0,1,1,2,8,0,1,2,14,0,4,4,1,0,2,5,4,0,0,0,1,0,1,0,4,1,2,0,46,4,2,1,1,2,2,6,1,0,6,2,12,2,0,2,0,0,0,3,1,2,2,1,0,1,2,0,0,3,3,1,6,1,6,3,0,2,2,3,6,0,6,2,48,4,1,1,0,2,0,30,0,0,4,2,4,3,1,0,0,4,1,1,2,1,1,3,0,2,0,5,1,0,1,2,4,1,0,0,7,0,1,1,2,0,0,5,1,5,5,2,5,2,3,6,3,0,3,3,2,2,0,0,1,0,4,0,1,1,4,4,11,0,2,5,5,2,0,3,4,10,17,2,1,0,5,0,1,1,3,0,0,1,0,4,4,1,0,4,2,2,0,0,0,4,2,1,1,0,0,4,2,4,0,1,0,7,0,3,0,3,5,1,2,3,1,1,2,1,1,0,1,0,0,0,0,2,4,1,2,2,1,2,4,2,1,2,3,0,0,0,0,0,1,0,3,4,10,1,1,2,3,3,0,1,1,1,1,2,2,0,1,1,7,1,0,12,0,3,2,2,0,0,0,0,2,0,2,3,28,0,4,3,0,1,1,1,0,2,0,7,5,0,1,1,1,0,0,1,7,0,0,2,3,1,1,1,0,1,3,0,1,1,0,1,1,3,4,2,2,1,1,1,1,1,0,3,2,2,0,0,0,0,2,4,0,2,0,0,1,0,0,2,0,0,0,0,2,0,0,0,1,0,0,3,0,8,7,2,0,0,2,0,0,1,4,0,1,3,7,4,0,3,2,1,6,4,1,1,2,5,0,1,1,0,0,2,9,0,0,2,2,3,2,0,0,2,0,2,2
east,3,5,4,19,2,9,1,22,3,0,6,3,13,57,2,8,3,5,7,16,2,25,7,10,9,10,16,11,5,8,12,83,66,6,29,47,70,3,5,3,2,27,3,4,9,3,2,5,144,54,15,11,9,59,15,6,9,6,3,12,5,6,4,8,9,13,65,1,9,19,6,2,1,5,51,19,12,9,14,10,17,0,11,5,60,3,4,0,13,5,14,2,3,18,28,5,12,4,37,3,4,15,13,3,8,12,1,6,7,4,13,5,3,8,1,15,0,3,17,50,54,27,0,36,9,0,4,0,1,3,16,1,6,29,9,31,3,0,10,8,3,26,7,1,5,45,6,8,11,2,16,0,10,5,2,2,17,5,6,30,3,2,3,6,0,9,4,14,11,2,32,56,16,10,2,4,45,1,5,23,7,13,7,10,6,12,14,10,11,21,1,1,6,7,2,5,7,4,5,1,10,0,2,9,13,4,2,17,0,8,31,8,8,1,1,5,0,3,4,1,1,15,0,4,9,19,21,13,4,0,11,11,4,6,9,1,17,3,2,5,21,15,4,15,13,3,2,18,19,0,3,12,18,3,8,4,2,1,1,9,0,15,7,2,0,7,4,3,8,4,34,5,4,3,1,3,8,0,4,0,25,0,4,12,5,18,2,1,4,0,0,0,1,1,0,1,13,6,1,4,12,6,0,1,2,2,17,1,7,2,3,14,13,9,7,2,5,9,7,4,17,4,14,4,21,2,11,23,5,17,4,1,1,1,2,6,13,13,0,3,6,11,4,7,1,10,12,23,8,2,1,4,4,17,10,2,4,1,3,5,6,8,15,1,3,4,12,10,8,15,1,23,2,7,1,5,5,1,5,2,23,2,12,12,4,13,9,8,6,4,2,8,4,9,9,2,11,1,20,1,11,3,1,5,3,1,5,6,22,14,6,41,6,13,6,9,3,9,4,15,4,3,9,5,0,4,5,2,6,5,3,1,0,3,7,2,14,9,6,9,5,10,4,36,22,1,23,11,15,4,21,1,5,5,44,2,1,2,4,8,6,17,17,29,2,5,13,9,4,5,10,10,2,3,1,4,2,2,7,1,5,11,2,0,5,1,4,5,7,3,45,14,3,5,4,5,3,2,3,3,10,0,3,0,1,2,4,5,5,1,1,2,4,1,7,6,1,4,0,3,2,9,2,3,3,1,13,2,9,12,4,0,2,3,5,6,2,5,14,2,2,1,2,8,9,5,2,3,5,4,5,0,0,19,5,5,16,3,4,3,2,3,6,1,4,5,5,2,3,13,9,3,1,2,2,4,5,1,4,21,6,8,6,4,2,1,5,1,3,5,8,8,3,0,2,2,1,0,29,2,6,2,1,1,2,13,1,0,1,2,11,3,6,4,15,4,5,3,3,1,4,0,1,6,0,0,6,1,1,17,0,7,5,9,4,0,6,6,0,3,2,0,0,8,4,12,1,3,0,83,14,7,2,0,6,4,18,2,2,2,3,30,7,9,4,3,0,6,4,4,2,4,18,4,10,2,2,3,2,4,9,17,4,6,6,0,2,4,10,13,7,11,8,22,2,5,1,2,3,3,22,3,0,1,1,8,10,5,0,3,1,2,2,9,3,5,9,3,3,2,1,1,3,11,1,65,1,2,1,4,7,3,0,2,2,3,8,4,24,3,7,7,1,8,6,0,6,11,3,3,10,0,1,4,0,2,4,3,5,4,5,2,0,1,10,4,5,3,0,7,3,23,5,3,2,3,1,0,5,2,4,0,3,0,7,7,4,9,7,7,5,1,1,0,8,8,0,7,2,2,4,29,3,1,4,2,5,1,3,1,5,7,6,1,4,4,1,3,5,6,3,0,5,2,4,3,4,1,1,1,0,3,1,7,6,3,3,16,5,4,1,0,1,3,2,2,1,8,2,8,5,10,3,1,4,0,2,1,1,4,5,5,1,2,0,2,3,1,7,2,0,13,0,3,5,3,8,6,4,11,0,6,2,0,8,3,2,1,5,1,11,18,0,2,2,3,3,5,4,16,3,2,5,3,6,5,0,7,2,6,0,4,0,1,0,3,12,3,7,4,4,4,1,2,7,4,2,5,5,0,1,2,1,3,2,0,3,1,3,4,0,3,0,0,3,3,2,7,0,1,3,2,3,0,3,0,17,12,2,1,3,19,5,3,2,2,1,0,1,6,6,1,5,8,0,4,0,0,8,1,0,2,1,0,2,0,2,4,7,1,2,9,2,5,0,1,1,2,0,15
build,4,19,7,157,18,51,4,31,3,14,13,13,61,165,1,11,30,36,19,14,5,42,69,59,25,42,65,74,31,76,14,252,163,54,98,197,111,13,13,35,26,42,11,20,56,11,24,10,193,222,82,31,38,208,59,8,29,24,63,43,9,20,22,43,36,28,174,13,12,25,36,9,16,6,274,31,72,1,130,54,106,4,11,30,183,31,22,1,43,3,20,17,9,65,45,11,43,9,107,34,44,40,18,41,36,45,3,9,27,10,42,16,50,60,46,45,2,3,52,137,53,132,13,220,17,14,19,8,12,13,79,25,19,64,64,195,7,4,21,24,15,59,18,12,1,144,19,39,20,11,69,16,25,21,14,19,108,26,2,138,32,7,20,12,14,69,14,38,35,9,42,194,47,19,43,5,126,21,18,158,44,15,57,57,10,56,44,29,24,57,4,12,27,23,11,10,35,22,23,12,46,4,9,15,32,37,14,31,17,39,101,69,16,11,20,44,6,17,20,9,8,29,6,13,48,71,38,32,15,9,17,34,28,33,80,6,39,20,25,19,95,43,9,16,26,7,7,107,94,22,6,20,37,3,5,14,1,4,1,35,2,67,7,1,9,26,14,85,46,7,110,7,18,5,6,19,45,14,3,3,134,4,7,12,17,6,31,35,18,8,0,17,16,18,13,5,36,5,13,15,39,24,5,6,6,8,37,1,8,3,7,16,66,41,51,25,27,21,11,8,50,4,56,36,72,3,13,98,11,33,24,15,13,4,11,16,45,7,8,16,6,33,49,10,16,21,23,61,31,32,4,21,0,61,12,15,13,7,10,70,30,32,46,28,8,20,33,13,37,82,14,102,9,65,7,33,6,8,25,6,48,7,53,12,37,55,7,18,20,12,12,29,14,5,10,22,7,0,24,5,15,34,4,21,6,15,15,3,56,30,8,13,14,26,10,39,21,18,15,48,6,17,31,5,8,4,5,9,17,24,5,5,0,19,18,2,19,26,44,4,23,22,11,38,12,23,1,24,45,18,77,2,51,3,78,3,25,7,22,17,31,45,26,86,7,22,79,21,30,16,55,24,3,15,10,38,8,3,43,18,16,23,8,10,14,8,12,26,3,0,152,20,4,14,34,5,14,10,7,7,15,10,5,9,9,18,11,8,7,8,1,6,7,8,12,12,14,8,0,19,6,15,4,22,2,7,31,14,16,26,26,12,14,15,10,9,7,21,50,23,11,5,15,15,27,1,5,13,2,3,6,4,5,49,9,17,44,6,6,14,5,4,12,18,6,11,8,2,26,50,22,6,12,2,8,1,7,4,8,37,17,7,22,45,6,5,6,3,3,25,23,28,25,12,18,4,20,10,19,16,10,2,11,0,5,21,8,6,12,4,24,8,13,6,13,6,7,10,9,3,11,2,6,21,12,3,0,4,11,26,16,17,19,16,9,3,20,18,10,15,20,13,2,10,6,20,8,1,15,122,23,16,4,3,8,28,45,16,4,10,0,13,0,8,1,2,0,6,5,3,4,4,7,2,5,2,2,3,21,7,63,58,5,10,11,3,18,11,5,31,7,54,2,32,1,25,10,2,14,12,8,3,1,7,3,23,8,9,0,5,2,5,2,18,14,26,39,3,9,17,11,5,3,36,19,15,11,4,3,13,8,13,8,8,2,4,111,9,25,8,11,11,40,89,45,5,23,42,10,3,15,4,1,6,9,13,2,6,8,25,20,18,3,7,24,23,22,2,8,7,23,6,15,5,8,10,4,1,3,7,3,2,19,7,8,6,3,2,13,9,6,3,1,1,22,16,13,4,5,0,1,7,9,11,32,11,8,3,12,2,12,4,5,12,18,1,1,20,3,10,3,5,3,10,6,2,21,5,11,1,10,2,10,10,12,11,1,11,8,8,1,2,0,2,4,16,10,13,2,6,1,13,4,3,9,11,6,3,0,10,1,8,2,9,2,0,3,2,17,11,4,7,11,7,9,4,0,3,12,6,1,5,10,1,2,5,6,2,9,9,28,18,10,5,1,5,5,5,16,44,13,1,24,3,1,0,2,4,2,16,4,7,9,6,7,7,7,27,8,6,0,2,9,1,6,1,7,6,1,1,5,8,4,7,4,2,6,3,2,20,12,22,7,0,2,15,10,24,19,1,2,10,9,12,5,3,6,21,13,1,4,15,0,2,6,46,2,2,2,9,14,5,15,33,1,5,27,3,8,2,9,3,0,6,3,5,8,40,4,16,5,14,4,11,13,6,10,0,7,35
threaten,5,8,2,58,11,13,6,24,2,2,20,6,17,81,7,8,12,15,11,18,5,24,27,30,22,10,26,14,14,27,14,122,101,13,34,92,88,2,11,18,3,26,6,10,24,15,15,4,170,71,68,8,14,96,14,7,23,12,18,21,10,10,2,8,13,16,67,10,14,20,13,9,6,6,69,17,24,8,56,29,26,6,15,10,127,9,11,2,22,1,7,7,1,31,30,8,7,3,35,11,5,15,17,14,12,22,5,5,13,6,16,2,8,8,7,20,3,4,37,126,28,39,16,65,15,5,5,0,2,3,24,6,7,31,20,54,8,4,8,12,5,34,29,4,2,64,12,18,4,8,36,3,13,9,5,14,32,7,12,29,7,1,11,1,3,12,4,19,25,6,4,97,22,1,10,10,104,7,13,42,28,15,13,22,6,28,20,14,23,37,0,8,5,4,1,6,5,6,5,5,12,4,6,6,26,9,6,14,11,18,43,21,9,4,11,12,0,9,13,0,4,12,11,11,22,49,16,16,9,5,9,7,12,21,24,5,23,9,8,10,56,21,7,14,17,5,7,27,19,2,8,12,15,2,1,9,12,1,2,9,2,31,13,3,9,8,8,24,24,5,65,8,6,8,3,4,24,2,6,0,63,4,9,9,7,6,10,7,21,0,4,10,2,4,2,10,21,10,8,19,23,7,0,3,9,7,16,0,7,2,8,4,19,10,12,13,10,35,14,5,34,8,29,19,40,5,7,34,4,28,9,3,5,3,7,9,20,5,0,5,10,19,9,9,3,7,44,41,17,13,2,17,2,30,14,2,5,1,3,27,12,3,13,22,5,4,22,8,12,34,4,41,1,24,10,13,3,1,17,6,26,2,19,14,10,29,12,14,15,6,18,9,4,3,11,9,24,2,23,5,14,9,5,9,5,0,9,8,18,9,7,10,2,9,9,18,9,7,5,21,1,8,22,9,4,3,4,10,7,16,1,2,0,8,5,1,11,18,20,5,8,12,7,15,9,11,24,1,28,10,39,1,14,3,36,5,10,4,9,11,15,24,21,25,4,6,30,7,8,5,22,9,2,2,4,8,5,6,19,6,10,17,2,5,4,5,7,12,5,0,99,14,6,7,16,5,4,5,9,11,11,3,1,7,10,6,1,7,2,3,2,3,2,3,6,8,4,8,19,2,2,12,1,10,3,2,38,4,10,17,7,3,14,4,4,8,7,11,35,13,3,0,8,0,4,3,4,12,12,5,9,1,3,33,3,7,18,3,5,5,7,2,7,0,4,10,4,3,20,31,3,4,4,5,4,0,2,5,7,14,1,10,6,13,6,10,4,5,1,7,11,14,12,5,23,6,2,8,28,13,7,2,4,7,6,15,3,27,5,1,22,12,4,7,25,3,7,1,3,2,8,3,6,20,2,1,3,11,7,11,18,12,23,16,7,3,8,1,7,3,7,4,10,14,14,15,2,10,3,113,23,8,10,4,7,9,21,6,7,5,2,8,2,13,2,6,4,11,13,7,12,3,50,7,20,9,2,4,1,2,2,11,13,1,5,6,9,4,3,6,7,22,6,13,4,5,14,4,5,7,9,1,7,6,2,6,9,9,1,4,3,3,5,15,12,20,15,4,9,1,6,4,10,13,3,1,6,2,1,4,6,9,2,2,6,6,9,5,18,6,7,6,0,16,13,3,8,11,5,3,25,0,2,6,2,9,3,9,3,4,6,10,1,2,9,10,14,2,4,8,9,7,2,7,3,16,8,2,3,4,5,6,5,3,5,3,7,38,1,9,7,4,0,4,4,6,10,4,3,3,2,2,2,3,19,5,8,8,11,8,6,5,4,7,2,3,7,12,7,4,2,1,2,8,0,2,7,5,2,3,8,3,5,14,15,11,4,19,6,5,4,7,3,9,4,5,4,6,5,7,10,10,2,1,7,2,8,4,4,1,4,3,2,3,1,4,9,2,12,6,1,1,3,6,2,2,2,1,7,3,2,6,2,2,8,4,3,8,5,4,4,0,0,2,5,2,2,5,1,11,4,4,8,9,5,1,7,3,1,4,0,1,1,4,2,2,1,3,2,2,6,15,1,3,5,7,4,14,7,4,4,3,7,1,2,0,1,1,0,4,2,8,0,0,3,7,7,1,6,4,2,7,0,5,3,1,1,5,11,1,0,2,1,0,2,10,6,1,2,4,18,2,9,9,3,3,5,5,5,3,1,3,1,4,5,3,3,13,9,4,1,6,6,7,3,1,4,4,1,11
condition,15,58,13,360,13,24,16,77,6,15,45,26,31,224,23,51,10,47,10,13,17,126,32,62,70,38,27,28,20,35,29,494,401,16,145,164,125,22,28,21,22,15,18,10,71,60,70,54,819,51,160,16,46,129,65,25,140,150,2,74,53,34,9,44,119,21,275,21,23,54,39,8,12,10,306,37,70,24,244,69,158,4,54,34,598,52,53,0,127,1,27,16,8,90,143,43,49,28,86,69,27,84,93,53,42,79,20,16,25,25,49,8,24,63,8,76,8,6,151,476,164,42,51,204,27,3,13,13,15,2,50,14,35,126,73,184,30,10,12,26,10,134,83,17,14,191,16,59,68,31,184,12,46,22,25,86,96,12,40,50,35,16,21,8,5,20,11,66,96,30,57,260,64,9,24,22,528,16,36,142,94,35,16,53,20,81,107,64,105,137,6,23,17,6,8,10,48,30,22,41,138,9,10,25,89,32,35,92,22,107,217,19,71,26,10,7,7,9,34,12,24,58,19,46,133,282,123,98,14,35,42,40,55,71,112,76,99,28,27,23,192,127,24,17,56,23,15,83,120,21,22,67,49,28,19,34,36,5,15,55,20,60,57,14,19,188,19,14,39,12,336,27,91,22,13,1,59,68,42,5,135,20,8,58,39,8,17,44,45,11,5,3,21,17,7,29,87,11,16,70,87,70,4,4,51,13,87,11,30,4,8,72,92,15,89,74,71,134,63,27,102,19,95,27,214,13,50,59,6,79,14,41,24,17,24,50,43,27,25,54,32,27,42,36,19,17,178,141,49,24,39,19,18,100,81,24,12,20,40,103,81,64,47,82,11,4,121,31,16,39,12,33,9,27,43,102,28,11,40,22,176,11,147,47,36,166,23,95,95,13,80,15,20,28,75,41,125,23,103,20,62,8,14,3,16,28,25,12,64,31,12,22,38,65,46,28,11,26,12,2,19,25,64,36,11,16,16,34,43,48,48,23,15,32,10,16,0,25,28,15,43,73,25,48,5,15,45,28,1,22,50,23,16,21,144,29,2,42,44,96,33,81,117,116,14,20,52,48,42,2,63,17,18,17,10,68,18,39,100,19,23,39,22,24,28,26,46,15,30,8,271,128,12,27,39,24,19,42,22,34,39,18,22,11,46,86,25,46,25,17,11,20,27,24,39,50,10,25,30,29,26,55,20,75,31,15,77,31,49,106,32,27,10,34,28,16,32,31,129,74,11,9,24,38,31,23,15,47,33,27,87,9,18,160,36,24,103,14,16,22,63,10,56,22,27,64,40,24,89,113,32,32,33,19,26,18,44,21,34,27,22,37,51,55,22,27,14,31,13,27,54,95,34,14,230,15,6,28,85,71,57,9,31,15,21,54,27,77,20,16,98,62,26,22,95,36,44,21,25,22,48,52,8,51,15,20,40,48,34,94,65,89,68,69,32,11,46,26,10,29,37,13,28,71,24,135,23,7,24,440,84,16,23,8,16,42,110,84,30,36,12,15,17,57,13,9,1,25,32,23,64,33,139,92,48,31,13,17,18,19,31,82,42,23,28,19,38,17,16,28,42,23,42,36,17,18,36,17,45,43,29,12,17,26,31,27,45,26,10,11,9,22,25,74,55,72,13,22,23,27,23,20,25,53,11,21,24,12,14,40,18,36,13,14,17,15,105,17,134,45,53,21,21,51,42,14,42,29,16,21,26,31,20,46,23,43,34,32,17,38,30,53,8,14,44,50,41,18,39,29,27,20,16,37,10,42,26,15,51,30,36,8,39,21,37,25,25,97,36,37,20,55,19,19,40,63,22,32,16,4,16,23,44,11,13,20,17,16,35,25,37,7,25,30,20,13,19,21,18,25,19,20,17,22,12,11,14,18,24,14,24,12,39,12,12,27,26,80,39,17,19,18,16,18,8,39,29,15,31,30,69,90,27,13,18,20,28,21,7,2,20,21,17,6,14,23,27,11,24,34,39,10,26,33,16,26,5,38,21,6,6,20,8,17,28,26,21,29,18,28,9,20,1,8,15,11,14,11,19,7,29,7,18,54,8,8,10,19,7,50,10,19,28,27,47,11,14,21,12,14,16,21,22,18,9,20,8,17,15,25,30,8,18,19,18,24,17,21,12,53,16,34,27,7,22,44,39,46,105,12,4,9,7,28,9,24,24,19,39,12,11,11,23,11,5,51,26,8,11,18,24,17,21,13,22,16,1,16,42,24,32,12,11,44,13,22,25,8,64,11,14,11,38,0,6,8,4,13,3,4
fall,1,19,2,96,7,8,4,21,3,6,7,9,7,47,7,5,9,31,8,2,3,27,14,14,20,9,21,17,9,26,7,139,118,21,36,54,29,13,37,10,19,16,2,7,26,11,14,11,156,34,37,3,19,54,24,5,57,14,10,13,7,6,1,9,16,5,73,4,8,12,28,8,9,3,97,17,24,10,61,26,58,6,9,7,141,18,15,2,41,5,24,4,10,31,43,15,20,8,31,20,23,15,38,15,11,29,9,5,20,10,25,3,18,18,6,28,6,6,54,174,28,19,15,133,10,2,4,1,7,3,18,6,8,42,21,53,8,10,14,8,6,24,38,3,5,56,8,20,18,17,53,8,22,11,8,28,30,12,1,18,13,0,4,5,9,9,5,10,24,8,15,59,14,1,11,8,146,2,7,34,14,9,7,16,4,29,24,15,23,32,4,6,12,7,1,4,15,5,12,5,16,3,4,13,17,11,14,29,6,16,61,17,17,11,3,13,7,7,17,2,14,10,6,14,29,75,28,32,5,20,11,14,29,15,33,44,25,4,10,7,50,37,17,7,18,16,5,20,28,5,10,29,11,22,7,8,8,3,6,27,6,25,11,5,5,19,11,11,17,6,117,21,54,9,3,2,12,34,5,0,38,2,1,7,15,4,6,11,19,5,1,3,7,22,10,9,35,1,7,15,16,12,7,7,19,4,16,6,5,6,3,25,25,10,40,26,22,27,7,4,20,4,36,16,29,2,5,27,2,14,7,12,3,10,12,15,17,4,12,13,13,8,24,8,9,8,37,32,16,17,20,13,2,29,15,7,1,2,15,31,21,6,6,15,5,6,24,6,5,21,4,28,8,20,6,25,7,7,11,14,31,1,49,5,5,29,9,26,28,5,12,6,7,2,14,18,40,5,20,8,11,14,12,6,10,12,12,1,16,6,4,6,26,6,6,9,10,4,7,5,3,9,22,10,15,5,2,7,9,12,18,27,6,20,7,2,7,12,10,2,11,13,6,15,9,4,18,10,22,1,22,4,9,5,57,4,5,6,7,28,11,18,28,24,3,4,24,9,14,5,21,10,3,4,1,27,3,3,13,6,1,16,3,3,6,9,20,9,6,1,40,27,7,5,23,3,6,23,7,19,10,5,12,2,3,33,21,5,6,3,7,7,3,6,2,10,7,3,1,12,1,9,6,17,3,9,13,7,7,21,7,3,4,6,13,14,4,8,33,13,3,0,1,20,23,6,7,21,10,2,26,2,3,46,3,8,27,8,8,5,19,3,17,4,9,10,13,1,23,29,10,6,22,1,3,1,19,6,4,27,9,16,8,9,2,8,6,7,5,15,14,18,8,6,19,5,3,4,18,6,12,0,9,0,6,14,5,9,6,11,21,7,5,4,13,8,23,2,8,3,14,8,5,32,9,3,2,7,11,24,39,14,21,17,4,2,8,10,4,5,17,3,17,12,6,20,4,9,6,75,11,6,7,1,3,13,32,12,5,12,7,3,6,11,2,3,0,5,8,15,20,4,26,10,15,3,1,5,6,0,12,20,4,9,6,13,9,3,4,8,6,13,13,7,6,10,6,2,13,7,3,1,2,3,3,7,17,8,4,1,3,15,3,13,23,24,11,4,4,4,5,5,5,15,4,7,11,7,5,8,7,14,10,5,3,4,6,8,24,8,11,5,3,12,5,3,18,7,8,5,17,23,24,16,17,11,5,9,5,38,33,8,5,8,20,26,11,6,12,8,8,0,5,14,4,14,18,2,11,11,6,4,21,7,8,4,5,11,7,10,2,8,5,3,9,8,2,3,1,2,4,1,3,1,9,1,7,6,5,2,15,4,7,9,3,4,6,5,8,14,7,11,1,7,4,6,5,3,3,6,15,7,15,5,6,9,6,18,5,1,2,7,2,9,8,6,10,2,1,12,2,25,5,5,4,5,8,15,2,1,2,5,6,3,4,5,4,3,1,7,0,1,19,19,6,4,6,4,6,2,0,11,3,1,8,0,5,3,4,5,5,9,4,0,7,8,2,3,5,7,6,1,10,4,6,3,1,19,14,9,10,24,4,13,1,7,5,5,10,3,11,8,2,12,2,5,5,9,5,9,5,2,2,7,5,7,9,7,4,8,3,20,23,19,13,35,25,25,72,2,4,1,3,3,1,22,6,2,17,4,1,5,0,6,7,2,1,4,1,12,6,3,17,10,5,7,7,8,3,1,7,4,6,11,1,10,5,9,4,4,3,5,7,1,2,10,9,4,5,4
security,3,30,17,198,23,50,6,51,3,9,30,8,41,192,6,24,22,21,31,20,9,58,92,73,28,48,57,65,27,63,25,309,216,43,88,238,151,12,21,32,23,58,7,25,67,26,47,37,349,163,83,42,58,167,26,9,60,28,45,36,26,19,14,19,45,37,185,16,15,24,49,14,19,8,275,18,41,17,117,55,91,11,17,18,299,39,18,13,39,14,20,23,22,86,89,17,29,9,100,27,14,68,47,29,27,55,26,13,34,19,61,14,40,59,25,65,10,5,99,236,54,98,39,175,21,12,9,4,10,8,73,10,31,109,52,173,7,6,25,18,10,69,42,9,9,144,15,38,24,17,104,11,45,22,10,44,85,30,20,103,29,6,47,13,26,58,7,43,46,16,37,184,41,12,34,7,200,11,24,128,38,39,56,59,17,39,61,29,33,70,9,16,2,13,14,10,59,33,21,17,39,26,18,17,63,27,24,103,32,41,133,28,42,16,18,44,6,43,27,4,16,29,6,15,82,117,24,42,21,52,36,26,46,37,56,27,57,22,16,22,121,52,20,24,35,13,15,94,94,30,13,22,47,13,21,25,7,4,4,11,18,101,23,3,9,39,11,76,36,23,180,48,72,27,9,17,87,23,13,4,142,6,9,23,19,11,59,38,32,9,2,18,22,24,12,22,66,12,13,35,59,50,1,17,28,241,41,14,14,5,23,46,83,57,95,20,71,47,29,25,83,8,51,17,108,7,24,97,14,51,21,14,12,5,18,9,55,14,15,13,16,24,48,13,10,17,56,69,25,30,19,40,5,80,50,15,17,3,22,58,35,31,30,29,10,19,46,15,58,64,18,107,30,48,14,43,15,4,35,14,105,26,70,20,28,31,13,48,41,6,37,19,13,14,38,21,54,13,42,3,36,30,9,26,10,11,21,2,27,45,8,11,5,18,10,39,22,22,11,55,10,12,21,9,12,5,15,16,10,23,47,4,0,22,25,7,11,29,81,11,27,57,11,48,25,21,77,39,50,22,1,12,37,17,59,12,16,5,16,32,28,51,58,44,9,6,64,15,15,7,57,25,12,18,9,18,2,14,31,15,8,24,3,14,11,6,19,27,4,5,130,36,9,13,39,7,8,25,16,16,16,9,7,26,7,104,13,15,12,14,12,7,9,4,22,14,8,10,10,38,5,51,12,38,5,14,41,21,28,43,20,23,24,18,12,21,15,17,47,30,8,6,10,13,23,3,4,28,12,13,50,3,3,80,16,9,47,10,9,8,25,9,23,14,23,17,19,13,46,57,26,10,20,8,11,2,7,8,7,51,0,19,20,50,10,4,7,10,5,19,35,49,34,10,27,8,12,14,58,23,23,9,17,5,6,27,8,23,10,14,39,37,13,14,38,14,31,4,8,7,17,55,7,64,4,3,5,23,18,62,48,27,45,32,10,7,11,21,15,16,21,13,4,30,8,45,14,4,9,206,8,14,12,7,12,23,40,21,10,11,15,16,15,21,8,4,0,4,12,22,34,12,31,15,25,3,7,4,19,2,14,39,15,10,16,10,26,25,8,12,13,41,21,33,11,26,13,9,15,17,30,5,3,9,11,21,26,18,5,2,6,11,12,44,32,40,37,3,10,13,13,1,12,32,17,18,10,6,5,22,22,21,3,19,10,11,43,13,40,10,14,12,7,21,25,10,27,28,27,7,29,8,8,6,10,24,5,16,9,57,58,9,5,14,38,29,17,6,11,11,34,15,9,24,17,23,44,5,8,11,10,4,16,21,26,19,16,16,33,11,13,5,2,8,33,32,16,6,6,5,5,6,9,8,24,18,15,6,16,12,11,11,15,4,10,5,8,27,12,16,2,5,4,1,1,4,22,8,27,6,25,5,24,28,21,17,12,31,8,7,8,7,3,9,16,7,15,30,9,24,18,33,8,12,4,14,18,5,5,7,3,16,10,8,10,8,12,4,20,15,0,2,61,42,16,13,2,13,14,12,0,6,5,4,2,4,14,6,18,6,22,14,4,3,4,3,12,1,8,36,10,6,25,7,10,0,11,10,4,23,10,20,10,7,7,5,10,12,15,9,12,11,8,5,7,12,11,17,0,41,9,12,5,7,5,4,17,10,5,17,6,27,10,13,33,38,47,10,52,4,2,7,21,15,3,3,4,19,18,2,2,11,12,1,6,23,5,10,3,12,17,7,23,21,4,6,16,5,6,8,5,11,4,20,4,11,8,34,11,12,5,17,10,38,5,10,13,5,4,29
observe,6,22,7,87,4,3,6,25,4,3,24,12,3,35,4,2,0,6,2,0,4,14,4,9,12,8,5,5,2,18,7,82,58,1,33,34,39,5,10,1,6,3,2,0,20,11,14,8,163,12,29,2,9,19,3,5,50,16,0,8,16,9,0,8,10,2,59,4,3,4,2,1,2,4,28,6,4,3,40,10,42,0,12,4,119,8,9,0,25,0,5,1,0,19,38,2,16,4,18,6,7,11,19,7,10,6,4,4,3,2,11,1,4,9,0,16,2,0,62,108,23,4,1,46,4,8,4,2,1,1,7,2,0,26,7,13,4,3,3,5,1,21,15,1,2,42,8,8,4,5,30,2,10,1,2,11,20,2,4,5,4,1,4,1,2,2,1,15,5,7,7,45,6,0,1,13,103,1,6,12,21,8,0,3,1,16,17,11,24,37,1,3,1,0,2,8,4,0,2,13,7,0,0,13,10,5,1,13,3,13,48,5,26,4,2,2,0,1,9,1,3,9,7,6,36,82,12,15,1,5,8,8,9,10,16,20,14,2,3,8,44,15,7,1,10,1,9,8,30,4,3,7,9,5,6,9,7,1,2,20,5,21,14,6,2,31,1,1,8,9,93,3,17,3,1,1,8,13,10,0,32,6,4,10,5,1,2,8,5,0,3,8,5,5,2,6,27,4,5,13,9,11,1,0,6,0,16,2,1,1,0,7,10,5,14,8,3,26,4,1,27,3,19,3,49,5,2,6,2,21,7,10,7,6,4,6,10,11,2,9,10,3,5,8,1,2,24,44,8,1,13,2,5,14,13,4,2,1,11,14,12,2,1,5,4,0,19,6,5,13,1,11,3,6,2,20,11,2,14,6,43,1,30,12,0,25,2,6,13,0,23,0,6,10,18,1,27,4,15,2,17,1,3,0,3,1,3,3,6,5,4,9,4,16,18,2,5,0,5,2,4,5,14,10,0,1,1,15,14,11,9,0,3,12,2,6,1,14,5,2,9,11,2,16,2,1,2,1,23,4,12,1,2,6,24,13,2,7,1,10,1,15,19,12,3,0,4,0,6,0,9,2,2,3,3,3,3,10,9,2,4,5,3,5,3,2,5,5,3,2,55,29,1,7,5,2,5,9,2,6,3,1,2,0,2,5,1,5,8,4,4,3,5,6,6,11,4,5,0,2,3,9,4,20,4,3,23,1,14,11,8,2,3,7,4,4,16,6,10,6,3,7,1,1,6,3,5,12,8,7,41,6,1,29,2,4,19,2,7,6,8,4,11,2,8,4,9,2,18,25,1,7,7,14,2,5,2,5,5,7,9,3,3,11,4,1,4,4,1,4,13,26,11,3,12,0,2,2,58,11,24,4,3,12,9,20,3,12,2,3,8,15,8,6,18,4,15,1,5,3,5,7,3,11,0,2,5,5,7,17,4,5,14,17,6,5,3,3,0,13,10,0,4,12,9,11,2,5,4,99,22,4,4,8,4,3,18,16,3,9,6,5,17,12,8,11,2,6,8,5,11,1,16,10,18,5,2,4,2,8,1,7,13,1,2,4,24,0,2,9,14,9,20,7,1,5,7,4,10,17,6,6,6,8,14,2,8,5,2,6,8,8,1,25,6,13,11,6,12,3,6,4,5,21,8,1,3,1,0,12,3,8,0,2,4,5,14,0,24,4,5,3,1,7,7,3,8,1,2,4,6,11,2,10,3,4,7,6,3,10,9,9,1,1,10,13,3,10,5,6,4,2,2,6,3,5,5,2,4,6,4,2,7,0,6,6,1,16,9,8,6,2,0,3,5,17,2,6,10,3,2,2,13,9,3,2,6,3,8,4,10,2,7,11,5,8,2,5,5,10,5,3,14,9,3,3,2,17,1,4,5,5,6,2,4,7,8,16,11,3,5,6,1,7,4,5,4,2,4,8,32,15,17,2,1,3,1,4,8,5,1,2,4,2,3,5,7,0,6,2,3,2,2,3,5,3,2,13,3,2,5,4,3,5,5,5,3,1,2,2,3,5,1,9,8,3,2,2,7,0,4,9,2,7,6,0,3,13,3,12,4,3,4,7,9,4,1,5,1,1,7,4,4,18,7,7,5,15,3,1,4,0,6,4,6,3,2,7,5,6,2,6,7,1,3,8,3,8,24,4,0,4,3,1,2,1,7,5,13,9,0,3,0,1,1,17,4,0,4,6,5,6,6,1,4,5,0,5,1,4,11,1,2,11,3,7,4,0,22,2,4,2,7,1,0,1,0,2,2,2
move,4,18,9,75,7,23,0,27,5,4,2,10,17,81,2,2,16,12,11,4,3,21,56,33,11,21,31,44,20,34,5,120,80,33,29,112,42,3,11,17,8,22,10,26,39,2,24,14,102,116,43,18,19,84,27,5,6,7,30,37,1,14,4,17,22,16,104,12,6,5,25,2,7,2,124,15,30,1,59,30,25,7,9,10,61,9,10,4,21,4,10,6,10,40,23,10,13,1,47,14,6,19,8,16,16,18,2,15,20,2,29,3,27,18,36,37,1,3,28,48,16,53,44,111,23,5,20,3,0,6,38,8,11,46,36,97,1,5,11,5,12,23,15,5,3,74,14,19,11,3,30,14,8,7,11,13,65,16,13,74,10,9,12,4,12,35,5,10,18,8,23,83,27,21,28,2,22,5,4,58,11,4,31,26,2,27,12,11,10,35,8,7,9,12,5,6,21,6,10,9,27,2,6,3,8,23,3,14,12,14,56,34,20,13,9,19,11,13,13,5,6,14,3,10,9,25,17,27,8,7,7,18,19,11,26,6,12,13,10,10,46,27,8,7,11,5,6,53,32,9,12,12,15,0,1,10,2,0,2,5,3,52,1,4,2,8,6,41,23,3,32,6,5,7,1,20,21,2,1,1,70,2,6,10,3,5,29,34,5,6,1,16,10,2,3,6,17,7,7,11,20,7,1,3,1,5,90,2,26,3,6,8,37,26,15,6,22,18,9,4,18,4,25,16,41,1,7,55,6,18,15,2,3,0,5,4,19,3,0,2,5,12,21,6,14,9,11,15,17,24,4,10,0,33,5,3,7,1,1,29,20,24,11,7,4,14,11,11,31,51,7,60,3,38,2,12,3,3,17,2,30,2,18,7,21,10,4,16,18,7,14,56,5,6,6,4,4,4,14,3,10,20,2,12,2,1,6,2,7,15,3,6,5,5,5,17,14,9,8,28,2,12,17,2,4,0,5,3,9,11,0,3,0,12,9,4,13,22,21,4,11,4,1,25,4,5,51,14,16,9,37,2,1,2,13,5,15,2,4,4,17,17,17,35,4,10,34,9,4,4,27,13,2,5,2,15,9,1,14,6,7,13,1,9,8,4,2,18,1,0,50,14,3,7,13,1,4,1,1,1,6,2,1,7,15,6,26,5,3,5,2,2,5,1,1,4,10,2,1,11,1,3,1,10,1,0,18,0,8,8,4,7,8,2,4,8,4,8,18,9,4,1,11,13,16,2,2,7,0,0,15,0,2,27,6,4,7,5,6,2,3,0,3,3,5,3,8,1,13,13,7,0,1,0,5,1,0,1,1,16,0,5,9,20,3,5,2,3,0,9,12,13,15,5,9,1,2,3,6,2,2,3,7,1,0,3,7,3,3,0,15,5,5,3,8,1,1,0,4,2,2,0,1,14,1,1,2,3,3,11,4,1,5,2,2,2,3,1,7,1,5,5,1,11,2,3,1,5,5,56,5,3,5,2,4,10,10,4,1,4,2,4,3,0,2,0,1,0,0,1,4,0,7,1,2,3,1,0,1,3,7,13,3,1,1,0,10,7,1,3,3,30,1,7,2,10,5,4,8,3,4,2,1,4,4,5,7,11,0,1,2,0,0,6,3,9,23,0,3,3,6,3,0,8,3,6,2,3,1,7,4,7,1,4,0,2,2,4,6,4,8,1,2,10,7,4,0,14,9,0,12,0,2,1,0,4,1,0,2,5,5,15,5,1,8,7,8,3,12,5,13,5,1,6,2,2,3,3,0,2,0,0,4,2,2,3,2,8,8,2,5,6,3,1,2,7,0,2,0,1,1,1,2,2,15,5,14,4,4,2,2,5,0,3,3,1,2,10,1,1,2,1,2,9,0,2,13,0,4,0,9,2,2,2,8,3,2,10,0,9,0,1,1,4,2,0,4,10,0,1,5,10,2,1,0,5,3,2,2,5,2,1,0,5,1,1,8,1,8,5,1,0,1,3,1,4,2,0,8,2,0,0,4,2,0,0,1,2,7,3,14,3,8,1,1,1,2,2,5,14,2,2,11,1,2,1,0,1,3,5,2,0,1,0,2,3,8,1,2,1,1,1,1,0,2,0,0,3,2,0,0,8,0,0,1,3,4,1,3,6,1,9,4,0,9,8,3,1,4,0,2,6,15,4,1,0,2,8,2,1,1,2,2,2,3,0,0,7,0,3,8,4,15,15,0,0,9,2,2,1,3,2,1,0,2,1,1,25,5,13,3,8,0,11,3,3,11,0,4,21
pledge,6,25,6,105,17,7,6,20,3,2,10,7,6,42,2,7,2,13,9,2,6,20,17,25,3,19,3,24,11,9,0,97,58,5,21,58,23,11,4,3,8,7,1,4,20,3,25,6,145,34,18,6,16,29,5,2,14,7,19,11,8,1,1,0,18,8,75,7,4,5,5,1,4,1,64,12,9,2,41,14,18,4,9,11,120,10,6,3,14,2,3,3,6,14,31,6,8,2,11,14,4,8,19,5,8,17,2,3,4,5,11,2,5,9,6,9,4,6,25,88,12,16,2,48,8,11,1,3,3,1,5,3,7,22,14,32,2,1,3,6,1,14,9,0,2,35,5,8,2,8,37,4,28,11,2,10,19,7,6,20,3,2,4,2,4,5,3,8,7,11,8,40,5,1,7,0,83,2,12,18,12,6,6,10,0,16,14,10,14,21,1,5,8,1,2,1,27,2,6,10,11,5,0,7,13,7,2,10,4,20,56,7,13,4,0,0,3,11,9,0,3,6,3,9,27,25,11,20,2,12,7,9,10,11,17,8,13,8,8,0,32,23,3,2,18,9,7,41,14,2,6,16,19,4,10,11,3,6,1,1,0,12,19,1,3,9,2,8,9,0,44,6,30,2,2,5,13,2,1,1,30,0,2,2,3,2,6,2,10,0,1,1,10,4,1,6,14,2,3,9,22,12,0,4,3,0,20,2,1,0,2,4,24,8,33,5,4,21,13,2,20,1,6,4,26,2,2,21,3,26,1,8,3,3,5,7,12,5,6,1,2,6,16,5,4,9,25,33,10,8,5,6,0,12,12,0,1,0,14,21,10,5,1,15,2,3,31,4,13,5,6,15,2,3,1,0,2,1,9,4,42,1,29,4,2,17,1,15,13,3,12,2,10,3,17,13,25,4,11,5,15,9,3,7,10,9,5,0,8,4,1,4,9,2,9,3,2,4,1,7,2,0,7,5,3,1,0,3,4,4,30,6,2,6,5,3,3,8,15,2,2,13,2,9,0,5,3,3,21,5,17,6,2,1,24,8,5,7,8,9,9,9,16,10,4,2,9,6,4,0,20,2,1,0,1,2,5,4,6,3,3,8,1,3,6,2,4,3,0,1,22,13,4,6,7,4,0,13,2,8,7,1,2,0,3,40,3,6,3,3,8,4,6,0,7,10,7,5,0,6,0,16,9,5,0,3,6,5,8,16,0,3,1,4,2,1,3,7,18,9,3,5,0,6,8,9,8,13,5,1,18,0,0,16,1,5,17,3,6,4,22,4,6,3,17,10,5,4,18,33,6,3,8,0,1,7,9,1,6,7,2,6,6,5,7,3,1,0,3,16,15,12,2,4,15,7,2,2,25,10,12,1,1,2,1,6,0,12,4,2,5,3,4,2,9,2,11,1,6,2,8,16,1,39,3,3,6,6,4,13,33,11,12,11,3,4,0,0,2,8,5,1,5,14,4,15,3,6,4,86,16,1,2,4,1,8,19,12,2,4,3,4,7,3,2,4,1,2,9,6,6,5,17,0,10,3,0,4,2,6,8,25,6,3,8,5,12,2,2,3,11,11,12,3,1,3,3,1,3,10,14,1,2,2,3,5,7,7,6,1,4,4,4,21,7,6,1,3,8,0,2,1,4,1,0,5,3,1,2,5,6,7,10,3,3,0,3,1,8,4,1,2,1,2,1,5,5,4,0,4,4,7,0,2,0,3,5,5,1,9,8,5,1,1,13,14,4,0,3,2,3,3,3,3,4,10,8,2,4,8,6,2,3,4,4,5,4,18,18,9,13,0,0,5,2,10,2,1,3,0,5,5,8,7,5,3,8,2,14,1,11,0,0,4,0,3,3,3,8,9,5,2,0,4,2,6,5,6,7,5,3,3,6,1,6,3,4,13,4,0,10,5,1,6,0,10,4,3,1,2,14,9,2,3,1,1,3,13,2,0,6,5,3,8,2,4,4,2,4,6,0,2,23,25,4,6,3,18,3,2,1,2,0,1,2,1,4,2,0,4,0,4,2,3,4,6,6,1,4,4,2,9,9,6,3,1,4,14,2,6,7,9,2,6,9,5,2,1,2,0,9,2,3,2,2,7,0,23,1,18,1,2,0,2,1,1,4,3,1,2,2,2,1,6,5,14,24,2,34,0,1,6,1,2,3,3,3,5,17,4,6,1,1,1,2,0,0,1,2,2,5,1,0,6,2,3,3,3,8,3,0,1,2,17,4,1,4,2,15,2,1,4,0,8,1,2,4,6,1,2
great,45,74,29,421,54,49,47,122,13,22,86,69,52,432,27,60,26,71,40,13,20,156,67,103,116,35,58,68,30,79,37,757,621,48,213,289,219,30,31,26,35,53,22,13,144,73,116,56,1505,198,195,29,64,212,45,28,203,109,20,94,101,55,22,78,65,37,444,46,56,123,59,50,18,31,372,98,88,20,351,90,266,8,77,37,927,85,63,3,183,6,41,37,8,111,240,64,80,26,137,60,82,143,142,56,63,106,18,18,71,38,79,30,40,57,8,143,25,25,239,651,175,103,55,319,41,16,16,33,22,11,71,23,43,227,100,217,47,16,28,81,21,158,152,25,30,256,20,93,95,52,286,10,63,40,39,87,159,30,39,48,59,23,44,10,11,37,18,99,115,23,104,436,105,26,12,44,736,13,54,124,101,76,10,74,20,106,161,112,292,371,12,37,60,12,9,14,52,31,48,78,126,18,13,54,128,27,18,145,72,148,309,39,100,41,17,8,4,7,46,27,26,94,26,89,135,322,141,130,30,22,75,93,68,121,137,91,165,34,66,30,262,152,33,33,68,26,22,112,167,25,53,96,111,49,64,69,38,11,32,86,27,97,123,26,24,132,31,51,77,29,513,21,168,29,14,7,68,64,52,5,282,28,22,94,81,26,13,40,75,14,31,29,47,29,25,53,179,19,30,86,124,98,12,16,54,20,120,22,18,12,8,81,109,29,111,79,105,198,44,24,180,36,126,21,330,33,31,114,29,119,13,49,53,36,40,54,99,37,19,66,52,45,57,53,31,52,170,300,53,27,58,59,29,151,123,24,13,27,65,122,76,43,61,65,26,17,145,45,23,70,12,51,29,32,38,109,35,21,76,39,242,13,184,76,15,167,35,87,115,32,97,35,31,80,124,60,291,14,131,25,111,18,39,4,28,55,26,37,167,47,17,86,52,78,40,53,51,41,18,8,31,28,87,59,13,21,13,65,44,83,46,33,18,45,32,26,7,123,31,18,78,100,36,130,18,44,78,36,144,57,59,24,13,24,1,54,10,44,40,135,39,138,131,138,32,20,65,90,74,11,88,22,18,22,16,115,21,61,71,39,32,70,45,29,43,39,58,23,42,19,348,154,17,22,46,32,29,50,59,70,97,52,27,12,57,102,27,72,27,26,19,28,44,33,62,79,32,48,18,58,42,75,39,98,28,25,97,43,77,120,43,36,4,47,56,46,45,44,190,111,35,22,26,19,42,48,23,75,103,39,98,15,27,179,18,51,183,14,39,27,119,23,124,34,72,68,57,39,115,197,54,32,64,15,42,96,23,43,34,83,38,54,61,61,48,57,38,33,38,48,126,157,45,18,86,21,28,14,352,96,103,17,27,25,44,101,16,65,24,28,109,85,60,60,131,41,81,24,43,24,52,34,21,61,15,27,49,30,42,123,48,105,108,87,35,11,58,39,28,47,61,13,42,60,43,79,29,22,21,991,137,48,44,25,39,73,197,74,20,80,17,73,136,797,68,37,71,62,73,51,75,46,83,113,155,26,15,44,13,36,61,150,60,63,54,35,48,26,38,151,77,48,65,115,27,36,32,40,68,65,50,38,30,26,44,40,77,32,13,14,23,42,22,113,88,64,16,53,46,40,24,13,27,72,17,77,31,15,26,57,35,51,18,25,24,8,76,24,178,55,49,43,21,72,90,24,62,58,29,31,41,23,23,52,30,70,26,69,35,63,55,52,16,20,92,81,54,33,28,86,34,43,20,47,16,90,41,17,38,60,14,25,60,19,45,32,36,31,29,48,41,28,46,27,43,78,15,42,17,26,31,17,51,22,26,27,42,34,67,28,38,66,82,51,34,27,29,60,20,60,24,32,49,33,53,28,18,28,29,36,28,30,56,12,23,52,39,113,56,19,37,21,22,59,44,44,28,55,13,43,120,92,29,34,23,31,31,27,26,9,76,31,28,17,23,40,25,21,27,39,13,15,30,54,36,32,57,122,56,85,39,26,18,27,65,22,27,18,33,26,19,135,9,21,30,49,31,7,19,37,30,35,17,30,41,27,55,55,19,78,21,34,34,38,60,20,32,74,16,26,45,75,23,67,44,31,60,81,30,31,24,30,21,38,21,24,28,21,32,60,23,54,9,10,9,44,64,70,93,18,12,24,22,23,18,22,47,58,52,31,34,56,13,14,12,140,16,11,16,67,32,31,30,33,45,30,6,36,55,18,34,36,31,24,33,21,51,16,50,10,21,5,32,1,3,14,9,32,13,6
rule,4,25,31,97,8,5,10,22,1,0,8,12,6,69,3,21,11,9,3,6,7,34,13,25,18,15,10,5,11,24,18,166,79,12,50,33,40,2,6,8,2,9,1,8,20,23,30,14,226,21,50,8,7,41,7,4,31,9,2,13,21,9,5,12,45,5,74,11,2,6,4,1,6,10,87,8,22,3,58,15,24,1,16,4,180,7,9,0,34,1,3,3,4,25,38,25,11,13,30,8,5,23,36,14,12,16,1,4,16,5,13,7,5,15,5,20,6,4,53,200,38,19,27,65,16,2,3,5,3,6,7,2,9,38,19,54,6,8,8,2,1,37,12,3,4,51,6,11,4,11,76,1,8,4,5,33,24,2,9,6,6,2,12,8,3,15,3,11,27,15,10,96,23,2,6,10,119,5,9,37,19,11,6,18,0,13,35,15,37,56,2,2,4,1,3,3,33,5,4,12,26,2,2,19,24,15,0,50,7,9,71,6,18,4,0,20,0,2,26,0,1,22,8,15,57,124,23,20,2,1,3,19,18,22,28,8,21,6,0,7,72,37,4,4,14,4,10,20,52,12,6,8,13,4,9,12,3,0,3,18,6,43,14,5,3,48,1,6,17,6,134,3,13,9,8,4,24,10,7,0,35,8,5,12,9,2,5,6,8,0,3,5,16,6,6,9,37,10,7,17,13,24,0,3,13,1,24,22,5,3,8,12,20,7,15,26,17,49,12,9,39,8,31,0,99,6,7,16,3,23,9,10,13,4,6,7,22,11,5,12,16,11,23,14,0,2,42,34,17,3,30,13,6,19,28,0,3,5,13,20,14,18,5,18,3,3,28,6,24,17,0,19,7,8,11,62,19,6,16,3,92,5,30,16,4,19,10,12,21,0,32,9,7,24,28,9,47,2,38,0,34,1,0,3,5,1,7,2,12,9,5,11,3,7,19,10,2,8,3,1,11,9,32,9,3,2,2,17,6,26,11,0,0,10,6,13,2,13,3,1,9,21,6,19,6,2,3,5,29,4,12,13,5,8,54,1,2,7,8,32,12,18,33,33,12,7,15,11,11,1,14,5,3,2,15,20,4,19,13,3,12,4,4,13,14,12,16,2,9,14,67,32,4,7,8,0,2,8,3,11,9,4,1,1,3,11,3,9,11,7,9,7,2,37,26,17,2,3,0,2,0,20,10,48,10,3,29,2,9,34,16,12,4,20,18,6,4,6,25,8,9,11,4,4,7,9,3,11,13,6,54,6,24,48,13,24,22,1,5,6,16,5,14,10,12,17,9,7,22,41,2,6,16,14,10,8,0,7,11,16,5,7,4,24,8,9,5,3,7,8,48,41,14,5,19,0,7,4,42,20,50,1,5,9,3,18,11,41,23,8,28,37,16,7,51,10,10,1,11,8,11,4,2,26,2,6,6,15,26,36,1,23,18,24,6,8,10,3,6,11,12,8,8,17,6,5,8,1,7,136,40,5,5,7,5,4,37,30,5,10,6,6,19,27,11,7,5,7,8,9,17,2,18,85,18,8,6,1,2,5,3,15,23,5,5,9,8,4,0,11,7,10,16,7,3,4,8,7,10,13,11,17,0,10,13,4,15,8,5,4,27,15,2,29,8,13,4,7,5,13,0,4,3,26,4,2,4,2,10,15,4,10,5,7,1,0,9,7,27,9,10,3,1,8,7,2,11,0,9,11,5,2,1,6,6,6,8,28,5,15,11,6,3,2,14,15,7,17,3,6,7,8,0,13,4,13,4,3,2,6,1,6,12,0,5,2,1,10,6,17,8,15,8,8,2,19,2,8,2,44,15,4,30,10,6,4,8,4,18,9,3,0,8,3,4,4,2,13,3,24,3,4,19,13,6,4,3,16,1,7,3,4,3,3,7,4,18,11,22,4,0,7,13,17,3,3,6,14,4,6,56,27,24,3,1,4,11,1,7,2,3,7,3,6,8,8,14,12,18,9,10,3,6,4,0,12,3,12,7,3,13,5,6,4,5,11,1,2,6,5,5,3,1,3,4,9,1,12,4,2,8,6,9,11,4,6,2,3,8,23,6,2,7,2,12,6,3,8,3,5,4,2,2,15,7,8,5,5,3,1,1,5,3,5,9,0,2,1,6,6,4,10,1,1,4,5,2,5,12,3,4,4,13,6,2,3,5,7,12,5,0,1,21,1,0,29,5,3,16,9,9,7,11,6,3,5,4,6,8,6,5,4,4,1,7,7,16,0,32,3,2,2,1,2,1,0,8,3,1,2
god,0,5,5,23,9,11,2,24,1,2,2,2,7,49,1,10,7,8,10,2,0,15,23,22,2,11,22,21,17,27,2,32,47,18,12,68,24,0,0,10,5,31,3,7,22,4,0,2,66,102,24,6,18,65,21,1,6,1,19,11,1,5,1,8,7,8,47,3,1,2,5,0,5,3,37,11,13,1,29,28,4,0,1,12,29,2,3,0,6,0,5,4,0,23,2,2,6,2,18,0,0,4,4,9,3,9,0,3,9,1,12,0,3,9,4,17,0,1,6,22,7,34,4,23,5,14,3,0,0,1,21,5,8,9,27,38,0,1,3,8,7,18,4,0,2,26,5,8,1,0,15,1,7,1,1,4,29,0,2,32,1,2,7,0,0,10,2,5,4,2,2,63,11,6,17,0,25,5,2,19,2,6,12,12,0,8,5,1,6,8,1,4,0,5,1,1,3,5,3,6,1,2,0,0,3,8,0,0,6,1,39,23,4,1,11,13,0,5,6,0,3,7,0,2,3,17,4,6,4,0,2,2,7,3,15,2,7,2,1,8,21,11,3,3,7,0,3,35,3,4,0,5,11,0,0,5,0,0,0,1,0,22,0,0,0,0,6,28,20,1,43,1,1,2,5,5,5,0,1,0,38,0,1,5,0,0,11,7,4,3,0,7,3,2,2,1,8,1,3,7,12,0,0,0,0,0,5,1,1,0,0,2,10,8,4,3,4,2,1,0,9,1,16,5,26,0,3,40,1,9,12,0,1,0,1,1,13,0,0,1,3,7,11,2,0,4,7,14,6,16,3,10,1,11,1,0,2,1,5,19,0,0,0,5,0,10,6,5,9,25,3,37,0,21,2,0,6,0,13,2,8,0,6,2,14,10,1,4,5,2,13,10,2,1,0,10,2,1,3,0,2,13,0,6,2,2,1,2,1,7,1,4,0,2,0,13,9,13,6,17,1,3,2,0,1,0,1,2,2,6,0,0,0,6,4,1,3,10,12,0,8,3,0,4,0,1,25,10,2,5,16,2,15,5,10,2,1,3,4,2,12,18,10,20,4,6,22,3,0,0,22,4,3,7,1,12,9,2,4,1,2,8,0,7,2,0,1,12,1,1,20,6,8,8,8,0,2,2,1,3,1,3,1,3,0,3,0,2,0,1,0,3,2,0,0,0,0,2,1,11,1,1,3,4,0,3,4,0,5,3,3,4,4,1,0,3,1,6,9,1,1,0,4,0,1,1,1,0,1,0,9,1,1,10,0,2,5,0,0,1,1,1,1,0,3,2,2,5,7,7,3,0,2,0,1,0,0,1,0,6,2,1,5,11,4,0,1,1,1,3,8,6,6,4,4,0,1,0,0,3,1,0,2,0,0,3,5,2,1,1,10,1,3,5,2,1,1,0,0,0,0,0,2,4,0,0,0,0,4,5,3,1,4,1,0,0,3,0,5,1,3,4,1,0,1,0,1,0,0,48,2,2,3,0,0,8,3,3,0,3,0,2,0,0,0,0,0,1,1,3,4,0,0,0,6,0,2,0,0,0,3,7,0,0,3,3,7,3,0,0,3,24,2,0,0,4,4,1,7,1,0,0,0,0,1,2,1,9,0,0,1,0,0,1,4,4,12,0,2,1,2,0,1,4,0,0,0,2,0,4,2,1,0,0,0,0,1,1,5,1,1,2,0,0,1,1,0,1,0,0,6,0,0,0,0,2,0,1,1,0,0,2,1,0,7,6,1,0,3,0,8,0,1,4,2,0,1,0,0,2,1,0,1,0,1,1,0,0,4,1,3,2,0,0,0,2,0,0,1,0,0,2,5,0,12,2,7,1,4,0,1,1,0,0,0,0,1,7,0,1,1,1,0,0,0,0,3,0,3,1,4,1,1,2,7,2,1,9,1,2,2,0,0,0,1,0,0,4,0,2,4,0,2,2,1,3,0,0,0,0,0,1,0,1,2,1,1,0,4,0,0,3,2,0,0,1,1,0,5,0,0,0,1,0,0,0,0,0,0,1,6,0,1,0,0,0,1,1,0,11,0,1,6,1,0,0,0,0,0,2,1,0,1,1,0,0,0,1,2,0,0,1,1,0,1,3,2,0,0,0,1,0,0,1,1,0,0,0,1,0,0,5,1,0,0,0,0,0,0,0,0,1,0,0,0,0,0,0,1,0,0,0,2,0,0,0,0,0,1,0,3,1,8,8,1,0,6,0,0,1,0,1,0,0,0,0,2,10,0,6,1,4,0,3,0,0,0,0,2,11
declare,10,70,12,198,11,5,3,50,6,6,44,13,4,70,1,11,19,11,8,8,6,39,8,28,17,11,22,8,10,23,14,166,97,7,34,32,36,3,3,3,13,10,5,2,19,20,18,10,448,26,57,7,5,39,2,5,74,11,3,10,17,10,1,8,12,7,99,7,13,8,9,1,3,5,61,12,24,1,72,31,29,0,16,6,210,13,12,0,31,3,10,9,0,24,36,19,17,1,28,8,5,21,45,7,6,28,0,2,9,3,31,4,3,15,1,36,16,1,136,164,37,11,71,60,8,4,1,2,3,2,6,5,8,41,13,11,14,6,5,11,5,16,38,4,2,72,5,10,10,4,85,1,19,1,0,31,24,9,45,6,5,2,4,4,9,5,6,19,15,14,9,83,21,2,2,7,181,2,13,12,25,13,3,18,5,8,23,25,60,69,3,9,1,3,2,7,4,2,6,11,10,0,1,8,39,7,3,14,13,29,50,4,47,14,3,3,2,0,9,1,0,24,3,15,43,138,15,19,2,18,15,10,10,15,27,13,24,2,6,15,84,32,4,6,8,1,7,12,69,9,17,7,25,5,8,8,6,2,3,10,4,33,19,13,5,15,0,7,28,6,92,0,25,4,7,1,20,6,19,7,41,4,1,14,9,2,1,5,10,2,6,7,18,7,3,10,37,19,6,15,24,22,0,3,17,1,25,2,2,0,1,16,22,2,31,7,1,27,9,2,63,4,26,1,98,18,1,30,7,27,16,13,13,5,5,18,14,12,3,9,10,18,14,24,3,4,55,58,8,8,14,23,7,20,26,8,15,4,14,18,23,5,2,26,1,3,45,13,3,12,4,26,1,0,8,13,3,0,15,5,111,1,39,12,4,29,18,11,34,0,26,1,22,21,32,21,64,4,36,4,34,2,5,3,3,8,1,3,22,5,4,13,0,17,11,11,10,3,5,6,5,14,23,23,2,5,4,18,13,13,8,6,7,16,4,6,1,7,8,3,11,9,4,14,0,2,7,4,42,6,5,7,2,7,44,7,3,1,8,36,16,26,28,20,2,4,8,25,10,3,11,8,1,6,1,17,9,20,16,8,10,15,4,5,6,28,3,6,3,2,144,40,1,9,4,5,2,13,13,3,13,6,7,0,11,12,1,30,10,1,1,8,10,9,5,23,3,6,11,12,2,33,12,25,25,12,17,8,26,29,20,1,10,10,4,11,15,9,49,10,8,2,4,1,3,6,10,15,11,3,122,16,16,52,2,10,48,4,10,13,22,10,31,3,9,14,3,7,46,28,7,7,7,5,6,9,4,3,7,18,3,10,5,7,8,2,4,4,3,5,32,39,7,1,12,1,5,2,81,10,32,0,4,11,10,18,4,42,5,5,35,15,10,2,29,5,10,4,18,4,5,0,2,29,2,10,14,4,10,43,3,11,25,32,16,2,4,11,2,11,7,1,12,23,11,17,0,6,11,251,10,5,8,9,21,16,35,42,17,15,4,5,41,24,21,10,1,11,6,8,14,5,124,67,27,16,4,5,1,4,5,25,10,5,7,6,15,3,3,11,33,4,13,12,13,1,10,12,31,15,2,7,8,7,9,1,12,3,5,9,5,13,14,19,13,38,5,14,13,5,8,7,26,22,2,13,3,0,8,19,4,9,1,3,8,5,17,3,47,11,5,8,1,11,20,3,5,3,5,6,2,3,0,6,0,11,10,5,2,16,18,7,10,1,20,12,9,2,4,9,2,2,3,41,3,18,4,0,6,18,2,3,23,2,7,4,9,77,5,15,5,19,7,7,4,11,5,11,3,4,6,5,16,22,4,4,5,5,12,7,3,4,24,14,7,11,4,13,6,12,6,5,0,11,0,5,1,16,3,7,6,1,11,12,5,8,6,14,21,7,9,12,18,13,2,7,7,6,2,15,27,30,13,3,2,2,1,10,15,1,6,21,7,3,2,12,4,9,13,5,6,6,0,4,3,4,3,25,16,1,4,7,7,10,1,2,8,5,11,2,4,15,0,5,8,27,9,11,8,2,2,14,5,7,22,9,6,5,1,21,2,3,2,13,20,6,3,20,1,0,5,7,7,15,3,12,2,25,6,6,4,10,5,9,4,4,3,4,6,1,1,27,2,1,9,17,12,8,15,8,0,9,5,4,7,4,1,11,14,8,3,8,0,0,1,27,2,4,16,4,17,7,8,5,7,3,0,7,7,13,1,9,12,2,5,20,12,2,34,3,2,1,1,0,1,10,0,12,1,2
kind,3,15,8,81,4,8,9,33,3,4,8,12,6,75,4,11,5,24,4,5,6,20,7,27,32,18,14,20,4,17,9,172,117,6,50,61,39,13,6,6,7,11,7,5,21,13,10,11,153,17,38,9,12,50,32,4,43,11,5,13,8,9,5,9,17,9,79,8,14,14,9,5,5,5,131,11,27,5,53,37,42,4,2,9,151,40,9,3,21,1,8,7,3,5,54,15,15,3,22,7,11,30,19,11,7,28,2,9,7,5,22,0,7,17,6,22,2,4,41,122,50,21,22,51,11,1,4,4,3,1,16,9,11,36,20,88,10,0,9,4,23,35,16,3,5,70,7,20,19,4,47,0,10,11,8,20,43,1,5,21,14,4,19,3,7,25,6,21,23,7,10,96,30,4,9,6,139,3,16,75,30,11,4,24,3,40,35,38,24,31,3,5,9,1,5,9,22,14,6,7,55,4,5,3,21,4,4,27,11,14,80,13,12,11,14,7,3,2,6,7,1,16,6,14,18,101,42,17,7,8,12,7,11,22,29,18,29,12,9,19,60,28,6,10,19,4,4,35,45,8,4,14,11,2,6,13,11,1,2,19,19,16,12,2,8,33,11,8,10,9,78,5,28,4,1,3,22,11,5,4,83,11,5,22,11,3,5,5,25,3,0,5,6,6,3,3,26,4,4,25,14,8,4,1,12,2,29,10,11,4,5,32,25,4,26,8,20,35,29,3,22,1,36,23,58,7,18,20,6,15,6,13,10,5,8,8,12,7,1,7,10,10,23,6,4,5,28,46,10,6,5,11,4,41,25,7,4,11,18,23,21,12,11,20,1,4,15,14,1,25,2,16,3,18,30,17,12,6,14,4,45,8,31,10,5,15,14,17,24,7,30,4,5,6,11,5,25,7,21,6,14,4,5,5,5,5,11,3,21,6,6,2,2,16,6,5,1,13,8,4,20,6,23,11,5,8,1,22,5,14,18,2,0,7,4,1,1,7,6,11,18,13,12,11,4,4,22,9,44,7,16,1,4,8,40,8,4,8,1,17,14,25,33,63,6,4,11,11,12,2,28,17,2,4,6,49,4,14,36,11,11,13,2,4,9,10,9,4,8,1,46,27,2,4,4,1,4,9,2,15,10,1,2,4,14,18,6,14,1,8,3,5,2,9,4,11,9,9,32,11,6,17,7,30,6,3,24,35,12,23,10,6,10,21,9,5,11,13,25,24,3,3,5,8,5,2,3,11,8,10,28,1,6,24,10,7,29,8,7,4,12,4,12,3,6,10,6,12,36,39,10,4,10,5,6,3,15,6,4,25,1,11,13,20,10,16,7,8,3,12,20,25,10,2,63,11,8,6,10,16,7,4,2,5,2,4,8,8,8,7,33,15,4,5,39,7,9,9,8,2,16,21,6,24,3,3,4,10,11,24,25,15,40,31,14,8,15,12,9,11,23,6,15,12,6,9,6,3,5,81,11,10,6,1,11,9,23,18,12,12,4,2,10,9,4,1,1,3,16,10,17,9,10,27,5,3,1,2,4,3,3,27,10,9,9,5,7,1,5,7,11,13,7,3,4,4,4,2,11,7,4,3,2,6,8,5,10,1,4,1,7,6,6,10,13,20,7,7,8,13,2,10,6,18,6,10,9,7,8,11,11,9,2,3,0,3,31,9,8,8,15,3,7,24,10,5,7,8,8,3,11,4,4,4,4,9,5,3,4,14,5,13,8,3,8,20,12,8,11,4,10,2,7,8,6,7,9,2,11,7,0,2,16,4,8,3,6,13,9,10,2,6,4,2,34,18,10,6,0,0,6,4,7,1,5,8,7,4,11,4,8,2,6,4,3,2,7,6,3,6,4,0,3,11,3,8,11,7,4,0,5,3,12,4,7,8,4,23,11,4,1,9,9,11,1,4,6,9,2,15,11,24,6,9,5,4,18,2,5,4,8,6,10,7,3,1,7,1,4,5,13,1,9,13,5,5,1,3,12,15,0,5,1,2,2,0,8,6,3,1,3,14,3,2,4,0,1,3,2,9,4,2,4,0,8,5,0,2,4,13,1,2,5,2,7,2,4,2,5,1,4,3,6,6,5,4,0,5,2,2,3,2,5,5,0,2,3,2,10,13,3,9,3,1,2,13,4,7,32,1,4,4,8,3,2,10,4,3,4,3,1,6,5,1,1,7,1,5,3,5,8,2,3,5,1,2,1,4,11,0,2,11,3,15,4,12,9,3,8,6,6,5,1,2,2,3,5,4,3,3
effect,24,38,20,397,12,7,14,96,12,17,36,23,25,131,13,15,16,34,6,13,11,107,11,47,52,22,32,26,10,40,18,470,287,15,129,102,68,25,49,6,26,5,7,11,93,53,72,33,673,26,123,5,30,54,8,20,212,63,1,37,46,16,6,43,65,13,212,14,29,23,41,9,6,10,172,35,79,13,169,48,135,4,44,8,505,53,44,2,108,17,35,15,1,77,136,69,19,19,62,31,25,75,106,25,22,71,61,14,41,10,45,19,21,42,2,69,21,13,260,444,105,22,39,153,16,10,8,11,15,3,26,7,11,102,39,102,15,6,11,15,2,80,85,18,3,192,18,31,38,58,179,4,37,21,13,42,64,21,21,11,34,10,23,2,5,6,11,57,49,28,49,166,48,8,6,28,458,6,31,56,65,24,7,79,13,53,84,64,84,138,5,18,37,2,14,12,42,12,10,30,64,13,6,37,50,14,14,102,31,79,219,11,69,23,6,1,5,5,41,4,14,43,21,46,114,268,59,53,10,18,38,50,62,71,79,88,103,25,27,21,192,89,12,10,25,18,13,38,99,9,31,98,36,18,31,48,33,8,15,32,14,55,60,14,13,93,10,14,21,15,360,18,107,13,9,1,42,53,33,10,110,16,13,44,27,2,5,16,35,2,26,22,45,22,10,24,96,13,24,40,57,82,7,15,30,8,41,11,11,1,5,46,65,13,112,79,25,127,25,16,108,19,59,20,93,11,12,64,8,61,14,23,15,17,24,45,41,19,13,46,26,12,38,22,15,14,147,130,30,6,36,25,21,82,39,23,17,19,43,72,54,20,29,42,10,4,94,25,17,28,7,26,8,17,31,92,25,11,58,20,164,8,116,21,4,84,10,50,73,7,59,6,26,49,93,26,199,16,125,9,56,6,9,3,17,20,13,5,75,37,8,23,20,36,26,23,14,29,7,3,10,23,39,33,2,13,5,39,28,40,27,31,17,67,3,14,2,49,14,19,48,52,17,33,5,8,17,11,96,28,32,10,4,9,135,32,2,36,17,1,28,44,71,41,10,10,42,31,11,1,23,19,12,7,11,32,12,20,53,14,17,23,7,11,24,23,37,11,20,12,138,107,3,16,27,23,18,38,20,30,37,23,15,3,20,87,9,41,19,31,24,16,33,37,49,35,11,31,20,22,9,35,29,54,33,10,61,41,44,64,32,12,5,28,28,19,26,25,89,45,19,8,5,11,41,29,20,42,51,14,97,16,31,121,33,35,84,11,13,13,76,17,99,13,49,52,33,11,101,82,26,18,69,16,16,29,79,14,21,36,42,53,28,22,18,18,20,21,16,32,51,77,17,9,60,12,12,18,166,30,82,9,13,26,19,49,18,79,35,20,71,88,49,20,60,19,100,23,32,13,35,15,12,60,9,31,23,32,40,78,35,68,78,48,34,6,19,14,7,24,15,3,23,55,33,72,18,20,23,394,50,12,25,22,19,38,91,31,29,31,10,17,98,71,27,34,9,19,27,35,55,34,101,105,66,20,6,41,13,18,21,175,35,23,17,25,26,20,14,22,46,19,29,28,16,28,21,18,53,37,34,12,15,33,35,13,44,15,24,16,5,35,28,90,64,63,24,16,19,34,32,16,28,63,5,24,20,12,15,31,23,40,11,24,10,12,37,14,84,26,31,17,12,25,18,11,28,14,9,14,22,31,12,47,15,42,26,47,15,48,47,35,16,29,48,49,12,28,18,28,11,9,5,35,14,31,33,3,43,37,32,18,30,28,21,25,24,38,18,46,20,28,17,15,43,42,25,24,16,16,15,15,24,21,15,19,17,15,41,8,56,11,58,37,13,10,16,26,13,23,18,10,20,40,14,22,6,24,27,25,23,24,28,4,13,21,34,58,19,17,14,22,19,26,22,24,17,36,15,17,59,68,22,16,10,19,22,25,20,6,41,17,11,11,15,21,14,10,15,37,11,27,21,38,17,19,21,47,35,14,12,36,14,11,35,13,13,20,15,23,9,26,2,15,16,38,18,22,23,3,21,26,15,26,15,25,11,38,24,43,12,39,18,37,29,22,6,28,8,10,15,24,17,55,13,26,11,59,28,15,18,12,24,20,17,19,14,14,7,30,13,20,29,21,30,44,31,41,84,18,26,10,8,9,10,32,12,9,46,16,14,14,14,15,7,38,8,6,11,16,12,25,13,9,18,18,1,30,20,18,24,19,11,22,18,13,29,4,64,2,9,7,7,0,0,6,2,17,6,0
set,8,19,8,123,18,19,7,35,9,6,32,13,30,123,2,27,15,32,9,9,3,41,59,60,27,22,37,36,26,37,12,212,132,29,82,127,96,10,17,10,14,24,6,14,63,20,28,26,280,97,73,22,16,84,32,11,50,33,29,25,20,14,5,14,33,18,144,14,19,12,18,4,12,10,128,26,33,7,93,60,43,6,28,22,260,25,18,8,54,7,23,37,10,33,57,20,30,6,42,24,8,36,34,26,18,38,17,9,15,6,28,7,17,15,13,41,6,6,76,145,54,56,29,101,24,9,7,5,2,2,25,11,16,53,30,88,12,5,14,14,19,58,40,7,4,98,16,24,21,8,69,9,20,7,11,23,54,24,25,42,18,4,15,5,18,27,11,30,31,17,14,138,38,13,16,12,165,11,17,71,37,9,19,41,5,28,50,30,37,63,6,9,7,7,4,4,27,13,13,17,51,7,7,9,27,20,6,35,13,36,112,28,32,23,17,22,12,20,16,3,5,27,9,21,38,123,30,24,7,11,13,17,25,36,39,16,31,11,13,8,107,42,8,18,36,7,8,55,48,11,20,27,48,7,6,22,9,5,1,21,12,42,30,7,10,19,9,24,37,4,123,11,25,8,6,34,31,13,12,7,83,10,4,28,16,3,13,11,27,8,6,16,30,10,6,9,36,12,5,38,47,23,1,7,17,9,31,4,8,4,5,22,41,10,48,23,18,47,31,7,35,16,45,16,109,7,23,50,5,28,11,15,9,6,9,20,33,9,3,10,12,20,15,16,10,13,32,52,18,17,14,22,5,33,26,4,14,9,13,47,30,10,15,28,6,12,45,11,24,37,5,51,6,36,24,27,15,7,25,4,99,11,45,13,21,44,9,23,30,6,40,6,16,10,27,24,48,14,52,2,20,15,3,11,17,13,9,5,28,11,12,11,14,19,19,16,11,14,9,13,10,9,21,23,5,15,3,24,7,34,18,9,2,18,14,9,4,21,12,7,18,18,10,16,3,6,31,15,33,11,28,1,17,9,39,12,12,16,14,28,1,40,33,68,6,18,29,19,8,10,36,9,3,13,12,24,10,18,47,10,14,22,5,16,18,9,6,19,7,8,97,35,6,14,12,6,9,15,11,11,13,9,4,3,21,18,10,12,14,12,5,8,13,11,16,18,20,19,9,12,9,22,6,26,6,10,26,18,19,27,20,11,5,16,9,15,8,22,32,17,4,5,11,11,14,8,15,22,15,6,35,4,4,52,19,16,21,2,3,15,23,7,10,6,13,18,12,11,35,40,5,7,7,6,7,6,9,11,3,17,5,10,12,20,7,14,8,5,3,19,34,38,17,9,45,4,16,12,32,20,18,6,8,6,6,20,5,27,9,1,31,18,15,6,51,6,19,10,9,6,8,2,7,34,3,7,5,6,9,31,25,21,36,28,11,10,27,4,6,7,18,15,21,24,4,30,4,6,15,160,29,14,8,5,11,16,25,23,5,13,7,2,10,13,8,8,8,14,10,13,20,7,71,36,22,4,6,3,3,2,11,35,13,9,10,3,16,7,5,9,13,30,17,15,4,8,10,4,13,10,12,4,7,6,5,11,23,12,4,3,11,10,7,29,18,27,14,5,10,7,5,12,10,20,8,11,13,1,5,21,10,8,10,10,7,1,16,7,50,10,15,9,7,17,15,8,11,8,6,6,18,9,9,10,9,22,4,12,3,19,19,29,8,11,11,7,20,9,4,16,11,4,7,24,9,16,7,5,26,16,10,5,8,12,13,6,7,26,8,17,9,16,8,4,19,21,6,5,3,2,3,5,8,2,16,8,12,7,25,10,6,4,5,9,6,6,4,18,3,12,4,5,13,23,5,2,25,11,5,6,8,7,9,7,6,14,6,33,5,4,5,11,7,6,3,9,4,13,4,10,19,40,13,2,4,4,6,8,10,2,2,13,8,11,2,12,7,5,15,20,5,7,10,7,9,4,5,11,18,5,6,8,7,6,14,3,11,7,5,3,7,8,7,4,7,3,6,7,8,16,6,8,8,18,6,5,6,15,9,11,3,6,11,5,22,4,4,2,10,8,7,12,2,3,6,6,1,13,3,1,0,8,8,3,2,7,2,5,6,5,2,19,3,4,8,14,10,15,28,2,4,5,5,2,2,5,5,4,9,2,2,4,3,5,3,9,8,2,11,3,5,7,17,15,4,1,5,9,9,5,4,8,5,4,6,3,9,14,12,9,3,7,5,8,1,10,15,2,4,13
ever,6,65,25,208,27,47,13,111,12,9,45,17,30,205,14,40,10,52,31,20,4,90,64,70,43,20,38,42,19,66,18,331,299,39,123,193,173,8,24,18,23,45,8,13,82,34,38,41,433,106,90,24,59,174,44,12,116,31,25,53,20,25,9,32,53,29,328,56,20,27,35,6,15,15,226,33,70,12,201,49,123,12,21,24,376,39,23,6,84,5,36,15,20,53,92,35,42,10,65,26,18,43,55,23,54,42,8,13,35,14,64,4,39,39,32,59,11,5,115,297,89,80,55,235,37,14,12,9,11,1,39,13,38,85,105,112,20,23,16,61,14,97,105,8,14,133,26,40,62,12,143,11,23,11,17,40,74,23,33,49,23,4,28,8,12,32,17,44,41,14,35,251,43,7,20,17,278,11,19,83,60,33,16,43,12,70,83,43,53,108,7,16,12,6,13,11,23,14,31,42,68,12,8,17,67,19,8,70,27,56,118,37,55,26,19,39,6,12,25,2,15,50,11,29,63,165,57,62,12,21,31,41,34,37,66,35,76,13,33,25,133,67,23,19,40,12,21,83,80,13,12,55,55,11,10,42,21,15,6,45,11,77,24,11,22,38,22,47,33,14,271,10,60,15,11,10,45,15,15,4,151,17,3,55,34,7,24,31,45,15,8,12,24,11,5,16,60,5,16,55,51,33,7,5,19,15,59,10,22,10,0,15,49,28,76,24,34,69,23,16,97,15,78,20,114,8,34,76,14,52,13,21,27,9,32,37,44,13,5,24,24,23,26,25,13,9,84,90,31,38,22,30,14,44,48,5,15,11,34,59,34,17,19,21,19,15,58,33,21,55,9,55,10,51,17,49,27,13,63,17,137,5,77,15,18,49,14,55,67,10,70,22,24,21,57,33,79,7,41,16,44,16,18,11,22,28,17,12,58,21,17,16,17,28,15,22,13,22,13,13,18,13,32,31,8,14,7,22,33,22,17,9,10,19,17,10,5,19,33,11,27,42,11,33,6,17,45,24,81,18,51,15,17,9,138,18,18,26,25,44,40,1,82,105,28,29,55,21,5,4,53,13,3,13,16,72,19,19,48,12,10,37,16,11,16,25,14,21,24,2,164,66,12,16,21,18,27,28,26,35,32,20,16,11,21,59,16,31,14,9,7,18,11,11,35,47,10,20,9,38,9,39,29,66,18,12,46,12,35,59,22,30,11,37,18,23,23,35,74,38,10,5,11,21,20,14,18,36,31,16,83,8,10,75,11,17,51,8,12,17,27,6,20,17,26,16,46,21,63,63,33,17,16,9,13,12,39,4,19,22,17,16,18,63,16,22,8,19,5,36,60,55,29,7,47,18,33,14,84,34,38,7,16,9,8,25,15,32,3,14,58,21,15,29,76,12,26,10,11,1,17,16,7,35,7,8,9,12,26,53,26,19,59,54,11,7,26,16,6,25,38,10,20,39,20,22,8,8,10,215,42,17,14,7,11,31,70,19,7,36,18,16,24,32,21,12,3,15,20,23,34,20,75,34,44,11,8,6,8,12,19,50,20,15,17,14,24,16,10,19,25,36,34,25,14,18,24,11,30,26,16,9,6,9,13,21,35,44,2,1,5,16,13,34,31,56,17,12,17,25,24,12,21,39,16,25,26,5,10,41,13,22,9,10,12,4,50,19,60,35,13,16,6,17,25,9,20,16,12,14,39,7,3,18,18,21,11,18,5,32,30,48,15,12,48,37,22,21,11,8,18,4,24,35,15,18,10,6,16,30,4,7,30,11,32,10,8,32,19,19,17,13,5,14,29,48,3,15,6,7,10,16,17,22,20,10,18,9,29,7,25,16,19,19,6,12,9,12,5,23,13,12,7,16,4,12,24,14,8,9,10,16,38,21,15,29,24,58,22,8,8,9,7,9,8,16,13,5,8,33,35,34,24,17,9,8,13,9,11,7,11,9,22,6,13,15,1,4,14,11,3,18,12,28,5,27,2,20,22,13,6,12,5,15,3,13,13,6,12,8,19,14,12,7,10,17,6,7,13,28,5,4,6,17,16,5,4,12,7,33,8,12,14,16,20,13,10,7,12,3,12,17,5,12,7,15,10,10,10,19,8,6,10,16,6,8,5,17,16,32,10,48,9,10,4,28,11,13,42,5,15,20,10,12,5,7,8,12,17,9,4,7,7,1,5,21,6,7,16,15,24,8,24,16,6,24,6,11,7,6,3,23,10,18,13,14,13,20,19,11,9,5,6,8,7,11,10,11,10,7
among,22,59,30,324,25,21,23,88,13,15,65,24,25,315,20,28,12,43,24,20,14,114,34,61,59,22,43,36,25,40,39,443,300,19,185,225,211,21,25,19,15,51,11,13,96,42,53,42,692,82,96,28,46,157,41,24,144,75,10,57,57,22,12,40,62,21,338,23,29,33,34,8,12,5,235,37,72,11,191,48,111,6,45,31,466,41,32,0,91,5,22,28,1,76,131,16,50,18,89,52,21,71,70,29,43,86,13,8,45,14,65,20,17,45,8,75,19,16,117,343,99,68,32,144,18,11,19,14,6,2,52,17,46,127,63,114,29,12,17,29,14,116,51,11,14,189,10,54,48,37,195,6,31,22,27,70,104,17,32,46,17,12,35,4,7,21,26,66,86,28,43,275,65,6,14,30,315,10,27,106,58,46,25,48,9,77,100,59,96,72,8,18,13,7,11,10,54,25,24,66,71,9,12,45,92,24,15,90,29,73,193,20,56,35,9,2,2,5,29,8,15,76,16,33,87,237,72,77,16,12,45,40,38,59,97,60,98,39,25,29,170,109,24,41,50,14,17,62,108,16,25,56,48,18,30,49,29,2,12,63,23,73,40,11,21,81,33,24,48,22,340,27,57,26,10,2,74,30,26,4,166,22,12,61,34,11,15,24,30,6,8,13,28,21,9,14,81,18,14,79,66,81,4,4,42,9,77,17,29,11,7,49,55,23,90,41,53,96,39,21,134,26,104,24,166,15,31,76,13,86,19,41,22,19,34,34,58,30,9,27,22,24,57,26,19,14,99,118,46,29,28,38,28,87,42,14,16,18,49,70,63,32,26,53,13,5,79,32,25,43,5,57,18,49,30,60,22,18,54,16,175,13,108,48,17,108,24,61,69,24,74,17,20,22,71,15,112,9,82,14,68,19,18,14,14,33,16,14,85,49,24,40,29,49,25,28,23,24,14,11,22,29,55,42,9,21,15,38,31,51,32,12,7,23,17,14,6,34,35,14,46,79,13,53,12,17,26,21,117,28,58,19,17,16,131,33,10,28,33,71,33,82,1,147,24,26,75,33,17,4,73,17,10,14,18,83,33,31,66,23,17,40,24,15,23,22,21,19,28,7,228,97,17,23,37,24,16,40,18,44,42,18,9,12,35,61,17,61,21,17,11,13,21,19,44,38,13,36,23,44,29,66,25,70,18,21,68,30,35,68,29,23,9,30,29,24,21,33,93,45,15,12,10,29,17,18,11,48,45,16,92,21,17,121,43,36,80,7,7,29,58,6,51,20,37,47,45,22,93,102,36,19,37,8,28,14,24,17,17,43,23,26,35,33,18,31,16,18,7,27,61,81,26,10,92,23,38,19,115,68,64,8,19,8,14,57,11,45,33,23,66,31,23,21,81,18,79,22,15,9,34,29,7,36,11,23,18,21,37,95,34,75,57,50,26,8,39,17,12,27,60,23,20,54,27,85,19,16,16,370,76,11,25,17,19,35,79,48,17,23,14,21,21,30,14,10,16,31,25,28,44,20,73,66,64,17,12,18,6,25,6,68,43,20,30,27,36,10,11,19,21,40,56,12,9,26,15,8,30,21,27,11,12,28,29,19,45,22,7,7,15,19,23,62,57,66,26,24,16,17,24,19,20,83,4,36,17,8,19,39,16,43,9,19,18,9,61,14,96,38,35,21,6,34,31,17,34,28,19,34,30,11,8,21,11,32,18,39,13,55,48,42,8,5,45,55,34,26,36,32,21,12,17,40,10,27,19,8,92,33,73,15,39,16,38,24,16,18,25,32,13,24,7,13,28,40,6,27,15,11,11,13,37,11,28,11,21,14,35,23,23,12,20,15,17,11,10,24,10,24,15,12,40,29,4,17,9,13,31,14,27,21,38,13,29,36,18,94,23,10,14,23,18,17,14,23,22,37,19,38,32,54,23,21,4,18,31,23,16,5,18,14,18,28,19,24,21,7,16,27,20,17,16,35,14,35,7,27,21,18,7,10,14,10,24,12,21,11,22,16,8,32,0,11,15,16,11,13,11,15,12,9,11,25,22,6,12,16,9,50,16,13,20,25,16,13,13,11,20,12,25,22,8,23,10,17,9,24,9,12,23,9,16,23,8,11,20,15,20,38,9,35,10,15,16,37,29,22,59,10,11,15,21,19,4,9,11,6,34,17,5,20,7,12,1,32,32,8,19,18,42,11,23,22,18,15,9,13,19,20,7,16,8,22,19,15,27,17,23,5,20,13,9,8,3,9,12,11,6,24
men,11,39,23,194,61,46,28,79,13,30,46,17,45,267,13,41,25,66,14,15,12,117,81,107,92,57,94,61,42,109,59,484,347,118,210,239,164,4,19,39,24,62,15,18,103,53,39,46,404,129,136,41,26,192,31,26,137,59,42,47,27,21,5,34,61,50,236,30,26,59,56,19,21,21,415,40,106,14,229,118,205,5,26,66,367,42,57,2,100,11,42,29,1,77,119,45,38,16,90,50,16,69,58,47,63,90,24,15,51,14,56,11,28,57,18,90,6,25,155,428,146,105,64,241,37,27,17,8,13,7,53,28,61,152,107,209,54,9,15,26,45,167,41,17,12,229,33,50,66,24,145,11,68,24,25,47,195,19,18,71,30,16,33,17,13,68,46,87,77,27,67,344,77,14,32,42,378,23,34,215,96,26,18,106,18,93,106,78,84,116,10,30,6,9,9,12,54,30,41,45,167,15,11,19,61,38,23,77,22,53,261,69,43,18,25,8,2,15,52,4,6,67,16,55,90,255,134,111,40,22,54,89,58,48,99,12,86,30,15,51,203,99,37,53,92,21,16,158,155,22,22,56,65,16,17,51,30,6,9,160,36,179,21,7,22,106,17,44,58,15,259,12,26,24,23,6,60,17,18,6,210,33,8,102,31,9,28,48,76,6,12,11,22,15,4,16,72,10,21,87,87,50,14,4,33,15,73,32,41,7,7,75,70,23,110,40,57,86,55,22,67,29,114,27,137,6,44,111,9,95,32,53,32,24,27,17,58,18,9,31,23,51,37,20,26,23,74,102,33,33,32,31,32,97,54,19,22,59,42,100,70,27,30,72,14,11,60,64,28,97,6,93,9,71,50,257,52,13,108,7,180,12,106,39,191,89,28,47,75,20,76,24,18,14,49,36,56,17,102,17,36,18,24,13,20,75,24,6,37,48,42,18,7,69,17,24,12,32,15,35,48,50,53,20,23,16,13,60,37,44,16,6,8,41,40,8,3,17,36,27,54,39,22,30,11,29,86,25,116,24,44,12,35,10,138,33,20,20,63,41,68,105,147,1,70,39,86,35,24,12,141,34,9,27,25,264,12,29,115,39,53,49,10,15,24,25,28,26,33,13,398,95,29,22,35,7,28,34,31,45,70,37,19,14,49,30,35,25,20,19,11,20,15,29,41,32,14,40,22,35,13,66,9,88,15,16,65,67,45,70,61,51,29,65,19,46,20,57,106,69,8,6,27,39,18,10,17,23,40,23,66,8,29,89,43,53,42,8,13,19,39,9,29,17,19,25,55,18,82,105,25,3,12,8,12,4,8,16,16,48,4,36,44,54,23,65,21,29,15,73,64,78,31,15,159,23,57,24,15,31,34,12,10,0,7,34,10,32,12,6,97,44,22,14,76,15,41,15,25,8,33,5,15,36,10,14,4,23,42,73,9,43,110,73,38,15,76,42,33,42,103,18,46,56,18,93,20,10,20,204,67,31,19,11,15,42,55,44,18,32,17,16,3,14,9,2,3,21,32,21,41,23,25,56,25,20,13,7,10,11,9,68,34,21,23,34,19,12,14,36,21,46,16,22,20,32,19,4,31,17,35,25,4,19,28,35,39,44,11,2,8,18,13,33,30,280,73,18,13,71,57,47,20,296,62,29,26,32,28,43,45,43,4,32,7,19,235,14,30,20,37,6,19,128,93,24,32,12,35,34,40,3,12,23,14,29,14,29,3,28,29,62,2,11,30,23,31,27,17,7,27,20,16,30,10,21,18,15,34,19,12,11,20,17,25,18,15,6,36,36,12,12,8,12,55,32,23,21,10,13,9,13,29,3,46,29,21,30,26,18,5,5,18,17,19,8,7,18,8,12,6,5,5,54,7,13,42,12,9,4,20,7,27,25,20,29,26,48,20,9,7,10,10,15,21,18,36,6,19,47,17,57,16,11,13,14,33,5,16,6,1,15,10,16,14,13,27,3,7,22,13,13,3,14,18,10,1,12,14,16,7,11,11,4,17,6,13,13,13,10,23,16,5,7,1,7,13,11,20,108,13,7,29,29,16,8,12,5,5,26,8,11,21,8,31,20,26,8,21,9,15,10,28,7,9,10,10,7,2,4,3,10,9,4,12,9,9,15,15,21,23,58,7,4,8,11,18,33,22,4,52,17,23,20,12,12,9,15,33,5,4,6,12,15,9,50,10,16,13,13,68,12,17,30,0,4,39,12,21,9,2,22,5,6,7,26,31,14,23,17,14,12,16,12,2,14,14,5,8,26
field,4,6,4,85,9,7,3,20,3,2,4,15,14,55,3,5,2,11,6,5,3,23,15,16,18,16,28,13,12,12,23,150,93,25,40,40,45,4,4,10,4,6,0,4,17,12,14,15,122,29,23,12,9,39,13,4,37,26,10,14,10,0,4,6,14,8,64,11,1,33,15,1,3,1,74,6,10,1,58,8,46,2,13,4,108,11,16,1,19,2,3,5,3,13,17,4,14,5,31,23,7,29,9,7,11,17,1,3,19,4,18,6,11,8,7,21,1,3,48,134,28,17,10,68,9,8,4,0,3,2,11,4,6,53,15,66,2,6,7,11,11,34,13,3,5,43,2,11,23,10,32,6,10,8,10,18,35,7,5,19,7,3,5,1,4,18,18,20,19,7,19,77,28,3,3,2,90,5,23,42,16,12,13,23,3,23,29,18,27,29,1,3,16,0,3,3,10,5,12,7,30,2,6,12,23,4,2,27,12,21,55,6,17,8,3,4,1,4,9,4,1,8,2,24,39,45,20,13,18,19,13,22,9,7,24,5,10,15,14,5,41,33,6,9,15,5,6,31,37,2,8,14,11,5,7,8,5,4,8,28,6,35,7,2,5,35,17,4,8,2,75,3,15,1,3,3,14,1,10,3,68,4,12,39,9,6,10,12,10,2,4,0,10,2,3,5,13,3,3,10,12,19,3,3,3,2,17,4,7,8,4,24,13,11,13,20,11,37,16,9,26,4,20,8,26,2,15,18,2,20,6,14,4,5,8,5,12,7,7,10,2,6,7,3,4,7,17,23,17,7,4,3,5,19,16,6,1,7,13,21,17,10,16,18,11,3,21,10,5,13,1,20,7,4,11,63,24,1,16,4,36,2,28,5,5,14,2,20,16,4,13,5,9,1,17,7,20,8,15,4,18,2,6,2,5,4,3,2,27,16,4,10,9,22,2,11,5,4,5,4,4,19,11,8,3,1,10,7,7,8,9,3,0,18,5,5,2,4,5,9,12,14,6,7,5,2,7,4,14,3,9,3,4,4,32,12,4,2,6,10,6,28,24,70,1,7,31,22,15,1,13,4,1,6,6,39,4,3,22,9,5,6,4,2,7,0,12,1,9,5,108,24,9,4,5,3,5,7,6,5,7,11,9,5,3,31,20,10,6,3,3,5,4,13,10,10,7,7,1,9,2,11,1,19,4,1,14,7,12,13,16,10,12,10,6,16,8,4,19,8,3,2,0,26,9,2,2,11,3,5,13,4,4,24,6,12,19,4,4,2,15,3,15,2,14,11,13,5,19,32,10,8,11,10,3,0,1,2,8,20,8,14,10,7,4,2,4,2,5,9,9,12,7,7,28,7,8,8,9,9,12,1,5,0,4,8,7,9,7,1,11,16,10,4,14,6,12,4,10,5,8,16,5,13,7,3,6,10,8,25,14,16,10,15,12,4,19,8,1,7,15,3,5,11,6,24,7,2,7,58,9,5,1,2,3,8,23,7,5,12,1,4,3,8,5,3,4,4,11,8,12,5,23,6,13,5,5,6,2,2,1,8,4,8,8,12,2,6,4,12,9,18,5,6,5,14,4,0,3,8,3,0,2,7,9,11,15,6,10,2,2,3,3,18,7,95,30,1,6,18,7,5,9,49,10,13,6,5,9,14,5,14,5,4,4,14,16,8,15,13,9,4,4,8,5,7,13,15,12,14,7,3,1,4,2,9,6,11,7,5,5,7,2,1,20,8,9,1,26,4,9,5,3,15,5,3,10,5,15,9,1,4,4,2,6,4,8,3,19,8,9,6,4,4,7,8,1,3,3,9,2,3,6,8,4,2,4,1,13,8,6,2,1,7,8,3,4,5,4,4,3,2,3,10,15,2,6,4,11,4,0,2,7,8,11,4,8,13,15,2,2,0,2,2,5,1,5,7,3,4,4,10,0,2,7,5,5,3,2,1,4,2,8,7,6,2,3,3,2,9,7,3,2,12,3,5,0,4,1,0,0,3,9,2,6,6,7,10,6,6,5,5,0,2,3,1,1,7,5,6,6,9,4,2,4,0,2,2,3,14,3,1,4,3,9,1,6,1,5,3,6,2,2,1,7,3,1,0,2,11,2,5,2,3,3,2,4,3,2,12,2,16,1,0,8,4,3,4,11,2,12,3,9,5,3,2,13,4,12,0,2,1,6,4,2,2,6,0,0,1,25,4,1,6,0,1,5,4,6,3,1,5,5,11,3,2,7,9,5,14,5,5,4,2,5,3,11,4,10,1
philippine,0,7,2,52,8,3,17,2,2,0,4,0,4,26,0,22,7,4,5,0,0,19,12,26,10,5,22,8,9,12,5,95,21,21,45,57,33,1,0,2,2,4,3,2,26,5,4,15,106,22,21,12,8,22,1,6,28,17,5,12,2,3,3,10,6,5,150,12,2,12,5,12,1,0,92,8,45,1,57,13,24,0,0,17,72,3,10,0,16,2,2,5,0,25,34,2,5,10,27,6,8,18,12,10,1,17,0,4,3,2,9,1,1,8,1,9,0,0,37,44,41,31,1,32,4,2,19,0,1,0,14,6,5,32,13,50,9,1,8,6,11,10,14,8,0,44,2,3,12,1,26,8,6,3,1,1,44,0,23,25,1,0,7,4,0,10,18,22,7,4,13,56,44,2,5,1,102,14,4,49,29,0,3,17,6,25,12,23,7,13,5,1,20,1,2,1,5,12,3,5,26,0,5,8,4,10,0,11,1,18,98,12,8,9,7,2,1,2,6,1,0,12,2,13,15,53,35,9,19,0,19,6,13,7,18,7,14,5,4,10,13,6,1,15,4,1,4,34,32,1,12,10,21,3,0,5,4,1,3,18,4,38,7,1,6,8,2,11,9,0,63,0,8,1,1,1,4,7,0,1,41,2,0,4,2,1,2,3,6,1,5,6,16,1,2,3,12,3,3,4,13,18,0,12,3,2,35,0,11,0,2,5,9,5,11,7,10,8,7,1,6,3,20,6,19,2,14,18,0,18,5,2,3,0,18,35,9,1,1,0,5,13,9,1,8,7,7,19,14,2,12,7,3,7,5,3,4,13,3,18,7,3,32,7,2,2,5,6,5,16,10,15,1,8,0,41,9,3,7,1,30,6,12,3,3,11,2,5,3,0,18,3,2,4,6,16,6,6,24,3,5,5,3,7,1,0,2,0,15,4,0,9,1,14,13,5,3,2,3,5,0,3,8,5,4,2,3,6,8,12,1,0,1,5,6,2,1,5,10,6,3,15,8,1,17,5,22,6,20,4,6,0,10,2,20,7,6,4,4,10,18,29,26,39,7,1,21,9,1,3,13,6,0,5,10,17,0,5,22,10,3,15,0,7,11,11,9,5,4,23,49,12,0,2,2,2,9,1,1,0,7,7,6,1,6,1,0,11,3,1,1,0,7,2,3,3,6,21,0,3,4,2,0,7,2,7,9,1,3,12,4,7,3,4,13,2,5,17,27,0,1,1,3,0,12,0,3,13,0,7,8,1,7,23,8,2,2,1,5,19,6,2,12,3,3,11,6,2,15,21,0,0,2,0,13,3,17,3,11,11,0,9,9,17,3,2,5,16,1,5,11,20,9,3,14,0,5,0,7,10,5,0,1,0,4,8,3,6,4,0,17,26,3,17,3,3,3,3,4,11,3,0,5,7,2,1,3,0,13,10,1,12,19,2,4,3,8,3,2,2,1,6,3,19,1,8,1,7,9,97,280,8,1,0,6,2,25,3,8,10,0,1,0,1,2,2,2,1,0,0,13,1,0,1,7,0,0,0,4,9,3,7,4,5,5,6,17,4,2,12,15,13,4,16,7,10,3,0,10,0,10,0,4,5,4,9,5,6,0,0,28,24,6,23,13,34,19,4,6,13,6,9,0,26,5,2,1,0,1,2,6,7,1,1,0,3,9,7,6,5,0,16,5,9,8,2,2,19,6,3,1,1,0,2,5,13,5,17,4,9,8,28,4,11,3,0,7,3,4,0,14,2,0,0,7,6,0,1,0,1,3,4,9,0,2,4,0,0,2,3,1,0,0,1,8,8,0,3,3,6,5,5,12,1,3,3,1,5,8,2,2,1,0,3,0,3,5,11,0,9,0,1,0,13,0,3,2,0,6,0,1,0,1,1,1,2,0,4,0,0,2,11,1,0,2,2,5,3,2,2,2,21,3,0,6,3,3,0,0,0,3,0,0,5,2,2,2,3,2,11,0,0,0,1,0,1,0,1,5,17,2,10,2,0,5,1,2,0,1,5,2,0,0,0,0,6,0,22,4,5,2,0,12,7,1,0,1,1,4,5,0,0,4,1,3,1,4,1,0,1,0,1,4,0,1,1,0,0,0,0,0,2,0,0,2,0,4,2,3,2,4,12,0,0,0,0,0,0,5,1,5,1,1,1,1,3,7,2,8,1,0,0,0,0,4,1,0,0,0,5,4,3,2,5,0,0,2,0,0,5,7,0,0,0,0,0,0,3,11,1,0,5,0,1,0,0,0,1,0,3
home,9,27,16,198,21,40,17,47,10,16,13,22,47,168,8,13,21,35,29,13,13,68,74,72,32,37,58,51,30,63,19,315,260,49,136,222,113,32,65,35,28,58,11,30,56,22,20,25,281,155,93,26,48,169,90,16,141,31,67,51,18,19,9,32,64,24,260,20,20,14,90,3,20,11,212,30,64,13,125,59,120,24,23,31,264,43,44,11,46,3,23,22,11,77,78,67,30,18,92,65,34,57,44,45,33,55,11,18,44,19,37,12,46,67,58,77,2,11,74,257,82,106,72,183,34,12,10,10,13,11,47,14,39,100,66,177,5,13,14,28,21,112,44,15,8,119,22,41,42,25,70,20,53,15,9,40,125,33,13,127,47,7,27,9,18,61,24,46,61,21,34,184,48,9,30,18,240,18,16,117,35,32,41,52,8,73,76,35,40,61,13,10,47,16,10,7,40,13,28,19,83,19,25,28,47,29,16,69,30,44,160,49,37,33,22,56,9,22,24,9,13,29,7,28,67,173,60,54,24,24,18,30,53,28,64,70,48,34,49,20,119,84,17,24,33,13,12,80,81,19,15,101,35,13,23,21,11,9,7,42,4,94,13,2,18,53,27,64,47,18,195,24,47,9,4,13,66,8,6,2,175,10,15,23,28,17,35,44,29,11,8,13,14,9,2,17,52,4,10,45,56,47,2,3,29,10,40,10,15,7,9,22,55,26,93,33,52,60,33,17,74,16,65,30,104,3,42,100,9,44,23,23,17,5,19,21,51,14,13,15,8,32,64,10,10,14,54,91,30,83,15,21,7,101,29,10,11,14,16,63,39,23,24,32,18,19,44,17,28,71,10,112,15,64,17,33,5,11,35,13,71,9,54,18,51,109,15,52,63,8,40,18,9,9,26,23,69,4,44,13,27,41,5,14,13,22,15,7,69,47,7,15,45,36,28,34,15,14,11,28,7,15,29,6,9,8,11,13,12,30,8,5,0,18,15,11,4,20,34,12,27,41,5,25,4,13,79,30,52,24,64,4,34,9,65,15,22,8,11,42,29,55,75,86,31,21,1,21,11,9,69,26,3,20,10,42,15,7,30,27,13,37,4,18,22,7,18,25,9,4,167,36,18,19,201,8,10,16,23,10,18,8,17,17,15,52,30,25,19,8,19,10,10,13,25,25,11,21,9,24,11,25,9,21,7,4,25,8,27,40,24,19,13,12,17,19,7,15,48,35,16,5,7,24,66,8,5,55,10,8,32,2,2,76,8,13,39,7,9,8,19,3,24,10,21,37,17,7,46,61,23,10,12,4,13,2,47,8,9,47,66,24,25,33,9,13,13,13,15,25,37,43,36,10,59,11,10,33,21,35,24,7,19,4,5,19,10,13,7,14,48,15,12,17,33,8,20,21,7,14,21,18,8,30,13,12,4,22,19,44,44,25,40,26,13,10,15,12,20,13,32,21,4,20,15,23,28,4,17,158,40,9,13,6,10,22,55,32,9,42,8,6,12,11,2,1,0,22,8,9,30,23,20,12,14,7,6,6,6,14,7,38,16,12,20,6,21,12,9,11,14,55,14,8,6,16,19,3,38,8,14,2,8,6,13,13,26,17,7,4,9,6,11,31,22,48,46,8,8,9,19,13,12,29,10,19,14,10,3,31,4,38,30,7,12,1,17,7,40,26,18,13,20,17,29,7,29,27,29,10,26,2,7,7,8,12,6,19,17,44,37,36,9,25,35,54,30,3,26,23,31,7,14,16,9,20,29,7,15,16,3,3,17,11,12,4,22,5,24,19,15,18,11,10,7,28,6,10,8,2,7,7,12,5,25,10,28,10,44,8,49,6,18,8,14,2,9,15,2,13,5,4,4,12,11,6,21,6,29,11,12,8,21,14,19,14,14,49,13,8,1,7,3,5,14,13,18,13,4,21,19,24,7,12,8,19,11,24,4,1,8,7,5,3,11,14,7,4,12,19,4,14,7,22,10,16,0,5,14,19,1,4,12,2,16,2,13,6,15,7,16,3,15,11,7,2,3,10,14,46,24,6,17,15,8,0,1,7,12,20,6,28,9,6,8,7,5,2,10,6,7,9,6,71,5,11,8,4,1,10,9,9,11,13,6,6,10,18,3,21,7,35,4,0,24,24,14,13,26,4,8,16,12,13,5,2,8,2,16,2,17,4,11,5,9,23,11,8,8,6,16,5,28,25,5,7,27,14,5,5,1,10,3,17,9,16,7,32,28,23,5,10,6,12,39,13,16,7,10,23
open,13,14,14,159,4,15,10,42,4,9,27,12,20,113,5,16,13,11,13,5,6,52,21,37,14,26,17,8,7,22,9,224,163,18,55,105,45,13,29,7,10,14,5,7,31,13,33,21,393,77,54,13,15,60,17,7,42,27,12,26,29,15,5,22,25,10,96,9,15,30,25,7,6,9,163,21,34,3,95,38,68,4,27,10,234,13,20,2,52,3,9,8,5,33,62,31,23,8,42,21,16,46,31,22,24,23,4,10,19,13,37,7,21,21,21,42,14,5,87,152,36,54,17,109,20,4,4,6,3,4,23,12,7,71,23,72,5,5,7,14,4,42,41,9,10,82,7,22,23,12,40,6,15,19,17,19,40,8,18,41,12,11,9,6,9,13,8,26,38,9,44,94,56,5,9,5,166,9,17,62,28,17,7,20,18,29,53,34,51,70,7,11,34,4,12,7,15,6,9,13,31,3,7,21,32,4,10,49,27,31,104,24,53,16,4,14,1,3,15,4,2,31,7,13,39,117,29,28,5,14,14,16,20,27,61,27,48,8,15,12,66,47,12,4,21,8,24,42,58,4,10,26,30,4,6,25,14,4,1,22,5,30,26,6,11,46,14,6,47,10,142,4,18,3,6,1,18,11,7,3,69,6,16,16,15,5,7,16,13,11,11,9,17,5,5,22,43,6,12,16,41,19,2,7,17,10,23,5,7,5,5,11,20,6,35,18,28,48,16,4,62,4,47,18,80,8,10,36,8,23,5,12,24,3,7,23,29,12,2,8,11,20,22,8,11,8,40,77,19,10,18,12,7,47,34,23,7,3,17,35,24,14,29,32,17,7,43,16,14,26,2,27,5,7,18,33,8,3,11,18,75,13,47,20,4,88,13,33,33,7,23,6,22,22,39,7,85,5,39,3,22,6,6,5,6,17,7,5,95,24,1,26,17,25,10,26,16,14,6,4,10,13,19,14,10,5,6,16,11,18,8,8,1,16,4,3,5,58,8,9,17,21,13,23,11,9,21,7,48,9,15,0,9,6,90,11,3,25,11,31,19,21,33,35,22,9,21,1,26,5,21,15,8,6,8,21,1,9,16,17,10,18,12,2,14,9,23,6,7,10,60,40,3,3,9,15,7,6,4,7,12,3,8,2,21,11,17,15,5,6,5,4,9,17,12,19,6,8,0,13,6,17,8,21,2,9,42,10,20,24,12,5,4,8,22,9,20,16,53,43,15,5,2,25,35,15,25,17,12,18,25,5,12,47,3,11,76,6,7,9,29,12,21,3,13,11,16,3,33,62,12,13,8,6,4,11,12,6,5,20,10,19,33,21,8,13,7,5,19,18,24,39,5,0,22,11,4,13,91,27,21,4,5,4,21,26,9,24,9,4,40,38,22,19,29,2,26,18,12,9,7,3,6,10,6,6,18,12,11,58,12,10,29,23,12,7,12,4,9,9,7,3,7,9,20,22,6,12,9,254,19,12,8,4,18,26,44,14,8,20,6,17,21,56,13,19,2,13,21,9,19,8,31,24,30,3,4,19,16,12,15,32,11,19,14,6,8,5,8,10,33,38,12,22,16,21,15,5,10,18,34,6,5,17,8,3,15,4,22,3,6,24,9,30,17,22,11,7,16,11,9,6,4,21,0,17,13,7,12,16,8,16,8,5,14,10,13,6,41,21,26,11,7,20,29,5,14,23,14,8,5,3,4,17,4,22,13,15,8,16,14,15,7,6,29,12,18,14,16,42,9,17,2,28,1,18,10,3,21,11,5,4,20,4,11,10,4,2,8,14,13,10,6,2,21,15,16,4,5,12,11,7,10,4,5,11,8,8,16,15,9,12,40,11,16,3,7,14,12,15,6,4,12,8,10,11,8,9,5,4,10,9,6,10,8,15,10,22,19,6,7,2,10,11,5,6,16,34,5,14,38,19,14,13,2,5,17,5,6,5,24,16,2,1,11,16,6,3,10,11,4,4,9,9,9,4,1,10,8,28,3,12,3,8,9,6,4,4,14,10,14,50,13,5,10,25,12,2,7,9,12,7,7,7,7,13,13,13,7,22,3,3,8,8,21,7,9,41,6,8,7,6,6,16,13,12,4,25,7,4,6,7,5,11,4,4,6,7,8,11,2,5,7,4,8,14,4,10,10,9,3,5,11,3,5,3,11,14,10,15,22,18,10,4,8,34,5,4,1,16,8,5,11,5,8,17,5,8,10,10,10,12,5,4,5,2,17,17,23,2,7,2,2,5,4,4,9,6,5,6
water,9,20,2,130,11,11,5,8,3,1,7,9,13,80,18,7,4,35,6,1,2,25,7,14,18,7,12,7,3,14,7,203,84,4,46,24,18,6,6,2,7,5,9,8,23,24,23,20,285,19,30,8,6,14,20,6,18,28,1,14,17,5,2,13,10,6,42,4,4,11,15,26,7,5,88,18,29,6,51,23,35,1,12,10,218,11,68,0,27,3,4,4,6,28,39,10,27,9,22,9,47,42,29,5,10,20,2,12,9,2,24,6,12,58,3,41,6,14,79,122,38,14,0,53,12,2,4,3,5,5,12,5,10,57,14,104,3,2,11,9,2,39,16,4,4,72,17,25,24,14,109,7,8,52,10,47,33,8,10,17,18,13,23,4,10,19,7,10,14,3,20,81,29,7,3,4,186,11,20,47,43,23,14,29,13,21,44,27,34,50,4,7,6,1,3,5,34,1,8,24,24,3,9,6,15,8,21,12,7,24,67,12,23,8,0,4,0,3,6,51,2,12,12,20,53,66,20,22,6,6,13,15,15,64,25,9,23,7,14,12,60,29,6,3,11,8,5,14,56,6,16,17,11,5,11,16,4,4,2,12,4,16,16,5,5,31,3,4,26,6,127,7,8,16,5,0,39,11,12,2,36,5,7,19,17,13,10,6,3,0,2,7,13,3,6,10,18,6,8,9,18,36,0,2,25,0,21,1,5,9,1,38,17,6,8,8,14,43,7,8,25,2,28,9,88,18,13,25,1,18,1,10,3,14,6,44,16,4,2,2,10,17,15,9,6,16,23,55,19,7,17,3,8,95,32,7,5,4,20,14,33,23,37,42,9,2,27,4,5,12,5,15,14,11,11,23,6,8,6,14,45,1,55,12,3,128,9,11,18,0,14,4,3,5,30,4,67,3,24,9,12,8,7,0,6,7,9,4,8,7,2,15,2,8,22,11,3,9,2,0,2,4,28,13,4,10,1,11,9,17,4,2,7,7,2,1,0,5,8,4,17,47,19,3,5,4,30,8,42,14,15,6,4,4,74,11,0,10,12,11,8,5,17,24,15,1,11,26,1,1,21,4,9,14,5,12,2,1,30,5,11,10,1,10,13,4,7,0,6,1,54,25,1,3,3,9,9,11,11,4,22,5,4,2,9,9,10,4,2,1,0,2,6,26,11,29,6,12,0,15,4,16,20,31,10,10,16,11,12,18,7,2,13,3,24,9,12,9,44,33,7,5,1,6,6,7,2,10,4,10,17,6,5,66,0,7,50,2,6,6,15,7,11,5,6,16,14,5,39,46,14,3,17,3,7,2,0,5,4,23,3,8,13,11,6,4,10,4,8,6,15,42,12,10,11,12,7,0,27,11,26,7,6,1,11,17,3,6,9,9,19,22,3,3,23,15,17,4,11,7,18,0,5,7,14,8,10,9,5,25,1,15,22,12,5,3,12,10,2,17,2,0,4,8,5,18,2,1,10,146,20,19,3,3,7,15,51,25,6,15,7,17,17,18,9,2,4,2,8,2,23,6,28,8,19,5,3,7,3,6,41,35,17,9,5,6,5,2,4,18,6,8,9,24,5,25,8,2,6,14,12,10,4,6,4,8,17,7,0,0,4,4,1,26,13,10,0,11,0,7,7,2,4,15,1,27,2,2,0,8,6,19,6,1,1,4,22,9,37,18,7,5,9,22,42,10,10,70,6,6,9,0,3,7,1,22,9,7,13,1,0,5,1,1,20,28,22,3,18,15,30,14,1,8,5,18,5,7,1,1,1,0,6,1,4,12,3,0,5,8,2,9,9,2,23,9,13,7,7,2,0,2,10,7,4,8,5,4,15,10,5,7,20,6,10,8,7,10,4,17,0,0,4,17,46,2,8,3,2,3,7,4,2,0,3,3,7,15,25,6,3,14,0,9,6,9,11,15,4,6,29,38,6,9,16,1,7,3,7,2,9,9,2,6,2,2,14,3,11,3,13,2,2,0,1,3,5,4,2,4,5,2,4,1,17,3,2,3,8,2,10,103,1,2,2,12,6,2,6,6,9,5,1,10,0,4,0,8,5,32,7,5,7,5,6,3,3,89,4,3,5,5,9,5,1,9,3,2,7,1,4,2,3,4,5,2,6,3,3,37,0,9,2,2,2,8,4,10,8,8,13,4,1,1,4,2,14,19,18,2,17,31,1,3,3,55,7,0,2,23,5,3,10,8,2,3,2,4,24,8,0,8,8,1,3,0,17,7,21,8,0,4,3,1,3,3,0,2,4,0
hard,3,8,1,18,1,11,2,6,0,4,1,2,6,29,0,1,1,4,9,3,7,5,16,10,14,11,9,12,1,7,0,50,24,2,10,60,6,1,9,2,2,2,2,3,14,6,3,2,23,28,5,8,4,14,17,0,4,1,8,4,0,5,0,1,10,5,37,0,2,4,21,1,3,4,30,6,17,0,31,17,8,1,0,2,18,4,1,1,4,1,7,1,6,6,6,2,5,2,8,2,0,10,3,6,5,2,0,5,2,3,3,0,13,6,12,17,0,4,5,26,8,26,20,39,8,1,0,3,2,3,6,1,4,13,5,99,5,1,1,3,5,5,3,0,3,20,6,11,3,0,5,5,4,2,5,2,18,7,4,31,8,1,11,1,3,28,0,5,10,4,2,25,13,12,9,1,9,0,2,23,3,4,2,6,0,4,13,3,6,9,0,2,3,2,2,0,7,3,3,0,17,5,3,1,2,8,0,6,1,5,13,6,8,9,11,31,4,3,3,0,0,5,1,2,5,12,5,8,4,8,3,4,6,5,11,4,4,0,2,1,9,14,5,6,6,4,6,10,10,1,2,3,4,0,0,7,2,0,0,3,4,5,0,0,5,3,4,8,2,1,14,1,1,1,0,5,5,3,0,0,21,2,6,5,3,1,9,7,5,5,0,2,5,3,0,0,0,1,3,8,13,2,0,0,1,4,3,1,3,0,1,3,8,6,10,1,4,4,4,1,6,2,21,6,11,0,6,21,0,7,3,2,1,0,1,1,6,1,2,2,3,8,12,1,2,2,3,8,1,22,2,1,0,9,4,0,0,0,1,9,2,3,3,3,0,7,5,3,14,22,1,9,1,7,6,1,1,0,9,1,6,2,4,1,3,7,3,6,5,0,1,4,0,1,0,2,1,1,8,1,6,3,2,3,1,6,0,0,5,3,2,2,1,6,3,2,0,2,4,1,0,1,8,0,4,0,0,5,0,3,0,0,0,0,6,0,1,0,1,0,2,2,1,1,1,5,16,5,2,5,7,0,4,0,11,1,0,3,2,1,10,4,4,12,1,3,9,5,1,1,14,4,2,2,5,10,2,1,3,5,2,3,0,1,5,1,0,1,0,0,12,3,0,3,4,0,0,1,3,3,2,4,0,2,4,0,2,1,3,2,1,2,0,2,3,1,1,4,0,2,1,4,0,3,0,3,4,3,2,1,1,1,2,1,1,3,0,4,11,3,0,1,6,3,0,2,0,2,1,1,1,1,1,3,0,1,0,0,0,2,0,1,2,0,1,3,1,1,0,8,3,0,0,3,0,0,0,0,0,5,3,0,0,10,2,2,1,0,0,2,3,2,2,0,7,1,4,5,2,0,1,0,2,0,0,6,3,0,0,0,2,0,0,2,5,0,0,1,1,0,1,0,0,6,1,0,0,0,1,2,0,0,5,2,0,1,7,0,2,0,5,4,0,1,0,1,2,0,5,14,5,2,1,1,0,1,1,4,1,1,0,2,0,2,0,0,0,0,2,2,0,0,0,2,0,0,0,0,1,0,1,4,2,1,1,0,0,2,0,0,0,9,0,1,0,0,0,0,1,0,0,0,0,2,0,2,5,1,0,0,0,1,0,2,2,2,4,2,4,1,0,4,0,1,1,2,3,2,5,3,0,2,1,2,0,0,0,2,3,0,0,1,1,0,0,1,2,1,2,2,4,1,0,2,3,2,1,1,0,6,7,3,0,1,0,7,1,1,2,1,0,2,4,3,0,3,4,0,2,0,1,0,2,2,4,1,0,0,1,2,0,0,0,0,1,2,0,1,0,0,0,0,0,0,3,9,0,1,2,1,0,0,0,0,0,1,0,6,0,1,0,0,0,4,0,2,11,1,0,1,2,0,0,1,6,2,0,7,0,1,0,0,0,5,1,0,1,1,0,4,7,1,1,0,3,0,0,1,0,3,0,3,0,2,0,0,2,0,1,1,5,0,1,0,1,0,0,2,1,2,0,0,1,0,0,0,0,0,0,0,1,1,10,0,0,0,0,2,4,7,0,0,2,0,3,0,0,1,2,2,1,5,1,0,3,1,0,0,3,0,0,0,0,0,1,1,0,2,2,0,0,0,0,0,0,0,0,0,2,1,0,2,1,0,0,1,2,0,1,0,0,0,1,0,0,1,3,0,0,0,1,0,0,0,2,0,0,5,2,0,3,1,4,5,0,0,0,1,1,0,0,0,0,0,1,0,2,6,1,6,0,1,0,1,0,5,7,0,1,3
life,11,62,24,186,27,40,9,40,5,24,34,8,45,166,8,50,19,31,24,22,11,60,83,84,56,53,56,52,33,77,15,358,255,51,127,212,103,10,23,10,36,63,10,17,69,27,46,12,320,152,71,24,34,131,121,30,80,36,62,40,17,11,9,39,48,28,266,22,26,34,63,15,17,6,230,44,77,12,107,67,89,4,16,32,292,21,27,1,62,1,15,21,7,46,63,24,43,15,68,40,15,55,44,35,39,80,15,14,33,12,41,7,23,37,21,74,10,10,78,255,61,134,55,189,29,29,12,13,5,6,54,25,63,101,84,173,16,9,18,36,22,87,35,9,14,139,21,45,18,13,92,10,21,17,26,54,117,15,20,101,34,4,90,13,10,46,31,47,71,18,28,235,64,14,26,15,243,14,26,120,40,37,36,48,9,67,62,40,53,68,9,21,25,12,19,10,20,25,15,32,29,18,3,23,39,35,2,51,31,44,202,35,66,18,23,34,3,13,27,2,1,51,10,19,57,169,66,59,29,16,32,29,39,31,79,25,71,27,22,25,125,69,46,28,54,16,14,78,62,15,19,36,45,5,3,33,19,6,6,51,26,82,14,4,19,45,41,32,48,17,162,19,21,23,12,9,91,9,9,5,184,20,15,43,30,5,50,42,37,12,6,11,25,17,8,10,51,13,9,43,49,42,1,8,35,13,44,8,36,7,8,37,65,17,68,29,39,77,29,13,99,17,70,50,126,17,36,113,7,66,18,17,17,11,19,21,49,10,2,13,17,44,83,16,9,35,37,70,35,75,21,24,14,75,38,7,10,10,23,70,43,51,27,30,4,25,56,44,32,77,7,78,9,53,24,64,17,5,47,7,119,6,95,23,57,62,33,60,43,31,36,21,25,14,29,27,64,4,76,6,32,25,10,20,12,16,9,5,18,30,22,15,5,43,35,28,11,27,14,24,13,28,47,22,16,6,8,28,13,30,11,12,3,21,16,3,7,15,27,12,35,49,7,19,6,10,55,22,63,21,57,9,27,20,88,14,22,11,28,23,36,53,73,141,13,13,69,21,21,14,1,34,10,24,11,97,17,16,48,21,34,22,9,19,18,10,17,23,9,5,148,45,15,17,21,12,5,14,9,16,25,7,13,27,13,6,40,13,10,13,5,9,8,5,26,6,19,20,15,19,29,135,8,32,17,12,50,12,28,32,24,28,22,26,13,14,9,12,78,21,3,5,17,44,17,8,37,28,14,13,45,5,12,62,8,14,47,6,13,14,28,11,30,10,15,26,32,18,42,65,21,11,13,13,17,0,11,17,12,33,11,18,22,43,9,35,16,10,3,28,35,43,20,10,77,15,24,25,36,21,29,7,9,1,7,36,12,15,8,5,47,17,15,16,52,14,20,7,15,5,15,3,8,27,10,8,4,3,27,49,7,23,43,39,14,9,38,11,28,25,47,28,33,36,6,32,14,13,17,170,35,21,16,8,10,29,42,28,8,25,17,10,10,13,9,5,2,9,9,20,38,19,50,48,17,15,11,5,23,6,13,50,16,15,12,16,18,9,8,15,14,59,12,13,6,18,17,9,19,16,19,9,7,7,7,14,15,15,7,2,7,19,8,38,27,42,40,9,17,12,18,18,16,50,22,11,10,15,12,21,7,20,10,12,5,7,26,15,32,15,16,1,10,25,26,7,26,21,16,19,22,4,1,15,6,26,20,20,5,11,13,22,6,13,54,39,37,10,26,10,17,10,24,36,9,39,11,11,49,14,13,14,22,5,13,18,13,11,10,25,6,12,6,14,35,22,16,10,6,1,7,14,15,5,24,13,11,18,26,15,6,10,5,12,7,8,14,14,3,10,5,7,12,10,13,5,20,10,6,8,17,19,19,9,22,11,19,52,12,5,3,8,5,25,30,6,11,22,5,31,24,37,14,9,17,8,14,4,8,6,5,21,12,10,16,20,19,3,14,15,3,2,7,9,12,3,2,8,17,20,4,5,6,5,14,6,9,7,25,4,26,12,16,8,17,21,12,11,13,44,11,5,16,13,12,8,11,5,6,24,2,6,7,2,10,5,6,11,11,4,3,10,3,13,3,3,5,10,5,0,8,5,7,6,5,3,3,12,18,17,5,36,8,2,9,5,26,19,15,9,11,23,17,6,6,2,10,10,13,4,3,14,11,15,5,18,7,11,2,14,25,15,22,24,4,4,17,8,12,9,7,9,4,4,19,18,13,24,13,24,14,11,2,10,1,9,11,3,21,17
stop,2,12,5,49,3,19,0,13,5,2,1,5,19,63,2,3,16,11,10,3,3,23,48,33,14,38,22,18,12,21,6,96,55,16,31,77,26,3,5,6,5,12,2,9,22,9,14,11,60,57,38,18,9,43,25,11,8,3,13,14,1,8,1,5,13,7,71,1,6,11,17,2,5,8,139,15,34,9,54,26,28,6,5,14,66,17,9,5,7,0,10,4,9,12,28,29,20,2,34,6,2,10,11,16,12,14,4,11,12,6,9,1,4,11,16,16,1,3,30,79,25,41,19,65,8,2,6,2,6,3,26,10,11,31,25,64,8,1,12,8,10,25,12,3,1,66,11,10,16,5,41,20,10,6,11,13,31,7,1,44,16,9,10,4,7,31,5,29,12,3,26,73,28,4,9,9,51,2,9,60,25,3,13,45,1,27,30,19,12,13,3,5,4,4,3,0,14,8,3,13,27,4,4,8,10,8,5,23,11,5,64,19,17,4,11,50,4,10,4,0,2,13,5,15,14,66,21,9,6,7,15,7,14,19,24,3,19,3,7,10,42,22,15,17,9,5,7,32,18,10,9,9,11,0,4,13,7,0,0,10,4,35,2,2,2,5,10,8,11,3,36,7,5,2,1,5,19,1,0,3,47,9,2,7,5,0,18,19,9,12,0,5,10,4,2,5,19,11,4,15,9,3,0,2,2,2,15,2,1,0,1,12,15,8,18,6,4,24,10,2,22,6,30,14,46,1,10,52,3,19,8,13,2,3,3,6,18,4,0,4,8,19,21,1,4,6,10,18,10,19,4,7,3,55,15,10,3,0,8,27,9,3,15,18,1,5,16,6,10,33,4,25,2,15,14,1,2,4,9,5,36,2,10,8,17,21,11,11,12,3,14,8,7,1,4,4,6,2,18,3,8,5,3,5,3,6,7,0,12,8,0,6,3,7,24,9,4,13,4,15,5,6,16,11,6,4,1,5,4,9,4,0,0,7,8,3,2,7,9,6,7,4,1,7,4,10,24,9,17,10,25,2,13,2,22,5,4,8,17,19,9,13,17,34,4,6,26,15,4,4,34,1,0,2,4,19,5,5,13,11,12,8,0,3,4,6,2,10,12,2,41,11,6,3,5,0,1,3,1,13,6,3,1,10,8,11,7,6,6,11,1,6,1,12,5,10,11,9,12,9,4,13,6,14,7,10,28,24,7,11,22,6,10,10,5,10,6,12,20,25,4,4,4,6,10,6,2,12,3,5,3,1,3,16,4,7,15,1,3,1,2,2,7,3,6,7,6,7,4,32,3,0,3,3,2,0,4,3,5,11,2,9,10,9,2,10,2,5,2,10,5,12,9,2,16,4,4,2,4,15,5,1,3,0,2,6,3,7,3,0,19,20,1,1,22,1,6,2,14,2,2,3,0,17,6,2,1,0,6,7,8,3,30,15,7,3,10,3,7,2,9,3,9,3,6,4,1,3,3,40,19,5,8,0,10,6,9,7,6,3,1,5,0,3,2,0,1,2,6,3,0,5,4,19,5,1,0,0,4,2,1,14,5,0,3,0,2,2,1,9,2,15,3,4,2,8,6,1,4,2,6,3,0,7,4,2,4,6,2,0,0,3,4,10,6,15,14,1,7,1,2,3,4,16,6,11,3,7,3,7,5,3,3,5,2,4,9,1,6,0,8,3,5,9,3,5,3,7,2,1,13,0,2,3,8,5,4,3,1,12,7,13,0,5,6,3,9,4,2,5,7,4,7,9,2,7,11,0,5,3,2,0,6,2,5,2,3,0,4,9,8,1,0,0,20,9,6,1,0,0,4,2,1,4,9,4,4,11,4,1,1,2,3,8,0,1,6,8,1,1,0,2,4,3,1,2,6,1,1,1,4,3,0,5,5,1,4,6,6,2,3,5,3,3,5,0,8,12,1,8,12,5,9,0,1,1,5,1,3,0,2,2,4,0,4,1,3,1,6,3,0,0,0,3,2,2,0,0,3,0,0,1,0,2,4,1,0,3,15,1,10,1,8,1,5,6,1,9,5,16,3,4,6,0,7,0,0,2,0,8,6,2,2,2,4,3,7,0,4,1,0,2,2,0,0,0,2,0,0,1,2,3,0,1,1,2,1,1,7,1,4,3,0,1,3,8,10,1,4,0,0,7,4,1,0,0,0,6,3,0,1,0,0,0,2,1,2,0,2,5,15,4,14,3,0,0,3,2,2,1,4,5,1,1,4,0,7,4,17,10,2,2,1,3,2,4,4,0,1,7
light,8,9,3,46,6,7,1,12,3,0,7,3,6,20,3,3,0,8,2,6,3,22,5,17,3,9,11,4,3,4,6,53,27,6,25,35,6,4,2,1,4,10,0,1,13,6,9,11,60,24,15,0,5,20,2,4,17,13,1,7,2,3,2,3,9,5,33,4,4,4,1,13,4,1,17,7,6,2,31,13,32,2,4,4,74,10,9,0,16,1,0,0,1,6,16,4,6,0,14,6,15,7,8,2,5,10,1,5,9,5,7,2,8,5,1,10,0,0,17,48,17,15,3,29,5,1,0,1,0,0,3,0,1,13,7,31,0,0,6,5,2,23,6,1,5,24,2,8,6,9,26,0,9,2,2,11,8,1,4,3,7,2,5,0,4,5,2,7,5,1,8,25,15,2,6,1,62,0,6,11,7,5,6,10,8,11,8,6,6,20,0,5,1,1,1,2,4,2,8,10,8,3,0,4,9,7,0,4,1,8,22,1,11,5,1,1,3,5,11,1,2,9,0,7,14,22,9,13,1,2,5,9,4,6,21,5,11,2,3,1,27,16,5,2,7,0,5,6,15,3,4,7,3,7,4,7,0,1,0,10,2,9,8,2,2,16,1,1,7,0,35,2,8,5,2,2,9,10,4,7,29,8,1,10,3,0,1,1,3,1,1,5,14,1,0,2,7,4,0,9,6,14,1,1,1,2,1,4,4,2,1,15,11,1,8,6,7,10,11,5,11,5,17,1,7,3,2,11,2,12,2,4,10,4,3,3,11,4,0,5,1,2,8,0,1,6,13,17,8,6,3,5,4,3,10,1,0,0,12,4,11,4,5,7,5,1,9,2,5,6,3,10,2,1,4,9,5,0,10,0,22,0,27,12,2,6,3,4,4,5,5,4,13,4,9,3,25,0,6,0,3,4,4,0,1,4,4,1,8,3,2,5,7,8,5,3,0,0,0,2,3,3,10,4,1,3,2,1,3,6,1,1,1,3,0,2,1,4,4,1,6,10,7,14,1,2,3,2,18,3,12,2,2,1,18,3,3,1,2,12,3,3,10,9,1,0,3,8,9,2,10,0,1,3,4,6,5,2,5,1,1,6,0,0,0,2,6,3,5,1,15,16,0,2,5,0,1,5,3,3,9,4,0,0,2,5,0,9,2,3,1,2,5,5,12,5,2,3,6,13,5,4,3,7,4,1,10,10,3,8,1,4,1,4,8,3,6,3,14,4,2,2,1,2,6,2,0,11,6,4,8,1,1,23,1,5,10,2,0,2,7,3,9,1,8,4,3,5,16,8,0,4,9,0,2,2,6,0,4,4,0,2,4,9,4,1,2,0,3,3,9,18,2,1,11,1,6,9,11,6,5,4,0,2,1,12,3,8,6,3,10,3,7,2,5,2,11,1,1,2,1,2,3,5,0,1,1,1,6,14,6,2,9,3,2,0,2,3,0,4,5,1,1,4,1,10,1,3,3,31,4,4,4,0,2,8,8,2,3,3,3,2,6,3,3,2,1,3,1,5,8,3,4,0,9,0,1,2,0,3,4,20,5,1,2,0,5,9,1,9,3,4,8,6,3,3,3,2,2,4,2,0,1,2,5,3,3,0,0,0,1,8,0,4,8,3,0,3,1,4,0,0,3,5,1,1,1,3,3,8,4,5,2,3,3,3,7,5,6,5,2,3,7,7,8,1,11,7,3,3,4,2,0,1,0,6,2,7,0,3,3,3,3,4,3,9,10,2,2,3,2,1,1,2,3,9,1,3,3,1,0,1,1,12,10,1,2,0,3,5,1,8,7,2,8,4,1,2,0,5,1,2,4,4,1,3,5,2,4,0,3,2,7,1,2,1,4,1,0,1,1,1,0,7,5,3,0,4,3,3,2,0,5,0,3,4,2,6,1,3,2,3,0,2,1,2,3,2,1,3,5,11,1,5,5,0,3,0,1,0,2,5,2,1,4,1,0,3,2,9,3,1,6,3,1,1,0,1,8,1,0,4,1,1,2,1,1,2,1,4,2,4,0,2,3,2,3,1,6,1,2,0,0,9,4,0,0,4,0,12,2,1,4,1,1,1,1,7,4,1,2,3,1,1,0,3,2,4,1,2,0,1,1,2,1,0,4,4,2,6,2,5,3,0,1,2,1,4,9,2,0,0,1,1,0,3,14,6,5,3,0,2,4,4,1,5,3,1,0,8,3,6,4,0,1,2,0,1,7,0,7,2,5,6,1,1,5,1,1,0,1,1,3,1,0,1,2,1,1,3
generation,3,7,4,32,8,24,3,20,2,2,4,15,14,62,6,8,2,13,5,8,2,13,18,22,9,13,9,10,13,6,1,67,75,16,33,53,33,1,4,5,11,16,1,0,14,4,10,3,61,36,22,10,3,46,28,2,13,1,11,8,1,4,5,3,11,12,63,3,5,4,10,0,4,4,59,11,25,0,37,18,20,0,5,10,43,13,5,2,13,2,2,6,5,7,11,6,7,2,14,11,0,8,15,9,10,13,2,11,12,2,6,0,13,12,2,17,1,1,15,47,22,36,43,43,16,7,4,0,1,1,27,3,11,21,17,32,6,5,3,14,7,16,8,8,7,29,4,15,8,2,24,5,4,10,3,13,38,3,3,13,6,11,5,1,7,18,5,7,10,7,8,74,18,8,7,2,64,2,7,17,12,12,10,9,3,16,15,8,12,27,2,16,3,2,9,6,6,4,8,10,10,0,1,1,4,8,5,17,1,9,42,19,20,5,10,12,4,3,1,3,2,17,4,3,4,33,21,18,6,2,6,12,6,7,15,6,21,5,8,1,25,17,2,14,3,0,1,24,12,2,4,6,9,3,0,8,0,1,0,8,2,3,0,0,4,3,11,11,4,4,25,2,8,5,4,2,8,0,0,0,45,2,2,9,2,4,4,18,5,6,0,0,7,8,3,4,4,2,2,2,11,4,0,0,4,9,6,2,13,2,1,17,18,11,22,0,4,13,0,1,6,3,16,10,23,2,15,22,4,8,4,7,6,1,4,4,6,1,2,1,2,5,5,6,6,3,8,15,0,16,3,11,2,31,9,0,0,3,6,10,5,0,10,13,1,7,8,9,8,21,0,7,3,9,6,7,3,2,7,2,5,1,7,5,9,28,0,6,16,0,5,6,5,4,7,8,3,1,4,0,7,9,1,1,4,4,1,0,4,3,2,5,0,9,0,6,1,3,3,2,2,0,12,2,3,4,0,1,2,13,1,0,0,3,3,0,1,1,1,3,3,5,2,9,5,3,15,2,17,4,18,3,5,0,22,2,7,6,4,7,13,13,14,27,6,5,20,6,14,2,24,2,3,1,2,22,12,2,9,6,7,2,4,5,4,5,1,7,4,1,36,17,5,5,9,1,0,0,2,7,5,3,5,0,0,2,14,2,0,5,4,3,7,3,3,2,3,6,0,5,5,2,1,6,2,2,10,0,5,8,0,10,4,8,2,4,1,6,19,10,2,2,0,4,7,4,5,13,1,0,12,1,1,12,0,1,6,0,1,2,2,0,1,2,2,3,5,0,5,12,3,2,1,3,2,1,6,7,3,6,1,1,6,17,5,2,2,6,1,2,9,7,5,4,8,3,6,4,0,2,2,0,4,0,0,9,1,2,2,0,19,7,0,7,9,3,2,1,1,0,3,0,1,6,0,6,0,2,10,7,0,4,10,7,3,1,6,4,0,4,7,12,2,1,4,1,0,0,1,24,2,1,10,2,0,3,9,6,2,0,1,2,0,2,0,1,0,0,2,0,3,5,0,6,3,0,3,0,0,6,0,8,4,0,1,3,6,1,0,1,3,8,2,1,0,4,1,0,8,1,3,0,3,4,1,4,4,4,0,1,5,0,1,4,3,2,2,0,2,1,0,4,0,0,3,4,6,3,1,5,3,6,2,1,0,0,2,0,6,10,11,1,2,2,4,1,4,13,3,4,4,0,0,0,0,2,1,1,0,15,9,16,0,2,6,5,18,2,3,1,8,6,4,11,1,1,0,2,0,3,2,0,3,0,1,1,3,0,2,0,4,8,4,1,4,9,1,1,2,0,1,2,1,0,2,4,4,4,6,0,0,0,0,1,4,2,3,1,0,3,3,0,1,2,1,3,2,0,1,3,4,0,3,4,3,4,3,6,1,3,0,4,2,3,3,1,4,0,0,4,4,4,2,0,3,0,1,0,0,3,0,1,0,2,1,0,7,0,2,1,1,3,1,0,3,3,0,2,2,1,0,2,1,1,0,0,1,0,1,0,5,5,11,0,0,0,1,0,3,12,0,0,1,0,0,0,0,0,4,8,0,2,4,1,3,0,2,1,3,1,1,2,4,2,1,1,1,0,0,1,0,2,0,3,1,4,1,1,0,3,1,10,0,0,2,1,1,8,2,0,4,3,5,0,3,0,2,1,0,0,0,0,1,0,1,1,1,0,0,3,3,5,13,5,1,0,2,3,2,2,0,3,0,0,2,7,2,7,0,4,2,0,1,2,2,4,1,0,4,3
test,2,8,3,33,5,6,1,13,1,5,2,7,13,36,1,11,0,4,10,5,3,12,20,10,8,9,18,10,3,8,8,77,35,3,19,47,12,1,1,12,2,10,2,6,18,9,14,8,59,32,18,3,5,24,29,2,23,10,13,9,6,9,6,2,14,8,44,6,1,2,4,2,3,0,42,5,15,0,43,15,18,1,5,8,60,7,7,3,23,1,1,2,5,12,10,1,6,5,10,9,15,14,8,2,5,11,3,1,2,1,12,0,11,7,6,11,4,3,25,89,19,10,5,43,5,5,3,4,0,1,3,9,4,23,13,25,5,3,3,3,5,16,9,3,2,36,2,1,3,3,27,3,3,4,4,6,19,3,2,12,3,1,3,4,0,6,8,8,8,1,8,27,12,2,4,1,64,5,3,15,9,3,7,16,5,1,14,15,11,13,2,3,5,1,2,4,8,5,4,3,5,1,1,5,6,6,2,20,4,5,38,6,11,4,0,11,1,3,3,1,0,8,4,10,21,29,14,5,4,4,2,6,9,8,13,7,17,4,0,4,30,17,4,3,14,2,8,18,22,4,2,6,12,1,2,15,1,2,1,8,4,10,4,2,4,18,10,3,8,1,32,1,1,3,3,0,4,0,5,1,40,5,0,9,3,0,5,8,2,2,0,3,10,2,3,2,7,3,2,8,12,12,2,1,5,2,7,3,4,2,3,6,25,7,2,11,8,21,2,2,7,0,11,15,32,1,8,14,3,4,2,6,3,1,4,8,8,0,3,3,6,9,15,7,2,1,6,14,13,4,10,0,1,28,7,1,3,2,9,10,10,8,7,8,3,5,12,2,13,4,1,7,7,7,4,17,9,2,7,3,32,4,9,6,3,5,0,9,10,2,8,7,4,2,6,2,10,3,10,1,5,2,2,2,0,1,6,2,7,5,0,3,0,6,10,3,1,4,2,1,2,5,8,4,6,1,7,9,2,6,2,4,0,8,2,1,1,3,8,4,3,4,5,4,0,1,10,4,10,1,9,3,2,1,16,15,1,1,6,11,12,16,18,25,6,10,10,8,5,5,11,4,4,2,1,10,1,2,8,2,1,5,0,6,8,6,4,6,0,4,37,10,1,4,4,1,0,3,4,5,3,4,3,1,5,3,1,4,2,1,3,3,3,3,13,7,11,3,3,7,2,1,1,13,6,2,3,0,3,12,8,4,1,8,5,3,3,1,10,3,5,0,0,2,4,3,1,4,3,4,2,0,11,13,2,4,4,3,0,3,6,1,6,2,6,4,12,2,16,15,5,3,5,4,2,1,3,2,3,8,5,6,11,12,9,1,3,3,2,6,6,14,2,1,5,0,7,1,12,7,10,1,4,0,4,12,4,9,10,2,5,13,5,1,21,4,5,5,2,2,6,0,1,6,0,2,3,6,9,10,0,4,22,10,2,1,2,2,2,2,11,3,5,2,2,13,3,3,3,30,17,1,0,3,0,5,20,9,1,3,2,2,2,0,1,2,0,2,2,0,3,3,11,17,3,5,2,2,0,4,1,6,4,0,3,3,3,2,0,2,4,9,5,4,1,6,4,0,4,6,0,6,3,6,2,3,5,6,0,0,2,6,1,24,2,20,4,3,6,8,2,0,2,26,2,3,1,3,7,4,2,3,0,4,0,3,13,3,3,1,4,1,8,9,6,4,7,2,2,1,5,3,0,2,1,9,5,2,1,5,6,5,1,3,5,2,4,1,5,0,5,2,2,5,3,1,1,0,0,0,0,0,1,0,0,5,4,0,6,5,2,4,1,2,4,9,0,3,1,8,1,0,10,1,3,2,4,2,2,3,1,6,3,2,0,3,1,0,2,6,0,1,0,1,0,3,8,4,0,1,0,0,4,2,5,5,7,12,8,1,0,2,2,6,3,4,4,0,1,1,24,7,2,1,2,2,3,1,0,1,0,2,3,1,1,2,0,1,7,4,1,2,2,2,1,4,0,0,3,1,0,1,2,0,1,3,0,1,1,0,3,1,4,3,1,3,0,2,3,6,1,1,0,6,1,0,0,1,1,13,3,2,5,2,2,2,3,0,5,1,1,1,1,2,0,3,1,2,1,2,1,2,0,0,1,0,4,0,2,3,4,9,0,0,0,0,0,3,9,0,2,3,6,0,1,3,0,2,1,1,0,0,3,1,1,10,0,0,5,3,4,3,9,2,1,0,2,1,1,3,0,2,2,0,1,2,3,1,13,6,1,1,0,3,0,3,1,1,6,5
man,2,34,20,60,28,16,21,72,1,19,46,14,22,184,10,30,13,42,10,10,4,45,34,71,75,32,40,41,17,31,13,280,202,36,141,122,89,3,14,6,23,25,10,5,47,21,24,15,207,33,80,27,22,60,42,21,73,16,13,21,15,12,8,18,16,8,225,34,11,40,17,9,7,14,287,32,52,3,107,67,112,5,16,32,296,43,10,1,37,4,6,13,0,20,119,34,31,8,58,47,12,30,36,13,46,48,5,6,23,3,28,5,14,18,6,25,0,22,72,289,105,62,112,81,9,15,11,10,2,3,35,7,50,103,67,172,37,5,8,16,40,86,21,4,13,128,20,50,32,18,115,6,18,9,35,28,143,9,10,52,13,14,43,2,1,48,13,66,28,15,23,308,65,8,16,21,266,11,33,97,69,22,7,73,13,96,69,52,88,59,4,18,7,1,10,8,8,23,15,73,108,4,1,8,21,13,11,64,19,26,131,14,23,17,13,6,1,2,21,0,2,80,5,42,32,229,65,100,9,10,35,25,15,24,71,18,58,26,14,32,98,52,17,36,46,6,7,83,75,8,5,53,31,7,3,22,7,0,1,38,30,34,4,2,19,45,40,7,31,8,170,6,25,7,5,4,20,5,3,1,191,29,1,63,16,2,5,22,42,15,1,2,8,17,2,8,58,8,10,83,47,16,4,3,16,16,60,24,54,10,1,62,31,7,80,23,70,67,27,18,52,16,89,66,146,8,50,33,4,52,6,31,26,6,33,10,34,7,3,3,10,14,32,5,8,18,38,76,19,20,27,8,27,62,65,8,9,26,27,49,56,11,34,58,8,4,22,41,10,50,4,31,16,70,24,54,19,16,83,5,154,7,49,44,51,46,49,30,43,6,53,6,12,4,21,30,37,5,42,2,26,7,21,4,12,68,18,4,25,12,47,13,5,39,1,9,2,21,16,3,62,35,24,14,12,9,2,53,16,30,9,2,1,3,16,1,3,0,10,6,24,22,10,11,5,4,38,8,68,27,18,3,15,2,115,20,12,17,49,32,24,72,83,264,39,17,42,21,12,10,97,19,6,22,10,1,18,19,47,39,28,24,4,7,30,14,16,9,19,0,127,45,12,14,14,2,14,6,9,32,76,10,18,0,13,15,18,25,8,15,11,5,9,11,14,19,6,24,40,23,10,55,6,52,12,11,39,81,31,64,41,38,14,69,18,30,13,40,109,81,8,5,32,54,10,6,12,35,23,9,27,6,16,37,6,28,33,4,10,16,14,7,8,9,2,18,36,13,31,86,18,1,5,8,9,2,8,7,14,25,12,7,36,40,15,84,8,23,7,21,41,46,23,7,126,21,77,21,5,35,18,7,11,0,2,17,4,14,10,4,49,17,3,11,61,6,15,12,16,3,23,10,3,21,4,12,5,6,34,43,12,22,110,59,15,16,57,37,15,19,100,28,46,15,9,13,13,1,17,108,25,30,17,2,17,16,32,51,19,11,3,4,2,14,1,1,1,4,14,7,41,15,16,45,9,10,6,2,5,12,4,24,16,15,15,5,11,5,1,11,16,21,7,4,3,11,9,1,35,2,9,23,1,20,13,15,21,6,2,3,6,4,8,19,18,74,4,10,8,36,14,48,12,58,26,25,13,36,28,18,23,33,4,16,3,0,58,14,11,20,33,8,7,44,25,15,28,14,24,27,21,3,1,1,0,18,11,3,1,20,17,53,0,3,20,34,26,9,24,6,11,13,25,30,5,18,8,6,2,15,3,0,42,18,25,4,20,8,6,10,3,15,6,14,72,29,21,13,3,6,2,11,19,0,15,4,11,19,24,1,1,0,8,5,8,4,6,3,0,9,1,0,3,10,0,4,14,3,13,2,13,1,14,18,16,16,13,46,16,6,1,16,10,10,9,7,11,5,5,46,13,13,9,7,7,7,32,2,4,1,0,10,12,4,2,4,10,1,7,11,4,8,6,15,11,5,1,10,7,2,2,6,11,0,7,0,9,7,8,3,10,8,1,1,2,4,1,5,8,27,5,4,4,4,3,0,0,15,1,28,3,1,7,6,14,2,8,4,3,0,3,4,5,5,5,6,2,2,2,6,3,6,6,3,2,8,5,12,14,16,3,51,2,2,3,20,11,4,11,2,4,13,8,1,5,2,4,0,10,1,1,1,6,6,2,24,2,5,6,5,28,7,14,26,2,5,3,0,8,2,5,15,3,11,4,34,21,1,5,14,11,2,1,1,3,16,11,2,14,5
earth,2,7,4,44,7,5,5,21,3,6,3,3,10,99,8,14,8,10,9,2,3,19,22,19,5,6,10,10,13,22,8,74,66,0,29,67,57,3,1,8,5,13,5,5,13,15,8,3,140,37,29,2,10,59,15,13,23,7,9,10,13,13,1,3,6,12,94,4,6,3,11,0,3,1,42,19,22,1,46,15,14,1,4,6,97,3,3,1,17,1,4,9,3,10,24,5,11,2,19,7,2,14,16,8,10,11,2,6,5,2,11,0,4,4,9,19,2,2,16,60,23,17,3,45,7,2,1,3,4,0,14,2,12,13,17,40,6,2,1,13,11,23,26,1,9,30,5,10,3,3,63,3,8,2,1,5,29,11,19,8,2,4,8,0,1,7,2,8,15,9,8,71,12,1,2,2,74,2,8,15,8,19,4,8,2,18,12,11,7,30,2,7,3,1,3,3,4,1,2,6,7,0,1,1,15,6,2,10,4,16,27,6,11,4,2,12,2,2,5,1,0,14,3,6,15,32,9,15,1,2,9,7,13,6,19,5,19,3,6,4,25,11,6,3,13,1,2,11,13,2,3,10,20,4,2,7,2,1,0,6,0,21,8,0,1,10,3,7,15,5,70,0,5,1,1,1,11,1,2,0,41,2,2,6,10,4,8,2,12,1,0,1,5,8,1,3,9,0,3,18,28,6,0,1,6,1,14,1,8,1,2,5,9,2,20,1,6,11,2,5,18,5,12,4,34,2,4,24,3,10,1,3,5,2,7,6,17,3,2,10,3,2,26,3,9,3,25,16,4,8,3,8,5,8,8,0,3,8,5,13,8,7,5,14,1,6,11,4,4,10,0,10,2,3,4,5,3,0,16,3,32,2,14,6,3,12,5,4,22,4,21,2,5,1,9,7,16,0,4,4,6,1,4,2,5,3,3,3,13,12,5,4,2,9,2,5,3,3,3,3,5,2,7,12,4,0,2,8,6,7,1,0,1,3,3,5,5,3,7,1,9,12,2,17,3,2,8,5,18,3,2,3,9,5,21,4,9,9,4,12,10,19,33,12,4,0,15,1,2,2,17,5,5,12,1,18,1,6,8,1,4,14,6,2,5,2,3,5,2,2,45,8,10,7,7,7,3,10,8,1,6,2,1,0,1,4,1,8,3,1,1,1,1,1,9,6,3,4,0,6,5,3,3,9,2,5,7,1,5,15,3,5,3,1,4,4,3,1,30,6,2,3,1,0,1,0,4,7,7,1,25,3,0,21,3,10,19,0,1,5,9,1,2,2,5,6,4,4,13,15,10,5,7,3,6,3,0,2,2,5,7,7,8,15,9,5,3,3,0,4,18,10,6,3,8,3,3,4,17,9,8,3,2,0,1,9,2,10,0,3,13,5,1,12,15,4,4,2,1,2,6,3,1,6,2,1,5,4,2,12,2,6,7,9,2,5,3,0,1,4,4,1,3,5,3,4,2,1,0,84,3,7,1,3,4,8,14,19,7,12,4,4,11,16,5,0,2,5,4,4,12,1,33,8,8,7,1,2,0,4,2,12,5,1,6,3,7,4,1,2,5,5,4,1,0,8,1,5,5,5,5,0,0,4,1,9,10,6,0,2,4,0,6,5,5,2,2,4,5,0,2,4,5,2,1,2,2,4,1,10,4,3,4,2,2,2,10,2,19,11,3,3,2,2,9,2,5,2,2,6,3,0,0,1,2,2,3,7,1,3,3,13,1,0,13,8,8,4,4,3,2,1,4,7,1,4,2,1,0,12,3,0,5,0,4,3,6,25,3,4,3,2,1,1,1,10,0,2,2,1,0,3,2,1,4,3,8,0,6,4,2,1,4,2,1,1,2,4,0,7,3,2,0,1,3,2,8,1,4,7,2,5,6,5,5,2,10,20,9,2,1,1,4,2,3,3,5,7,0,6,10,9,7,4,1,1,3,0,3,0,2,4,1,2,3,6,4,1,0,0,0,1,7,3,0,6,1,7,3,0,0,1,1,2,1,0,4,1,8,1,2,2,2,1,3,2,4,1,2,4,1,2,5,8,1,1,4,7,0,7,1,1,2,1,3,1,2,4,3,0,4,3,5,3,0,5,6,2,2,0,0,3,5,4,0,1,2,5,0,9,1,9,2,1,2,4,5,4,4,2,0,4,5,3,0,2,2,1,4,1,0,1,1,2,2,5,2,0,1,4,4,5,9,5,0,3,1,0,4,5,0,5,0,2,1,1,3,5,3,4,7,2,2,0,0,1,7,3,9,1
representative,30,114,73,317,10,5,8,71,13,1,60,29,10,84,6,13,6,26,12,7,6,62,7,43,34,15,16,22,17,17,12,230,178,20,48,46,46,12,3,4,6,10,5,5,38,33,61,13,556,25,42,6,13,28,5,5,86,40,6,17,34,7,3,21,27,15,228,13,17,23,5,3,5,8,94,15,22,5,107,30,31,3,15,10,329,17,9,1,53,3,11,8,0,30,63,14,27,5,36,13,14,37,43,8,12,58,1,1,14,6,21,5,3,16,1,19,21,4,92,177,52,17,7,52,7,2,1,5,5,1,10,9,15,40,16,64,16,8,6,13,12,39,36,5,5,100,12,17,18,12,99,3,32,5,3,23,39,5,13,5,7,5,5,4,0,7,4,33,23,10,13,129,18,1,0,9,255,6,8,34,22,28,4,20,3,27,39,15,60,76,15,4,2,1,1,8,23,3,16,13,25,1,0,16,26,23,5,40,16,25,105,4,91,10,4,1,0,3,33,3,7,24,4,18,51,139,25,36,2,4,26,20,19,43,24,20,64,10,10,13,84,41,10,11,12,3,4,22,49,8,21,14,31,11,11,19,21,3,7,15,14,19,34,10,9,56,3,6,11,12,210,5,17,6,9,0,10,7,20,34,64,6,3,29,11,2,9,13,16,4,16,17,64,9,3,10,72,8,20,23,18,63,0,5,12,3,34,14,16,2,1,25,34,6,18,7,11,58,17,2,62,12,43,12,69,8,12,37,11,56,44,17,4,6,13,22,12,12,4,13,14,22,19,10,2,13,68,75,19,4,18,10,12,38,30,1,20,9,22,29,48,4,13,22,4,1,67,8,14,20,4,26,1,11,18,29,15,1,20,13,120,5,53,10,1,35,10,30,31,5,13,4,374,254,49,14,74,4,50,2,29,3,6,5,6,4,2,7,31,24,3,12,1,12,9,7,11,14,3,4,10,13,53,11,4,3,1,18,15,18,21,8,4,28,8,11,0,12,4,6,18,28,6,8,1,2,3,6,39,3,14,10,1,4,61,19,2,20,14,20,18,19,31,29,3,5,7,9,1,1,16,5,2,2,2,19,6,1,12,7,8,14,8,9,12,16,6,3,13,6,60,60,3,5,10,6,3,14,13,14,14,5,1,0,10,29,7,26,12,19,8,10,9,2,19,29,9,11,9,7,4,20,5,35,12,9,34,8,18,33,14,15,4,9,13,4,12,16,40,32,5,9,9,9,8,10,7,15,19,10,125,13,8,51,22,12,33,7,12,20,43,17,41,4,19,17,19,8,51,58,17,9,34,0,9,16,13,3,8,9,3,18,7,14,16,4,8,9,2,14,30,38,8,1,31,7,3,6,48,22,28,2,5,9,11,27,8,81,8,7,47,38,42,11,52,25,28,8,17,9,20,6,4,29,1,13,18,16,21,51,6,30,45,37,17,8,9,9,5,5,16,3,17,30,9,40,2,15,7,283,32,11,9,17,18,23,62,28,14,16,21,6,26,30,17,10,5,11,11,15,20,13,49,27,39,12,7,24,4,4,3,29,22,22,19,15,8,9,2,6,20,16,20,11,11,19,12,24,25,28,34,6,8,12,25,19,28,16,8,10,14,12,6,49,17,19,5,14,18,14,6,29,8,25,4,21,3,4,11,22,25,22,5,5,10,4,12,4,49,16,26,8,6,7,8,5,16,11,8,17,15,3,2,9,0,10,13,14,3,1,0,11,11,4,34,5,17,18,7,9,13,2,1,18,7,10,5,8,3,9,0,9,9,8,45,11,13,48,10,23,12,34,14,14,13,15,8,16,8,37,8,9,30,19,6,3,12,12,12,8,2,14,12,23,2,12,7,16,7,10,11,5,77,29,2,9,4,30,9,7,9,9,23,11,19,20,20,34,9,15,15,29,9,18,6,1,4,17,17,13,26,40,7,10,14,5,7,3,6,3,9,16,15,17,6,21,1,29,10,20,5,13,6,6,15,12,14,19,36,25,5,7,11,6,9,1,10,5,8,10,7,7,2,3,5,11,2,21,6,2,9,11,4,16,69,11,3,12,2,22,9,5,10,5,27,6,8,5,2,3,13,8,6,10,12,8,10,50,8,10,11,7,11,6,7,5,8,5,9,14,6,14,3,1,2,3,3,6,45,4,4,7,4,10,11,4,3,1,33,2,4,6,7,2,3,20,6,0,55,8,1,9,7,9,9,8,1,5,6,21,1,6,14,9,4,7,9,2,15,1,5,4,11,2,2,2,0,8,0,1
possible,6,26,10,196,16,11,13,29,5,9,27,19,26,154,8,12,10,36,5,9,5,51,28,63,55,27,33,29,16,31,23,442,204,26,104,108,97,14,26,8,31,10,7,13,65,21,29,40,348,57,102,22,21,109,31,14,85,44,8,27,36,23,1,20,60,9,139,28,19,29,33,5,11,4,186,19,62,11,137,59,87,7,39,33,307,49,27,4,50,3,17,22,7,49,102,28,32,18,58,23,19,56,56,33,20,51,18,14,34,13,39,16,29,45,17,53,10,5,92,330,132,42,74,120,20,4,7,4,5,4,31,16,8,89,41,132,12,6,14,11,12,91,36,8,5,135,19,32,44,28,110,8,35,13,16,57,92,11,17,41,22,11,24,11,18,28,11,64,45,19,33,162,66,7,17,23,260,5,16,138,51,27,28,54,10,80,96,53,75,92,8,16,11,5,6,8,36,11,20,27,77,8,14,35,50,39,23,71,31,51,133,16,33,17,12,21,6,20,19,5,10,28,14,46,77,218,58,45,15,34,35,29,46,46,78,43,72,37,13,30,134,55,11,19,30,16,14,95,115,9,32,28,38,16,11,28,16,6,5,59,12,43,20,10,15,64,16,22,29,4,203,21,51,19,3,6,44,34,10,7,108,16,8,30,18,6,10,30,29,14,9,17,20,15,9,17,60,17,17,28,45,46,3,10,21,5,46,12,28,10,5,67,48,21,57,38,32,71,25,13,62,15,56,35,116,10,21,61,2,42,15,29,13,11,15,15,34,14,5,23,36,25,28,23,25,19,78,67,35,17,18,10,7,74,40,14,13,13,29,65,53,29,30,59,3,4,67,13,17,56,10,38,10,34,25,79,24,13,29,13,108,6,93,23,13,57,7,22,40,13,36,11,16,21,51,25,50,12,66,3,27,6,9,7,28,11,19,5,37,27,11,23,7,30,21,15,12,15,17,10,10,15,37,22,6,9,4,19,25,30,24,13,1,32,4,8,6,19,27,14,25,27,26,20,4,7,43,19,100,13,31,9,14,6,71,13,4,16,36,53,47,48,66,115,22,22,30,16,30,3,48,13,5,9,8,47,8,12,1,26,24,16,12,16,25,10,20,14,17,13,186,72,4,11,16,6,18,20,10,23,30,15,9,6,20,53,18,25,17,11,18,9,10,13,24,27,18,29,49,18,8,32,13,50,18,10,65,26,32,54,30,15,10,32,23,23,19,35,73,40,5,11,7,21,30,14,28,31,19,14,34,12,13,66,25,27,28,10,11,19,21,7,34,20,24,26,18,23,63,104,15,7,25,6,18,2,17,19,18,45,8,26,20,30,10,17,24,16,2,25,25,60,33,7,55,9,24,20,42,46,35,2,12,5,17,45,7,38,29,12,45,38,20,7,60,18,27,20,16,7,18,15,8,33,16,27,5,22,23,42,29,35,53,38,14,8,34,16,7,19,19,4,14,38,12,44,16,8,13,203,40,14,11,9,10,21,64,38,12,26,11,10,14,14,5,8,16,19,29,24,47,18,45,63,31,15,6,7,18,14,32,39,17,24,11,13,22,6,11,23,13,28,16,20,19,23,16,6,28,18,16,11,6,12,16,14,27,12,3,6,7,15,11,31,32,69,24,11,16,17,13,17,5,46,13,12,14,7,3,11,27,23,11,14,17,9,66,14,34,12,30,4,14,49,21,14,21,25,10,8,11,13,9,17,8,19,10,20,7,18,16,34,14,7,23,19,17,16,15,18,13,8,12,19,7,22,9,8,32,14,9,10,18,19,15,11,10,6,24,21,9,14,6,5,31,43,31,11,5,8,8,17,24,8,13,9,4,9,25,7,12,11,13,10,10,9,10,21,5,14,11,4,29,22,10,8,15,7,10,10,9,5,12,12,14,19,16,29,22,5,9,7,13,14,3,8,11,28,9,20,45,33,23,8,7,12,13,9,2,2,9,7,15,11,19,13,3,5,19,21,6,17,23,11,8,9,5,10,11,5,1,11,10,2,8,6,25,12,7,5,12,10,8,6,13,17,9,8,12,16,14,5,5,15,13,11,9,2,10,39,14,15,10,17,12,11,9,11,14,6,8,18,8,12,4,12,11,16,10,11,11,3,10,3,6,5,3,6,7,19,12,24,8,3,17,28,26,25,52,2,10,12,7,16,10,6,4,14,18,4,8,2,3,6,2,28,10,4,3,9,7,4,14,11,8,4,7,14,20,10,10,6,7,11,9,26,13,11,25,7,5,13,5,3,3,17,7,0,3,4
enough,1,15,3,58,2,13,5,17,3,8,4,6,17,71,8,2,5,22,10,5,4,23,18,31,33,5,12,16,8,7,9,137,67,13,45,55,36,6,19,2,3,3,0,2,13,9,23,4,108,34,43,11,7,52,19,2,35,10,11,14,5,7,3,6,18,2,71,18,8,14,10,3,4,5,106,20,32,3,51,16,43,3,11,13,127,40,12,5,14,1,10,2,5,13,28,17,16,7,27,23,12,22,24,7,23,20,7,13,14,3,8,4,24,17,12,25,1,3,28,107,36,27,25,56,10,7,8,5,4,1,30,4,6,35,12,58,1,11,11,3,3,15,10,6,6,60,13,20,33,14,34,4,15,11,7,20,49,15,5,28,18,16,17,2,6,27,6,9,14,4,5,63,28,14,4,2,84,4,4,59,22,7,7,32,4,48,36,18,14,23,0,9,4,4,6,4,14,8,8,1,27,4,1,5,27,10,17,30,6,7,52,8,16,10,10,32,3,12,9,0,5,13,2,10,18,68,20,14,1,1,16,14,15,14,29,18,44,17,7,5,45,22,8,12,17,2,5,37,47,7,3,15,15,0,5,8,1,3,0,22,7,24,4,0,5,19,6,28,11,6,74,10,12,4,0,5,11,6,2,1,65,6,6,4,9,2,14,29,12,9,2,4,14,4,0,7,15,2,5,13,29,12,3,1,6,11,11,2,8,3,2,23,25,10,31,10,17,17,7,6,26,7,41,8,39,0,14,27,2,18,4,7,6,8,7,10,8,5,3,8,5,16,12,5,11,8,14,35,12,13,10,4,2,69,14,1,3,5,17,20,18,9,15,27,1,4,14,12,11,28,4,18,3,16,9,19,8,4,6,4,32,6,23,6,6,54,6,14,19,6,16,4,5,2,13,11,22,3,14,2,3,2,4,0,10,4,1,0,18,8,3,5,5,10,2,9,1,6,6,4,3,7,15,7,4,3,2,10,5,6,5,2,0,1,0,1,5,3,6,8,7,12,5,1,0,1,18,6,19,6,15,2,6,3,39,3,1,8,11,14,10,12,23,39,9,10,27,17,5,5,21,11,1,6,2,39,1,7,26,1,16,11,3,5,6,5,3,5,7,0,50,26,1,4,7,7,14,9,4,9,13,12,5,2,6,7,12,8,6,15,1,5,4,2,3,9,1,10,6,17,3,13,5,11,1,2,18,8,11,22,6,9,7,11,11,9,5,6,27,19,6,0,2,8,11,6,4,21,9,7,11,4,5,22,9,7,14,2,4,4,8,3,9,5,15,8,4,4,16,27,4,1,13,5,4,4,5,4,6,8,5,9,10,9,4,3,4,10,4,17,6,20,12,5,12,3,10,5,4,17,4,2,5,0,1,21,4,10,10,10,24,9,1,5,8,2,13,2,6,2,5,10,5,9,2,5,3,2,10,25,15,11,19,13,2,3,14,4,2,7,9,1,10,13,5,6,2,3,4,69,8,5,10,6,4,3,24,16,2,4,5,3,0,4,2,1,2,5,6,3,17,5,4,17,10,3,2,9,1,11,5,14,2,5,6,6,11,5,2,12,4,9,3,4,5,8,4,0,10,4,1,1,3,7,4,8,11,1,2,1,3,1,2,4,13,22,4,3,3,7,9,2,1,26,9,3,12,4,4,3,5,9,1,2,4,0,19,9,9,9,11,7,8,25,13,8,11,7,4,3,8,4,0,1,1,8,4,5,2,15,13,14,1,1,4,10,4,6,3,5,4,7,3,11,2,3,6,0,9,2,2,5,13,7,9,3,7,1,2,8,2,4,1,2,6,12,4,3,2,0,1,5,6,0,6,7,5,3,14,3,5,0,8,5,2,2,3,6,7,6,1,0,2,7,6,4,9,1,12,2,8,4,3,6,12,6,4,11,9,1,1,8,7,3,4,4,5,3,4,9,9,20,9,3,3,5,2,0,5,4,1,2,5,1,3,4,8,2,6,5,2,5,1,12,5,3,0,4,2,0,0,2,1,0,2,0,7,3,3,8,6,7,6,6,4,0,1,1,5,7,4,8,0,1,4,0,0,2,1,8,0,1,4,3,9,1,2,2,2,1,4,4,2,3,1,1,0,3,1,6,1,3,2,1,3,5,1,8,3,4,2,17,2,6,7,9,8,3,12,2,2,5,6,3,3,0,5,4,7,2,20,3,1,1,3,6,2,4,2,9,5,3,8,11,2,1,1,5,2,0,0,4,3,14,4,2,2,9,1,2,5,1,2,1,3,1,5,2,4,2
destroy,3,14,3,63,4,11,1,34,2,7,14,4,14,83,6,10,5,18,6,2,4,33,15,17,16,4,12,10,10,15,14,115,90,13,34,34,37,1,10,4,6,11,4,2,19,9,10,5,143,11,50,6,15,39,4,5,46,7,5,10,7,3,0,12,28,7,102,9,8,6,15,5,4,5,98,13,16,2,48,24,35,2,14,18,113,25,15,0,22,1,6,5,1,19,28,18,14,1,29,14,4,16,16,10,11,16,4,8,8,2,6,6,1,11,2,35,3,0,29,139,28,13,5,34,8,3,4,2,3,2,16,3,9,33,22,43,9,1,5,3,4,30,9,6,5,52,21,15,14,6,49,3,8,13,4,12,31,3,2,9,6,14,13,1,3,11,6,18,25,7,11,62,21,10,6,6,106,6,10,46,21,18,3,14,3,18,35,23,18,28,3,10,7,1,5,4,5,3,2,8,34,2,2,2,19,3,5,25,2,12,64,5,16,16,3,15,2,3,8,0,5,20,4,11,27,81,44,26,6,8,7,12,11,19,35,35,37,9,4,3,47,31,10,12,30,2,3,18,25,5,10,35,24,5,3,16,9,2,2,10,1,26,9,1,5,18,2,10,12,5,79,2,17,8,0,1,24,3,1,1,35,14,5,15,15,2,3,16,11,2,4,1,9,1,1,7,10,4,0,16,26,10,1,3,4,2,13,5,11,7,0,14,14,0,22,7,5,32,13,14,23,6,27,4,38,7,5,25,1,24,2,15,8,3,3,2,13,9,5,8,5,9,12,7,6,12,38,28,6,5,6,9,4,58,18,3,6,4,11,22,15,9,8,20,1,2,15,5,1,23,1,24,2,10,9,14,6,4,14,8,43,4,26,9,4,31,13,15,26,2,15,6,6,4,11,8,33,0,14,4,9,5,0,0,7,10,18,0,16,9,3,7,1,8,5,5,1,6,5,4,6,4,15,19,3,5,1,14,8,12,8,1,0,5,4,2,2,1,8,5,11,21,3,4,2,5,16,10,23,1,8,4,7,3,32,12,2,10,11,17,14,10,17,53,5,3,13,10,11,2,34,12,1,7,1,28,4,8,24,16,1,7,2,6,6,3,3,4,8,3,42,28,3,1,8,3,22,8,5,9,13,3,2,1,9,6,11,8,5,12,9,3,7,4,9,8,4,9,27,15,7,33,5,22,4,6,37,9,7,21,15,8,15,13,8,5,5,7,46,22,9,2,12,9,6,12,6,16,5,3,44,1,9,32,1,5,21,4,6,4,4,1,6,4,7,11,6,12,27,23,6,5,3,8,2,6,7,11,3,12,6,5,8,16,6,3,4,11,2,4,14,17,8,8,21,16,13,9,8,5,12,1,6,1,1,16,1,11,4,10,27,8,4,3,19,5,13,3,4,4,10,4,5,10,3,0,3,5,4,20,5,5,28,19,4,1,11,2,4,2,14,4,8,21,5,7,3,1,12,80,10,10,7,5,13,7,13,16,10,14,3,3,6,2,10,1,1,6,5,13,15,8,20,19,9,11,1,1,2,9,0,19,7,8,4,2,7,2,3,6,6,5,3,6,3,7,11,2,11,3,19,4,3,8,5,5,9,4,3,0,2,5,8,11,10,6,6,2,2,5,10,7,5,20,4,8,11,5,2,14,5,6,4,4,1,0,15,4,26,3,14,2,4,20,8,5,5,3,2,3,9,0,0,3,4,7,7,3,2,18,18,11,0,6,7,10,12,4,13,4,7,13,5,14,2,17,7,2,17,7,7,2,4,5,10,1,8,10,1,4,4,3,1,1,9,22,8,4,0,2,2,5,12,2,12,0,9,3,9,8,5,6,4,6,5,2,3,6,5,12,4,0,1,4,9,3,5,5,1,1,22,3,5,7,6,3,4,19,7,3,1,7,4,7,5,7,9,5,1,15,12,12,6,5,4,2,3,6,7,1,1,13,8,1,5,1,32,0,6,6,4,3,3,6,3,5,2,6,10,2,1,2,2,5,3,0,4,3,8,0,7,17,0,1,2,1,5,2,5,15,6,0,2,5,2,0,7,3,2,9,1,1,5,2,7,1,4,5,3,6,4,8,3,14,0,3,0,5,2,2,4,0,4,3,2,2,2,11,2,2,0,8,0,1,0,5,9,6,10,1,1,11,1,3,0,2,4,3,3,0,1,11,7,1,1,6,4,1,10,5,14,4,4,1,0,1,0,3,4,9,0,9,9,3,5,3,11,0,6,1,2,4,0,1,0,1,3,6,0,9
advance,10,39,6,150,16,10,23,55,0,7,33,12,13,115,6,18,12,20,8,1,7,58,19,29,29,20,24,16,8,26,13,185,151,18,64,124,81,9,32,18,8,34,5,8,41,24,36,16,308,42,82,13,44,70,15,11,60,24,6,37,17,10,13,19,24,7,148,13,14,11,20,4,4,1,127,17,28,2,117,35,78,1,18,11,208,27,11,4,39,4,9,10,4,34,80,10,19,8,75,20,17,35,34,17,16,37,6,4,25,7,26,9,6,18,5,24,8,2,101,178,57,33,16,117,11,3,17,8,4,5,32,10,16,57,36,84,19,7,5,14,10,37,42,4,7,96,6,22,20,10,79,4,10,11,6,29,38,14,14,27,13,4,9,10,6,8,2,34,27,17,20,100,31,5,10,14,202,6,12,40,34,19,14,19,9,40,43,33,36,60,4,11,15,2,2,2,26,10,13,31,30,0,5,10,34,13,1,43,25,33,82,12,25,15,2,5,1,4,15,8,5,27,19,21,46,92,42,30,3,16,18,12,15,26,54,27,41,6,13,6,72,53,8,7,30,9,5,34,54,7,12,15,15,9,6,21,16,3,2,19,7,50,13,4,7,38,24,16,28,12,137,15,32,8,2,5,26,19,14,5,93,8,2,11,14,4,17,9,20,2,8,7,8,5,6,13,47,8,6,34,27,22,7,3,19,5,53,6,13,5,1,16,31,19,35,15,32,55,14,5,50,8,27,15,63,4,9,36,8,21,9,10,11,4,11,11,31,4,4,21,12,9,14,9,22,5,35,81,27,15,15,12,3,20,18,3,7,9,15,35,22,13,19,16,9,3,48,18,12,19,4,39,7,20,7,17,10,5,33,10,78,3,58,14,11,55,7,14,45,5,27,15,17,24,42,21,57,2,41,14,25,11,5,9,2,19,8,6,40,19,8,4,13,20,13,18,10,8,3,10,1,17,26,12,5,4,7,12,21,28,6,9,4,23,7,10,4,23,17,6,13,15,14,20,6,11,23,17,39,16,24,5,13,8,70,4,8,15,13,23,22,37,40,49,6,15,37,18,10,3,22,8,6,2,5,24,14,14,16,11,7,1,8,8,13,13,10,10,4,3,122,44,1,3,19,15,7,8,17,11,16,9,2,3,3,18,13,9,6,6,8,9,7,0,20,21,17,15,4,7,17,7,6,27,15,4,17,12,20,31,12,9,7,7,12,13,17,11,43,23,5,3,8,13,21,12,7,31,19,2,41,4,3,64,9,17,34,6,6,9,18,3,21,4,22,14,11,11,43,44,28,10,16,2,18,4,6,9,8,15,15,12,15,29,13,23,4,8,2,23,23,35,4,3,24,9,8,5,61,35,25,7,6,11,1,21,7,41,20,5,33,19,16,11,18,6,19,3,5,1,23,13,11,24,4,6,10,8,7,30,9,23,22,29,7,7,12,10,9,9,4,4,9,26,9,23,7,7,7,170,17,8,11,1,10,12,53,16,15,15,10,9,15,18,13,13,5,18,19,14,36,7,85,20,30,2,4,5,4,3,10,24,22,9,14,7,21,15,5,9,29,27,7,17,7,21,10,6,15,12,20,3,9,5,5,19,25,15,4,5,8,5,7,43,16,42,15,11,14,11,9,10,15,25,11,27,10,5,8,16,20,25,7,13,12,3,36,10,45,35,5,8,4,20,18,10,13,23,13,5,10,9,12,21,11,7,4,14,9,17,20,16,1,6,27,20,13,8,18,12,7,2,5,9,3,16,20,4,26,20,6,5,13,7,10,9,11,82,2,14,11,15,5,9,2,12,4,5,7,2,8,6,12,6,6,3,10,8,18,5,11,5,5,10,5,2,6,7,7,6,4,8,6,5,4,6,7,7,11,9,13,4,19,9,9,22,13,59,16,9,8,11,10,12,6,10,12,9,9,9,10,31,7,9,6,2,12,14,7,5,10,9,8,8,8,8,2,4,10,14,6,3,4,12,6,14,1,11,23,21,5,4,4,4,10,7,5,15,5,6,4,13,4,4,7,7,9,2,13,10,6,5,8,8,20,5,7,8,0,13,4,18,6,16,13,7,9,8,14,0,10,11,9,18,3,7,5,11,5,4,3,4,5,11,8,4,5,7,5,19,5,12,3,4,11,14,17,22,25,10,9,4,12,7,4,2,2,6,20,4,4,12,5,3,3,7,6,3,3,14,6,4,8,12,6,3,2,15,4,7,2,12,7,8,7,3,10,10,16,5,8,13,13,3,0,1,4,6,21,14
continent,8,8,2,38,0,5,7,17,2,4,35,10,4,67,2,2,1,19,8,1,2,11,5,9,5,7,6,14,3,1,5,73,59,1,29,52,36,3,0,7,3,3,1,1,11,7,18,1,160,39,14,3,9,42,3,3,13,7,1,11,23,7,1,15,5,4,63,0,2,27,7,3,0,4,53,9,6,1,38,19,15,0,13,4,86,0,2,0,19,0,4,3,1,5,33,10,12,2,11,4,1,18,21,2,5,4,0,0,11,4,7,6,1,5,0,17,0,4,18,59,14,9,0,23,5,3,2,2,3,2,3,2,1,21,34,24,2,1,2,10,5,13,11,2,5,28,1,10,13,5,34,2,2,10,3,3,8,1,5,5,6,0,1,2,1,3,1,11,14,4,9,63,12,0,1,1,70,0,5,16,6,12,2,2,0,11,12,8,19,31,0,5,2,2,1,0,5,1,8,1,8,0,0,6,27,1,1,12,5,21,25,3,10,7,0,0,1,0,2,0,10,12,0,4,16,16,8,11,3,7,5,2,9,20,20,6,20,1,2,2,18,18,7,3,10,2,5,9,16,3,1,3,13,3,3,6,4,1,1,3,0,14,9,1,3,8,0,3,11,1,55,3,5,4,4,0,6,2,1,2,29,0,1,11,10,2,1,1,5,1,1,3,0,1,7,1,22,4,8,9,14,11,2,5,2,4,16,1,3,1,1,4,13,2,5,4,10,19,11,1,25,5,13,0,35,1,4,18,3,12,0,1,4,1,8,7,6,6,0,6,1,5,7,8,3,2,13,25,10,2,6,4,3,17,14,1,1,6,3,8,6,1,6,11,10,4,29,2,0,4,2,8,1,6,2,7,1,0,8,3,27,1,6,11,1,22,0,18,20,2,11,1,3,5,22,9,23,0,19,1,12,3,1,0,2,1,3,2,18,8,3,32,1,16,3,6,4,4,1,2,1,4,11,18,2,4,3,5,5,7,10,2,0,3,3,11,0,2,7,3,7,14,5,45,5,2,8,2,22,3,3,3,1,1,45,4,0,4,2,7,5,16,24,10,4,0,4,12,1,0,9,0,0,4,0,4,6,8,12,3,2,8,1,1,7,6,6,1,2,1,38,15,1,3,5,6,4,4,1,0,11,1,3,0,16,17,0,5,3,2,0,3,0,2,5,4,3,4,1,8,7,1,7,9,3,1,15,0,7,19,7,1,2,3,8,5,3,10,22,9,5,1,2,0,2,1,4,6,5,8,10,2,1,24,1,0,23,1,6,5,12,1,4,0,9,5,7,6,13,26,3,5,6,1,1,2,3,4,4,9,4,7,10,15,5,5,5,6,4,6,22,25,3,3,5,1,2,0,17,22,5,2,4,1,3,11,4,5,2,1,6,2,6,9,9,6,7,8,3,3,4,10,2,4,0,4,21,5,5,22,7,9,10,13,5,1,1,2,1,8,6,3,1,3,9,3,5,1,0,133,16,6,1,1,3,5,14,7,2,6,2,12,8,27,8,4,2,4,11,6,5,5,21,0,24,1,2,2,2,2,3,17,10,4,5,1,8,3,5,19,4,3,6,20,0,1,7,4,7,7,5,0,2,2,1,1,13,6,1,3,2,4,4,6,13,2,3,3,3,1,2,2,2,4,1,24,4,0,1,7,4,3,1,2,1,1,8,3,24,10,7,12,4,8,9,5,3,3,1,1,7,1,0,1,2,5,4,12,2,1,0,3,1,0,18,2,9,6,0,6,2,3,3,3,2,4,2,6,8,9,4,6,6,0,4,4,3,6,10,7,4,1,3,4,2,4,2,3,0,0,3,7,1,3,3,0,2,4,11,5,0,7,9,7,1,1,1,7,3,8,3,2,3,3,6,4,0,3,3,6,2,5,3,0,2,7,7,10,9,0,0,0,1,2,0,5,3,3,3,5,14,5,5,1,0,2,2,0,2,1,6,6,3,3,4,5,0,3,3,0,2,2,2,4,1,3,2,18,3,3,2,3,0,5,1,4,3,0,1,3,13,13,0,4,4,2,2,0,3,2,0,2,3,1,0,0,6,2,2,10,3,0,4,0,5,1,1,3,2,1,6,5,4,3,3,1,9,9,4,8,1,2,2,8,0,1,9,2,1,1,4,1,0,0,1,3,4,4,1,1,1,5,3,1,1,0,3,13,2,5,0,0,0,4,2,7,4,0,0,19,6,3,4,2,7,11,0,5,18,2,5,7,3,5,0,0,8,1,12,0,2,2,2,0,0,0,0,0,3,8
sense,2,14,7,64,13,6,5,21,3,2,11,13,6,69,1,4,7,12,4,3,2,24,17,14,16,7,20,15,6,10,8,70,59,23,32,54,26,1,1,5,4,12,6,2,16,24,9,11,163,28,35,7,8,36,7,6,38,3,6,5,23,8,0,5,17,17,80,1,11,4,3,1,2,1,58,5,11,2,48,16,9,0,9,11,104,5,3,1,18,0,4,4,1,25,27,2,11,2,21,3,9,9,14,14,6,13,0,2,5,2,8,3,3,7,10,20,1,2,40,101,29,22,7,27,2,5,1,2,1,2,10,4,4,18,25,34,15,1,3,13,4,26,9,2,2,47,5,11,7,1,29,2,8,1,2,11,16,5,13,15,3,5,6,6,3,14,1,14,12,10,9,65,11,2,7,11,118,5,5,18,15,8,11,10,3,22,12,12,30,22,5,5,1,2,8,2,10,2,6,12,10,0,0,9,7,20,0,18,4,7,47,8,13,3,7,15,1,5,8,3,3,19,5,11,19,59,13,11,4,4,5,2,7,11,15,3,20,2,2,6,37,22,3,5,12,1,3,25,12,6,7,9,17,1,1,8,5,2,2,2,7,26,6,1,7,16,8,17,15,3,65,2,10,1,0,1,20,3,8,2,36,15,0,13,2,1,3,8,9,1,6,11,2,4,2,5,20,7,6,13,25,12,0,1,14,7,15,3,8,0,1,12,20,5,11,2,8,19,3,2,27,7,17,3,82,5,5,28,2,15,3,1,8,4,4,4,14,4,1,7,9,10,13,15,2,1,16,29,11,9,8,5,11,13,14,0,7,1,6,19,14,0,7,14,2,7,20,12,10,19,4,15,1,13,5,15,4,2,12,3,34,4,15,7,7,11,3,5,13,2,29,5,12,6,26,8,28,2,8,1,23,6,3,2,0,5,6,2,10,8,5,7,2,4,26,7,4,2,3,7,1,4,16,8,2,2,1,8,5,7,1,0,1,8,3,8,1,15,14,3,8,10,4,9,1,0,10,5,24,3,14,5,9,3,29,13,7,5,4,11,16,11,15,15,2,7,18,2,10,1,19,3,0,5,6,7,2,9,16,5,6,8,1,1,6,4,5,4,6,3,60,18,2,12,7,1,1,14,8,14,6,0,2,2,3,2,0,10,0,3,0,7,2,5,14,15,7,7,4,6,1,8,2,19,10,1,12,5,11,15,8,5,4,8,6,4,6,3,23,8,2,2,3,6,3,5,2,6,14,3,25,2,6,23,5,5,21,0,0,4,9,1,7,2,4,11,7,3,15,6,6,5,4,2,4,3,7,5,5,6,4,6,2,17,6,6,2,3,1,6,9,28,5,2,13,2,2,2,24,11,7,0,6,2,6,11,4,18,3,3,17,3,4,4,19,9,7,1,4,2,1,0,2,8,1,0,9,6,10,5,1,6,13,13,7,2,5,5,3,2,4,2,13,6,4,4,3,1,2,81,16,3,6,3,2,9,16,30,5,4,5,7,3,7,2,5,1,3,5,6,5,1,14,19,13,9,4,0,1,5,2,8,8,3,3,6,11,3,2,3,10,11,11,8,3,2,7,6,9,3,1,8,5,7,3,2,10,3,6,2,8,3,4,20,10,4,7,8,3,3,0,5,2,9,1,1,4,2,0,10,3,2,2,4,3,0,7,1,18,3,5,3,1,2,9,2,4,7,1,7,7,1,0,0,1,0,13,1,3,2,0,6,3,2,7,9,5,3,1,8,6,2,3,5,2,6,4,0,1,5,1,4,3,1,11,4,3,3,4,2,4,1,1,0,2,8,0,6,4,2,2,2,15,1,9,2,5,3,9,1,5,0,5,0,0,5,3,3,1,11,6,0,0,0,1,4,5,4,2,2,4,0,5,4,7,6,7,15,19,6,4,10,4,2,3,1,3,1,3,7,41,6,10,2,3,2,7,0,3,3,2,4,3,3,2,3,4,3,13,1,2,5,6,1,4,3,2,3,22,1,1,2,1,1,1,3,4,1,1,4,7,0,1,1,9,1,1,0,2,8,2,2,4,9,2,0,1,2,3,17,5,0,6,3,7,1,2,2,3,1,4,5,2,2,2,2,0,10,5,0,3,0,3,0,2,1,0,1,3,5,0,6,0,2,0,8,1,2,6,6,0,5,5,2,0,0,1,4,5,2,0,0,1,2,3,16,0,0,9,5,0,5,11,6,1,1,2,4,2,2,0,5,2,0,6,1,5,4,31,9,3,1,1,1,0,0,1,0,1,4
success,14,17,6,74,14,5,3,22,3,4,23,8,13,76,4,11,6,13,9,8,6,18,17,20,18,8,15,13,6,13,11,163,130,8,46,60,45,9,6,9,6,19,4,5,37,26,10,16,172,34,49,15,22,57,25,2,37,26,6,23,17,10,1,10,11,2,86,8,10,8,13,4,2,8,70,16,14,6,56,20,34,4,11,12,152,16,11,0,31,2,7,13,2,22,57,8,17,12,36,17,5,25,20,13,7,18,5,5,6,9,19,6,10,16,12,25,4,1,31,78,36,26,14,47,10,3,4,1,2,1,14,8,5,39,20,60,9,1,6,8,7,27,19,5,5,55,12,17,16,8,38,7,7,10,3,14,29,20,9,21,4,2,7,2,4,12,4,48,26,8,14,71,27,6,5,7,125,10,4,29,24,11,22,21,1,21,33,10,20,44,2,5,8,3,3,2,7,3,10,9,52,3,7,10,28,13,3,40,11,17,71,7,6,9,4,10,5,2,9,3,4,10,3,13,32,48,11,25,8,14,10,10,18,12,23,14,38,9,10,4,51,32,7,10,16,6,6,31,31,7,8,14,31,8,6,4,9,3,8,15,1,32,5,3,6,22,8,6,16,6,82,9,15,12,2,2,12,14,9,3,64,8,2,22,12,1,6,7,13,2,2,2,3,5,4,5,41,5,8,19,20,21,0,1,15,3,20,6,9,3,4,11,21,9,17,24,13,34,8,6,38,13,20,19,45,1,4,31,4,18,1,8,6,5,10,8,15,5,2,15,10,8,25,6,6,5,24,45,14,8,4,12,7,18,25,2,10,7,7,27,16,15,15,9,9,4,27,9,18,11,7,16,3,16,15,17,6,8,23,4,49,7,27,11,8,23,5,10,14,1,13,6,10,3,21,6,39,3,14,7,20,6,3,5,8,13,11,4,21,10,3,16,2,8,9,12,3,4,5,4,8,4,12,13,3,1,5,16,11,12,3,6,0,4,11,3,1,15,10,3,16,22,13,18,8,5,14,4,28,6,11,3,8,6,43,14,2,6,9,24,18,16,23,24,7,11,22,14,13,5,18,4,0,4,8,30,5,12,25,6,6,13,7,6,1,6,8,5,8,3,54,27,5,8,11,5,10,12,7,9,22,3,3,0,6,5,2,16,4,7,2,4,11,3,24,14,12,8,6,8,3,11,1,8,5,2,13,11,12,17,10,7,5,12,7,6,9,19,35,22,5,3,4,5,7,5,8,18,6,2,12,3,7,27,14,6,27,4,6,8,5,6,9,3,10,13,12,4,18,24,3,8,11,2,1,5,6,4,3,7,14,14,9,19,9,11,3,8,2,15,14,27,5,1,28,2,8,3,31,21,10,2,7,3,4,12,4,11,5,2,10,10,17,8,18,5,15,6,6,3,8,3,0,5,1,6,7,7,19,31,6,16,18,13,7,9,8,2,4,11,7,6,10,16,8,20,6,5,4,107,25,5,12,0,6,7,19,17,9,13,3,10,6,11,9,2,1,8,10,17,10,4,34,6,14,4,4,5,2,4,4,25,12,10,11,9,10,5,4,11,7,12,8,21,5,5,7,4,8,6,9,9,5,7,5,14,20,6,2,0,8,9,5,25,10,18,3,8,2,8,15,14,6,17,3,5,7,14,5,5,4,11,3,12,5,1,16,11,19,6,9,3,4,7,9,7,9,21,15,9,15,5,2,7,4,9,8,11,8,5,4,10,7,4,19,14,2,4,7,7,19,2,1,6,4,8,1,4,12,6,5,6,17,1,9,12,3,10,2,11,10,3,2,3,17,3,6,5,7,4,5,5,10,1,5,6,6,4,13,6,10,0,2,9,6,4,2,1,4,9,5,2,9,8,1,6,12,5,7,6,5,3,5,3,5,15,12,30,9,3,12,3,4,5,6,4,2,2,5,9,25,14,6,11,4,5,3,3,5,3,6,5,5,9,3,18,4,0,7,5,3,4,4,4,20,4,3,15,5,14,5,3,1,6,6,7,8,7,0,2,6,11,3,13,8,4,7,5,5,10,5,1,7,11,2,4,7,6,4,22,6,9,1,2,3,3,4,2,6,5,7,9,4,4,6,6,2,18,3,0,2,4,9,5,6,2,4,7,6,10,9,12,4,2,2,11,9,6,16,5,1,13,7,4,3,1,2,12,1,3,2,6,5,3,3,9,2,1,2,12,12,1,9,11,3,3,9,9,10,8,0,7,4,5,9,5,10,5,10,5,3,3,11,3,0,0,6,6,8,3
decide,3,23,15,151,13,4,17,34,2,4,24,13,8,44,8,14,26,14,8,1,7,31,5,14,21,7,10,7,7,8,16,167,59,6,37,25,30,5,5,9,4,4,0,1,26,14,28,6,236,16,37,5,3,19,1,0,51,32,6,11,8,3,2,10,18,2,108,8,4,8,9,4,4,2,73,7,20,5,60,15,18,0,12,4,166,5,4,0,13,1,29,2,5,32,27,19,13,2,26,6,13,24,33,6,9,26,5,2,4,2,9,0,4,19,4,24,9,4,53,137,22,18,28,47,13,2,3,3,1,0,11,3,3,34,23,48,18,4,2,13,3,20,20,3,5,70,3,5,11,5,65,4,11,2,0,18,19,2,19,8,9,0,2,1,0,4,3,9,13,4,13,76,19,1,3,1,194,3,12,36,14,5,2,12,1,13,20,26,84,43,3,3,0,1,1,0,11,4,17,9,26,0,1,4,14,4,3,14,10,16,70,5,18,13,2,4,1,3,11,0,4,23,9,23,36,87,28,12,4,5,12,13,6,22,20,2,23,5,0,6,49,27,0,13,6,4,7,10,34,12,13,8,15,4,4,9,8,0,6,13,3,15,41,9,5,26,3,5,11,3,109,1,45,5,1,1,16,1,20,8,41,7,0,16,1,1,2,3,12,2,11,2,15,1,0,4,36,5,5,18,19,24,1,0,11,2,17,3,3,2,0,11,14,4,30,2,5,38,2,4,64,6,19,1,61,13,5,15,4,22,21,8,13,7,12,11,5,10,2,9,14,19,12,11,4,1,32,46,12,4,12,22,11,26,17,5,5,8,11,6,14,4,8,9,2,2,23,7,1,12,6,8,2,5,6,11,8,1,23,4,64,8,29,7,6,13,16,19,48,1,33,2,19,21,35,7,51,2,18,0,14,2,2,1,3,0,8,1,5,5,3,10,0,11,5,5,8,2,4,0,1,6,19,15,3,3,0,12,22,15,3,11,12,6,1,1,1,15,10,7,10,19,9,8,4,1,8,5,26,9,6,2,4,2,39,12,0,28,10,23,9,25,22,25,0,11,7,9,4,1,10,6,2,5,6,14,2,16,10,5,3,13,6,4,6,1,8,3,3,3,38,38,1,5,3,3,5,25,9,10,8,2,6,0,5,6,1,30,12,4,2,8,1,9,6,26,4,10,1,12,0,32,7,22,8,8,19,7,22,29,6,5,3,13,25,6,7,15,30,13,4,4,3,2,3,23,4,12,14,6,72,9,13,29,9,7,19,3,8,9,18,5,21,6,8,12,14,9,19,23,8,7,5,7,4,3,5,1,3,5,1,5,9,16,9,7,3,4,4,14,21,30,15,3,11,0,3,5,79,17,16,3,3,13,18,13,5,47,6,3,25,52,16,1,61,5,10,2,22,4,5,1,3,24,1,9,1,3,15,19,0,9,64,25,15,3,4,13,3,4,7,2,21,18,10,8,2,12,9,132,11,6,7,6,6,7,30,9,11,20,2,9,57,9,18,7,3,8,5,10,12,5,77,107,77,1,5,5,4,5,9,36,12,8,6,9,8,1,3,8,29,6,10,1,9,5,7,3,12,8,11,5,3,4,10,4,12,6,1,4,12,4,6,24,16,7,3,8,13,4,5,9,6,10,3,6,5,2,6,4,8,8,0,4,11,6,16,3,39,2,10,4,5,10,14,5,8,3,2,3,3,2,0,4,1,2,1,10,2,3,4,15,8,0,8,3,13,2,1,10,12,2,0,18,4,21,2,3,4,7,0,3,4,2,8,4,3,34,2,6,1,19,5,1,7,14,11,7,0,6,8,4,18,6,1,0,3,0,18,6,1,2,6,7,3,5,3,5,7,9,1,0,4,27,1,4,1,8,3,3,2,4,9,5,3,8,6,19,14,4,8,19,22,61,4,19,4,2,1,21,20,38,8,1,0,4,4,3,11,1,2,11,7,0,12,6,1,4,6,3,2,1,0,4,2,3,3,8,4,2,18,11,5,10,27,5,5,5,1,1,4,8,0,1,13,26,9,5,7,3,8,7,1,4,13,6,7,1,3,36,0,0,5,11,13,3,6,4,0,2,5,6,8,4,2,12,0,12,9,1,2,2,7,1,3,1,1,4,4,3,2,13,0,1,4,18,10,3,9,8,0,5,2,4,1,6,3,1,23,7,0,1,3,6,0,9,1,0,12,1,4,6,6,2,10,0,2,10,4,1,7,7,7,0,6,9,12,0,10,1,6,0,2,0,0,4,1,9,0,1
greatly,3,21,15,117,4,5,5,25,4,2,14,9,10,49,3,4,1,15,3,2,4,29,6,22,23,13,5,9,2,11,4,171,139,19,51,49,39,17,25,7,9,3,3,5,32,16,39,23,239,24,50,2,16,50,14,2,71,45,2,16,16,8,3,13,28,8,74,11,11,18,15,9,10,4,76,16,8,5,77,13,150,2,17,8,199,14,21,2,38,7,9,3,5,32,70,21,16,10,30,29,22,39,30,13,13,24,15,4,24,8,19,7,13,18,0,28,0,4,48,284,37,18,17,92,8,1,4,1,4,0,8,2,5,45,12,58,6,0,4,4,4,38,34,12,4,65,7,14,31,27,46,3,11,17,5,29,26,6,8,7,26,3,9,1,3,2,4,22,32,15,28,86,26,1,6,7,175,2,12,37,25,9,7,14,4,20,33,16,32,67,1,6,6,3,2,4,31,2,13,9,38,2,9,15,31,9,4,52,12,40,59,9,24,8,3,1,2,4,38,4,11,17,8,7,48,75,23,23,5,10,13,23,52,33,37,48,33,9,15,3,56,27,9,6,8,9,5,16,32,6,16,30,11,24,15,31,9,8,4,29,11,24,15,4,3,80,2,5,22,16,139,8,61,9,7,0,10,45,10,3,45,7,5,24,10,2,3,11,15,1,3,1,17,5,5,15,20,4,7,18,17,32,2,2,17,1,19,8,5,5,4,30,36,20,53,26,26,54,11,4,36,8,15,6,29,3,7,20,7,18,1,14,9,7,4,9,11,7,6,19,10,6,24,5,8,3,38,40,28,5,20,9,5,31,20,8,3,3,15,30,17,30,13,13,10,0,27,9,10,9,3,17,14,11,8,40,9,7,16,8,49,2,29,23,2,46,7,18,17,4,16,4,11,11,41,18,51,8,30,4,20,1,6,1,7,7,10,2,45,26,4,11,32,18,7,12,4,7,2,1,7,13,23,6,2,3,8,12,8,23,20,2,0,3,2,4,0,18,11,2,13,14,7,30,1,4,12,7,46,20,19,5,2,4,58,16,1,3,9,37,6,14,21,28,12,9,18,23,7,0,17,2,6,1,4,16,3,6,20,3,3,10,6,5,8,8,1,9,13,12,69,39,1,3,22,11,9,23,6,10,16,10,6,1,15,39,3,12,3,6,18,7,3,7,12,13,1,11,1,8,6,17,8,15,6,5,33,6,18,32,10,7,1,8,7,8,6,11,37,21,9,7,4,8,14,16,7,18,23,12,17,3,7,50,13,12,53,13,8,7,22,6,23,7,23,30,11,8,37,40,7,16,26,6,4,6,16,7,7,26,8,11,24,16,10,14,6,9,7,7,25,28,12,4,40,3,4,14,19,19,30,4,5,5,8,27,4,35,20,6,28,27,5,13,33,11,17,5,8,8,22,8,5,27,7,3,8,6,15,34,26,25,21,14,5,3,6,15,1,14,10,6,6,24,5,33,13,5,5,123,16,6,10,5,2,12,41,6,4,13,9,9,5,24,9,3,2,12,15,17,23,9,32,38,20,4,4,4,4,6,9,21,15,12,14,7,13,4,13,16,12,16,13,18,10,12,13,2,11,14,9,7,6,6,15,12,13,12,3,2,7,6,11,29,16,35,9,5,3,30,11,2,3,38,2,7,12,8,3,14,14,20,7,4,5,5,41,11,26,19,14,6,10,18,9,8,35,14,13,9,11,8,3,21,19,24,9,19,7,43,39,15,4,5,24,34,7,1,15,12,9,7,3,9,3,16,27,6,8,9,5,10,7,6,9,6,12,16,15,16,7,12,5,10,12,22,8,3,5,7,4,5,5,6,2,2,20,6,10,4,19,8,3,15,6,1,6,3,3,12,7,14,8,17,10,4,3,8,16,9,13,9,15,5,8,14,18,25,5,11,2,5,8,5,8,10,9,11,15,11,8,18,10,13,4,8,20,8,6,4,17,5,4,11,8,15,5,6,8,21,14,7,16,24,11,5,2,8,9,0,0,6,3,3,6,5,6,6,7,7,2,2,1,4,7,4,8,3,7,1,20,6,2,8,4,2,3,19,10,11,6,18,11,14,11,4,11,8,6,3,8,10,3,10,3,5,0,5,4,3,5,1,2,9,5,9,13,4,2,13,8,8,18,12,13,26,18,13,51,3,2,4,3,8,9,2,5,7,14,6,3,3,4,9,5,13,10,8,3,8,5,3,8,4,6,3,4,13,15,1,17,4,4,15,6,7,11,10,3,0,7,8,8,1,2,4,3,2,1,1
succeed,1,8,5,54,7,15,0,22,4,3,18,6,16,46,1,20,9,13,10,11,3,19,30,26,5,6,27,31,15,34,3,89,97,21,20,77,40,7,2,6,9,17,6,9,36,16,5,5,108,86,32,14,17,63,35,4,14,6,20,16,6,11,5,9,20,13,46,6,1,3,13,2,7,6,72,6,15,1,39,28,12,1,4,7,90,3,3,0,16,0,3,6,2,30,12,4,7,1,29,5,0,19,11,17,4,17,3,3,14,8,23,5,7,11,10,23,1,3,35,58,26,47,4,65,10,6,6,2,3,1,25,14,1,15,26,60,4,4,5,8,5,28,13,0,1,49,11,9,6,4,34,2,7,3,3,7,36,7,13,36,5,1,8,4,0,23,7,23,17,13,14,88,20,4,16,6,68,5,2,35,6,10,15,18,0,20,18,11,9,32,6,6,1,6,1,3,7,9,7,7,14,1,1,4,20,9,5,10,6,15,53,18,12,10,9,13,0,4,9,0,2,12,4,4,12,14,11,10,9,5,8,12,14,8,15,10,10,4,2,9,39,17,11,12,7,2,4,31,10,6,3,7,21,1,0,9,6,1,1,9,0,36,3,2,4,8,6,22,16,4,55,2,3,3,1,6,12,6,3,0,79,0,0,15,8,3,14,19,12,3,0,7,3,4,2,7,14,5,3,9,23,8,1,5,2,3,18,1,3,2,2,4,24,11,7,13,7,19,2,5,27,2,35,20,32,2,12,44,4,19,16,4,1,3,8,6,18,6,1,7,4,12,12,7,2,7,14,34,7,18,2,11,2,16,11,2,6,1,3,31,6,5,2,7,2,7,17,3,17,32,3,47,3,19,6,4,2,1,13,4,38,2,21,5,24,19,0,12,16,4,16,6,9,2,8,10,15,3,14,2,11,10,1,10,10,1,0,6,10,14,3,11,1,3,6,18,11,7,8,21,5,11,9,10,9,1,0,5,5,19,4,0,5,14,6,1,4,16,11,4,16,5,3,9,1,5,26,12,15,9,27,5,18,3,23,2,12,6,4,11,19,21,19,26,1,5,25,6,0,1,23,10,3,7,6,9,5,3,14,5,4,10,1,4,5,3,9,1,5,1,43,12,3,14,14,6,3,6,9,9,8,4,1,7,5,10,6,6,2,7,3,3,4,3,4,4,3,4,0,7,5,7,2,12,0,10,12,0,14,7,6,5,11,9,4,7,4,10,26,5,2,2,6,0,4,1,7,3,5,1,13,0,3,28,1,1,15,2,3,3,5,0,3,2,9,3,12,2,18,11,2,2,3,0,2,1,0,3,2,13,5,10,6,17,5,1,1,4,2,6,13,15,11,3,4,1,6,1,15,3,8,2,5,3,3,6,5,10,3,1,16,2,6,6,9,5,8,0,1,0,4,3,3,12,2,0,1,0,9,15,7,8,11,10,4,0,3,1,13,3,13,4,6,19,4,4,4,0,0,58,7,2,2,1,4,13,14,13,4,10,3,2,3,8,3,4,2,5,10,3,4,3,30,6,11,5,0,6,3,1,3,11,0,2,4,1,7,11,2,2,5,20,2,4,3,7,7,2,5,4,1,0,0,5,2,7,7,9,1,2,0,7,8,9,4,14,24,2,3,0,7,1,7,12,6,5,2,3,1,7,3,5,1,7,2,5,6,6,21,3,8,7,1,4,3,3,5,3,3,1,13,6,2,6,2,8,3,5,1,3,3,9,1,0,8,6,3,3,3,0,7,3,4,5,2,9,7,4,11,7,3,4,2,0,3,0,4,8,2,5,4,2,1,0,0,4,0,2,1,3,2,3,2,2,11,3,9,5,11,7,2,6,4,9,2,2,4,8,1,8,4,3,5,2,0,1,10,5,5,3,5,2,4,1,4,0,4,21,5,2,4,3,1,1,4,2,1,5,0,4,8,6,1,1,1,5,5,2,1,3,3,5,4,2,5,9,2,1,6,2,0,4,1,4,2,5,0,5,5,0,0,1,1,4,2,1,3,0,7,2,16,3,6,2,6,1,8,4,5,13,1,3,6,5,1,1,3,8,0,8,1,2,1,3,2,5,1,4,4,2,5,2,2,1,2,3,0,6,4,0,1,0,1,2,3,2,1,2,5,3,3,8,1,0,2,4,3,3,8,5,0,4,11,1,2,1,1,3,2,6,2,4,1,0,1,6,0,1,1,0,13,6,10,9,2,3,7,8,3,3,0,2,1,4,1,0,6,11,7,13,2,3,3,3,1,1,0,5,10,19
endeavor,0,14,2,47,7,6,4,31,1,0,17,6,8,55,5,3,2,7,0,2,3,22,10,12,21,13,12,8,2,5,10,78,66,11,35,41,30,1,2,1,2,7,0,1,16,5,7,10,145,5,21,9,17,19,13,8,28,6,1,13,8,8,0,10,11,6,61,4,3,11,3,2,0,4,66,10,11,6,34,9,19,0,9,9,107,7,2,0,11,1,10,5,0,11,31,5,8,4,17,2,1,22,12,13,5,12,3,3,7,2,6,5,0,9,3,13,0,0,21,72,32,11,3,23,6,2,1,2,1,0,13,3,2,22,12,33,12,0,5,3,7,32,13,6,4,51,4,11,15,6,47,2,9,3,5,14,23,5,2,6,5,7,3,0,0,13,5,23,16,5,2,60,21,8,2,7,108,0,7,19,16,10,1,32,0,28,27,20,20,24,1,8,4,0,1,1,8,2,6,19,24,3,2,12,19,5,3,18,4,14,44,4,13,3,1,0,1,0,10,0,2,13,0,4,10,57,20,18,2,2,6,6,6,14,22,11,23,3,5,5,34,25,3,15,15,1,3,20,20,2,5,9,12,1,3,9,5,0,3,8,2,14,6,3,3,12,2,3,6,2,72,0,8,2,3,1,8,5,4,0,35,7,3,21,6,0,2,10,9,2,4,2,4,1,0,5,17,5,3,15,16,8,0,1,1,0,19,1,3,1,0,32,11,4,6,4,8,17,16,6,30,5,18,3,42,5,15,10,3,12,0,5,6,4,6,2,13,6,3,5,9,1,2,7,4,8,19,27,7,0,6,4,5,28,15,1,1,4,13,15,13,3,10,12,3,1,17,6,4,23,3,9,3,6,13,11,5,0,8,1,53,3,25,7,2,16,6,5,8,2,15,3,8,9,17,5,21,1,16,2,11,0,6,3,2,11,4,4,8,9,6,4,2,15,10,5,1,7,2,1,7,3,17,18,3,6,2,9,8,6,4,1,1,4,7,2,2,5,2,0,8,13,8,11,6,7,3,5,30,6,4,3,1,0,42,9,1,3,8,20,7,24,28,33,9,4,9,7,6,0,9,12,5,4,0,19,2,13,17,7,8,4,2,6,8,3,13,5,1,4,30,19,4,4,4,6,7,10,7,27,12,5,3,2,12,3,6,19,6,9,3,8,7,7,12,15,8,9,9,10,7,7,2,15,8,3,16,21,18,9,8,8,5,9,7,6,9,12,17,12,1,1,5,4,6,3,9,4,10,4,28,5,3,22,8,5,12,1,1,4,6,3,7,6,8,4,11,5,21,41,1,4,1,2,6,1,5,1,9,7,5,8,5,6,5,6,4,4,2,8,12,15,3,4,44,4,0,1,30,21,11,3,1,3,7,12,2,5,5,3,16,14,4,3,25,2,11,4,7,2,4,2,4,3,0,2,1,9,9,11,8,12,15,17,8,4,12,4,1,3,8,5,4,12,11,4,1,3,5,62,14,6,8,3,4,7,18,6,7,6,5,3,5,7,2,1,1,3,9,3,7,6,13,6,13,4,1,1,4,9,1,17,11,9,1,4,3,7,1,4,3,2,8,8,4,2,10,2,9,2,14,4,4,6,2,2,9,1,1,0,1,0,5,9,9,4,1,5,4,3,6,2,2,7,0,3,2,1,4,9,5,4,1,7,2,0,4,4,23,5,15,4,1,2,4,3,4,9,2,9,8,1,0,3,0,10,6,4,4,3,6,7,1,0,4,4,7,6,0,6,6,4,3,8,4,6,0,0,2,6,7,2,4,5,18,4,5,2,5,4,4,4,2,4,11,11,1,2,2,1,5,1,2,2,3,3,2,3,12,3,1,2,0,4,0,1,5,3,4,2,2,0,8,3,2,0,1,6,0,2,5,5,5,2,5,4,6,14,0,3,3,4,0,2,4,2,5,3,0,9,8,12,4,0,3,2,8,2,2,0,3,0,4,3,1,2,2,2,3,3,3,4,3,4,3,1,4,5,8,4,0,3,2,3,4,2,4,0,1,0,1,7,1,1,1,3,6,1,2,0,2,4,1,3,3,2,5,1,5,15,0,4,3,0,3,1,0,3,2,4,5,0,0,2,1,3,4,6,4,1,3,2,6,3,5,1,0,5,3,6,3,6,2,0,1,4,2,2,5,1,1,1,3,1,2,0,0,4,1,5,1,7,3,0,0,3,3,3,7,5,4,2,5,6,0,3,0,3,7,2,1,5,1,12,1,0,5,1,8,3,3,2,0,0,2,0,0,0,0,0
civil,3,13,2,71,5,0,1,19,1,0,12,5,2,13,1,5,4,4,0,3,2,10,3,26,13,9,6,5,7,5,2,67,46,5,23,32,16,0,0,2,1,4,2,4,11,9,4,17,151,5,14,3,3,5,1,2,20,24,0,6,5,4,0,0,10,6,32,5,1,7,9,3,1,2,16,3,5,0,13,4,17,1,1,1,75,1,2,0,19,1,1,5,3,12,17,2,7,6,16,4,1,17,8,1,4,14,6,8,7,1,8,2,3,8,2,14,8,5,48,36,8,11,8,37,7,1,2,1,0,1,1,0,1,19,9,30,5,9,0,5,1,13,14,1,3,24,1,6,11,7,25,0,3,2,0,43,7,1,3,1,5,1,2,5,0,2,5,6,13,1,6,31,5,2,0,5,87,2,6,14,13,6,3,9,0,4,15,8,13,12,2,3,0,0,1,4,2,3,5,6,11,0,0,6,11,3,0,23,4,8,26,3,17,3,1,1,0,0,11,2,1,6,5,3,17,92,15,11,1,10,3,8,7,5,11,3,11,2,0,5,29,7,2,3,2,3,2,8,20,1,10,2,8,8,2,5,3,1,2,11,13,10,6,4,2,25,5,3,2,2,60,0,14,1,1,1,10,7,0,5,21,2,0,7,4,2,4,2,3,1,7,1,2,2,4,4,15,1,2,7,4,22,2,3,5,0,7,5,0,0,4,9,3,7,9,8,4,15,6,2,30,2,8,0,34,18,1,10,1,9,2,4,3,1,1,3,1,3,1,9,1,3,8,2,1,2,20,16,10,0,10,2,3,6,8,0,5,1,6,12,12,6,3,2,3,1,6,1,10,5,4,8,0,3,3,108,9,1,7,5,24,1,7,4,3,12,9,12,6,0,19,2,3,2,17,5,33,2,16,2,9,0,1,0,0,2,2,0,3,6,0,6,0,15,3,4,0,2,0,0,3,7,12,7,1,1,2,14,2,7,3,8,1,16,2,0,0,1,9,5,9,16,1,3,2,3,0,0,8,1,5,2,0,1,19,14,1,2,1,12,8,2,7,13,5,23,4,10,1,0,5,2,1,1,4,0,2,6,13,0,3,3,1,3,3,3,12,1,4,1,44,10,4,3,2,3,2,9,8,1,5,4,0,2,0,0,0,12,2,4,0,1,6,8,4,7,1,7,2,5,0,6,3,14,4,2,10,1,5,9,2,0,1,5,7,4,7,0,14,8,0,0,0,1,0,9,19,1,4,3,18,11,16,17,6,3,5,0,5,3,5,2,5,10,8,6,2,14,16,21,9,3,7,9,7,1,2,5,3,11,0,17,1,8,3,1,4,3,0,1,18,10,4,1,6,0,0,1,14,8,15,3,0,0,0,11,5,23,12,3,13,64,11,4,19,7,5,0,12,9,9,0,9,11,4,2,2,0,10,24,0,17,4,12,5,1,2,2,3,6,4,2,4,9,3,10,5,11,2,93,31,4,1,3,2,1,18,4,4,5,3,7,5,7,2,1,0,4,7,5,11,1,10,85,12,5,4,0,8,4,3,7,8,3,13,7,6,2,1,0,7,1,3,2,4,2,7,3,12,4,7,2,4,2,8,6,6,2,5,2,2,16,2,7,5,17,6,2,1,10,5,1,1,25,2,11,1,1,7,9,3,6,0,1,3,2,10,1,20,2,2,1,0,1,3,1,5,4,0,1,4,0,4,16,10,10,1,14,7,3,2,1,10,4,31,4,9,8,1,3,5,2,0,13,9,5,0,2,3,4,0,1,4,0,3,2,2,18,0,4,6,15,4,1,1,5,0,6,1,16,0,0,4,2,0,2,1,3,7,4,0,0,3,4,1,1,4,6,1,4,1,5,1,18,1,3,2,2,0,2,2,1,7,3,3,4,5,15,5,1,0,4,12,0,0,3,2,0,2,6,2,12,11,3,1,4,1,1,6,2,0,2,2,0,5,5,0,3,2,7,2,6,0,0,2,2,0,0,3,0,0,5,2,0,10,4,3,1,4,2,1,6,0,3,1,16,3,7,3,3,0,1,18,6,7,8,0,0,3,8,1,0,4,9,5,6,2,1,0,2,0,2,1,0,2,9,1,2,0,0,7,0,2,5,3,0,0,2,3,5,6,2,1,1,0,2,10,6,6,1,6,0,5,0,5,1,0,0,7,0,1,0,2,7,0,4,4,11,0,0,2,1,2,1,1,0,8,4,0,4,0,0,1,0,3,1,5,0,7,2,4,2,4,2,3,1,0,3,3,0
war,26,117,34,729,88,72,23,174,23,29,119,40,114,751,30,44,68,72,51,38,24,218,90,184,111,82,98,119,60,147,197,1100,769,107,379,532,820,27,105,77,57,82,43,35,174,147,142,98,1784,230,409,55,49,558,23,84,268,289,42,116,127,82,26,89,102,56,487,58,48,191,170,56,29,11,594,86,169,48,654,133,376,14,82,80,1058,107,125,14,261,25,73,55,46,232,288,38,132,27,314,78,107,193,160,72,90,181,66,49,100,51,144,30,90,88,38,236,39,31,449,1340,267,151,100,575,73,44,31,51,30,22,91,45,46,297,196,253,54,36,38,71,43,270,268,34,29,455,41,82,126,134,420,24,120,60,19,84,223,63,133,87,115,28,72,33,166,63,79,124,143,76,145,618,142,21,55,102,1012,33,71,315,166,109,91,133,30,124,232,146,199,341,30,36,9,19,30,34,102,42,63,93,64,17,11,78,257,71,48,133,69,231,427,68,101,61,43,26,19,54,51,17,48,172,40,102,373,364,189,224,70,207,68,163,197,142,253,66,175,63,113,52,399,193,49,50,118,63,41,200,342,42,66,103,126,42,63,111,88,34,29,217,11,404,107,22,27,394,16,87,110,44,772,39,179,33,27,22,164,196,84,11,370,32,33,81,63,21,21,67,119,29,47,37,48,74,50,59,195,35,38,120,184,197,50,42,81,14,193,28,28,12,12,105,187,38,216,124,81,235,48,42,249,48,227,16,516,30,59,237,34,231,53,79,78,30,58,74,153,55,53,138,97,135,119,84,47,61,284,368,106,41,62,35,30,209,142,23,33,50,69,320,79,42,58,147,27,18,270,83,28,113,24,153,23,52,38,328,79,27,104,46,398,19,370,77,63,178,50,169,179,27,152,54,42,39,219,83,247,49,228,45,100,49,28,22,37,24,39,22,129,65,28,55,34,125,159,93,38,81,23,68,32,75,99,114,19,39,33,130,131,134,41,47,49,102,53,38,30,76,171,36,142,114,52,176,13,45,152,99,271,40,130,55,50,22,348,67,20,144,46,138,97,164,228,398,108,49,167,60,54,12,148,41,15,36,37,127,45,60,186,50,42,122,38,60,54,38,69,43,30,44,1,242,45,61,58,44,59,112,79,46,69,57,34,20,39,44,30,75,22,22,36,32,43,11,83,99,29,48,7,86,31,124,14,156,57,50,176,35,122,169,101,52,122,61,39,75,83,33,242,63,39,19,36,39,45,38,132,91,73,42,123,42,14,241,74,70,188,19,28,56,132,26,104,38,79,121,84,52,251,185,61,44,122,16,55,30,19,31,51,132,26,128,61,142,55,50,48,42,42,69,139,217,56,32,66,20,27,32,252,135,149,49,49,35,43,125,29,182,49,32,163,91,38,38,166,58,106,9,28,29,58,12,30,110,30,35,51,61,61,169,32,102,113,126,67,28,30,82,31,104,62,14,38,172,39,446,32,35,17,1132,163,48,47,20,37,108,215,149,75,81,37,41,34,154,55,33,28,64,68,68,163,52,630,59,151,78,18,26,44,36,34,193,94,40,79,66,94,46,49,140,95,77,87,110,57,63,70,24,60,77,51,57,23,51,50,96,132,88,34,46,18,109,63,209,101,592,173,56,77,83,113,35,138,259,60,60,81,19,19,78,66,102,22,30,41,68,457,40,197,97,95,67,45,205,157,37,95,54,29,42,65,33,85,153,67,70,68,81,25,48,41,77,33,37,99,39,58,55,38,61,52,9,18,105,49,109,43,28,68,68,33,23,97,10,60,51,32,239,62,80,38,22,6,34,27,83,13,51,31,23,19,44,82,30,58,26,49,31,75,47,30,19,88,58,36,52,31,56,41,84,28,37,54,85,19,26,33,40,26,24,55,48,42,105,51,43,79,186,110,22,51,23,9,27,42,88,36,46,36,86,198,110,40,37,25,54,46,20,37,13,32,27,34,29,54,67,45,12,111,69,35,38,37,28,38,54,18,62,63,45,9,25,39,58,44,26,47,75,51,28,36,49,13,37,71,113,67,23,41,203,48,45,79,63,30,72,15,20,12,145,27,66,22,66,57,62,34,28,27,34,50,59,52,53,35,45,38,84,37,7,31,27,37,46,36,19,16,43,27,52,41,81,78,39,38,92,107,217,140,25,61,55,23,75,56,47,30,66,133,23,6,23,12,26,25,197,57,100,5,58,269,48,73,46,24,35,100,72,44,54,17,23,16,13,53,26,64,37,195,29,22,35,63,21,8,23,21,65,14,29
present,32,104,38,602,33,26,16,126,27,18,68,30,35,212,23,17,25,58,15,7,38,112,17,74,69,35,35,42,24,84,30,539,356,28,171,123,117,31,56,16,21,14,16,14,91,60,109,51,834,45,151,18,51,95,14,22,196,179,6,58,66,27,12,32,81,24,270,31,29,28,65,12,15,15,238,31,57,28,264,79,177,4,51,23,683,67,46,5,141,8,35,17,11,134,202,52,59,23,130,40,62,104,124,34,55,85,49,20,56,27,50,20,43,40,3,98,15,18,214,552,152,30,51,322,33,16,11,10,34,10,72,9,14,144,73,154,29,11,14,20,10,113,87,11,11,205,12,39,55,61,165,4,56,31,16,82,84,23,25,13,39,14,28,13,25,23,14,50,84,36,62,277,60,9,19,31,556,18,28,108,68,39,26,52,35,69,115,61,143,173,8,24,7,2,10,14,91,14,38,29,88,19,16,28,70,24,25,119,40,70,214,20,86,22,3,2,21,22,53,11,52,60,23,49,195,299,117,95,37,52,45,67,110,57,93,114,112,28,22,26,214,121,16,17,32,18,23,60,157,19,41,73,64,55,41,53,45,9,11,68,17,68,86,28,34,186,15,17,34,14,447,30,207,25,25,1,53,116,61,23,175,20,5,63,37,11,13,38,44,4,18,20,94,50,19,30,133,28,19,52,74,163,10,10,35,8,53,25,22,9,5,65,109,11,110,58,47,132,29,23,97,30,91,18,169,24,47,66,27,59,18,48,32,18,26,42,37,27,30,71,55,32,59,41,20,19,172,149,70,31,61,37,15,90,65,30,10,17,51,153,63,33,30,61,21,4,106,27,34,49,13,60,22,30,31,103,39,6,45,42,263,1,157,36,10,134,6,83,101,11,85,11,70,34,149,40,259,40,82,16,70,10,14,4,22,23,26,13,62,40,3,21,22,67,37,26,19,20,16,2,8,33,72,49,2,25,12,43,46,53,91,37,49,47,7,15,6,31,29,19,42,62,24,51,7,14,20,14,128,27,36,29,14,13,154,32,6,40,27,107,35,66,97,95,24,12,36,40,25,3,45,11,16,17,10,45,8,60,72,26,28,44,15,18,27,38,39,12,19,10,242,1,7,18,29,24,14,58,24,38,38,24,20,12,50,90,21,43,29,19,13,26,27,25,60,72,21,33,31,28,12,51,28,68,35,17,74,13,70,96,44,19,12,24,41,29,47,42,98,76,12,8,3,28,36,37,17,63,61,35,131,16,22,175,26,34,101,13,15,40,140,28,73,12,62,68,47,39,107,117,43,41,113,10,18,32,39,23,32,75,20,52,34,37,35,13,24,35,13,33,60,118,43,22,44,10,19,19,123,56,72,13,24,14,38,74,27,81,32,17,105,88,36,16,152,27,66,18,41,15,56,27,24,79,14,32,40,41,41,71,53,99,81,68,33,16,33,35,15,39,21,4,32,88,25,204,15,18,27,456,57,24,36,25,23,53,143,39,17,41,35,19,34,49,17,29,10,33,55,46,62,21,104,144,129,20,24,47,14,19,27,84,44,35,28,37,45,19,11,34,58,33,71,44,26,39,33,17,52,63,29,20,27,24,44,30,52,21,12,18,11,69,18,107,63,73,23,23,36,31,29,14,14,100,12,33,44,8,16,46,39,48,21,22,29,18,118,17,86,48,54,30,14,44,34,17,53,24,14,13,39,76,64,129,65,61,26,37,19,76,78,47,23,44,45,52,21,32,18,34,27,14,12,62,14,42,32,10,52,34,21,21,49,20,43,19,14,50,27,45,31,42,11,20,55,65,27,25,15,19,21,17,40,51,9,13,18,19,56,21,32,21,15,36,28,17,22,23,20,42,12,19,23,34,19,17,10,36,13,17,44,50,49,9,20,36,52,72,41,27,22,35,26,35,11,27,32,25,39,23,63,68,21,19,12,7,26,28,17,5,14,13,13,20,25,18,12,28,27,68,26,15,32,40,17,23,13,55,34,14,12,28,21,18,38,20,27,30,18,26,6,25,0,12,27,25,17,12,31,4,20,32,13,48,37,11,25,41,16,77,11,69,18,71,49,12,28,20,9,18,28,26,16,29,6,22,16,62,18,25,15,19,25,24,19,29,14,33,19,47,21,30,180,54,44,67,50,178,249,26,12,14,14,25,29,47,24,24,80,20,33,13,13,10,14,52,31,17,19,23,18,23,22,16,19,26,10,31,22,10,24,23,23,30,29,32,25,10,57,4,15,8,36,2,2,12,6,40,3,4
heart,3,9,8,15,6,9,4,17,2,6,10,7,8,49,2,8,4,12,9,2,1,10,18,17,5,10,11,6,14,13,7,72,63,10,12,62,27,3,0,6,4,16,4,1,20,3,6,3,46,32,20,4,6,40,4,7,9,4,12,9,3,2,0,1,6,12,57,4,1,29,9,3,0,3,45,8,6,4,21,10,6,2,1,10,47,1,1,0,5,0,1,5,2,12,11,4,7,0,20,3,2,8,5,4,1,13,1,5,4,3,11,1,6,9,3,14,0,2,11,73,12,27,1,17,4,8,0,1,0,1,12,3,5,15,9,13,2,1,0,9,7,14,7,0,6,16,4,3,4,5,24,3,2,1,1,8,19,4,5,12,2,1,5,0,4,4,2,8,6,2,8,39,15,1,0,4,41,0,7,14,12,7,7,7,0,16,10,9,13,14,2,6,0,3,1,1,6,3,5,4,6,1,1,5,4,4,1,2,6,13,21,6,9,5,6,7,1,2,4,0,2,8,1,8,10,10,11,5,3,3,5,5,5,0,6,0,8,7,0,0,12,5,6,5,7,2,0,9,6,1,5,5,19,0,0,8,2,0,0,5,0,15,4,2,0,0,0,11,5,0,36,1,0,2,1,1,5,2,2,0,25,0,1,11,2,2,2,1,7,1,1,3,2,2,2,2,13,2,1,10,13,4,0,1,2,3,5,9,2,0,1,2,2,6,8,1,4,5,5,1,9,6,8,1,17,2,6,30,2,22,1,3,4,2,4,2,5,0,2,1,7,3,8,2,1,6,5,14,4,15,3,8,3,4,4,1,3,4,4,6,1,3,2,10,2,3,13,5,1,6,3,8,2,11,7,8,1,1,16,3,17,1,11,2,5,9,5,3,13,1,6,2,3,1,5,5,8,4,10,3,2,3,4,3,2,1,1,0,3,5,3,7,0,5,3,9,0,10,3,1,2,2,2,2,2,0,2,3,2,5,0,0,0,2,2,0,3,5,10,1,1,4,0,4,1,3,4,6,12,7,9,1,3,4,17,4,8,1,2,3,6,12,17,29,9,0,18,3,1,0,15,6,0,5,1,12,10,3,4,1,3,1,1,2,5,1,1,3,4,4,45,7,1,12,7,0,0,2,3,2,3,2,1,0,1,2,2,6,2,0,2,2,1,0,4,2,2,6,0,9,0,4,0,2,0,3,6,0,1,9,4,9,15,3,1,2,4,4,9,2,4,0,1,0,1,0,1,4,4,0,6,1,0,8,11,1,3,1,0,4,3,0,1,1,4,2,3,3,11,9,4,0,0,1,1,8,0,1,1,1,1,9,5,5,1,3,3,1,1,6,9,7,2,1,9,0,0,3,5,3,1,0,4,0,2,9,0,0,0,0,4,0,3,5,8,2,4,0,2,1,1,0,2,4,1,1,3,3,2,6,0,6,6,9,3,0,7,4,5,0,3,7,2,8,1,4,0,1,1,30,2,4,3,0,2,5,6,6,5,6,1,5,2,6,4,1,0,3,1,2,5,3,10,4,3,3,0,1,3,1,2,4,4,1,1,4,4,3,0,2,1,5,5,1,2,2,4,2,2,4,1,0,0,0,0,1,4,3,0,0,1,2,0,1,1,17,2,0,2,2,5,1,0,4,0,3,6,2,2,8,2,2,2,0,1,11,3,4,8,1,6,2,1,2,2,1,2,4,3,3,12,0,0,1,0,2,4,1,0,0,0,1,0,1,11,6,2,1,1,1,3,1,1,3,0,1,0,1,3,2,1,2,6,0,5,2,1,1,2,1,1,2,5,0,0,3,1,0,1,1,2,2,2,0,5,2,2,1,4,0,0,2,4,0,0,2,0,1,6,0,0,3,2,2,1,4,4,0,1,2,2,2,6,10,2,1,6,10,0,1,0,2,1,0,2,0,4,2,1,9,8,7,0,2,0,1,3,0,0,1,0,2,1,1,1,0,1,0,1,0,0,1,1,0,0,4,0,5,7,1,1,1,0,4,0,0,0,1,8,0,4,5,0,1,2,2,0,2,1,10,4,2,1,2,0,1,0,1,0,3,0,1,2,0,0,1,0,0,4,0,4,1,0,0,3,1,1,1,0,1,1,2,0,2,0,0,4,0,0,3,1,8,0,0,1,2,0,1,0,1,0,4,3,1,1,1,2,1,2,1,0,2,1,0,1,0,6,0,1,0,21,0,2,6,0,3,1,1,1,5,1,2,1,2,3,0,2,0,1,4,2,3,3,1,1,0,1,3,0,0
struggle,0,17,6,46,16,16,5,27,2,4,8,4,6,79,5,14,7,13,9,8,1,22,12,18,6,18,20,23,10,22,6,69,60,13,30,75,39,1,3,4,7,38,1,4,18,21,7,12,148,46,46,16,10,71,25,6,22,1,19,10,14,12,1,7,23,12,91,4,5,3,11,0,1,4,55,9,19,8,41,26,19,0,3,11,106,4,5,1,15,0,4,8,3,18,26,2,13,1,38,3,1,13,13,11,11,9,4,4,4,2,14,4,6,7,10,12,3,2,25,87,16,31,14,50,9,8,4,3,2,0,18,5,12,16,30,29,4,2,8,12,6,30,9,2,5,41,8,8,2,2,34,3,8,3,1,11,16,11,21,34,9,3,7,0,2,12,4,20,16,11,10,54,16,3,9,7,89,3,9,24,4,5,9,16,0,6,10,16,25,22,3,4,4,5,2,4,12,5,7,9,9,0,1,9,27,6,2,3,4,21,44,12,10,10,10,13,5,8,4,0,4,11,2,6,18,18,8,14,4,5,5,2,10,12,20,4,21,5,4,6,33,16,5,5,16,2,6,19,17,4,1,9,19,0,0,10,6,2,2,5,0,30,5,0,8,3,3,11,18,3,41,7,11,1,4,2,6,3,3,0,45,5,3,13,2,2,7,8,6,2,6,7,4,2,0,8,14,4,3,13,23,4,0,1,7,4,15,3,4,0,6,5,20,6,12,4,5,23,8,3,24,9,22,9,44,1,12,33,0,12,8,10,7,3,3,4,19,6,2,7,8,5,14,6,2,3,19,25,8,21,2,14,3,13,10,0,5,4,8,19,5,1,7,10,1,8,20,5,8,23,3,31,0,7,11,1,3,1,18,3,24,0,12,3,9,10,2,15,15,3,11,1,5,4,15,14,21,4,16,3,10,5,3,3,2,2,5,3,7,8,5,9,1,6,20,13,5,9,3,8,4,2,7,8,7,3,4,8,9,12,3,1,3,5,6,2,2,10,7,4,9,9,1,16,3,5,14,7,27,5,13,7,7,6,22,7,8,9,4,16,14,16,23,22,4,2,19,3,3,3,17,3,2,5,4,14,7,5,11,4,1,3,3,12,8,5,3,14,4,3,61,18,12,1,8,3,1,6,11,11,2,0,1,3,1,3,0,8,3,1,1,5,1,2,2,13,3,11,4,11,1,10,3,10,4,2,9,1,6,13,5,5,4,6,1,10,1,7,18,7,1,2,3,4,4,1,18,10,4,0,14,5,2,19,0,2,11,3,3,5,4,2,8,1,6,6,9,3,15,8,4,3,1,3,1,2,10,4,3,11,2,7,9,20,8,3,4,3,2,5,12,24,10,1,8,3,2,2,7,10,10,2,3,0,2,8,2,11,1,0,10,2,3,8,7,1,10,1,3,1,4,0,3,14,0,2,6,4,6,17,6,2,7,16,3,2,8,2,3,3,4,5,3,12,4,8,0,2,1,89,9,5,5,0,4,11,21,19,5,3,3,7,6,8,0,3,0,3,8,8,4,3,27,8,3,12,0,1,1,5,2,10,8,2,2,3,15,6,2,1,7,8,7,4,3,1,10,2,8,2,4,3,1,2,0,1,11,5,0,2,4,3,3,9,3,4,4,9,4,2,4,2,3,4,2,2,2,2,1,14,1,7,3,1,3,1,2,3,13,6,1,3,1,0,2,1,4,2,4,2,14,2,0,0,2,5,9,5,0,3,1,12,4,1,10,8,1,3,2,2,4,2,1,4,3,11,2,1,1,4,0,0,6,1,1,4,3,14,5,4,6,4,2,1,0,7,0,1,0,1,1,1,9,0,10,3,6,5,5,4,2,2,2,2,1,2,4,4,2,3,6,1,0,3,0,4,7,1,2,1,2,1,6,2,6,12,4,19,7,1,2,4,2,6,2,2,1,3,2,3,14,5,6,3,1,3,0,1,2,3,0,6,1,0,3,5,1,0,8,0,2,0,2,1,2,4,1,10,8,4,0,4,2,4,2,3,3,1,2,3,5,4,8,2,6,7,1,1,0,10,2,6,4,6,0,1,3,1,1,11,5,4,6,2,2,3,0,1,2,0,8,4,2,1,0,3,8,12,1,1,0,0,2,1,2,1,0,3,3,2,2,13,0,0,1,2,8,3,4,0,2,6,5,1,0,2,0,4,4,4,0,1,0,3,2,5,0,0,4,1,5,4,11,7,5,0,3,3,1,4,0,1,1,0,1,0,4,5,29,6,2,4,2,3,5,3,4,3,5,14
abroad,1,8,6,110,11,17,5,27,2,8,8,8,11,95,7,9,9,24,14,11,11,32,29,23,19,13,24,26,16,23,6,183,208,32,69,121,70,15,24,19,11,27,4,7,31,16,13,11,206,83,60,11,27,106,21,3,79,23,19,22,13,15,2,13,48,16,99,10,21,7,16,3,7,3,97,16,23,13,106,39,79,4,8,13,143,23,13,0,22,3,8,12,3,39,61,20,17,12,48,37,2,24,25,12,19,26,6,3,25,14,20,15,16,27,10,45,5,3,47,157,25,56,11,72,6,6,9,2,4,4,22,3,10,69,33,74,2,11,13,16,6,42,21,8,1,77,10,27,28,7,38,3,27,10,7,6,50,8,6,39,33,2,11,11,12,13,9,25,33,9,24,94,30,3,20,8,128,5,11,44,21,15,17,25,3,52,33,10,28,24,3,5,30,11,1,2,10,7,6,13,54,4,6,10,32,7,9,55,18,28,58,14,15,13,9,7,3,4,9,2,12,15,6,14,29,94,38,40,6,8,12,15,26,12,45,30,26,17,39,8,57,57,9,8,17,16,5,37,50,11,11,45,17,11,13,17,8,9,4,22,0,44,13,2,8,40,8,26,19,6,138,13,42,5,5,9,31,10,3,2,89,1,13,16,15,8,9,14,14,4,8,5,8,5,3,4,29,8,11,23,22,27,2,7,17,5,18,2,7,2,7,9,62,13,52,20,29,40,32,9,62,8,33,11,43,2,31,38,3,37,6,14,7,2,9,5,17,7,4,16,9,24,30,4,9,6,38,33,20,17,9,9,2,39,14,6,2,7,18,31,27,8,19,18,10,11,41,12,11,31,9,45,6,31,10,18,2,8,15,10,51,4,50,16,14,16,6,25,27,2,13,10,6,5,23,17,38,1,26,11,23,10,8,11,3,8,9,2,68,20,3,5,63,17,3,16,13,4,7,17,5,16,15,2,0,11,9,8,9,10,13,3,1,10,4,1,3,12,13,2,15,33,5,36,2,4,34,16,39,23,39,5,13,7,46,8,8,4,4,27,12,21,37,35,5,2,201,9,3,4,21,5,5,9,4,14,7,10,16,7,8,19,5,7,11,3,22,14,4,2,58,29,7,8,1,5,6,16,8,8,9,5,9,3,17,50,13,18,9,5,5,5,1,6,20,11,4,11,3,14,3,9,9,13,4,2,27,4,26,27,13,10,7,3,16,16,5,9,41,13,5,6,6,18,37,4,4,33,13,8,16,3,6,47,3,5,40,4,5,10,15,5,17,1,8,24,15,6,25,36,16,11,7,1,2,0,66,4,5,20,28,9,12,27,13,13,5,13,8,17,28,23,18,5,33,5,12,10,11,10,6,3,9,1,2,21,8,13,2,2,27,17,6,11,30,9,12,14,6,1,9,14,8,22,2,6,2,11,12,31,66,23,21,13,6,4,10,6,6,11,14,7,4,12,7,21,8,1,7,115,4,2,5,5,3,20,35,12,5,12,3,4,6,8,2,1,0,4,12,9,17,10,10,9,15,5,2,6,3,4,5,26,12,8,13,8,19,3,3,9,9,23,14,3,3,7,9,4,8,9,6,2,8,13,15,10,17,8,1,3,2,8,8,17,14,13,14,1,4,6,7,1,2,17,5,2,9,9,3,15,5,18,22,4,6,5,16,6,7,9,10,3,3,24,17,5,15,8,12,5,18,2,7,12,11,9,6,11,6,32,27,15,10,18,19,29,12,6,23,5,13,5,7,15,6,12,25,3,0,8,0,6,7,10,13,5,13,6,10,15,14,6,2,4,3,10,3,7,7,3,6,6,6,3,15,4,21,7,14,5,45,9,8,3,13,3,3,13,5,3,5,2,4,15,1,5,10,3,17,9,11,5,21,9,15,9,6,28,11,5,2,3,1,1,7,14,13,12,5,10,9,10,4,5,8,12,8,23,3,4,2,5,5,4,2,5,5,2,7,9,4,11,8,23,7,5,1,3,9,2,0,5,3,0,2,2,6,1,6,6,6,3,2,1,4,3,0,0,1,20,10,3,11,14,1,2,7,12,2,19,4,17,6,2,11,6,6,9,8,5,7,10,3,23,3,5,6,3,2,10,7,0,10,2,5,3,9,6,4,8,4,22,3,4,16,23,22,8,27,5,5,3,0,8,5,1,2,2,18,3,0,2,4,2,4,20,2,0,0,10,8,3,7,12,2,3,7,10,5,1,7,3,0,14,6,5,3,20,2,3,5,6,6,6,1,3,1,0,1,12
occupy,2,10,1,111,6,4,4,33,4,4,12,3,6,35,3,2,4,7,3,2,3,36,3,5,12,4,6,8,3,7,5,106,94,2,38,16,30,15,11,2,1,2,3,2,23,9,18,4,210,21,17,0,8,25,3,8,42,27,1,16,16,7,1,4,8,2,48,6,5,13,3,6,3,2,25,6,4,8,55,6,17,0,8,1,151,7,8,0,21,6,6,2,2,17,34,3,12,3,14,5,15,12,20,10,9,18,3,2,15,1,6,4,1,2,0,13,8,11,35,94,19,9,1,37,8,1,2,1,2,1,12,1,4,26,18,18,8,1,1,6,2,18,34,2,2,29,6,7,10,10,42,0,2,3,3,10,7,1,8,6,9,7,4,3,0,5,5,10,19,10,13,45,6,0,1,3,107,4,9,12,12,11,0,10,4,12,17,10,18,24,2,9,3,0,0,5,6,0,6,6,11,2,0,12,21,4,4,12,12,22,43,2,17,6,2,1,0,0,11,0,1,13,5,7,25,57,11,6,4,1,11,11,3,14,23,8,20,7,3,4,47,25,1,5,2,4,6,4,22,3,8,11,10,4,8,5,4,2,1,13,7,13,12,1,3,35,3,2,6,3,71,2,8,6,2,0,19,4,12,4,26,1,2,10,10,3,2,6,4,2,7,0,3,1,4,11,23,7,5,12,18,14,0,2,5,0,13,2,2,0,1,10,9,6,21,10,7,24,9,7,34,4,12,3,34,7,2,10,1,17,1,10,10,4,7,14,10,9,4,11,1,11,10,9,5,6,32,37,8,4,3,3,3,15,16,2,3,0,8,14,10,2,5,11,1,3,26,6,2,7,1,10,1,5,7,17,4,1,8,6,36,4,21,5,4,91,2,10,15,5,13,2,7,6,19,8,48,5,37,5,22,2,4,1,4,5,3,3,12,10,2,10,1,11,11,8,8,4,2,3,6,32,12,8,6,3,5,7,6,7,5,2,1,9,1,2,2,11,11,4,5,18,1,10,3,5,5,5,24,3,7,2,1,4,32,0,0,5,1,23,6,18,24,7,3,2,8,15,9,0,12,0,0,1,1,2,7,6,6,7,3,15,6,1,5,3,11,6,6,3,44,24,0,3,5,1,4,11,1,9,14,3,3,1,6,6,6,11,4,5,2,3,8,4,14,12,2,8,1,6,11,21,4,12,2,5,14,2,12,20,5,3,4,3,6,4,15,3,27,13,3,2,2,2,2,3,1,16,12,3,22,9,2,43,5,2,18,4,4,3,22,4,14,0,16,3,4,8,25,22,15,6,3,0,3,4,6,2,3,10,6,16,13,8,7,0,10,2,3,8,9,24,6,2,14,3,3,1,41,6,11,0,6,1,3,12,4,15,4,3,22,11,9,7,15,7,7,4,2,4,11,1,4,15,1,4,8,3,9,32,7,28,20,16,8,0,3,2,3,13,4,2,4,26,6,17,3,5,1,131,15,2,7,3,6,4,23,10,3,14,3,4,12,17,4,4,0,15,13,5,17,6,64,11,23,4,2,10,1,15,5,10,10,10,6,5,5,2,2,9,14,5,9,11,5,11,6,5,3,22,10,2,10,7,6,5,12,2,4,5,2,5,2,12,20,38,21,4,9,3,8,1,13,17,2,29,6,3,1,10,4,14,12,4,6,8,8,3,61,17,8,14,13,1,5,6,3,2,3,1,6,2,0,1,3,9,5,9,3,2,4,7,2,1,23,13,17,7,7,15,3,6,1,8,2,5,2,4,43,7,21,7,4,0,9,5,5,63,7,5,3,7,0,4,6,13,3,14,1,9,1,10,6,4,1,2,0,6,11,8,1,16,9,4,3,5,4,3,9,8,5,3,8,12,5,3,1,4,6,6,8,7,2,11,7,8,7,24,7,7,4,4,1,1,4,6,4,4,9,8,10,19,4,3,0,2,3,7,3,2,5,2,2,3,2,10,4,2,8,13,5,3,2,7,0,1,9,14,6,6,0,5,4,1,13,2,10,6,7,9,1,13,0,4,8,12,10,1,8,4,6,3,2,6,1,0,5,5,2,9,4,1,3,6,13,3,1,8,2,1,8,6,4,1,8,9,4,15,5,2,7,0,5,7,1,4,3,2,1,13,0,7,0,1,3,11,4,7,16,4,1,1,1,2,1,1,6,3,8,4,12,9,6,3,0,6,5,0,2,4,3,3,2,1,11,7,0,5,5,9,3,4,6,7,4,2,1,1,19,0,1,1,6,0,1,0,0,14,1,1
material,4,7,1,34,1,4,2,9,0,6,4,7,13,44,3,5,1,12,2,1,1,20,6,13,7,1,4,7,4,3,4,84,61,5,22,42,15,9,17,1,3,5,1,2,6,11,8,11,78,12,21,3,14,27,4,2,25,19,0,21,13,3,0,4,15,4,62,5,2,7,17,11,0,1,39,5,13,6,29,4,42,2,9,11,61,8,15,0,13,3,3,1,2,17,26,2,10,5,16,17,27,13,11,4,4,7,3,4,6,6,5,4,5,8,2,18,0,1,23,53,12,6,3,38,3,4,2,3,3,4,6,2,3,24,10,39,5,1,3,8,4,18,10,2,3,38,5,5,14,7,27,2,9,12,7,5,11,6,2,10,15,3,3,0,1,5,6,11,15,2,21,31,11,0,1,2,75,1,5,30,22,3,7,12,2,24,27,14,8,19,1,4,12,0,1,2,6,5,4,3,24,4,0,5,10,1,5,13,2,13,47,8,2,3,1,12,0,2,4,2,4,7,1,20,23,34,16,14,2,5,10,9,8,13,19,6,14,6,20,0,27,24,1,7,7,1,4,13,28,3,3,25,7,6,8,4,2,0,2,14,1,10,4,2,2,22,5,6,6,1,49,4,22,3,2,0,5,6,5,1,28,5,2,8,2,2,3,7,5,1,1,3,2,1,2,1,16,1,5,6,5,13,2,1,4,2,9,2,8,0,1,10,14,2,15,13,15,13,7,4,10,1,13,1,15,4,5,19,0,15,3,9,4,2,3,2,10,9,2,7,3,8,12,2,6,6,10,13,8,3,2,1,1,20,5,3,1,2,5,14,8,4,12,10,1,1,5,2,0,7,1,9,2,5,3,18,1,8,8,3,18,1,27,9,0,5,1,7,11,0,8,7,2,3,12,9,19,1,8,5,5,0,1,1,4,10,2,0,16,1,1,11,9,10,3,3,1,5,1,2,0,6,8,1,0,1,0,6,5,3,0,3,2,3,2,0,0,8,19,4,4,8,6,4,1,3,14,4,19,6,8,5,4,0,29,2,2,2,4,18,9,27,16,28,5,9,10,7,9,0,5,1,1,0,0,14,3,3,18,14,22,7,4,1,10,5,9,3,7,2,59,14,0,1,6,4,1,7,5,14,8,3,3,4,5,3,7,8,6,6,4,2,7,3,8,4,2,2,0,6,5,7,1,9,3,2,9,2,8,12,8,6,0,6,3,8,3,4,8,9,3,4,4,10,7,8,2,6,9,2,5,0,1,18,3,2,21,2,2,2,7,0,4,2,1,6,5,4,15,16,3,7,9,2,3,1,17,0,3,5,23,10,8,4,5,1,12,1,1,3,6,12,6,1,13,3,0,7,5,5,6,2,2,0,4,9,3,5,8,10,16,14,4,3,7,0,10,5,2,2,11,0,0,7,2,3,2,4,5,9,3,12,10,8,5,2,3,11,1,4,3,1,1,5,5,10,3,2,1,50,18,3,0,1,2,8,13,5,0,8,1,7,0,4,12,2,2,2,5,1,14,4,3,3,10,7,3,1,2,1,10,16,3,5,10,8,4,3,4,20,2,10,5,8,3,16,3,0,2,3,5,1,0,2,8,9,8,8,1,1,2,2,3,3,9,9,1,1,2,5,4,1,0,6,2,5,7,5,3,7,7,6,6,3,4,1,22,0,14,10,2,5,9,20,6,4,10,17,4,5,6,0,4,9,10,6,2,5,7,11,19,5,0,1,16,11,6,7,6,5,2,4,1,2,2,6,3,3,4,3,1,1,3,1,7,2,2,0,4,7,2,8,2,3,5,8,8,4,3,3,3,1,4,2,8,1,3,1,8,9,10,0,4,4,3,0,2,3,2,1,1,1,1,12,6,1,4,2,1,3,27,0,3,3,3,2,1,7,5,3,3,6,0,1,1,5,3,5,0,1,1,4,2,4,2,1,2,5,0,2,7,6,11,5,1,1,4,2,3,1,2,4,1,1,1,1,1,0,3,2,2,2,2,3,4,3,6,3,0,3,6,13,0,5,3,1,2,2,4,1,6,1,1,1,6,2,0,3,2,4,0,5,5,6,5,1,11,4,5,6,2,5,1,6,4,3,2,1,6,0,6,1,4,0,1,4,6,16,2,11,3,2,1,2,3,3,1,10,3,0,2,0,1,5,3,0,2,4,11,1,1,4,1,2,3,12,7,6,0,3,4,1,2,7,1,1,1,0,10,1,0,1,0,1,0,0,0,4,8,0,2,2,8,0,3,1,3,0,3,1
due,8,25,14,162,30,4,4,28,6,2,26,13,2,120,9,5,7,16,5,5,12,61,6,38,27,24,4,10,5,27,21,310,176,10,80,54,49,17,23,8,16,9,10,3,44,24,38,23,401,21,56,4,10,26,5,8,84,33,1,20,22,8,2,15,11,20,105,10,6,9,24,9,7,4,57,16,20,12,138,25,90,3,22,6,362,32,22,0,50,10,19,7,3,52,130,22,21,18,44,25,27,35,53,6,22,38,18,10,16,3,32,7,10,18,1,51,27,10,97,218,45,20,19,153,11,7,4,4,10,1,7,4,4,53,20,45,21,18,4,7,6,49,47,4,6,74,7,15,22,26,70,1,25,17,5,42,20,11,12,9,21,0,7,8,4,6,6,24,24,14,19,92,15,1,3,14,217,5,19,24,26,9,4,13,7,24,43,34,48,92,2,10,8,2,2,8,24,1,17,19,33,4,4,17,33,16,13,22,16,25,72,1,27,6,3,0,8,12,31,7,21,31,5,11,68,158,51,46,7,22,17,46,25,18,44,29,47,5,10,10,74,40,13,10,9,25,7,30,63,12,15,32,23,29,14,25,20,6,7,31,9,40,44,9,13,66,2,4,10,8,177,20,134,7,9,0,29,57,15,9,71,4,5,34,7,1,6,11,11,1,5,2,40,16,8,21,100,5,10,26,39,49,10,9,24,1,41,11,5,2,3,13,42,8,167,29,18,79,13,4,99,11,19,2,72,7,4,25,3,52,4,8,8,5,7,26,17,10,16,20,18,10,20,15,10,4,70,69,28,9,31,12,9,37,27,9,3,9,19,52,24,11,10,18,8,0,56,10,4,9,4,20,15,11,11,57,11,3,17,13,97,2,51,11,3,42,7,42,37,8,49,6,19,6,43,13,84,9,43,7,43,2,9,1,7,8,14,11,35,10,6,8,14,23,20,12,2,12,5,2,6,5,18,6,3,5,3,16,20,19,43,34,40,25,3,12,2,18,14,9,22,35,7,11,2,2,10,5,42,23,25,9,1,13,50,8,2,13,9,38,15,28,40,34,7,1,16,6,11,1,14,3,5,0,3,6,10,14,20,9,8,8,4,14,12,25,23,6,10,9,112,58,2,6,16,11,7,1,7,25,27,7,7,3,14,37,7,30,6,3,5,13,16,7,15,20,6,9,12,14,6,33,8,35,7,11,30,5,19,35,20,10,5,8,8,7,16,13,59,31,6,4,11,7,7,17,6,19,20,18,27,8,12,53,10,13,32,14,9,11,42,6,41,4,20,23,16,16,55,48,13,9,39,14,6,9,7,9,3,42,7,30,10,16,14,7,8,9,10,9,33,41,26,6,33,6,8,1,71,22,17,14,2,5,13,31,11,29,8,13,53,33,27,18,58,13,28,2,12,10,19,17,7,50,15,6,9,13,21,41,29,32,28,23,12,9,20,17,3,17,14,1,12,26,7,51,11,22,8,269,29,6,8,9,10,19,48,10,14,36,11,9,68,12,18,4,5,12,22,24,23,7,101,51,85,5,6,8,8,10,20,32,24,8,17,34,34,6,4,11,37,10,27,18,29,12,12,2,11,23,18,10,7,10,21,7,17,7,3,7,2,33,12,34,21,44,11,14,22,15,13,4,5,45,6,13,14,6,2,15,8,27,13,2,8,13,43,8,46,1,21,12,7,12,15,3,23,6,7,17,17,26,12,33,21,11,21,17,6,47,52,17,7,8,37,28,16,14,17,36,5,5,6,26,11,15,24,6,16,21,7,8,17,10,16,7,12,21,12,27,10,14,3,10,12,26,10,5,11,7,9,12,33,9,1,3,10,9,31,3,13,10,16,7,7,8,12,12,7,18,19,15,5,30,7,10,2,7,16,9,41,12,23,6,6,5,7,36,13,7,9,10,13,13,9,25,15,13,6,24,29,40,13,7,2,7,11,19,13,6,8,3,19,10,10,11,6,8,11,15,10,3,40,28,11,7,16,30,19,15,31,18,4,9,20,13,7,12,6,8,0,15,0,2,15,47,6,4,12,5,12,7,6,15,11,11,11,21,9,26,16,17,7,65,15,8,5,6,6,14,15,16,15,10,5,13,6,46,11,13,6,5,8,14,7,5,7,8,10,11,7,27,30,24,23,124,69,60,108,8,0,4,8,6,10,32,12,5,44,18,2,7,9,12,6,26,5,18,1,4,8,14,10,9,8,9,9,5,16,3,15,5,19,26,6,6,10,6,53,1,4,5,7,2,1,6,2,14,4,1
sustain,5,12,7,76,23,3,6,43,2,3,13,5,7,52,5,7,2,9,8,7,3,28,8,22,15,7,12,12,2,21,10,114,100,8,30,53,47,4,13,15,10,19,5,2,27,24,11,14,211,23,36,2,21,26,7,3,41,14,3,12,20,6,7,7,8,10,88,10,4,10,12,2,1,3,60,10,5,1,64,19,46,3,9,10,140,18,20,0,19,2,13,4,0,19,42,19,8,2,32,18,4,17,32,6,16,19,10,4,14,2,19,9,8,8,2,23,5,5,42,92,28,14,11,59,5,13,1,5,1,1,15,1,5,32,34,22,11,2,4,7,1,32,30,3,4,49,6,19,20,17,45,3,7,6,9,14,9,3,15,14,18,7,6,3,2,9,8,17,22,7,20,52,15,5,3,18,148,4,9,22,12,9,3,8,0,15,26,19,35,38,0,6,10,1,1,7,8,6,6,10,13,1,1,7,27,8,5,26,3,21,44,3,17,4,1,2,1,0,7,1,7,12,4,10,40,74,14,30,0,10,5,15,13,12,27,21,27,9,8,2,69,20,1,7,8,7,8,14,31,5,11,18,16,8,13,12,8,2,5,11,3,17,21,1,8,31,4,11,8,11,105,5,29,5,3,1,16,18,11,2,55,3,2,18,9,3,5,8,12,3,2,4,5,4,2,4,29,2,4,16,16,11,2,3,5,1,9,8,4,2,1,5,25,7,35,18,11,31,13,5,50,9,20,2,39,11,5,32,2,11,1,4,9,5,1,7,7,11,1,18,9,5,10,5,8,5,47,41,11,6,5,9,4,23,20,2,1,4,12,14,24,6,4,17,6,4,23,10,2,5,7,13,4,12,5,23,4,2,27,5,35,0,33,6,2,22,7,25,22,7,28,5,10,5,33,18,40,4,14,0,18,6,3,1,1,6,2,2,21,11,5,8,2,11,0,11,3,6,4,3,4,5,14,17,1,5,3,5,10,12,5,2,3,8,2,3,4,12,17,2,9,19,2,13,1,3,7,9,22,7,16,2,1,2,59,3,1,13,2,20,11,26,18,31,6,1,23,4,11,3,9,1,3,2,4,9,8,13,10,4,5,17,1,8,7,9,6,9,7,8,79,24,3,11,8,1,5,7,1,12,11,2,2,2,1,20,7,17,6,2,6,6,8,3,15,17,4,7,4,12,1,11,2,14,6,2,13,3,25,24,3,6,6,3,5,7,9,4,25,17,3,2,1,6,4,5,11,6,12,5,27,7,2,26,5,7,21,5,0,4,12,4,21,2,14,7,14,2,34,23,17,5,11,6,6,0,9,9,7,16,5,12,6,15,12,3,6,6,4,13,22,27,8,2,20,8,0,5,25,13,11,1,4,3,6,14,3,21,5,8,16,6,9,11,29,5,17,2,11,3,15,6,6,15,2,4,3,10,8,16,10,11,22,13,1,0,4,5,3,9,9,2,6,12,4,21,6,2,7,116,5,2,8,2,3,13,27,13,2,7,5,7,7,24,4,3,1,6,15,10,13,11,29,22,42,1,2,7,1,3,1,13,18,4,3,17,13,12,2,5,3,5,15,3,12,3,5,6,18,13,12,4,2,5,9,8,21,4,4,5,3,3,8,31,19,16,7,5,6,4,13,1,8,27,2,4,8,3,4,20,2,13,3,2,2,1,16,7,30,18,6,1,5,10,16,4,15,0,12,2,14,4,3,5,4,15,6,8,5,2,5,15,0,2,14,20,12,3,5,10,10,6,0,10,6,11,9,3,7,9,2,4,13,2,3,4,3,9,6,17,6,14,5,3,3,11,4,7,9,1,4,2,13,0,5,6,10,4,14,7,3,6,6,7,2,0,4,1,4,8,4,2,1,10,0,5,5,3,5,8,6,7,6,2,3,10,8,30,6,1,5,4,7,9,42,9,6,3,2,6,11,20,10,5,0,4,3,6,9,2,4,4,10,3,3,7,8,2,7,3,0,7,5,10,8,8,8,7,12,4,7,4,1,6,10,3,3,2,7,6,0,2,0,4,21,5,2,2,4,4,6,9,1,6,3,1,3,6,1,9,1,6,4,12,9,5,10,3,7,2,7,11,3,7,2,9,3,16,4,4,4,2,5,4,1,8,6,8,7,2,3,13,5,3,1,13,5,11,41,7,1,8,5,9,1,1,3,2,18,3,1,1,5,4,1,19,2,1,7,1,8,4,8,4,5,1,3,11,4,2,9,6,2,5,3,6,9,6,15,1,1,6,5,3,2,6,4,4,2,3
evil,0,21,12,157,5,3,4,40,1,1,4,12,2,52,8,11,2,23,10,4,5,25,26,26,31,4,14,13,7,10,10,127,156,8,46,67,37,11,13,2,11,13,3,2,30,36,25,7,247,10,35,10,29,25,10,7,59,9,1,14,17,7,1,8,19,5,106,16,5,13,4,0,6,6,111,20,17,2,67,31,28,5,10,11,164,26,10,0,27,1,9,6,0,14,48,15,34,9,22,16,5,23,37,13,16,37,5,9,11,5,10,5,4,16,0,26,9,5,69,222,55,4,5,41,4,3,0,4,5,1,8,0,5,52,42,36,25,8,8,13,13,42,16,0,10,63,24,21,18,22,82,0,15,4,15,43,29,5,6,4,11,0,10,1,1,9,7,34,33,11,7,108,22,1,3,18,148,2,14,24,26,9,1,35,2,73,54,19,42,25,2,7,2,0,2,4,15,3,5,23,64,7,1,14,16,10,3,46,4,22,73,4,26,7,4,0,0,0,20,0,1,36,6,14,32,151,37,28,5,4,23,10,10,38,54,19,49,9,5,15,78,38,6,21,26,9,6,33,44,4,11,31,21,4,14,20,8,1,1,20,4,28,11,2,8,21,5,3,16,5,126,2,15,3,1,0,23,5,7,1,40,20,4,18,7,1,4,6,27,2,5,0,9,0,1,14,30,13,5,22,31,31,2,0,16,3,30,7,4,2,1,21,13,3,24,14,14,55,25,9,23,13,39,1,63,2,15,25,2,23,8,14,10,10,10,15,32,4,5,10,12,7,18,8,4,7,60,52,18,2,20,32,5,34,25,12,6,1,24,45,42,7,7,27,4,1,48,8,18,16,2,6,2,18,21,17,16,6,18,9,57,2,58,12,9,26,7,18,23,6,25,2,13,4,33,12,42,2,21,3,22,3,5,1,9,33,10,3,20,10,4,9,0,23,12,7,1,16,2,7,17,5,34,26,0,10,2,14,9,17,22,2,2,2,3,5,0,2,4,9,11,15,5,11,0,3,7,11,34,19,16,6,1,8,70,11,3,3,15,30,11,35,44,45,5,0,10,7,4,3,16,13,3,7,5,32,1,14,23,9,9,11,0,14,9,10,10,9,27,1,46,38,2,11,8,9,14,25,12,1,23,10,11,12,14,58,7,26,12,19,14,47,16,15,24,21,9,12,38,16,4,24,22,35,14,5,42,39,15,31,15,11,11,14,6,11,9,13,39,26,8,5,3,5,9,7,6,18,17,10,47,4,17,38,7,18,32,9,12,14,16,8,18,7,17,15,15,13,30,55,10,9,2,11,5,9,24,12,16,16,13,11,18,25,11,12,9,6,4,7,14,40,11,2,33,5,2,7,10,19,18,2,4,1,9,27,5,14,18,3,46,22,4,6,46,13,27,11,9,9,13,9,4,19,3,8,8,14,19,25,27,24,49,30,4,9,35,4,2,8,18,18,19,15,11,15,9,2,9,97,7,3,9,8,5,10,33,19,5,7,3,8,4,8,5,0,1,4,13,14,21,6,15,44,11,11,8,7,1,6,1,22,10,3,6,4,12,2,3,1,8,9,18,5,6,3,8,2,11,9,3,7,15,7,7,2,17,6,11,2,4,6,2,26,20,18,7,9,2,3,3,10,5,22,2,3,14,5,5,13,13,5,5,15,4,1,7,4,24,11,10,5,4,2,2,7,15,3,3,6,19,5,1,6,2,11,13,9,6,8,9,6,1,2,16,37,19,17,3,5,5,3,5,16,4,12,14,2,14,8,4,6,18,5,13,4,5,3,2,10,4,18,7,4,14,13,13,7,6,13,5,8,13,1,10,1,5,9,17,4,4,1,4,4,3,6,4,3,5,11,6,2,9,6,1,8,2,4,16,2,9,8,20,4,6,11,8,32,16,2,5,12,19,14,3,9,8,4,7,15,34,27,7,7,1,0,17,9,9,0,4,7,2,5,19,6,10,2,11,9,3,6,2,32,10,3,2,0,13,0,0,9,4,4,4,4,4,4,5,12,1,1,0,6,5,1,1,2,0,5,8,2,0,7,21,2,0,16,3,23,11,2,10,6,9,3,1,4,4,1,9,3,3,4,0,7,0,4,2,13,10,2,7,2,6,8,6,6,5,6,7,8,2,5,6,27,12,1,24,2,1,5,2,1,1,4,3,4,18,13,2,2,9,4,1,8,2,0,9,3,5,2,16,3,4,8,0,3,14,5,6,11,4,19,10,5,20,3,16,5,4,2,5,1,4,1,4,7,0,1
whole,10,22,7,108,8,7,7,37,2,5,20,8,16,99,11,6,6,17,18,0,3,39,12,29,38,10,8,28,18,24,14,215,146,9,79,63,36,25,19,7,6,6,6,6,33,24,11,11,302,27,49,5,27,40,8,7,49,28,2,15,17,12,5,14,32,12,143,13,6,22,36,7,6,8,128,32,36,3,75,31,66,1,20,18,214,21,22,3,34,7,12,5,0,39,73,16,19,9,25,29,14,28,34,8,16,20,13,6,29,9,25,5,7,20,0,31,3,7,47,167,57,14,44,100,13,4,4,8,4,1,16,6,13,51,44,58,6,3,4,8,5,47,30,7,5,91,8,24,38,15,65,1,10,18,12,32,44,8,12,28,16,11,17,2,7,17,12,34,29,8,17,136,34,13,3,14,147,9,15,63,30,8,13,33,4,56,58,43,47,40,3,18,13,0,4,13,14,8,12,17,59,4,1,12,29,13,13,43,7,36,77,6,17,15,7,5,8,9,13,1,9,35,9,15,36,101,35,60,10,15,23,22,14,34,35,25,47,8,16,11,80,24,4,9,11,4,4,41,41,2,7,37,17,22,22,11,5,4,3,18,3,24,18,2,6,28,31,6,32,3,143,14,59,5,1,4,16,22,12,0,95,14,0,25,23,7,7,13,10,6,1,3,10,14,4,14,41,2,9,28,31,27,5,4,14,5,26,1,12,5,5,28,24,6,51,10,44,41,15,9,25,7,44,37,50,3,15,17,6,36,1,23,13,4,18,13,21,7,8,15,10,6,14,11,12,15,38,91,9,4,23,7,13,50,30,13,4,12,21,30,30,16,32,22,8,3,28,25,6,33,1,20,15,23,14,26,6,12,26,11,85,1,38,16,9,59,22,23,34,2,34,3,14,10,38,12,51,2,22,1,23,8,10,0,16,24,7,2,21,11,12,19,2,22,2,8,6,14,5,0,14,15,33,20,3,6,5,16,12,13,17,13,4,6,5,6,0,4,12,5,14,10,6,28,4,10,15,11,39,10,16,3,6,7,97,9,1,13,10,37,13,32,42,70,7,7,18,12,22,2,25,6,9,5,3,76,6,14,30,13,13,16,11,6,22,8,16,8,12,5,69,38,3,2,9,14,8,27,11,23,1,9,11,3,4,44,14,25,7,8,9,9,8,12,17,11,8,19,10,6,6,24,7,27,10,10,32,15,22,27,13,10,5,24,12,6,10,22,65,45,7,5,10,10,10,8,8,11,11,8,41,2,12,69,9,13,25,6,6,9,29,4,15,4,9,21,13,12,22,35,26,7,16,11,8,5,29,8,4,31,12,9,15,24,16,16,12,16,9,18,24,37,13,7,32,5,19,8,37,23,18,3,3,0,7,24,6,19,11,5,29,11,16,18,31,19,19,9,14,3,17,18,6,16,0,7,3,8,13,22,17,14,34,31,16,1,23,27,2,10,28,7,24,22,12,17,5,2,8,151,11,20,11,5,13,10,40,13,4,16,9,16,13,15,7,3,1,7,14,12,13,11,42,23,9,9,5,6,2,20,1,27,17,18,16,11,9,11,15,35,10,8,14,20,8,10,9,3,18,13,5,8,3,15,8,15,23,5,1,4,1,7,2,28,24,21,4,6,11,25,15,12,11,28,9,9,12,7,3,28,13,19,10,7,8,1,29,11,57,22,18,7,6,26,20,12,17,13,8,12,10,13,6,7,2,17,5,8,3,12,11,22,4,4,25,12,10,12,20,12,7,9,3,14,1,12,8,4,12,18,7,5,23,7,9,7,16,20,24,13,2,16,6,4,22,23,13,9,4,1,6,13,19,1,9,6,9,8,17,2,6,9,8,7,4,2,5,4,9,12,2,5,2,5,12,5,6,9,8,5,19,9,9,1,4,14,12,24,17,10,4,3,5,12,5,16,7,1,2,15,10,20,7,7,4,3,7,9,4,3,8,7,0,6,3,6,8,5,10,8,1,9,12,14,9,13,2,11,8,5,0,5,4,2,9,6,8,9,6,3,2,14,0,3,3,3,5,5,9,6,8,1,4,10,5,4,3,8,5,26,8,12,6,16,11,4,1,13,5,8,8,4,4,10,6,9,9,4,1,12,3,1,6,7,6,5,9,10,9,14,8,14,3,12,3,17,23,48,51,1,6,5,3,4,4,11,34,16,15,5,14,26,3,3,1,16,4,2,2,11,7,5,13,8,5,2,4,11,6,4,4,9,6,11,7,16,15,1,11,1,4,3,7,0,0,12,2,3,2,3
small,1,13,4,64,4,5,1,11,2,3,4,7,13,68,3,7,2,5,3,3,4,20,13,20,15,7,9,8,8,9,5,111,69,11,33,31,30,5,6,2,4,8,1,3,16,8,19,9,88,13,32,1,8,41,4,3,29,14,5,9,4,7,1,4,11,1,53,13,3,24,10,2,5,1,48,16,15,2,47,15,36,0,7,4,89,19,8,1,14,1,7,4,3,11,15,9,10,6,16,6,5,19,14,3,11,12,9,10,10,8,8,2,14,11,2,14,4,8,29,136,23,10,36,54,7,0,4,4,3,2,11,1,3,21,24,38,2,2,1,9,2,17,9,4,3,42,2,15,39,26,28,1,8,7,6,7,22,5,1,10,17,6,16,2,3,10,7,7,26,2,15,43,24,6,2,15,81,4,3,33,11,6,4,17,2,15,24,13,6,22,7,7,3,0,14,2,14,7,7,11,36,16,2,4,14,2,8,12,6,23,43,2,20,3,3,7,6,4,13,4,10,6,2,17,22,44,14,19,4,12,16,11,16,7,33,9,19,13,6,3,26,13,6,3,9,6,2,27,35,10,7,13,8,10,4,18,6,5,0,29,6,14,8,1,2,21,5,10,7,1,58,17,23,7,4,1,8,14,4,3,47,3,0,9,10,4,4,9,9,1,3,0,16,7,2,1,15,1,2,9,12,18,5,2,8,2,3,3,5,0,2,15,19,6,23,8,12,22,7,9,15,4,21,0,24,0,5,21,1,17,5,7,4,0,14,7,7,7,2,8,6,8,11,3,4,2,13,22,13,3,4,3,2,23,9,9,4,4,8,16,9,5,6,12,6,2,20,3,3,13,3,5,2,11,7,26,11,3,6,3,27,1,17,5,3,13,3,12,18,1,12,5,14,4,9,6,20,4,17,2,10,2,5,1,3,10,1,0,12,7,0,3,5,10,0,4,0,5,4,1,1,4,11,1,5,2,3,6,6,6,11,2,2,6,3,7,0,6,5,2,7,6,4,9,1,0,10,3,18,5,9,1,2,1,52,4,3,6,1,23,9,20,18,37,11,7,8,3,5,4,7,3,4,3,4,10,2,5,15,12,3,9,1,0,3,2,10,4,5,4,57,24,2,0,5,3,3,7,2,10,9,1,9,4,2,15,6,6,9,7,3,1,10,1,7,4,1,9,2,6,0,11,0,16,2,0,12,8,7,12,5,3,9,2,6,6,3,16,21,11,1,1,0,4,5,3,3,9,4,5,19,2,1,18,5,13,18,3,5,2,9,1,9,2,7,8,10,1,17,15,7,4,14,0,6,5,2,6,9,3,1,3,15,14,5,2,8,4,0,7,6,15,7,2,9,5,3,1,5,10,10,4,0,3,4,8,2,7,5,6,11,6,4,0,14,8,13,4,2,0,7,2,5,8,1,3,1,6,2,14,10,11,8,15,11,2,4,10,1,8,1,1,3,3,3,16,5,4,5,50,6,5,5,0,4,2,18,4,4,3,5,1,1,4,3,1,0,5,3,5,5,3,13,9,14,2,2,2,0,4,1,12,6,4,3,2,8,2,4,14,1,8,7,5,2,5,3,0,8,5,3,2,3,2,8,1,8,6,2,1,0,5,3,13,11,39,4,3,2,19,5,4,4,15,7,2,8,0,2,8,5,12,1,8,2,7,25,6,13,8,10,2,6,11,16,6,13,10,1,7,6,4,4,7,8,4,5,10,1,10,10,7,2,6,12,7,4,6,8,11,10,4,4,11,4,7,12,4,2,6,3,2,14,5,5,8,6,1,3,10,3,7,6,3,2,16,2,6,6,1,3,4,6,5,6,15,3,5,3,2,7,1,6,4,3,0,4,8,4,6,0,4,4,11,6,1,4,6,6,6,13,3,3,5,3,8,2,11,4,5,3,6,2,1,3,4,2,2,6,2,8,8,3,2,1,2,2,1,0,2,0,1,2,2,2,3,2,1,1,9,6,0,2,5,3,6,0,2,1,1,2,4,1,2,13,1,5,2,2,3,1,9,1,2,2,0,6,5,3,8,2,3,4,8,0,2,1,13,2,3,3,5,2,6,4,2,1,2,3,0,4,3,5,6,2,3,0,2,2,6,4,2,1,0,6,2,2,3,0,7,5,6,4,0,8,6,11,9,15,2,6,2,2,1,6,1,1,4,8,0,0,2,3,1,4,13,6,3,10,6,13,3,1,3,3,0,1,5,5,5,6,2,3,6,4,5,6,4,2,0,2,5,4,0,1,7,2,0,2,1
compare,4,4,2,51,2,4,7,17,0,4,2,9,10,28,3,5,1,13,0,3,2,10,11,9,4,3,6,3,5,3,1,84,59,7,21,36,13,12,18,4,9,3,0,5,12,7,9,10,93,5,13,4,11,29,5,1,25,22,3,10,3,10,1,7,10,3,48,6,7,5,39,3,1,1,39,9,12,2,26,8,82,0,0,4,102,11,11,1,40,4,10,3,3,8,17,16,16,6,19,13,11,10,25,4,6,10,15,2,14,12,6,3,11,6,1,19,0,0,29,102,13,5,49,117,12,0,1,4,4,3,4,5,5,28,10,17,2,2,1,9,2,12,12,8,2,18,2,9,14,16,16,1,9,5,10,25,11,1,4,3,19,0,4,1,9,5,2,3,5,2,16,47,9,0,3,3,82,2,4,19,8,7,6,4,0,11,24,15,12,14,1,4,5,0,2,0,4,3,12,5,15,5,0,2,15,2,0,16,2,10,42,5,14,4,2,1,9,4,5,3,5,8,5,9,24,53,53,29,17,41,13,17,13,9,15,38,16,5,10,2,22,8,2,6,6,5,2,21,29,1,13,20,6,14,6,7,2,2,1,14,6,7,7,2,5,50,5,4,6,1,62,4,80,1,0,0,3,56,4,0,23,1,2,8,17,4,3,5,13,1,4,0,7,18,0,2,19,1,3,8,10,9,12,2,5,0,4,3,2,0,0,14,4,5,23,4,11,24,17,6,12,3,7,4,11,0,4,18,0,12,4,13,0,0,10,6,5,2,6,5,4,1,3,1,3,0,13,18,14,7,5,3,1,19,20,4,2,1,8,33,12,6,4,10,2,0,10,5,0,4,1,5,6,5,1,16,0,0,6,6,31,1,15,2,4,13,0,18,16,0,7,1,3,1,13,4,24,3,3,7,15,2,3,0,5,8,5,0,10,4,1,7,18,11,2,4,0,4,0,1,1,3,9,0,2,2,1,4,3,14,33,5,6,5,3,1,0,2,4,5,10,4,1,9,1,3,5,1,22,12,7,2,1,2,27,1,1,7,2,15,4,16,9,19,9,6,17,8,4,0,13,1,0,5,3,18,1,1,9,5,2,2,3,2,3,6,6,1,3,0,34,20,1,1,9,3,3,7,2,11,11,9,1,2,4,49,8,8,1,3,7,2,4,1,5,4,1,11,0,3,1,6,5,12,1,3,5,2,12,11,4,7,0,6,6,1,0,1,11,8,2,2,1,17,6,3,3,8,8,4,11,1,3,19,0,2,11,0,3,2,7,1,8,1,1,3,8,3,24,9,4,0,10,0,2,6,8,3,4,18,10,4,9,8,2,1,4,1,4,6,9,13,5,2,10,2,1,3,5,7,11,2,0,2,4,10,2,3,5,1,14,11,4,2,13,6,5,0,8,1,9,34,4,20,2,8,4,4,4,8,32,9,4,11,3,3,8,8,4,1,14,3,5,7,2,16,2,4,4,39,7,3,2,1,0,7,13,7,3,11,2,3,5,7,2,0,0,1,2,10,6,7,5,10,2,6,5,7,2,3,4,5,6,3,2,2,0,0,10,3,9,6,7,4,1,6,3,1,15,2,0,0,2,3,5,3,6,1,2,2,4,4,2,7,8,14,3,1,0,10,2,4,0,9,1,7,5,0,3,11,2,8,2,0,2,4,19,3,7,14,4,3,2,4,3,2,8,6,1,2,2,20,34,31,23,5,7,3,4,56,49,9,13,19,11,36,9,3,21,1,8,1,4,2,4,3,12,0,6,5,0,1,8,3,2,6,3,0,16,4,1,5,2,6,8,12,2,4,6,3,1,4,7,2,1,0,4,8,7,6,9,1,2,10,7,1,2,6,1,3,5,27,0,3,0,1,2,1,31,3,11,4,3,0,3,2,0,18,7,2,1,3,7,2,9,3,1,3,2,3,1,8,2,4,0,4,4,0,1,2,0,3,0,0,2,2,0,1,2,7,3,0,6,24,5,4,1,3,1,1,0,6,0,0,0,2,7,3,0,3,1,5,4,0,3,0,1,1,6,4,1,2,0,2,5,4,4,0,3,5,2,6,1,8,2,2,5,2,3,7,3,2,0,9,3,0,0,0,2,22,2,3,0,7,1,11,2,10,0,5,3,20,45,8,4,12,20,27,26,1,2,3,2,0,4,2,6,3,6,0,5,1,2,8,4,3,0,5,0,3,0,1,6,0,1,0,2,0,2,1,20,0,4,29,0,12,5,1,1,1,1,2,8,1,1,11,0,1,0,0
insurance,0,16,2,82,1,12,0,1,3,3,0,0,5,8,0,1,7,3,3,0,0,10,15,20,5,13,6,19,4,12,1,99,26,6,16,20,4,6,5,1,12,4,1,20,6,2,24,12,54,18,15,5,5,22,27,1,9,0,12,7,0,3,0,4,21,5,67,4,1,2,78,1,7,1,44,7,23,0,22,9,26,6,5,5,39,11,10,2,7,1,6,3,10,10,3,8,7,0,28,8,4,12,4,7,7,7,5,8,19,5,14,5,11,20,42,23,0,2,16,43,5,71,28,56,8,1,2,3,1,3,12,1,0,40,11,56,3,2,8,3,3,26,5,1,4,43,9,3,6,7,25,6,3,1,4,60,11,0,0,55,41,0,9,2,4,48,1,4,7,3,2,39,15,0,10,2,19,2,0,50,8,13,25,16,0,9,10,4,1,22,0,0,0,3,1,1,35,8,12,8,32,22,6,3,2,14,2,53,4,41,29,8,23,3,15,28,4,9,8,1,1,5,0,1,18,24,2,5,5,9,7,5,22,12,23,4,9,7,3,2,31,13,33,15,1,3,1,26,46,2,11,2,6,1,2,4,0,7,0,3,13,11,0,0,1,8,0,8,5,9,16,15,3,3,0,9,19,3,0,6,32,4,2,8,2,7,182,71,5,10,0,3,7,4,1,5,19,1,1,6,4,16,1,1,3,6,7,1,2,5,3,9,14,21,35,3,44,8,1,3,9,2,12,2,10,1,2,21,0,2,3,5,1,0,1,3,3,1,9,1,2,3,14,1,2,4,0,8,6,38,7,10,0,11,2,2,14,3,4,8,30,18,8,9,0,3,3,1,31,20,1,14,4,12,1,13,0,1,4,1,10,4,9,12,13,1,0,4,6,0,1,4,2,1,0,1,2,4,4,2,9,3,7,2,6,2,1,0,3,6,0,0,6,6,0,4,5,4,4,5,0,3,9,1,0,2,1,1,0,4,0,10,0,2,2,5,1,5,6,1,9,17,2,1,0,0,9,7,11,2,26,0,7,0,12,1,3,0,4,3,3,11,12,14,5,1,17,2,2,2,27,10,0,0,1,0,0,0,6,2,1,3,0,2,0,0,1,7,2,2,20,12,0,3,3,1,4,3,2,12,3,4,2,1,31,14,8,3,3,1,4,8,1,10,0,0,8,0,0,2,1,1,13,4,0,0,10,28,1,10,2,3,2,1,0,3,0,2,2,6,0,0,2,2,8,0,0,14,1,1,0,0,0,10,2,7,5,0,2,2,4,1,8,4,0,0,9,0,2,1,5,0,2,0,1,0,0,7,0,24,0,0,6,3,1,1,0,0,1,4,6,2,7,29,3,0,0,6,2,9,2,0,1,0,0,1,3,2,2,2,7,2,3,1,1,0,0,0,0,0,3,0,1,4,9,0,0,2,3,4,1,1,20,12,0,2,1,6,5,1,2,3,0,2,0,3,6,8,9,12,0,0,1,4,0,6,3,9,1,1,0,0,2,6,0,1,0,0,1,1,0,0,0,2,1,1,2,1,1,0,2,3,1,1,0,1,3,7,0,0,1,8,0,1,3,3,1,1,9,0,0,2,1,0,0,0,3,4,2,1,0,1,0,7,11,2,4,0,0,3,0,0,0,2,0,0,0,1,0,2,0,4,0,0,0,3,6,0,0,2,5,0,4,2,0,3,1,1,0,2,1,1,3,0,0,1,0,4,11,2,4,16,1,3,22,6,0,8,3,2,7,0,6,1,1,2,14,4,0,1,0,0,2,0,1,2,1,0,1,4,3,2,1,0,2,10,5,2,0,1,0,1,1,2,3,1,0,6,4,0,2,0,0,1,0,0,3,4,0,0,0,1,0,0,0,0,11,1,2,1,10,4,1,0,1,2,1,3,1,3,0,0,0,2,3,6,2,2,3,0,6,4,1,0,3,5,0,0,0,0,0,4,0,1,0,1,0,0,7,4,9,1,5,0,0,0,0,0,1,0,1,0,0,0,0,0,1,0,0,1,4,0,2,1,3,0,1,0,2,3,3,0,2,0,1,0,0,1,1,21,3,14,0,1,3,1,1,1,0,0,0,3,1,0,0,0,0,0,6,2,1,6,0,0,0,1,7,1,0,9,0,1,0,0,2,6,5,4,4,0,0,0,3,8,3,2,1,1,9,0,0,0,0,9,3,0,0,11,0,0,0,0,8,4,0,0,15,2,0,0,2,0,0,0,7,2,1,19,0,9,0,4,0,2,11,15,12,2,0,3
company,10,19,1,133,2,12,7,22,2,32,15,15,10,24,2,3,11,9,3,0,5,36,27,30,20,18,5,20,6,16,6,182,52,6,33,22,18,8,14,1,5,1,8,8,28,13,36,8,282,38,42,9,6,35,17,2,16,30,10,11,19,6,1,25,28,8,55,7,6,59,18,9,8,14,62,14,22,4,67,17,44,2,33,7,162,28,17,0,39,3,16,3,4,19,33,33,21,5,16,10,25,39,36,9,11,21,6,5,12,6,16,5,10,23,50,15,4,8,43,117,18,29,31,55,10,3,3,3,6,4,5,7,5,65,11,80,10,1,7,4,2,37,21,1,5,52,12,9,26,14,44,11,8,6,7,27,39,9,4,45,21,0,11,0,4,23,8,6,16,11,53,128,31,1,3,1,162,2,9,44,20,5,2,18,19,19,25,17,35,85,5,8,9,3,3,6,23,15,2,11,66,14,13,2,19,0,7,17,15,19,84,14,30,15,5,27,4,2,4,6,1,30,1,6,36,79,33,12,7,7,17,24,30,62,17,2,15,11,4,4,34,27,13,8,9,5,9,23,40,14,9,8,10,5,14,12,9,5,3,36,17,24,15,8,5,43,4,5,4,0,55,14,41,5,2,2,36,4,11,2,21,6,3,19,5,2,21,17,5,3,5,3,16,10,3,5,25,5,3,13,18,34,2,1,3,7,6,3,5,4,3,16,14,8,60,11,14,39,126,4,43,4,19,1,89,10,9,29,4,38,3,11,2,6,5,44,24,4,3,7,11,7,12,12,5,0,34,40,14,16,4,34,3,46,21,29,4,3,8,31,26,4,9,13,8,4,35,6,7,21,2,13,14,18,5,34,3,10,8,2,48,4,40,14,3,58,5,28,31,0,13,2,9,5,19,8,61,9,36,2,15,4,8,0,10,2,7,0,10,12,2,7,2,11,1,3,2,5,8,0,2,6,15,29,2,6,5,5,6,15,2,9,0,8,10,8,0,10,4,4,32,23,6,7,0,1,9,10,46,3,7,2,15,3,57,3,0,11,14,20,21,21,35,49,3,6,15,21,9,4,13,8,2,0,5,13,1,10,20,6,9,3,16,3,6,5,15,5,12,0,39,50,1,1,17,6,5,14,1,14,4,2,4,31,1,18,3,8,18,4,2,3,14,5,5,14,3,9,34,7,6,25,11,23,2,7,27,23,13,24,12,2,1,4,7,4,8,3,26,30,6,4,0,4,10,4,1,10,14,12,6,4,19,40,12,2,16,11,7,0,32,7,30,1,10,8,7,2,46,51,17,5,22,2,4,4,1,6,3,23,25,25,7,6,0,5,2,2,2,6,6,19,14,7,31,1,14,5,28,12,24,15,5,0,8,12,9,11,8,0,13,38,11,10,52,8,10,41,5,3,12,1,1,16,3,8,28,5,18,31,4,16,15,11,17,6,6,10,6,3,1,1,4,34,2,22,4,4,10,208,38,3,0,0,7,22,25,13,9,16,1,4,6,30,8,3,3,6,11,2,8,13,10,34,35,0,4,9,25,12,35,26,13,9,7,0,1,2,7,8,14,18,20,51,6,15,11,9,13,18,5,5,8,9,8,3,18,11,1,4,0,22,5,9,25,36,15,2,5,4,6,4,4,28,7,10,5,9,3,6,4,12,8,2,5,9,10,2,34,2,11,15,11,16,3,12,8,1,6,11,4,0,3,5,9,9,3,12,3,43,38,12,2,16,13,13,10,10,1,15,2,1,2,6,4,7,11,7,9,2,1,7,9,33,5,9,6,5,2,21,5,8,9,6,72,13,43,13,2,0,8,10,3,5,0,0,4,3,24,2,2,18,8,14,3,4,5,2,9,10,7,1,4,12,3,4,7,5,1,5,15,5,5,6,2,7,7,14,8,5,3,0,3,4,5,46,6,17,7,13,28,41,9,3,0,3,5,23,8,13,13,17,13,9,7,0,2,7,7,9,6,8,17,4,3,5,7,22,7,4,8,17,2,9,11,4,8,4,4,3,14,20,7,8,4,11,4,3,2,5,4,1,1,4,0,4,42,3,2,11,7,10,11,22,5,14,5,6,2,1,8,8,6,0,3,8,1,4,6,8,2,4,3,10,3,4,15,6,2,14,1,5,5,0,0,19,4,9,15,1,11,14,4,10,6,10,8,7,15,4,7,2,1,12,0,12,6,7,0,9,1,2,5,8,6,3,3,1,30,2,36,4,0,6,3,2,1,3,4,2,5,3,1,0,1,4,20,6,0,0
bank,9,40,12,184,6,5,0,60,1,2,2,6,7,47,4,12,15,70,9,5,6,121,25,42,29,11,11,15,7,38,0,382,391,23,94,75,30,39,36,3,12,2,6,6,48,36,66,23,720,27,114,9,21,40,3,0,92,38,9,12,13,2,1,8,44,9,205,14,11,2,133,0,27,5,163,29,53,8,180,46,137,5,37,21,473,170,59,0,98,11,29,15,16,45,126,35,31,28,107,42,21,51,90,20,9,81,26,6,40,47,57,25,37,61,10,78,3,12,102,408,66,21,33,181,11,5,6,8,23,9,24,4,6,96,33,61,5,8,6,21,6,65,55,8,6,106,10,13,58,26,177,5,69,26,6,92,30,18,10,37,6,1,24,6,13,19,13,33,70,24,46,258,29,2,13,30,290,19,20,67,30,29,8,31,1,61,64,47,41,48,2,32,5,1,3,5,86,14,55,63,158,50,7,8,42,10,79,213,7,39,164,11,38,14,6,13,4,12,23,0,11,22,7,13,172,157,60,90,31,178,34,54,39,106,97,48,75,20,32,12,175,83,12,2,19,26,9,137,108,16,39,97,32,32,71,51,41,17,22,26,3,27,32,15,26,80,8,12,32,7,240,96,279,21,8,4,32,31,12,4,114,7,5,50,72,8,4,8,25,0,7,5,53,9,13,22,52,6,29,34,73,50,24,8,37,0,25,4,8,4,12,70,104,34,169,59,24,122,142,19,26,30,55,4,46,6,10,46,13,99,9,33,5,27,50,31,30,15,39,46,27,11,40,5,12,5,113,66,62,17,32,39,10,145,39,5,12,4,33,76,30,11,18,56,11,4,127,9,23,27,7,50,19,98,20,31,30,23,31,14,116,5,84,14,6,51,5,83,76,16,7,5,17,7,59,28,94,16,56,2,42,8,3,2,27,10,47,0,89,25,1,8,24,13,0,15,41,11,1,6,14,5,36,26,18,4,4,46,11,54,345,40,7,20,8,4,1,8,7,16,21,12,4,38,0,2,18,6,86,33,104,5,6,40,102,11,3,12,18,87,18,59,61,30,31,1,52,11,9,0,6,11,5,2,3,15,4,29,53,7,6,18,17,2,5,6,39,10,3,0,44,90,2,3,50,6,3,37,20,58,44,15,49,14,18,1,43,25,15,34,20,11,9,24,72,23,12,6,6,14,0,43,64,75,18,2,100,53,38,55,10,7,3,28,9,20,6,12,65,87,11,26,2,26,29,2,3,61,40,35,102,8,4,96,17,25,33,23,22,12,46,12,33,8,34,41,45,22,61,111,30,20,18,2,6,14,3,11,28,37,6,19,29,42,13,6,23,25,6,16,37,61,43,14,29,9,14,10,13,52,28,3,18,2,4,56,9,44,10,31,40,14,20,8,75,26,40,3,10,12,103,350,16,239,15,11,1,13,18,80,241,22,54,40,27,4,14,26,8,53,7,2,8,30,9,57,27,21,9,312,0,6,35,4,6,27,118,17,18,7,9,1,6,30,9,0,0,14,30,46,62,6,1,8,18,25,5,12,0,1,5,37,39,3,13,13,47,5,34,0,13,21,55,0,26,11,49,1,20,40,4,15,6,5,50,16,40,8,15,0,7,16,29,71,33,4,5,15,1,7,13,2,12,39,0,10,34,3,3,72,43,39,18,9,6,3,1,19,4,6,28,9,10,2,2,27,23,41,23,4,21,32,47,11,18,17,8,31,17,92,84,7,10,25,37,77,6,17,33,5,10,5,2,15,0,33,225,20,0,24,1,18,54,93,18,13,44,3,134,22,10,5,2,24,8,58,9,7,9,2,25,23,30,4,18,2,28,25,19,7,27,3,1,34,15,0,5,6,22,31,0,11,1,37,0,19,5,12,211,10,35,8,135,1,8,39,25,34,18,3,0,16,3,11,49,31,32,9,17,18,3,72,6,31,2,84,10,38,8,8,12,10,19,10,54,28,5,5,13,15,2,15,72,284,52,36,0,4,17,2,1,26,13,6,3,0,11,11,3,19,8,15,7,1,16,1,2,22,28,3,38,3,2,27,6,31,2,77,5,20,34,191,26,30,11,6,13,6,26,6,30,4,4,7,1,3,2,2,6,334,2,4,19,7,8,21,30,26,3,9,6,21,18,17,43,132,64,28,255,8,0,3,3,21,11,26,2,1,53,8,1,8,18,0,9,3,0,2,6,5,3,8,16,12,7,7,2,22,28,4,1,14,15,177,7,17,28,55,1,2,1,15,17,5,6,6,6,16,1,7
farm,0,0,7,56,0,15,1,5,2,4,1,0,31,55,6,2,3,17,1,0,1,27,5,9,11,7,9,13,4,3,2,117,124,12,38,31,8,15,77,8,10,4,1,14,14,6,6,23,83,26,26,9,20,20,21,0,9,9,3,20,9,1,1,6,25,4,74,17,3,17,35,1,4,2,109,18,35,11,30,23,79,6,8,16,92,23,21,0,15,1,2,2,15,9,13,21,12,13,44,41,1,21,13,1,22,18,7,14,18,3,11,3,26,17,20,18,0,3,21,71,34,6,16,110,10,0,10,9,1,3,34,8,13,39,10,64,0,8,4,17,4,33,15,11,2,59,4,20,23,15,25,3,6,13,29,50,17,3,6,23,13,19,10,2,20,17,9,15,29,4,24,46,14,13,8,4,87,4,0,52,4,8,32,20,6,34,38,16,10,29,0,8,83,2,4,5,9,4,20,7,46,14,2,7,16,5,14,30,7,18,48,7,13,6,4,0,2,7,9,3,20,18,3,4,5,32,20,22,2,28,15,33,35,14,28,5,44,20,58,2,34,32,16,3,10,24,3,19,45,8,4,46,15,9,3,14,1,4,0,17,2,8,3,3,5,51,15,4,5,3,30,10,14,4,2,4,16,7,3,5,52,2,20,15,10,13,6,17,2,0,3,2,7,3,1,4,4,5,0,10,13,15,0,5,12,5,23,9,16,9,6,28,28,13,16,9,22,36,21,4,15,5,6,24,11,2,33,19,2,7,0,5,6,2,5,11,16,5,14,7,3,2,8,4,13,11,15,19,16,32,7,0,2,61,17,9,1,6,21,20,20,22,25,20,6,4,5,3,8,14,0,27,10,9,12,15,4,9,5,9,19,3,28,22,11,77,4,28,13,4,4,10,2,0,4,2,14,2,13,3,4,5,1,0,4,10,6,0,19,22,0,14,39,18,3,0,0,2,8,2,7,8,35,3,5,2,5,6,3,9,6,4,0,1,6,0,0,0,3,5,9,6,8,13,0,4,11,1,25,21,13,1,26,3,27,3,0,1,6,9,10,16,17,35,20,0,30,17,10,2,40,7,0,14,1,18,1,7,18,12,11,13,0,0,2,1,3,6,6,0,30,21,2,0,13,6,7,7,7,7,14,6,8,8,3,43,1,9,5,11,4,3,8,4,5,2,1,10,2,6,6,11,3,3,2,2,16,23,13,19,8,8,0,1,6,7,3,15,22,15,7,0,0,161,57,5,3,6,0,3,1,0,1,8,21,2,17,6,4,4,7,1,11,0,8,1,2,7,15,22,5,0,2,1,1,0,11,6,5,15,15,6,11,4,0,1,12,11,1,20,5,7,4,4,45,19,9,10,3,2,8,4,5,0,4,13,7,3,4,0,16,13,7,4,7,4,5,1,0,1,14,0,7,1,10,3,0,5,10,26,2,10,8,14,6,4,24,3,2,5,14,0,0,8,4,17,8,1,2,39,3,7,12,0,0,6,18,5,1,11,2,2,0,2,1,1,0,7,5,11,12,2,6,1,2,16,6,3,0,8,1,24,0,8,2,0,0,8,2,1,6,7,2,2,3,6,1,0,1,2,0,1,4,8,2,6,20,4,0,4,2,3,4,7,7,2,1,0,1,7,1,3,2,0,1,9,14,3,1,3,1,21,11,3,10,0,0,13,12,16,12,1,5,3,1,3,4,24,7,4,1,3,9,7,10,11,15,14,5,31,33,8,5,8,21,12,27,11,105,5,12,12,15,7,0,4,33,4,41,2,8,1,2,14,9,6,6,3,8,4,3,12,1,2,8,21,8,7,5,0,1,3,1,1,2,5,2,3,11,1,5,1,3,2,6,3,3,4,1,2,0,4,3,45,3,2,5,3,0,7,2,1,1,0,3,5,1,11,3,1,0,2,0,2,16,0,17,0,5,6,3,6,0,3,4,1,8,8,0,0,5,2,2,6,1,6,5,2,0,10,5,3,4,2,14,3,0,0,7,0,0,1,3,0,4,0,4,5,1,1,2,13,1,2,1,0,1,7,6,5,11,0,0,4,0,2,1,4,3,5,9,38,0,3,4,0,1,3,2,3,0,12,1,7,0,1,0,0,3,3,3,2,1,1,1,5,5,0,0,16,2,2,7,2,35,9,10,15,12,1,1,1,4,10,0,1,1,2,6,2,5,7,3,3,5,0,7,0,1,3,0,1,18,10,0,0,7,1,3,3,0,3,3,1,11,3,3,23,0,0,5,6,1,0,7,25,10,0,0,0
favor,8,25,9,178,11,3,6,42,3,2,35,21,9,79,1,14,11,20,9,6,4,43,12,34,28,16,12,7,9,17,6,224,174,7,69,80,43,16,16,10,5,7,9,4,68,20,26,22,344,9,62,10,10,40,6,5,83,31,1,20,22,12,3,20,34,2,138,11,20,29,10,6,4,7,74,18,28,5,86,36,71,0,14,13,309,24,15,0,40,6,15,10,0,28,81,24,15,18,44,21,21,28,51,13,19,26,15,6,18,1,20,7,10,16,6,49,14,7,78,232,44,18,24,85,9,1,1,6,3,3,9,0,9,63,21,49,15,5,4,9,5,52,36,4,9,56,11,11,24,19,87,3,26,10,10,32,32,8,16,2,8,1,11,2,0,12,6,25,32,14,17,101,29,0,2,6,234,1,11,42,30,12,2,20,8,49,49,17,50,61,3,4,17,0,0,5,22,12,12,20,43,4,11,13,29,4,1,54,19,45,85,7,28,9,5,6,3,2,23,6,20,32,12,12,57,126,45,33,5,9,15,18,20,21,42,42,33,10,19,10,77,44,10,13,22,11,13,23,59,4,20,43,18,9,9,23,13,5,3,14,7,23,30,11,13,53,4,10,18,7,126,6,64,10,7,1,22,20,23,11,55,14,1,29,18,2,9,10,13,4,6,4,23,5,1,16,58,10,8,41,48,39,0,5,20,4,30,3,7,2,3,35,23,7,63,23,35,50,39,6,70,8,25,1,40,9,14,48,4,43,19,9,16,7,8,35,17,8,6,11,13,10,21,16,5,4,74,46,13,6,24,16,10,40,23,13,6,4,10,43,24,10,10,22,10,1,34,11,16,25,11,19,7,11,17,34,10,9,29,5,103,3,44,14,0,46,10,31,53,10,36,2,24,20,52,11,61,8,31,6,27,3,5,1,6,22,10,6,41,21,8,9,13,34,12,12,7,19,9,5,14,11,32,17,2,6,3,16,19,16,14,13,16,10,2,8,0,12,8,5,16,34,6,22,2,5,8,7,46,5,15,5,5,6,72,9,2,30,14,41,12,31,61,25,10,11,25,15,4,1,13,6,9,2,4,25,8,26,25,8,8,9,5,10,16,30,12,6,19,12,75,43,6,8,18,11,8,30,17,26,25,6,8,3,8,25,9,1,12,12,14,13,13,13,15,37,5,12,36,22,4,29,10,35,10,5,51,32,24,30,17,15,8,13,9,16,14,14,34,34,7,2,2,10,23,12,10,34,16,8,78,4,13,40,5,16,30,10,9,12,25,7,24,5,14,18,24,10,48,44,11,17,15,1,7,11,37,5,7,13,24,20,26,18,9,13,6,11,7,11,34,33,22,3,53,8,14,5,59,31,30,7,7,12,5,40,11,28,9,7,30,30,7,15,48,11,15,9,16,4,19,2,2,27,1,13,8,13,12,31,17,25,28,31,12,7,14,11,7,13,22,2,12,33,8,28,5,16,8,206,30,10,7,12,6,17,45,17,11,16,14,12,46,19,14,6,15,11,8,18,21,12,78,26,54,8,5,13,1,7,1,30,17,9,12,11,12,5,5,9,29,8,17,15,7,7,3,10,32,8,15,11,16,6,19,2,21,4,11,17,6,10,3,38,19,15,3,7,9,6,11,8,7,19,0,7,13,3,10,26,8,14,9,10,8,9,15,11,30,11,16,15,6,13,7,7,9,13,5,18,13,18,10,15,11,16,8,18,11,37,45,16,9,4,30,22,27,10,15,10,10,2,2,18,4,11,5,7,1,15,4,8,13,6,20,11,8,29,11,21,13,14,5,9,14,35,11,12,8,9,6,8,24,5,12,2,8,11,28,10,17,3,14,15,7,7,5,16,7,16,10,7,5,10,7,11,7,14,9,9,5,9,15,8,14,21,10,28,6,10,6,6,5,16,14,8,11,14,11,18,26,22,8,9,2,7,10,14,10,1,13,6,9,2,1,16,10,6,5,35,8,6,18,19,4,11,0,17,27,8,26,8,6,5,5,10,5,14,10,13,6,11,0,6,9,21,2,3,4,2,10,8,6,9,23,8,5,6,4,37,1,2,9,16,15,6,7,6,6,5,18,15,7,23,7,4,16,16,5,4,14,10,13,7,4,3,9,5,7,12,4,15,8,7,19,38,24,12,46,8,2,10,12,5,6,10,2,7,12,6,2,3,2,7,3,14,7,5,16,4,21,7,9,3,8,5,5,9,11,5,3,15,6,17,22,16,18,3,20,3,6,4,8,1,3,3,4,6,3,4
fix,3,15,8,103,2,7,12,5,2,1,6,5,7,22,3,4,16,9,7,1,2,30,20,23,15,10,4,10,3,12,7,109,53,3,26,28,18,12,17,0,11,4,0,2,25,12,18,9,162,11,21,4,9,13,8,2,45,21,6,15,7,3,0,12,12,3,40,14,3,20,10,6,7,4,47,9,22,3,57,16,21,2,8,4,132,22,15,0,37,0,10,7,4,19,28,44,15,6,16,11,17,29,21,6,4,28,6,4,9,0,10,1,10,17,5,20,3,5,45,140,22,14,14,31,6,1,0,5,6,3,5,2,8,36,14,57,0,2,5,2,3,24,14,4,5,37,4,10,11,16,51,4,16,1,5,16,16,3,4,11,23,3,9,2,0,13,7,12,18,0,7,62,20,2,5,4,117,3,6,29,20,4,2,21,8,31,21,18,14,41,5,2,10,4,1,5,18,5,8,4,35,5,1,12,17,6,4,28,11,16,55,10,11,8,2,17,5,4,5,0,4,7,1,11,37,90,15,20,8,8,15,11,21,10,18,11,21,9,7,2,55,28,6,3,7,6,2,24,41,3,11,20,12,2,8,9,7,3,2,27,2,13,21,6,6,27,3,2,10,4,95,9,29,11,3,2,15,11,3,3,26,11,2,10,5,1,5,2,12,1,3,8,8,4,5,4,32,3,3,12,13,29,2,1,5,6,12,4,1,1,0,9,14,2,57,7,14,28,14,4,29,4,10,2,36,2,6,13,2,23,4,7,4,5,6,11,8,5,3,17,4,6,12,6,2,3,22,30,5,8,9,6,3,19,12,8,3,4,12,14,21,1,2,8,0,5,24,6,12,8,2,12,5,5,6,24,6,8,5,3,50,2,43,3,2,34,8,10,27,8,9,2,10,8,20,6,40,1,24,1,16,1,2,3,6,7,6,0,8,10,1,13,4,10,7,5,3,9,3,0,3,7,15,6,0,5,1,7,5,5,12,13,2,9,3,3,1,9,6,5,11,9,7,6,0,5,7,2,25,6,12,8,3,3,27,11,0,10,1,19,14,14,21,20,6,3,19,5,2,3,10,6,2,0,2,8,3,12,17,6,5,6,3,0,4,12,3,2,6,2,22,29,2,3,9,4,6,6,6,12,7,9,1,3,18,15,5,12,1,3,3,10,11,12,9,13,6,13,3,10,2,10,16,12,10,6,11,11,19,11,20,6,1,4,14,11,11,8,28,11,3,3,2,10,19,14,2,5,7,4,15,1,6,46,5,6,26,6,5,5,17,3,18,1,13,16,11,6,17,19,10,3,13,2,4,1,10,1,4,15,10,8,10,7,4,2,7,2,3,13,11,25,11,7,35,5,13,9,25,4,17,2,6,4,9,25,3,13,13,1,15,49,10,4,22,3,16,3,8,4,6,2,6,13,1,9,6,12,6,15,32,26,24,9,3,1,4,3,3,10,14,5,5,20,5,14,7,5,4,114,9,6,3,2,4,6,16,10,1,7,4,5,18,8,6,7,0,11,9,3,12,4,7,32,26,3,2,7,1,6,11,40,8,3,7,6,5,3,5,10,11,7,8,6,8,8,1,6,8,16,11,1,3,4,5,4,9,2,4,4,5,7,5,16,30,24,4,2,5,4,8,4,1,30,1,8,3,1,4,5,7,10,7,6,10,10,7,5,20,4,11,3,3,6,8,9,8,4,3,7,7,4,3,4,1,6,6,19,4,9,9,7,6,5,17,23,12,5,6,3,6,0,4,11,2,9,6,1,3,7,2,4,2,11,8,9,2,0,4,17,6,6,1,2,12,6,30,6,0,5,14,8,8,4,1,3,4,3,12,3,6,3,5,9,4,3,1,10,5,11,2,2,2,13,3,5,6,1,5,4,9,2,7,2,7,2,6,13,3,3,4,5,5,6,9,9,3,11,5,4,15,16,5,2,2,2,1,21,4,5,2,4,7,3,4,5,2,1,2,15,5,1,13,22,2,3,1,5,3,0,9,21,5,1,12,4,4,5,3,6,1,5,0,1,1,4,5,4,7,2,4,1,4,6,10,3,0,19,3,13,0,3,4,15,2,5,1,0,6,4,4,5,2,10,2,8,5,2,3,2,2,4,7,1,2,9,1,3,4,8,2,4,1,1,6,27,11,6,19,2,10,5,3,2,4,13,3,1,18,5,1,5,3,18,0,10,1,5,3,2,1,5,2,1,1,2,4,4,3,4,29,5,7,17,4,4,2,3,7,0,1,0,2,1,3,9,5,4,3,1
check,0,21,5,66,3,4,1,20,2,2,7,3,9,29,11,3,2,7,5,0,3,19,10,13,14,12,4,9,5,6,4,68,67,4,31,25,20,6,13,2,6,4,0,6,20,10,16,7,95,6,25,1,10,16,15,5,26,6,0,13,4,1,1,3,8,1,75,3,2,8,8,0,3,5,44,12,16,6,40,12,28,6,11,5,84,19,11,0,15,0,8,2,1,8,22,8,11,4,18,10,12,10,14,2,9,7,2,8,12,3,4,6,9,7,5,15,1,3,27,77,24,13,23,35,4,1,3,3,1,0,16,1,3,17,7,42,8,2,8,4,5,22,13,5,4,48,6,18,17,11,38,2,9,7,12,17,20,8,6,14,6,11,6,1,0,13,1,24,8,7,9,46,15,7,1,4,110,4,9,24,13,16,0,16,4,24,23,8,8,21,2,9,5,2,3,2,6,3,3,14,24,2,0,9,10,6,9,39,3,14,48,4,17,5,2,5,1,3,10,0,7,4,2,2,22,52,23,16,3,4,9,6,8,16,23,19,25,10,5,2,46,20,5,3,6,6,3,22,12,5,4,16,8,2,7,12,4,0,1,3,7,9,5,0,7,20,3,7,5,2,56,7,15,5,0,1,12,5,5,0,31,12,3,5,4,2,1,14,9,2,1,4,13,0,1,6,10,2,2,14,18,9,1,0,4,9,11,0,5,0,1,14,8,6,23,14,8,26,21,6,13,7,19,2,40,1,4,16,3,21,6,6,2,0,4,15,14,5,3,4,3,5,12,1,9,4,17,20,11,9,3,6,1,35,10,2,2,1,10,21,15,2,3,15,2,1,12,4,3,17,1,11,5,10,15,17,4,3,11,0,27,5,27,2,3,45,4,13,13,1,10,3,22,7,12,4,28,2,17,3,6,6,0,1,6,10,9,1,10,6,1,3,2,7,15,3,0,4,4,1,8,5,17,11,2,0,0,17,7,12,5,2,0,2,1,3,0,0,3,4,4,6,3,7,0,1,8,3,17,3,14,4,5,3,26,7,1,1,8,31,12,9,17,19,3,1,8,6,1,2,13,11,3,5,1,15,1,19,11,15,12,6,2,3,7,4,6,7,9,4,22,19,0,1,5,5,6,3,2,19,8,7,3,1,4,34,11,12,3,1,6,5,5,4,7,10,4,2,16,8,3,17,3,16,5,4,26,20,7,11,10,1,4,8,2,7,4,10,26,21,2,3,3,4,10,6,0,4,3,4,39,2,0,11,5,3,12,4,2,1,7,2,10,5,7,11,7,0,13,26,7,8,5,5,3,3,7,4,7,6,5,10,9,4,5,2,1,8,1,5,6,9,4,2,20,5,0,1,1,3,9,3,4,0,3,8,7,23,4,3,19,5,2,0,12,5,11,1,1,4,10,3,1,7,1,3,5,2,11,17,7,8,12,12,9,2,8,4,1,3,5,1,8,15,7,11,4,3,3,43,8,3,13,4,5,5,16,5,1,5,7,1,1,3,2,0,1,7,7,4,14,0,7,9,7,4,2,9,0,9,1,21,8,0,6,4,7,3,2,3,0,4,5,2,2,8,3,0,12,6,0,2,2,8,14,1,11,5,2,5,5,6,2,19,4,6,3,3,0,2,4,3,5,6,0,4,5,0,2,5,11,6,4,2,1,1,1,4,19,7,14,7,1,3,3,6,2,7,4,4,9,2,1,1,1,8,2,9,5,8,9,8,1,1,13,14,5,9,3,7,4,5,1,14,3,7,10,2,7,3,4,1,9,10,11,4,6,7,2,4,4,4,0,3,6,5,5,2,4,5,2,0,5,1,3,0,1,4,9,3,6,1,3,3,2,1,5,1,3,7,5,3,0,0,3,2,4,8,5,2,7,10,9,3,6,10,8,17,2,3,2,3,0,7,4,5,11,0,8,6,6,11,7,3,3,2,9,5,7,2,5,5,3,4,3,4,6,3,1,6,2,6,3,10,4,0,0,5,1,0,1,5,3,0,2,4,4,2,3,7,2,5,0,2,2,4,10,1,4,3,2,4,3,2,2,5,0,5,4,6,1,4,1,3,5,0,2,2,8,1,5,1,2,1,0,0,0,2,0,4,0,0,4,0,4,10,2,1,4,4,4,2,2,0,5,8,4,1,8,4,0,4,4,1,1,2,5,1,3,1,5,0,2,2,0,2,6,5,11,3,3,7,11,2,2,3,1,4,3,3,1,4,4,4,6,3,8,2,10,2,3,0,4,2,1,0,2,6,0,3
diminish,3,5,6,48,1,0,1,22,0,0,2,2,2,25,5,1,0,4,1,2,2,11,5,8,12,5,4,1,0,6,4,75,58,3,30,42,14,9,10,1,13,3,3,3,21,8,13,4,84,5,23,3,13,20,0,2,75,19,1,9,10,3,3,13,11,3,48,15,2,14,17,0,4,5,40,5,9,0,28,12,95,1,9,5,122,23,14,0,22,2,10,3,1,13,27,36,11,9,15,15,2,20,14,6,7,18,15,4,9,0,8,2,8,17,0,22,1,3,28,109,20,1,34,45,4,4,0,2,8,5,4,3,1,20,8,23,3,2,2,8,1,14,12,3,3,27,5,7,12,19,12,1,12,2,5,4,13,3,4,1,11,2,3,1,5,7,2,8,15,9,6,38,14,0,2,5,75,0,5,14,15,3,5,5,0,14,39,10,12,11,1,2,4,0,0,1,7,2,4,7,18,4,2,7,8,0,2,34,5,23,51,2,7,27,3,2,0,2,4,0,3,5,7,15,24,41,18,25,7,6,5,10,32,15,17,102,18,5,8,1,27,15,4,2,5,6,2,8,19,3,4,28,3,18,11,8,3,2,3,26,5,15,9,2,7,24,1,1,4,7,89,7,49,4,3,1,6,31,3,2,27,3,6,5,5,1,3,9,6,2,2,2,8,4,2,9,14,3,1,12,13,14,0,2,3,1,16,8,3,1,0,8,6,3,27,13,15,20,11,1,14,2,11,4,5,3,1,11,1,18,1,12,4,3,6,1,8,2,3,6,8,0,14,3,4,1,21,14,3,3,9,3,2,4,11,4,2,0,18,19,8,3,1,12,3,0,18,3,3,7,1,14,4,9,5,16,5,9,7,12,32,4,23,3,2,8,7,8,14,0,10,0,2,5,15,8,24,5,8,3,9,4,3,0,4,7,6,1,15,6,1,5,4,14,1,7,4,4,0,2,2,2,11,5,1,2,2,8,3,17,7,4,9,5,0,0,3,2,9,4,6,21,3,7,1,1,1,2,11,7,12,4,2,8,19,9,0,1,3,24,5,7,11,11,3,1,19,5,0,1,5,1,1,4,3,11,1,8,18,1,9,8,0,0,2,2,18,3,3,0,36,13,2,1,5,2,4,5,6,14,9,3,7,4,2,20,4,14,3,6,1,5,2,1,12,5,1,5,1,3,1,4,2,7,1,4,10,2,3,10,3,4,6,13,3,5,3,4,15,15,5,1,1,5,12,5,1,22,4,5,9,2,1,19,4,6,17,5,2,1,12,0,15,5,5,16,4,1,18,19,11,4,7,0,3,2,19,0,3,11,10,2,14,4,5,1,2,4,4,3,11,13,6,1,12,2,12,6,7,8,7,3,1,3,2,8,2,15,2,17,11,4,3,5,10,4,13,4,4,2,7,4,2,15,0,2,1,10,2,10,2,12,12,11,2,1,6,4,4,6,8,2,3,9,1,20,1,2,5,37,6,2,8,4,2,3,17,6,2,9,7,2,0,6,1,2,1,3,6,5,14,9,11,3,4,4,1,2,0,0,1,9,3,2,3,2,4,4,0,4,0,3,7,0,5,2,5,2,21,6,2,2,2,7,13,4,9,1,5,1,3,2,11,11,7,24,9,6,1,3,0,4,2,11,4,6,10,3,1,2,3,9,6,6,1,8,7,2,7,11,6,1,1,1,4,2,14,6,6,5,4,16,6,14,11,5,0,8,3,36,40,5,1,12,5,7,3,2,12,3,1,0,0,6,1,8,5,2,7,3,4,4,3,2,3,3,12,0,7,5,4,0,0,1,5,8,1,2,5,1,0,7,2,2,6,0,14,6,11,2,12,1,4,1,4,1,3,3,5,4,3,5,7,1,1,2,2,0,4,5,6,4,13,4,3,4,2,15,3,1,2,1,1,1,5,6,6,4,4,4,3,6,4,15,0,2,9,7,6,2,2,1,3,0,4,3,2,1,4,4,4,4,6,7,8,5,1,6,5,2,0,4,1,1,2,0,2,4,4,3,1,2,0,0,2,0,2,0,4,0,9,3,1,5,2,6,0,8,8,8,2,3,3,16,4,6,3,7,4,1,5,7,4,31,0,7,2,2,4,3,1,1,6,1,1,5,3,5,2,3,1,10,14,10,15,12,14,17,35,0,2,0,4,2,2,6,2,0,4,2,2,1,0,1,3,6,5,4,0,0,10,2,6,2,2,2,0,2,4,4,6,0,7,2,4,14,5,1,0,0,1,2,3,1,4,2,0,0,2,0
remedy,1,22,7,90,5,1,2,17,3,1,10,4,1,40,4,11,1,12,0,3,5,17,14,11,13,4,9,3,9,4,6,82,64,7,23,36,14,2,7,4,2,10,0,1,13,13,14,11,140,2,19,2,10,21,4,3,32,11,0,9,3,7,2,4,16,8,62,1,9,7,3,0,1,3,75,14,12,4,30,9,17,1,5,3,100,8,11,0,16,1,4,3,0,8,22,0,19,8,12,6,1,13,23,11,9,16,5,3,8,4,6,7,4,6,0,13,1,0,26,110,21,7,8,23,8,0,0,0,2,1,7,1,1,27,9,23,23,0,3,5,4,23,10,2,9,32,5,6,3,12,53,0,7,0,4,27,22,3,8,3,9,4,8,3,1,4,2,22,16,8,3,52,14,0,9,12,81,2,7,22,12,12,2,13,1,23,21,12,17,22,1,4,4,0,0,0,4,2,1,12,28,1,1,10,9,6,4,33,2,5,35,6,19,2,1,0,0,0,4,2,0,16,1,6,25,89,18,14,3,1,4,7,7,18,27,5,24,4,4,3,35,30,2,6,13,5,2,16,39,0,9,18,8,0,7,7,6,1,2,7,5,15,16,1,5,29,4,4,7,3,85,2,5,4,0,2,7,2,6,4,39,16,4,17,5,2,3,2,10,1,2,1,7,0,2,1,7,1,3,8,15,20,0,1,11,2,18,3,2,1,3,14,11,4,15,9,11,36,9,7,25,6,19,4,43,5,14,6,0,29,2,5,3,1,4,4,20,4,1,6,6,2,13,9,0,3,33,31,12,4,30,12,4,17,11,4,1,1,15,15,23,3,1,7,1,0,20,6,13,8,4,7,7,10,6,13,5,1,9,2,28,1,27,6,4,15,2,16,12,4,29,1,6,0,21,6,32,0,9,4,19,1,4,1,5,6,5,0,9,8,0,5,0,13,5,4,2,10,2,2,5,2,24,12,1,4,3,4,9,11,11,3,4,10,2,2,0,2,1,2,7,8,7,3,2,2,6,3,20,7,7,3,2,4,28,7,3,8,5,16,8,18,13,20,5,0,10,4,2,2,9,6,2,3,3,5,1,10,9,5,3,9,3,7,4,8,7,3,8,1,32,26,2,5,5,3,2,13,6,47,9,1,2,8,3,11,3,13,10,5,5,1,3,7,11,12,4,10,3,8,4,9,8,24,14,2,15,17,20,18,7,4,2,9,1,4,5,0,12,9,1,0,3,2,9,6,4,12,8,3,34,4,9,31,3,6,12,5,4,7,13,3,14,6,18,12,9,2,19,25,6,0,1,4,1,1,10,3,7,11,5,6,6,5,6,5,4,4,1,8,13,14,5,0,17,2,1,1,17,11,14,2,4,2,3,10,7,14,12,3,22,5,5,3,36,4,14,2,6,2,4,3,7,8,0,2,0,14,12,17,9,14,23,16,5,3,9,3,9,4,8,2,16,10,4,6,5,2,6,56,2,11,6,7,5,5,17,8,9,7,1,4,5,0,4,2,2,4,5,7,10,8,24,50,17,3,4,5,1,3,0,16,10,4,7,6,10,4,0,1,9,0,5,5,5,2,3,2,5,8,3,1,6,1,2,2,9,1,1,2,5,2,2,13,9,7,3,5,0,4,2,7,2,12,0,3,3,1,3,12,10,11,2,9,3,2,6,1,8,1,5,4,1,3,0,2,4,1,1,3,8,2,0,3,0,7,8,8,0,7,7,7,4,1,14,7,6,4,3,4,4,2,3,10,4,9,4,1,0,4,0,0,13,0,4,3,0,2,2,6,5,7,2,1,3,18,2,0,2,1,2,3,3,0,3,1,4,6,10,5,2,1,3,4,1,2,1,3,0,3,2,0,2,3,0,7,2,4,5,0,3,6,10,5,1,6,7,16,8,2,1,11,7,5,0,10,5,1,2,9,5,22,8,3,8,0,5,0,7,1,0,3,0,2,7,5,2,3,4,7,4,10,4,14,6,2,0,5,4,0,3,0,1,2,1,2,3,1,2,1,2,4,0,0,8,5,2,4,2,3,4,4,2,0,10,1,0,0,3,17,1,1,10,4,1,2,0,0,6,1,4,3,5,2,1,4,1,3,3,1,2,1,2,3,6,3,2,7,1,5,4,2,2,1,2,13,7,3,11,2,2,6,3,0,2,2,1,1,10,5,5,1,2,1,0,8,2,2,0,3,1,9,5,0,0,5,0,10,5,2,4,9,3,7,8,0,11,4,5,0,1,2,3,1,0,0,0,1,2,1
proceed,23,21,8,111,5,5,8,33,4,3,12,10,11,37,5,9,5,2,2,3,2,48,10,16,15,10,4,9,3,6,11,116,83,2,26,40,23,5,9,2,5,5,4,1,15,7,21,8,240,9,40,5,6,10,6,5,28,25,2,23,9,3,0,19,11,4,59,4,10,12,7,12,1,1,44,8,18,3,52,13,29,1,32,5,119,9,8,1,46,3,12,3,0,18,20,9,17,5,23,8,11,21,27,6,8,20,5,7,7,4,7,2,3,5,0,26,6,6,84,66,31,5,9,24,5,2,5,3,6,2,10,1,4,25,13,52,3,7,2,4,4,21,17,4,4,73,3,3,9,11,34,3,13,7,3,10,25,7,6,0,8,10,3,1,1,6,1,17,11,10,12,58,20,3,0,2,97,3,9,29,24,5,4,11,7,13,34,16,29,42,4,8,3,0,3,1,12,3,3,11,16,2,3,12,18,5,3,15,5,17,57,4,19,9,1,0,2,1,6,6,1,12,3,6,28,64,22,17,0,3,11,11,9,22,26,9,28,4,3,3,58,21,3,6,4,4,13,7,48,3,6,13,18,5,6,13,6,0,2,16,1,18,18,6,4,31,3,6,8,3,90,7,22,1,0,1,11,4,11,6,43,6,0,15,7,0,4,8,15,2,14,8,11,5,2,7,38,3,5,15,19,12,3,4,7,3,16,3,4,0,5,16,29,3,19,7,7,29,18,2,42,7,18,1,31,10,3,17,0,25,5,13,0,4,6,13,10,4,1,14,5,8,6,13,14,5,24,42,3,7,11,8,5,27,15,5,6,2,9,12,9,2,6,21,2,1,29,2,4,11,1,10,4,5,7,18,2,3,12,9,65,1,32,3,2,21,4,13,39,5,25,5,12,17,24,6,43,6,39,2,18,3,2,2,10,8,7,2,9,3,1,15,2,10,18,6,1,11,5,2,5,7,16,11,1,2,5,12,12,11,9,5,3,17,5,5,2,32,7,3,13,12,12,9,3,4,7,2,27,3,9,5,5,6,44,2,2,10,2,33,13,11,21,15,4,7,10,9,6,0,8,1,5,7,3,9,1,9,10,4,7,7,0,2,11,1,3,4,7,6,43,27,1,1,1,8,7,16,8,16,8,10,4,1,14,9,8,13,11,5,2,3,1,5,9,12,9,5,0,8,0,23,7,15,3,6,20,10,22,9,4,2,3,2,12,4,11,4,41,9,3,1,0,1,4,17,4,10,5,7,41,7,0,42,7,6,20,6,7,4,14,6,26,3,8,10,7,7,36,23,9,6,23,0,12,4,9,7,6,12,2,21,9,7,5,1,3,3,2,7,12,21,7,5,14,3,1,1,50,16,16,1,1,6,7,8,11,8,4,7,22,25,42,3,12,3,8,0,5,6,8,1,2,21,3,5,4,2,10,23,3,9,18,20,11,1,7,4,0,9,3,3,3,25,7,20,3,2,5,125,23,1,10,4,3,10,31,10,3,17,2,8,17,15,15,14,9,14,11,7,11,7,21,15,26,2,2,13,6,6,8,31,10,5,4,7,6,6,11,20,7,10,19,8,8,10,8,10,3,12,17,10,3,6,4,11,16,11,3,4,1,12,1,25,18,14,7,6,6,3,7,8,5,15,2,6,5,0,4,12,2,13,3,5,3,7,19,4,33,6,10,11,6,5,10,4,7,6,3,12,7,2,5,7,2,5,4,14,5,4,2,16,5,2,20,5,10,6,4,5,5,10,1,15,3,5,3,0,9,7,2,4,5,5,9,4,4,2,3,11,4,9,0,1,9,13,2,5,3,7,4,10,14,5,0,3,2,7,11,5,3,11,6,16,9,6,3,9,8,9,0,2,13,13,4,5,0,8,4,3,6,3,4,3,6,7,2,21,5,10,11,4,4,8,7,4,8,20,3,12,17,28,5,3,2,6,6,8,1,1,5,3,8,0,2,6,9,6,3,6,5,1,2,6,3,4,5,13,7,2,2,5,3,7,31,1,17,5,2,5,5,24,0,8,3,8,4,8,5,1,3,9,4,7,12,9,10,14,6,14,4,3,2,7,6,10,6,5,1,3,10,2,3,5,2,12,1,37,7,7,5,2,10,5,8,3,3,2,1,12,2,5,2,0,7,9,9,5,17,6,3,7,3,3,2,5,2,8,15,2,1,9,3,5,2,28,0,5,10,4,2,4,7,3,8,4,3,4,6,9,0,4,11,3,2,6,2,0,20,0,2,0,5,3,0,1,0,7,1,0
regulation,6,13,5,109,3,6,3,13,1,3,5,4,10,31,15,4,8,11,2,0,7,26,8,17,21,4,11,3,2,7,4,120,66,7,48,28,7,4,9,1,8,4,1,5,50,15,18,29,160,6,34,7,7,8,4,1,33,12,0,12,7,3,0,9,12,7,35,2,10,5,1,1,5,3,68,10,21,2,40,25,29,6,7,3,164,8,19,1,22,1,3,5,5,12,48,39,14,6,11,21,8,20,18,5,7,22,2,10,5,2,10,3,3,24,0,27,1,2,57,93,51,13,11,35,7,1,0,5,1,2,4,1,5,45,12,42,4,4,6,2,3,31,15,4,3,36,9,9,9,7,80,2,9,11,7,43,28,8,2,11,15,2,7,2,3,15,1,21,19,2,8,65,25,1,5,3,118,3,9,43,17,6,19,26,8,24,17,12,25,31,1,4,4,1,2,5,11,2,7,12,50,5,4,7,15,8,6,38,9,22,68,6,14,6,2,4,1,0,13,0,1,18,6,11,28,122,22,16,2,1,11,11,17,26,21,11,18,9,5,5,43,30,2,11,18,5,4,19,41,9,6,15,12,1,7,8,3,0,1,9,4,7,12,1,2,27,5,3,13,4,90,5,7,10,4,2,20,7,5,0,28,17,5,19,4,4,12,4,4,0,5,4,9,4,2,5,18,7,6,8,11,20,1,1,20,0,11,2,13,1,5,39,14,2,9,19,16,40,6,11,19,5,21,2,42,9,17,12,0,14,2,5,8,2,6,13,9,4,7,6,3,6,12,3,6,7,47,41,14,6,18,13,9,29,8,20,1,2,15,19,38,13,17,17,1,3,21,5,20,15,3,9,1,7,17,43,6,11,8,2,58,1,40,17,3,29,0,12,24,3,15,0,4,8,30,5,51,4,21,3,21,4,3,0,7,15,4,1,21,8,0,5,1,20,1,2,7,2,3,2,2,5,26,11,0,7,5,11,3,9,1,4,0,7,1,2,0,8,1,5,22,19,2,3,3,1,8,3,24,6,4,6,1,0,33,37,0,9,9,37,11,11,19,29,13,2,13,17,26,2,5,12,5,3,3,11,1,2,13,2,4,0,2,5,3,9,7,3,7,8,11,25,0,2,6,4,3,7,3,15,12,1,1,10,5,24,4,13,12,4,1,7,5,1,21,17,3,11,9,8,5,12,26,38,13,4,35,39,18,19,13,7,3,9,9,4,9,22,13,32,5,5,3,6,9,2,3,11,13,12,31,7,8,33,14,16,50,8,3,6,23,0,13,5,8,8,12,7,14,46,8,3,5,17,6,5,23,9,6,14,11,16,9,11,14,4,11,5,9,13,17,23,14,8,22,4,8,4,25,11,23,2,2,8,1,15,7,25,13,2,15,48,10,9,21,1,21,27,15,3,7,1,1,7,4,12,4,12,11,24,0,24,32,14,3,1,22,2,2,3,5,1,2,16,4,11,4,1,11,83,15,7,5,11,3,9,23,6,3,10,5,7,9,18,3,3,7,2,11,6,11,9,3,23,13,4,3,5,1,0,8,25,8,4,7,7,0,4,0,7,3,13,5,5,2,9,3,4,8,4,3,6,1,6,22,3,9,5,2,2,11,8,3,12,10,3,2,5,9,14,2,3,1,14,2,6,3,4,7,10,5,11,2,11,3,2,3,2,13,0,13,0,5,5,23,4,5,12,14,7,2,2,0,5,3,11,6,17,5,7,8,8,2,2,14,12,4,15,8,7,6,4,0,9,0,6,3,4,7,6,2,2,10,3,6,9,5,1,3,11,6,8,5,3,36,15,21,4,1,8,0,3,4,3,4,4,3,1,6,4,6,0,20,9,4,1,5,7,0,6,2,2,12,18,2,3,9,5,1,1,7,1,7,1,0,6,5,9,11,5,3,9,6,5,4,7,8,8,3,2,10,18,15,5,1,6,12,2,5,3,10,1,7,2,2,3,7,2,7,9,12,4,5,5,6,6,2,3,4,2,6,0,7,0,12,2,4,5,3,4,1,10,0,1,2,2,0,3,4,0,4,3,5,1,1,2,6,5,8,15,8,5,9,0,9,5,0,21,1,2,4,1,5,6,6,6,3,3,1,7,9,8,5,2,3,2,3,4,4,10,5,1,1,0,4,6,2,4,18,1,0,2,4,3,4,6,2,1,9,7,2,0,6,5,2,14,1,5,1,2,2,1,5,2,1,4,2,6,8,6,2,2,5,1,5,2,9,2,4,2,2,1,2,0,2,1,3,2,1,0
experience,8,27,11,174,12,7,1,52,6,6,16,10,15,49,13,11,5,26,15,8,7,55,15,22,32,10,17,11,10,22,12,191,181,18,63,85,44,12,15,6,8,10,6,4,41,31,28,20,287,18,43,14,23,38,8,10,105,40,4,19,18,18,2,22,42,10,122,11,12,11,16,0,6,6,80,17,22,7,119,29,68,0,15,6,277,36,20,1,42,1,11,6,1,30,59,28,21,7,47,22,26,43,45,11,18,27,16,4,23,10,17,8,13,22,7,33,6,7,70,165,65,16,17,92,10,6,8,5,10,6,12,8,7,59,24,76,8,5,7,13,3,36,38,9,10,59,15,13,8,16,71,2,26,16,6,35,25,7,11,13,20,11,9,4,2,11,7,23,43,9,29,100,30,3,5,23,192,6,11,49,19,16,9,23,5,25,43,21,35,48,7,4,6,0,0,3,21,6,18,17,56,7,4,18,33,13,9,98,11,41,73,6,27,31,4,4,3,0,22,2,2,20,10,39,73,118,71,54,3,16,23,18,32,31,47,66,45,13,19,10,86,53,12,5,13,7,8,39,69,11,15,39,29,23,18,18,14,4,6,24,8,25,28,2,9,41,6,8,10,7,215,6,39,16,7,1,22,10,7,1,70,16,3,35,16,1,5,10,12,2,12,2,24,5,1,14,34,5,15,28,51,40,2,4,18,2,28,9,3,5,2,22,23,13,31,26,32,75,21,11,48,10,37,5,61,8,13,28,8,23,8,18,10,7,15,14,17,8,9,23,16,6,31,7,12,7,57,48,29,10,16,18,4,36,27,3,0,6,23,30,20,13,12,8,15,3,40,11,9,10,5,28,8,23,17,43,11,9,23,6,95,2,53,12,1,61,6,22,26,8,19,10,29,12,55,17,64,8,31,5,33,1,8,0,14,12,17,6,25,20,2,2,7,27,9,10,3,8,2,4,8,11,33,15,2,12,27,16,15,25,20,8,1,13,1,6,1,2,11,5,16,28,9,14,0,7,12,6,39,2,22,6,1,7,62,26,0,5,4,49,16,35,44,41,10,3,25,12,11,3,26,5,12,3,13,14,9,19,24,3,9,20,5,14,24,6,12,4,12,4,83,60,4,2,20,14,8,15,15,24,17,7,5,0,5,72,5,15,9,7,12,11,9,21,1,32,19,27,19,22,11,17,21,35,16,7,38,26,19,44,17,15,3,15,12,10,13,9,38,30,11,2,7,12,21,17,29,31,14,8,67,9,4,68,22,21,38,9,3,14,32,3,38,8,31,33,49,16,34,49,16,19,15,9,8,7,22,10,10,14,24,11,30,19,24,6,11,9,4,21,37,45,13,5,34,8,13,18,25,26,21,2,7,2,4,24,7,25,11,16,29,31,14,9,37,14,28,9,13,10,25,17,11,23,7,9,8,28,23,47,29,37,33,26,5,10,14,4,1,29,9,1,5,24,11,31,11,5,12,131,24,5,14,14,3,13,44,15,7,11,17,0,17,16,2,1,3,13,21,12,28,13,11,14,22,10,9,16,6,15,4,41,22,11,11,16,10,2,6,5,11,14,16,8,8,12,15,8,17,19,4,6,15,7,16,11,16,7,8,5,5,10,13,41,29,24,9,14,5,13,15,2,5,36,6,12,11,5,6,15,16,36,11,9,10,6,19,8,35,14,14,3,5,13,15,8,23,8,13,11,15,11,1,14,7,24,14,26,12,22,23,16,4,7,26,41,10,15,25,16,4,6,1,13,6,14,19,10,31,23,16,8,10,8,12,7,17,2,16,14,7,6,3,9,12,25,10,8,6,9,6,3,19,8,3,6,12,7,16,11,9,3,11,9,3,6,5,10,9,5,5,6,1,16,8,8,10,2,14,8,6,8,22,4,8,12,21,26,17,8,1,8,4,3,17,13,13,1,10,12,26,27,6,18,4,5,15,12,2,5,5,6,6,6,11,17,10,10,22,27,6,6,4,40,9,10,1,10,19,2,2,4,7,4,12,6,4,5,5,14,5,3,1,3,5,15,6,5,9,2,6,10,5,15,7,9,1,14,6,18,9,12,2,15,11,4,5,14,21,9,13,13,9,22,2,11,3,10,6,20,6,1,11,3,8,7,16,6,3,27,10,13,1,9,5,11,17,17,38,5,9,4,7,1,6,1,4,6,16,6,5,8,18,3,2,24,7,3,10,7,5,7,9,1,5,5,8,18,10,8,0,9,11,27,13,8,16,5,13,5,6,6,5,3,0,2,5,4,1,1
opinion,15,56,20,286,17,4,6,61,9,3,15,17,6,71,8,5,15,28,5,3,12,50,7,27,40,20,9,13,8,27,11,241,183,9,74,47,62,6,11,5,7,12,1,3,46,31,40,17,386,10,71,9,23,38,4,7,119,75,0,22,36,13,9,15,39,1,166,7,51,15,2,3,9,7,91,14,33,6,124,29,68,2,15,2,317,29,19,0,74,4,22,9,0,59,79,30,32,8,40,15,20,29,55,11,13,34,17,4,15,3,28,7,9,32,1,41,11,10,119,268,66,6,23,77,10,7,2,9,1,1,12,2,10,57,25,56,11,6,15,9,3,55,53,4,5,86,10,13,29,25,129,2,34,10,2,35,33,8,21,3,18,5,8,0,1,4,5,24,19,12,17,128,18,0,3,19,326,4,24,33,33,17,2,21,11,18,68,30,85,64,2,5,8,0,1,5,26,11,8,23,45,1,3,19,33,11,8,42,25,44,121,9,40,8,2,2,3,0,15,8,5,19,14,34,81,164,30,38,3,10,27,15,24,33,34,38,43,15,5,16,115,31,7,4,18,4,10,27,50,10,25,29,23,16,18,24,15,2,10,14,2,40,49,16,12,62,10,11,20,9,213,12,62,12,7,0,19,30,25,6,79,17,6,27,12,2,3,9,19,2,5,1,57,9,3,11,67,13,11,21,42,63,1,0,22,2,30,10,7,1,2,23,37,13,31,28,21,62,12,4,51,12,30,0,92,12,15,39,15,40,14,25,15,9,14,37,23,13,3,17,21,19,12,15,10,6,89,76,33,7,15,26,6,47,38,11,6,8,31,46,42,12,7,43,8,1,73,12,4,15,5,20,6,13,10,29,18,5,24,20,116,3,65,19,0,71,18,31,54,10,30,4,34,18,74,28,170,12,41,12,55,2,4,1,9,11,9,3,17,19,2,14,4,25,20,29,5,7,13,2,12,13,30,26,3,8,8,20,24,21,20,5,6,10,3,5,2,9,12,7,15,24,15,9,1,6,12,8,50,10,14,11,4,10,79,17,0,23,11,35,18,47,38,32,10,3,25,19,29,1,6,10,5,2,7,19,6,29,27,9,8,21,4,15,14,26,13,4,15,7,99,72,2,13,11,12,4,20,17,21,11,4,4,0,14,23,2,37,13,10,5,12,12,17,32,1,10,21,4,20,7,21,13,49,14,11,22,17,34,59,19,16,2,11,22,20,19,22,55,30,9,4,3,6,6,16,6,27,29,16,100,16,8,84,13,15,35,7,8,17,33,8,38,5,44,20,23,11,48,42,20,20,24,6,7,9,23,4,11,23,7,27,18,23,28,11,10,16,8,14,25,80,17,4,19,8,6,4,61,31,43,4,14,6,15,41,5,64,12,14,34,44,21,9,67,16,37,0,24,8,21,13,7,30,10,11,7,26,19,41,17,44,43,46,8,2,12,6,11,9,18,2,17,61,13,71,7,11,16,197,17,7,16,9,11,9,63,21,9,15,16,6,8,22,12,7,7,12,21,19,24,13,54,53,30,11,7,15,3,7,10,44,45,13,16,20,18,5,8,9,11,14,26,15,8,9,9,7,29,26,1,9,26,13,14,10,22,9,13,13,6,9,10,74,25,29,10,15,7,7,10,8,6,41,3,13,13,2,8,15,19,14,8,11,14,1,18,7,45,15,22,7,4,6,9,6,20,22,6,10,18,14,12,25,15,31,19,20,5,21,18,14,5,7,21,35,12,6,20,24,10,3,5,25,6,24,13,5,12,19,1,4,17,8,9,9,9,28,9,27,13,14,4,11,17,31,8,17,4,4,12,1,24,9,12,2,12,5,39,12,6,1,11,11,6,18,10,15,7,17,7,5,3,23,10,16,5,18,13,11,4,6,20,6,16,20,18,37,21,8,10,16,9,30,8,11,10,10,15,19,42,40,15,11,6,7,12,16,10,3,3,9,24,5,12,23,6,6,36,31,5,5,8,12,5,10,3,11,68,4,6,8,10,11,25,12,11,10,7,6,7,15,2,7,14,8,5,2,4,2,12,12,3,15,28,7,3,16,2,51,12,7,11,20,17,9,6,27,4,8,29,11,9,16,4,16,4,17,7,12,12,6,17,13,7,9,8,5,10,26,9,16,26,5,11,33,8,30,71,5,9,6,6,8,7,6,3,6,24,12,9,4,15,1,6,16,17,10,12,5,2,15,14,5,11,6,1,14,16,12,7,21,13,16,15,6,16,2,21,4,4,2,6,0,0,2,1,11,4,0
step,2,26,7,82,4,8,3,16,3,1,11,4,12,37,0,3,5,7,5,5,1,25,20,20,9,17,9,15,5,19,5,94,63,15,27,41,28,5,12,3,12,13,1,7,25,11,19,15,142,28,26,12,7,39,14,5,25,13,4,20,6,7,3,12,10,12,75,1,6,8,18,3,7,1,83,9,12,10,49,16,26,3,11,10,120,19,5,2,19,2,9,6,7,10,32,2,23,1,30,9,9,22,8,4,7,24,2,12,12,4,11,4,9,14,13,20,2,3,36,89,22,28,24,56,10,1,4,3,6,1,9,9,4,30,16,37,8,2,4,11,7,35,14,5,2,147,9,11,2,7,33,8,9,4,2,9,26,3,9,26,9,1,13,4,4,13,6,24,10,8,9,46,28,3,3,8,92,11,12,47,22,8,7,16,1,10,12,9,18,27,5,4,5,7,4,1,17,5,6,11,19,2,2,7,12,8,2,22,7,17,50,9,16,6,3,7,4,6,9,0,3,9,1,10,18,39,20,13,2,7,8,10,9,21,18,9,14,7,3,3,42,22,9,8,13,2,5,13,25,1,7,6,24,3,5,8,2,2,3,7,5,19,8,1,4,12,3,5,11,3,63,10,3,1,5,7,16,2,2,0,47,6,0,16,5,3,23,13,12,3,4,5,9,4,4,5,17,6,6,6,16,9,2,0,5,5,51,1,2,2,1,6,13,10,22,7,6,26,8,3,22,2,25,8,25,1,10,21,4,14,2,9,7,4,3,3,14,1,2,6,11,13,7,4,7,3,21,22,12,17,7,7,2,14,4,3,4,2,11,32,16,10,7,7,0,1,17,2,19,5,3,9,4,9,4,4,2,1,10,5,49,3,25,6,3,11,4,12,18,2,13,8,12,6,26,9,35,4,22,4,11,5,3,3,3,11,8,2,15,7,2,5,0,12,21,8,2,3,3,7,3,9,25,13,0,4,2,13,8,13,10,0,0,4,7,7,1,4,5,5,6,9,1,9,4,1,14,4,10,7,8,4,10,7,32,2,0,3,9,11,20,10,13,14,7,6,11,6,6,1,19,11,2,3,11,6,3,9,18,1,4,17,3,7,12,4,1,3,8,1,29,21,2,3,4,2,2,6,4,9,8,1,1,8,3,12,1,5,6,4,1,4,9,3,19,10,1,18,5,7,5,14,7,15,8,6,17,10,7,13,6,3,4,4,6,9,4,8,21,12,3,1,4,1,11,9,2,10,4,4,17,1,1,29,7,3,18,5,7,3,8,2,4,3,8,9,8,7,16,30,5,5,2,2,15,2,2,2,2,12,2,14,4,14,5,2,0,2,1,10,7,22,6,5,12,2,1,3,19,12,13,0,5,2,7,18,1,16,3,4,17,14,8,4,9,1,10,1,6,6,9,7,1,17,5,6,4,3,7,17,7,9,20,4,2,1,12,2,0,8,4,1,3,11,6,24,1,3,6,72,32,4,3,1,6,3,18,10,2,6,1,2,1,6,2,2,2,6,2,3,1,3,17,4,9,2,2,2,1,3,1,20,3,6,6,2,7,6,0,3,3,11,8,10,0,5,8,4,5,9,3,5,1,0,3,3,13,4,0,3,6,2,0,26,11,9,9,6,7,3,3,4,7,7,3,2,3,2,2,7,2,2,3,9,5,5,13,0,9,3,5,7,6,7,5,4,5,9,2,6,4,2,4,1,2,8,5,7,1,11,9,12,6,0,9,14,6,3,2,4,9,1,1,9,4,7,12,0,9,5,2,0,5,2,2,1,2,6,3,9,7,3,1,2,1,11,4,3,2,5,4,3,7,2,4,3,8,3,9,1,3,5,2,12,1,2,3,11,7,7,0,2,3,5,0,1,7,5,3,4,7,1,11,1,2,7,3,15,5,4,2,4,4,7,4,6,7,9,1,9,5,18,7,0,0,5,3,6,4,1,2,2,9,1,2,1,4,2,2,2,3,0,3,9,8,1,4,8,7,3,0,6,1,2,4,1,6,3,12,3,6,3,4,1,6,4,5,7,9,6,5,4,3,5,6,1,0,6,1,17,7,2,1,1,4,4,4,2,9,4,4,4,2,3,4,5,2,10,1,7,1,2,2,0,2,1,4,2,5,3,2,6,1,1,6,10,5,1,14,2,0,5,6,3,2,3,3,1,12,3,0,1,4,1,1,5,2,0,8,2,0,3,5,8,1,4,2,2,1,1,1,3,5,7,3,2,3,6,7,9,1,5,1,3,9,7,3,2,3,1
wise,0,16,13,122,12,3,14,49,3,4,12,5,6,63,7,11,6,20,9,7,6,33,11,18,25,8,13,16,13,7,9,144,109,15,53,84,36,14,17,3,7,12,2,2,36,21,22,12,187,8,37,19,20,28,14,9,71,16,1,18,16,11,7,9,21,5,123,9,9,6,5,4,7,3,122,14,28,1,72,36,35,2,6,12,212,26,16,0,33,1,5,13,2,24,63,10,15,7,39,16,13,30,33,6,8,26,6,6,5,4,10,4,13,10,1,16,4,2,61,168,46,12,13,56,9,6,11,3,2,0,15,12,4,33,23,55,9,4,8,7,5,23,20,5,2,44,13,17,16,19,71,0,16,11,4,23,31,4,13,14,19,3,14,1,0,8,3,34,21,10,11,82,37,1,8,9,179,11,13,40,22,7,2,17,6,34,32,35,43,28,9,9,5,0,5,1,16,11,5,20,35,8,4,8,19,10,2,39,14,51,79,5,20,9,2,1,2,2,8,1,2,17,3,8,34,97,33,25,2,4,18,10,17,18,33,21,33,10,10,8,50,24,7,7,19,4,8,24,38,4,6,17,23,6,10,16,8,1,6,16,4,19,13,3,16,29,14,7,16,6,149,7,25,7,6,0,15,18,11,2,62,11,2,25,4,1,5,6,9,0,2,4,7,4,0,5,24,8,9,21,26,23,2,3,20,5,17,9,12,3,1,18,18,9,30,15,19,42,16,6,21,8,22,8,62,2,13,22,0,30,3,12,14,8,13,17,10,4,2,8,9,3,13,7,8,5,36,44,15,6,10,21,7,31,19,5,4,7,13,34,35,8,12,19,3,1,38,20,9,18,2,21,4,14,21,13,15,6,19,8,63,3,34,7,4,61,7,17,37,16,23,5,7,4,21,13,49,6,22,7,33,2,11,1,5,12,4,5,13,13,3,8,3,17,8,15,2,9,2,2,6,6,34,10,3,10,3,12,10,19,1,0,0,7,5,1,0,11,4,10,9,28,7,13,5,4,8,8,25,3,10,5,2,5,48,3,2,6,9,31,19,20,36,40,7,21,21,8,12,4,20,9,3,6,3,24,4,11,29,10,9,15,4,7,8,10,11,4,9,7,48,33,6,11,11,8,2,9,7,12,19,9,11,0,9,6,10,12,13,2,5,10,5,11,27,21,18,1,12,13,7,22,13,30,14,12,30,20,19,27,10,10,3,13,16,8,23,27,51,31,7,4,4,11,13,9,16,14,14,7,36,6,3,42,14,14,37,3,5,6,27,2,20,4,17,13,12,10,23,33,9,9,11,4,5,2,18,7,8,11,8,13,9,24,8,3,8,10,4,16,23,33,9,4,37,10,1,2,12,24,21,4,8,5,4,34,10,22,10,2,27,21,6,15,19,7,20,2,10,3,13,0,5,8,1,6,3,12,18,25,4,24,42,27,6,1,11,1,5,8,12,4,16,18,7,18,4,6,6,83,29,14,9,2,3,11,18,6,10,12,10,6,8,7,7,2,1,8,11,8,9,15,9,24,9,3,2,10,5,8,16,18,18,4,11,8,6,9,0,9,13,9,7,4,4,8,4,3,15,18,2,4,6,9,6,6,17,5,3,5,16,1,10,20,26,11,6,8,3,12,5,7,3,12,1,8,11,4,1,14,12,15,3,6,9,2,18,10,25,7,9,5,2,11,6,2,10,7,5,4,18,1,0,12,9,8,9,9,6,5,4,20,5,2,13,19,4,10,9,11,14,1,1,14,10,15,5,4,19,11,10,6,8,9,7,7,8,2,8,18,7,18,7,14,13,19,7,2,5,7,5,6,3,2,4,9,7,6,19,2,5,3,3,8,2,10,6,9,4,6,2,1,7,10,2,1,7,2,5,5,3,3,14,4,17,15,8,22,10,5,1,10,6,7,7,5,9,6,11,15,6,24,6,8,0,3,12,8,3,1,5,6,1,4,5,9,6,0,8,13,6,7,6,2,8,8,2,5,7,3,1,4,3,5,1,1,6,5,3,8,3,10,1,8,5,0,2,5,4,2,8,3,3,8,18,0,0,3,5,20,3,3,6,10,16,2,2,7,5,5,9,6,4,9,0,5,4,3,1,1,2,1,8,5,3,3,5,1,4,12,5,12,4,9,9,7,13,6,20,4,3,7,1,3,3,3,4,4,9,6,7,5,8,3,0,4,4,0,8,5,5,6,2,3,3,3,0,2,9,3,3,7,8,1,9,3,10,2,5,0,1,3,4,0,0,1,2,9,1,0
combination,0,5,4,53,1,1,1,20,1,5,3,2,6,15,2,3,2,3,4,0,1,9,4,44,28,9,3,3,3,6,3,110,78,0,23,9,8,12,28,2,2,1,20,2,34,4,14,12,89,3,67,9,8,12,1,0,13,3,0,3,3,0,1,2,11,2,33,3,0,12,2,0,1,1,50,8,4,1,24,44,15,4,1,33,75,13,4,0,5,0,0,0,3,2,56,12,8,0,3,2,6,10,9,3,4,15,5,3,5,0,5,2,9,12,1,2,4,3,49,115,17,1,1,11,3,1,1,0,1,0,1,0,2,20,10,26,2,1,7,1,5,17,15,1,1,16,7,5,21,21,61,0,3,0,2,30,21,9,3,1,23,1,4,0,1,3,3,38,9,8,7,54,43,1,3,4,142,3,3,29,28,4,1,50,2,65,15,13,16,26,2,2,8,0,0,4,7,6,1,12,66,0,2,2,26,1,2,18,7,9,38,0,7,1,5,0,1,0,1,0,0,10,1,5,6,217,67,11,3,2,7,4,12,51,24,2,8,4,19,23,49,16,22,21,7,2,1,8,29,8,2,32,6,2,4,5,0,0,0,7,16,5,8,1,22,9,0,6,3,0,48,0,10,3,0,0,12,3,2,0,25,8,1,16,5,0,3,6,9,1,0,0,5,0,3,7,11,14,1,19,14,9,0,0,5,5,6,2,0,19,0,20,2,0,10,27,11,54,60,3,12,3,11,0,40,8,8,15,2,27,0,12,2,6,1,12,10,2,2,2,6,0,1,6,1,1,55,15,6,3,6,54,2,13,12,5,1,2,13,41,23,0,1,22,4,1,16,7,4,44,4,4,0,6,48,12,3,5,6,6,32,3,32,1,1,15,1,8,14,3,38,4,3,1,6,4,26,4,18,4,34,2,2,0,4,17,45,1,28,6,1,1,1,12,1,1,1,5,21,2,8,1,14,22,0,8,2,14,0,6,1,0,0,1,0,1,0,0,3,1,27,13,7,1,0,0,0,19,30,1,10,0,1,0,18,0,1,11,32,20,9,9,23,22,1,0,9,0,0,0,15,12,6,0,3,40,0,9,49,6,27,4,1,4,6,1,1,0,9,2,7,31,0,4,3,1,0,12,4,38,10,2,0,0,34,6,2,36,3,16,1,3,0,9,19,4,5,12,1,16,3,13,10,27,7,4,106,83,6,16,8,12,4,17,6,7,7,9,31,68,3,3,4,10,12,6,5,21,1,4,8,2,58,16,9,6,49,20,3,1,11,1,11,3,7,14,6,17,51,67,3,2,3,8,13,1,4,0,5,12,10,7,7,5,6,3,1,1,0,3,7,15,6,0,48,0,19,7,0,11,6,4,2,0,1,5,4,9,5,2,52,46,1,0,55,3,17,38,6,0,7,1,2,7,2,1,1,3,11,20,1,5,17,20,17,2,6,3,2,2,5,1,20,11,3,1,1,1,4,56,4,2,3,1,0,7,22,9,3,6,3,0,1,1,5,0,0,9,2,0,10,7,1,58,2,7,0,5,0,9,0,14,11,2,1,0,1,4,2,0,5,3,3,0,7,7,6,0,7,5,0,3,7,16,4,4,4,1,1,1,1,3,0,6,3,2,0,1,1,2,9,23,3,9,0,3,22,0,3,3,7,10,11,4,2,1,0,1,4,1,8,2,0,2,0,10,22,2,7,1,10,0,0,2,1,3,2,5,1,2,2,3,0,0,8,6,1,2,1,8,0,0,0,7,3,5,3,0,3,4,1,0,4,17,13,2,1,0,2,3,0,1,0,2,55,28,63,20,0,0,0,0,5,1,1,0,3,0,6,1,2,0,0,1,0,2,1,0,1,2,3,0,0,3,3,2,0,5,2,1,7,1,2,0,1,11,4,8,2,2,0,2,27,44,1,9,6,30,6,3,29,11,16,2,0,2,22,12,15,1,0,3,3,3,4,5,1,2,1,2,5,4,10,3,5,4,0,0,0,0,0,0,0,1,0,1,3,2,0,3,0,1,0,1,21,0,1,1,2,0,1,1,0,1,2,2,0,1,0,5,6,0,1,2,5,0,0,0,3,2,4,2,0,9,0,2,0,0,0,1,6,1,2,1,5,2,0,1,1,8,0,2,1,0,6,0,1,1,2,1,0,19,7,0,1,0,2,0,1,3,3,0,0,0,0,0,0,0,3,0,2,2,4,0,0,2,0,1,1,0,1,6,2,2,4,3,3,2,4,0,1,0,0,0,0,2,0,2,0,6
alone,4,24,7,116,13,15,2,44,4,2,6,2,14,82,6,10,13,15,12,8,4,39,18,30,15,19,18,20,12,16,6,139,106,15,47,79,57,9,14,8,10,20,2,11,39,19,19,25,214,36,44,17,16,64,9,7,48,7,14,15,11,12,4,13,17,17,97,9,5,9,37,8,2,2,118,7,20,2,53,23,61,7,10,11,148,17,9,8,20,3,13,5,23,28,39,14,7,4,34,5,12,26,25,13,21,21,6,8,17,9,19,5,9,15,18,30,4,7,51,142,39,35,19,86,8,12,3,6,1,4,20,5,13,44,31,64,6,2,9,12,8,37,22,4,8,50,13,16,20,6,70,6,15,7,10,32,40,4,6,16,13,1,9,2,30,15,3,22,16,13,15,75,27,4,17,13,129,9,13,39,22,14,9,20,4,26,22,11,39,37,2,6,7,5,5,5,14,8,7,10,31,6,4,8,33,12,4,30,16,16,50,8,17,12,7,8,9,16,18,4,4,17,6,13,50,80,27,24,6,17,13,21,18,24,42,33,40,10,12,9,59,28,5,14,16,5,6,33,43,11,9,23,16,8,8,21,6,5,5,15,2,36,11,5,8,17,9,14,14,5,93,10,12,9,0,5,26,15,9,1,69,14,10,13,17,5,8,4,13,3,3,6,12,5,5,7,31,4,6,21,25,14,2,4,9,8,19,5,8,7,3,19,31,8,33,14,19,35,12,14,43,7,34,7,64,9,24,35,4,25,13,14,7,9,10,4,17,9,3,7,7,16,16,11,2,7,27,39,11,13,10,14,7,23,19,4,5,6,17,32,16,12,4,14,3,7,31,9,6,23,6,31,2,12,12,17,10,9,23,9,49,4,35,10,5,24,22,19,27,7,21,5,13,7,18,21,45,1,18,9,11,3,4,5,5,23,7,7,17,11,2,13,16,12,6,14,4,7,2,16,8,5,24,17,3,9,1,16,8,11,10,4,2,5,9,7,4,15,18,4,18,12,7,20,3,3,19,2,29,12,38,2,11,6,58,2,11,12,11,22,12,38,44,35,9,3,24,13,15,2,19,9,13,5,7,23,6,7,18,17,15,7,8,6,8,12,8,7,10,5,86,28,9,11,14,6,6,14,12,16,6,6,3,2,7,14,6,22,10,8,3,8,8,8,22,20,7,13,16,1,10,19,13,26,8,9,31,28,21,32,12,11,8,9,9,10,10,13,25,16,10,3,8,13,10,7,6,15,13,2,40,5,5,22,8,13,22,7,6,11,18,4,16,1,11,13,13,5,25,25,12,8,12,5,5,12,5,3,11,19,7,11,13,13,6,4,7,3,6,12,23,31,14,3,18,3,9,7,36,16,15,3,12,3,5,14,6,22,3,9,22,12,9,8,22,7,19,4,6,0,7,6,5,10,2,3,6,5,9,24,15,7,24,13,4,4,5,8,3,9,8,6,7,22,2,15,7,5,11,105,10,11,6,3,4,13,20,21,10,11,6,9,5,17,3,1,1,9,10,11,17,6,12,21,7,5,1,5,1,4,9,29,9,5,11,7,13,8,2,13,8,16,5,13,4,9,15,2,11,6,28,3,3,5,12,3,17,5,5,0,3,5,6,23,15,23,13,7,2,5,9,0,8,17,4,6,5,8,9,16,6,14,1,7,6,2,29,8,14,15,9,6,5,8,7,11,17,12,11,4,6,9,4,5,7,10,4,4,1,15,18,12,2,5,12,14,13,9,5,6,7,1,3,16,5,16,9,4,9,9,5,4,15,6,14,1,0,4,5,13,8,12,5,3,13,15,4,6,2,2,2,1,12,1,8,4,10,4,9,8,6,1,18,6,3,2,3,9,9,8,2,8,3,1,0,4,11,5,10,9,7,9,16,15,8,8,7,34,10,3,6,10,7,7,15,14,10,12,0,16,13,17,11,6,2,5,5,8,8,3,2,6,10,6,4,6,3,1,9,5,3,3,7,13,9,7,5,7,12,6,0,4,3,2,1,0,4,1,4,5,6,19,1,5,3,3,6,3,11,19,4,3,5,5,11,5,3,3,8,19,4,2,3,8,7,2,7,3,5,4,6,6,3,6,2,7,6,12,1,2,3,3,4,4,6,2,6,4,6,7,7,11,5,3,12,12,19,4,19,4,6,9,2,2,1,1,2,7,4,5,2,4,13,3,9,14,2,1,3,9,14,9,13,13,4,4,4,8,7,6,1,9,2,23,6,6,9,11,6,2,4,5,5,7,5,9,4,4,3,7
civilization,2,5,8,38,4,5,5,19,1,6,8,2,5,46,9,5,0,7,3,1,2,13,2,10,6,10,21,8,4,10,3,85,46,1,25,30,37,2,0,1,3,8,0,0,17,4,10,5,129,15,17,7,11,40,19,21,24,20,1,41,13,3,1,7,11,3,63,6,7,10,4,0,1,2,51,14,20,5,31,12,18,0,5,3,78,3,5,0,12,0,4,7,0,12,24,3,8,1,14,9,3,13,16,7,7,7,0,0,4,4,5,1,1,4,2,21,0,1,19,43,26,7,0,23,9,4,4,0,0,1,3,8,11,22,16,29,1,0,2,10,0,19,12,4,5,23,7,7,9,2,23,2,8,7,4,11,14,4,8,8,3,2,12,0,0,4,4,16,21,5,4,46,12,7,1,1,61,4,2,10,10,14,2,4,1,6,20,0,15,13,1,5,4,0,0,2,3,1,2,2,3,0,0,2,21,4,0,12,3,19,26,6,5,7,2,1,0,0,1,4,1,5,2,8,10,29,22,16,4,1,4,1,6,18,16,1,16,4,3,4,19,22,4,2,14,3,2,8,17,3,5,9,16,2,3,8,4,2,1,11,3,19,4,0,3,6,8,4,6,2,61,1,4,5,1,1,12,2,5,0,34,3,1,8,9,0,2,4,9,2,0,1,1,1,0,7,12,3,4,16,15,9,1,0,4,3,23,2,11,3,1,9,4,3,6,4,9,23,6,2,15,4,18,10,46,0,14,15,0,4,0,6,4,1,1,5,8,5,1,4,3,5,4,8,3,7,27,25,10,9,1,1,3,28,5,0,0,4,9,19,3,9,7,7,3,2,16,6,4,2,0,9,3,5,3,7,7,1,12,1,31,3,16,6,5,46,1,12,8,6,18,9,0,2,10,7,15,2,9,8,15,0,3,0,2,6,7,5,12,8,1,1,0,6,20,6,4,0,5,0,2,2,10,9,2,1,6,9,3,9,2,0,0,3,1,4,1,1,4,2,5,8,6,12,1,2,6,2,26,1,5,3,1,0,42,0,1,2,6,9,9,9,29,13,2,4,11,6,4,1,29,4,5,5,2,10,5,4,8,3,7,17,7,1,3,0,6,5,7,0,31,12,0,1,3,11,5,6,1,4,6,0,1,1,6,0,6,4,2,3,1,4,0,5,11,7,5,7,3,10,1,7,4,7,4,3,11,5,7,7,7,6,3,3,2,6,3,5,22,3,3,3,2,1,6,3,2,6,5,2,9,3,3,32,2,5,10,0,1,9,10,1,6,0,7,9,5,7,11,15,7,2,12,2,7,2,0,1,2,7,0,7,5,7,7,13,6,5,1,2,10,8,3,2,12,9,1,0,19,14,8,0,9,1,0,7,0,2,5,2,11,9,5,9,14,5,5,4,2,2,5,0,3,6,0,2,6,4,2,13,0,11,6,11,5,1,8,4,5,5,3,14,1,3,7,16,4,0,4,78,16,6,2,2,6,5,15,8,2,3,0,1,3,8,2,1,4,8,5,7,9,6,3,2,6,1,3,3,4,3,1,10,2,9,8,1,6,3,3,6,3,4,4,9,2,2,5,0,2,2,4,3,1,3,3,4,4,3,0,1,1,2,4,10,17,3,4,4,4,9,4,1,7,5,1,10,2,5,4,8,2,5,1,4,2,1,9,7,28,13,3,3,2,3,3,5,6,10,4,0,1,0,0,3,1,6,3,8,5,0,0,7,0,0,11,4,3,1,6,3,3,3,2,3,8,5,2,2,59,11,35,4,7,1,5,5,3,0,3,8,3,4,4,4,8,11,0,5,6,1,2,1,3,1,2,4,2,6,5,2,0,2,1,2,1,0,6,2,1,5,2,0,3,4,0,0,6,1,0,3,0,4,9,2,4,11,3,6,7,1,0,0,3,1,2,5,1,2,1,2,4,4,4,1,2,0,6,0,2,1,0,3,8,4,1,2,4,2,1,1,1,0,0,0,3,3,2,5,2,27,2,2,1,3,7,2,0,2,2,1,1,8,4,2,3,3,6,0,1,4,4,1,4,10,6,0,1,4,4,15,5,0,4,3,4,1,0,3,1,2,5,2,3,1,5,3,4,0,2,0,1,0,5,3,1,1,3,1,2,13,8,2,0,0,1,3,1,3,2,1,0,2,7,0,3,0,0,7,3,4,4,16,5,1,1,3,9,2,1,2,3,4,4,1,2,3,0,1,8,0,0,7,0,0,1,1,1,0,4,0,4,4,2,0,0,0,3,1,7,1
property,6,36,14,175,10,10,13,46,8,4,57,11,9,95,9,48,12,35,6,6,10,55,10,51,35,16,16,9,12,25,18,292,212,13,106,48,80,19,14,7,16,20,12,4,53,27,27,20,612,18,41,15,18,37,13,13,69,31,0,19,26,5,6,10,23,5,182,11,13,18,23,15,21,4,110,21,18,14,131,38,51,0,22,11,389,26,22,0,64,2,14,10,0,45,71,17,23,14,57,27,17,45,33,14,17,39,8,2,16,6,19,8,3,13,1,48,10,6,111,350,66,63,59,80,13,2,2,5,4,6,18,3,19,78,37,41,40,11,10,16,9,65,42,1,11,113,33,24,19,21,131,2,51,9,2,54,34,4,19,9,20,3,38,6,22,6,9,47,36,18,48,131,40,0,4,29,308,5,20,48,43,33,6,21,4,30,49,32,64,73,7,11,7,0,0,5,15,6,9,28,64,10,1,22,45,11,8,40,14,39,130,6,47,9,4,0,1,0,21,7,2,41,4,23,66,162,32,48,4,42,24,19,9,32,61,21,45,24,16,8,170,52,21,17,31,11,10,42,69,19,14,34,36,11,17,16,25,6,7,54,7,47,25,9,8,34,14,2,30,12,221,12,61,19,8,0,107,8,14,10,90,22,4,41,19,1,0,7,28,0,12,4,27,6,6,18,61,9,3,35,52,41,8,5,22,3,35,6,11,1,5,30,28,8,62,29,21,76,34,4,254,24,53,25,228,23,11,31,8,79,6,19,19,8,10,23,18,11,10,25,18,23,18,18,6,19,56,75,15,5,23,24,26,54,70,14,12,11,19,41,29,10,10,36,22,1,74,15,7,21,1,24,12,37,28,26,14,9,37,8,176,18,84,19,7,59,26,53,49,7,52,1,19,8,48,13,73,3,95,9,41,5,4,2,20,40,13,9,27,36,9,27,5,30,34,11,6,20,5,3,14,21,41,23,4,10,5,35,15,26,11,12,4,18,10,9,0,15,10,10,27,104,8,9,2,9,15,12,55,9,51,9,3,16,75,20,1,33,17,35,22,39,66,66,11,2,25,17,16,4,135,13,4,2,1,55,3,20,32,13,33,7,1,8,11,32,17,7,7,6,124,51,4,10,9,21,7,33,11,24,24,11,6,1,25,43,11,29,10,17,4,9,23,12,17,21,14,22,13,19,7,1,20,63,20,23,52,41,41,57,26,27,29,23,14,14,13,19,91,27,9,4,17,9,10,14,27,42,32,13,79,7,13,62,10,9,66,14,11,17,31,8,55,8,18,27,33,28,59,74,8,13,10,9,18,2,8,19,9,31,3,24,17,25,9,15,14,9,10,18,57,41,18,6,67,24,8,3,114,29,46,2,5,7,15,41,9,12,6,13,41,31,15,12,75,17,28,2,18,11,16,10,5,33,5,10,8,13,26,55,8,29,71,46,29,10,20,13,5,32,40,12,19,45,16,41,8,10,10,366,46,5,7,3,20,19,54,28,16,31,9,21,23,18,17,3,3,17,14,26,39,16,158,70,100,10,4,9,50,30,21,51,24,12,25,10,25,8,5,11,15,20,23,23,18,9,15,12,14,20,30,11,12,12,6,5,22,6,2,9,9,15,11,32,32,17,31,11,14,5,11,11,24,30,5,11,22,5,8,26,21,20,17,14,30,1,34,23,106,20,13,23,14,25,34,10,13,10,3,8,29,10,6,14,5,14,18,18,7,6,8,20,8,5,32,52,24,14,7,14,16,9,3,131,7,42,13,8,46,19,16,11,22,8,26,15,11,29,7,32,12,10,6,9,34,35,17,14,5,8,5,22,18,5,14,1,2,15,27,18,7,10,22,12,15,8,11,8,10,22,12,4,7,16,4,7,4,7,17,11,13,18,16,7,17,27,28,48,30,10,16,16,18,16,17,28,21,9,6,53,34,75,20,9,4,10,14,33,29,4,8,21,5,6,17,25,34,4,13,16,1,5,3,17,5,7,9,27,8,5,7,10,10,6,12,7,11,11,29,3,30,23,0,9,47,35,13,12,13,7,13,11,2,23,18,9,16,15,2,24,7,14,22,18,16,8,10,21,1,9,7,8,12,13,2,11,7,37,9,7,7,5,9,7,3,7,4,15,15,6,8,32,0,3,35,11,23,26,24,17,1,12,5,3,5,9,13,12,21,12,12,11,10,14,2,57,9,0,14,15,9,13,10,11,11,10,1,13,13,19,5,11,10,7,15,27,22,4,29,0,9,11,4,0,3,7,2,11,3,6
regulate,1,12,3,137,1,1,6,34,1,1,5,2,4,38,4,15,7,14,3,1,6,35,4,8,16,3,12,4,4,6,3,124,82,6,41,31,14,4,12,2,3,5,2,2,19,11,23,12,232,6,25,10,7,12,2,2,39,12,0,9,16,6,2,10,10,10,66,6,7,5,2,4,3,2,63,12,16,0,57,13,24,1,5,3,171,28,17,0,13,1,1,7,0,15,38,20,5,1,17,10,14,27,15,5,3,19,3,2,9,3,10,9,4,15,0,15,4,2,55,128,27,4,6,33,6,1,2,1,3,1,2,4,4,33,12,34,3,7,8,4,0,22,11,2,6,35,4,3,6,7,131,0,4,3,5,31,15,2,8,0,10,0,6,1,0,2,2,14,9,4,9,58,15,0,0,8,142,1,9,33,8,9,1,8,5,27,18,15,26,27,2,2,3,0,1,5,15,3,3,14,37,4,2,6,21,7,4,30,8,15,67,1,19,6,0,0,3,0,14,1,4,13,3,8,38,146,15,24,1,9,17,4,7,51,31,17,23,4,11,1,52,24,3,2,13,8,5,22,40,4,4,18,8,6,15,19,6,2,6,9,3,11,21,2,9,27,0,1,19,1,105,6,27,4,4,0,23,12,9,0,29,6,2,11,8,0,4,3,11,0,2,6,11,4,2,9,15,10,1,11,14,28,1,1,11,1,6,1,4,0,4,26,9,4,18,19,11,26,16,3,29,2,18,1,43,6,4,13,3,13,5,6,7,6,11,19,13,3,5,6,8,6,13,13,3,4,42,26,12,4,9,18,4,18,26,11,3,4,24,14,38,8,7,12,2,2,25,4,5,8,3,9,4,7,9,19,4,9,10,8,51,2,34,13,0,35,4,18,30,8,17,4,4,5,25,13,67,6,21,4,18,2,4,1,6,11,3,0,21,17,0,6,5,9,1,9,2,6,4,1,5,4,29,14,1,7,3,21,6,8,22,3,1,6,0,3,0,8,3,4,19,20,4,5,0,2,4,1,20,6,12,4,1,9,39,10,3,12,7,29,6,29,25,9,1,0,9,8,20,0,8,6,3,1,1,6,3,5,13,5,5,6,7,2,1,7,8,2,2,3,14,28,0,3,9,4,1,8,2,22,7,0,5,13,11,64,3,10,16,3,2,8,7,26,21,13,7,13,10,13,4,20,1,46,25,8,35,32,17,29,10,8,2,9,10,3,13,8,29,28,7,3,5,6,13,9,5,14,13,9,65,5,8,31,8,12,66,11,4,3,26,2,17,3,21,11,10,7,33,31,13,3,6,1,7,5,11,6,2,9,4,18,14,16,7,2,8,4,8,8,30,27,8,4,15,3,8,4,36,12,22,3,6,4,3,18,8,20,8,10,22,43,6,7,22,11,20,0,10,3,15,18,1,29,1,9,4,12,11,26,31,22,27,23,7,0,9,3,1,7,8,0,8,15,9,8,6,1,3,84,9,2,6,6,1,6,29,8,1,3,4,5,23,13,10,2,3,3,10,8,14,5,14,30,13,5,2,11,0,4,5,23,10,3,13,3,10,0,3,3,17,1,17,5,0,5,8,4,10,15,4,4,3,4,10,3,12,3,1,1,7,4,4,14,19,10,0,3,9,5,2,4,6,9,0,6,4,3,4,17,12,16,7,6,6,2,8,3,31,5,7,2,2,5,1,7,10,3,8,4,4,9,6,7,6,4,6,12,5,8,6,10,1,1,21,36,2,9,4,2,4,0,1,14,2,5,12,1,3,4,0,5,8,1,8,5,4,0,17,9,3,12,3,8,26,17,12,3,1,4,2,4,15,4,1,0,1,6,7,3,7,0,7,7,3,4,3,11,1,12,4,6,1,2,4,5,6,6,21,2,2,8,29,1,2,14,5,14,14,2,4,11,7,4,2,12,6,9,5,4,21,37,13,7,1,7,7,6,8,1,9,5,8,3,5,8,2,2,6,6,7,3,10,33,2,6,2,4,12,0,1,8,0,1,7,4,5,0,4,13,1,12,0,2,1,8,2,0,3,0,7,2,0,8,14,3,0,17,2,15,4,1,10,3,12,0,1,6,3,6,12,5,1,6,0,6,2,8,2,14,6,8,6,6,3,4,3,6,3,6,2,12,1,3,2,15,11,6,24,5,0,0,2,1,4,2,7,2,23,9,3,3,4,6,1,13,2,3,2,12,5,6,1,2,3,15,2,4,14,4,4,10,3,27,8,3,10,7,4,0,4,2,7,0,0,1,0,7,2,1
exercise,26,91,25,284,9,7,9,90,6,7,44,16,17,127,13,51,10,30,8,3,6,93,25,53,59,14,27,20,20,38,15,281,187,26,108,82,106,9,15,16,12,37,10,3,89,50,41,58,710,41,106,27,16,72,3,11,144,39,5,24,44,19,6,22,37,19,244,12,6,16,9,10,14,12,195,22,25,9,132,60,75,6,19,15,515,44,21,0,71,3,4,7,0,55,93,23,38,8,46,27,27,69,62,18,18,56,9,7,23,12,37,8,18,26,2,51,11,7,127,408,91,41,39,100,22,10,10,4,11,3,24,4,8,76,48,83,20,7,12,6,10,60,33,8,11,127,22,33,24,24,428,1,22,8,12,102,81,10,21,8,13,2,28,4,0,25,2,59,45,12,35,209,50,1,13,16,353,8,24,83,45,41,4,42,18,39,60,59,104,68,12,8,1,4,0,7,22,9,21,53,94,2,0,29,50,37,18,83,20,44,208,9,67,15,9,1,2,4,43,4,4,44,12,36,77,254,66,52,6,17,31,25,23,150,78,38,58,11,12,23,130,58,9,12,25,4,5,66,120,34,17,16,19,14,18,30,20,3,5,33,20,66,31,12,15,94,6,16,41,5,284,4,24,12,7,7,53,22,24,3,129,26,0,46,15,1,13,22,25,6,12,8,49,12,5,20,54,18,13,55,46,42,1,6,30,9,44,13,12,3,1,91,29,13,38,25,35,89,28,16,76,25,62,9,259,45,6,51,2,68,36,38,26,30,29,45,36,12,6,23,32,18,16,44,4,14,98,91,33,13,37,35,24,57,83,11,11,17,25,39,49,6,12,31,15,5,77,20,11,28,5,36,5,26,29,42,31,13,45,15,184,12,96,25,3,42,21,46,63,10,61,9,35,24,63,29,133,19,84,7,77,7,8,2,7,39,14,6,25,23,4,18,5,49,38,26,6,17,5,8,10,23,69,34,9,15,8,48,24,46,32,10,5,34,3,12,1,18,20,13,46,44,12,28,3,3,22,10,75,17,38,20,10,5,98,48,4,25,30,54,26,66,70,88,19,7,21,21,31,3,32,14,7,6,13,52,9,35,50,11,22,27,9,19,8,22,15,12,15,14,156,68,2,10,13,12,9,35,14,35,27,16,12,4,23,75,3,35,12,16,7,24,15,38,35,49,15,30,27,26,7,63,46,1,64,14,77,56,32,63,27,10,8,40,28,15,33,25,66,66,18,6,5,8,9,12,30,39,36,27,233,20,15,129,13,23,75,11,19,16,44,3,42,11,35,34,22,23,77,100,26,8,21,13,19,4,13,13,16,29,8,35,20,43,24,3,9,8,7,25,52,93,20,13,40,12,14,6,92,26,45,11,9,6,14,36,11,85,27,13,73,75,41,17,95,16,49,8,35,9,30,19,5,47,7,18,16,14,39,59,28,32,59,53,32,10,39,13,12,18,27,5,41,62,20,42,6,8,18,307,80,17,12,17,15,14,75,46,21,28,16,14,32,30,13,7,4,8,18,25,44,13,33,107,39,18,4,12,23,12,18,41,27,14,18,22,34,12,6,26,21,25,27,15,19,14,21,14,31,35,17,16,9,25,20,7,28,8,8,12,20,18,15,54,47,69,36,14,22,17,26,18,12,78,16,22,8,14,12,31,37,33,5,24,15,17,53,8,88,25,34,10,8,39,26,17,22,16,14,15,27,7,3,15,0,19,22,40,17,21,21,17,10,1,33,20,14,15,13,9,16,10,4,36,17,24,12,12,20,18,6,11,31,18,30,9,19,24,22,27,15,36,11,15,65,46,21,8,5,12,9,9,44,5,9,4,6,3,37,20,7,15,19,13,14,16,9,11,14,45,3,9,6,27,0,20,10,20,18,9,27,14,39,12,16,37,35,33,47,6,12,26,25,21,8,12,22,27,6,29,71,141,22,26,4,15,18,2,16,1,5,23,29,6,22,14,10,15,34,14,25,7,11,18,7,21,5,12,31,3,13,6,6,9,9,9,9,7,10,10,15,17,1,2,10,23,5,36,12,9,5,12,26,22,45,14,12,24,18,42,16,1,21,7,30,7,5,12,8,1,10,8,12,10,4,14,4,15,12,27,10,10,19,10,11,5,11,4,15,17,11,21,3,3,11,15,10,5,41,2,3,13,9,9,11,9,8,15,28,9,3,4,22,4,3,37,5,0,17,15,11,32,28,10,6,13,3,11,13,22,8,14,7,19,14,14,24,7,42,5,6,6,8,1,1,7,0,6,5,11
confer,4,56,6,133,4,2,2,29,2,1,21,4,6,39,7,11,5,16,2,2,2,27,5,10,22,4,9,9,5,5,4,94,77,9,41,32,16,6,1,6,6,4,6,3,25,20,8,12,251,2,34,6,10,14,5,1,30,16,0,13,23,4,3,11,18,3,75,5,6,3,2,4,9,3,84,5,10,3,36,18,18,0,4,10,194,25,8,0,22,1,3,1,2,20,34,24,13,3,14,4,9,19,26,12,4,16,4,2,4,1,11,6,2,11,0,21,2,1,86,147,26,8,9,29,2,2,2,4,2,2,4,1,2,27,13,17,5,3,7,7,1,23,8,1,2,32,6,7,10,10,171,0,11,1,2,33,12,3,7,5,5,1,3,5,4,4,1,13,7,9,9,56,17,0,3,11,247,3,3,16,30,18,0,18,5,27,13,16,40,24,2,5,0,0,1,1,3,2,2,16,18,3,1,11,16,14,4,28,4,10,48,4,26,11,1,0,1,1,5,0,2,17,1,14,42,90,16,9,3,3,10,11,9,37,33,10,21,7,3,8,46,21,3,1,16,1,1,10,33,12,6,15,15,2,8,10,10,3,8,13,8,18,11,6,3,21,13,1,14,2,99,5,7,1,4,0,21,10,18,1,38,15,1,8,6,0,2,6,17,1,6,2,16,4,7,10,20,2,5,17,15,18,0,1,13,2,11,1,5,0,0,36,20,1,15,11,22,39,8,4,43,8,24,11,92,15,6,12,1,14,5,5,14,6,5,24,18,4,3,6,9,7,6,19,6,2,45,18,11,2,16,10,11,16,25,6,1,5,14,16,26,3,4,11,3,2,34,7,5,11,4,9,2,13,10,9,4,4,7,7,59,2,48,6,2,20,5,13,19,5,16,2,8,7,28,8,49,2,14,3,16,3,2,0,4,9,9,3,11,9,3,7,3,12,19,3,1,6,2,0,2,2,13,13,0,7,1,8,11,14,9,2,4,9,0,5,1,7,5,3,14,18,8,7,1,3,2,3,31,3,5,4,1,0,28,10,0,25,6,33,6,18,18,15,4,2,7,2,10,0,17,7,4,2,6,12,2,12,18,1,4,15,3,10,5,8,6,0,8,4,57,35,0,4,4,2,3,7,6,14,10,2,1,0,2,18,2,10,10,5,1,14,3,13,16,14,8,14,7,8,4,20,25,64,1,7,16,25,19,27,13,8,13,12,1,9,13,10,27,16,5,1,1,9,9,2,4,8,21,8,81,4,11,44,6,5,30,2,1,5,6,4,14,3,16,11,10,7,25,21,5,4,12,0,5,2,11,9,13,4,2,13,8,12,11,4,7,5,3,5,16,32,8,5,12,7,3,2,26,9,20,2,3,3,6,17,5,27,4,8,21,40,9,2,40,12,20,0,24,1,7,4,2,19,1,8,8,8,6,16,18,17,20,29,7,0,17,8,0,16,15,4,8,18,3,20,0,0,8,114,16,3,4,4,3,3,20,13,8,11,5,0,9,12,8,2,0,5,11,7,19,10,11,60,20,9,2,6,3,6,8,19,9,3,6,5,14,7,8,4,13,4,11,5,5,3,6,3,18,19,1,7,3,3,5,3,7,2,5,2,3,9,2,20,6,11,4,9,11,2,9,4,12,11,2,3,4,4,2,7,9,8,6,7,5,0,12,2,16,7,6,2,1,2,4,2,5,2,4,6,9,4,1,11,2,5,14,2,1,9,8,3,0,1,13,18,1,5,4,4,7,0,0,17,2,6,2,3,6,4,8,4,6,6,10,3,7,1,6,7,3,23,5,2,22,9,7,2,2,2,4,3,13,5,1,1,3,3,7,3,4,1,10,6,1,8,11,2,4,20,0,3,7,2,3,2,5,7,1,1,3,4,25,3,5,9,5,10,20,3,2,4,12,7,0,6,4,8,7,11,29,57,9,7,4,1,4,6,4,1,3,11,7,4,5,0,0,2,9,1,2,2,12,8,5,2,3,2,14,0,3,2,3,4,9,2,1,3,1,4,4,2,1,0,4,5,2,3,3,2,5,1,3,13,12,4,0,7,2,18,3,2,13,1,12,1,2,1,5,2,5,4,4,3,4,7,1,9,8,2,0,3,4,14,10,0,3,4,4,6,1,4,4,3,4,14,11,4,28,9,0,0,0,4,5,2,1,6,25,4,6,0,2,1,1,21,2,2,8,3,9,4,7,3,2,4,1,9,4,5,3,10,3,12,6,9,11,1,20,3,4,1,2,1,0,0,1,0,1,0
name,4,19,8,71,13,3,10,19,7,6,13,10,4,34,4,5,7,9,2,4,2,23,2,14,5,10,6,5,7,9,5,80,60,7,35,29,29,7,3,5,5,4,6,3,27,14,12,6,157,11,16,5,4,11,3,5,30,14,1,2,9,2,1,7,6,8,55,4,7,10,8,7,3,4,44,9,11,4,41,11,29,1,7,7,122,6,6,0,31,0,3,7,0,17,14,5,14,5,13,4,3,8,12,11,5,21,5,1,9,1,15,6,2,5,2,12,5,5,50,52,15,13,5,55,6,1,2,1,5,1,5,13,7,34,8,25,6,5,2,5,2,20,17,2,0,42,8,6,3,8,46,0,9,3,0,14,12,2,2,4,7,1,9,4,1,5,7,10,7,10,11,54,16,0,0,8,108,3,5,15,10,0,1,11,0,7,17,10,19,20,3,4,4,0,0,1,13,10,8,9,10,1,1,5,15,4,0,11,6,5,46,6,11,4,7,3,2,0,5,0,3,11,0,7,30,48,22,14,11,1,11,19,3,15,8,4,18,5,1,3,31,12,3,7,12,4,3,13,28,1,6,4,7,5,3,7,5,0,1,22,0,16,13,9,5,10,0,2,5,2,83,2,29,5,7,1,21,10,7,2,16,7,2,19,2,0,1,6,13,1,4,4,6,7,10,3,13,3,5,9,13,14,12,3,6,6,14,4,3,0,0,5,19,2,25,6,6,16,7,6,31,5,20,6,39,5,4,19,3,15,9,5,2,5,12,10,5,1,3,10,5,8,14,8,0,5,15,34,5,6,5,6,2,21,8,4,6,1,7,27,9,4,3,9,2,2,21,1,5,6,0,9,0,7,7,12,4,1,6,4,28,5,30,2,6,5,1,10,20,6,19,0,6,5,17,7,24,1,23,2,15,4,4,0,3,8,1,5,8,0,0,8,1,7,17,8,2,8,6,0,4,8,11,9,1,7,1,5,4,10,6,2,9,12,6,4,0,3,7,1,10,15,3,0,3,1,7,2,15,9,14,3,0,3,25,3,3,12,3,10,10,12,21,16,1,7,4,9,10,3,12,10,1,2,2,11,5,9,10,2,6,4,1,1,2,8,5,10,3,2,50,17,3,2,2,5,2,11,2,5,10,0,3,0,7,2,2,5,6,4,4,2,6,4,7,11,6,12,4,9,3,23,8,14,7,1,10,10,14,15,9,5,6,3,10,4,8,6,29,8,3,5,4,1,4,8,3,7,14,1,19,3,5,33,10,6,20,1,1,5,10,0,11,0,6,3,7,6,22,15,6,3,5,1,4,0,1,2,4,18,2,10,7,7,3,2,3,3,1,6,10,14,9,10,14,3,4,0,35,5,9,0,4,1,0,8,4,8,2,8,15,19,8,5,23,7,10,0,2,2,7,4,2,13,4,5,3,4,8,13,5,4,18,13,5,0,2,3,4,3,20,1,10,8,2,25,3,4,1,95,16,6,4,3,7,11,16,8,3,4,5,6,17,10,6,6,2,4,3,5,10,2,18,39,21,6,3,4,5,2,5,12,6,3,3,4,5,3,2,9,7,2,8,2,0,6,2,5,6,8,4,3,3,2,4,4,8,6,2,3,5,3,3,12,8,20,1,3,8,3,2,4,6,20,2,4,3,1,3,4,3,3,1,4,3,1,12,0,23,3,4,6,8,12,4,2,19,2,2,8,3,4,11,23,13,8,2,12,0,6,4,11,3,2,6,3,12,2,3,4,4,0,2,24,1,6,1,2,6,5,0,2,10,2,5,0,8,5,3,1,5,11,4,0,5,8,4,6,5,8,2,2,4,2,2,0,5,4,11,3,0,6,6,2,1,2,4,5,1,6,2,9,6,5,4,3,3,7,2,0,8,3,5,5,3,2,7,26,5,5,7,4,5,7,2,4,1,2,3,5,15,26,7,3,2,2,6,3,6,1,5,3,5,1,2,6,1,6,5,4,2,2,2,0,2,5,10,2,10,4,7,5,8,1,9,0,2,3,2,4,5,19,2,3,5,6,2,2,6,8,3,5,5,4,9,7,3,6,5,6,6,0,3,13,4,6,1,5,2,6,5,1,2,0,4,4,0,11,0,3,1,2,3,1,3,3,2,0,11,2,3,14,16,2,2,12,2,8,15,3,1,4,4,3,6,6,7,2,14,0,1,2,3,4,4,18,7,53,1,6,5,3,1,3,3,2,2,5,7,3,1,8,6,4,2,1,4,0,17,1,5,0,0,3,1,0,1,3,0,5
prevent,22,42,20,233,13,17,5,44,14,8,35,19,16,131,8,19,18,24,11,10,14,84,28,68,59,37,25,29,14,37,34,370,296,20,98,122,90,20,42,5,15,14,21,14,76,39,52,30,616,76,154,22,24,80,22,14,104,34,14,30,23,20,5,23,44,19,168,8,14,46,24,5,11,9,220,27,45,14,123,62,75,12,26,31,418,45,38,4,54,4,11,8,11,67,118,24,22,9,72,31,28,50,72,15,36,61,7,17,34,13,23,19,10,27,5,69,12,4,131,347,95,64,13,103,18,1,4,9,4,4,45,5,15,83,42,93,21,9,11,15,5,58,57,11,13,201,31,30,41,32,164,4,28,9,16,48,70,14,16,46,32,24,17,11,6,29,9,84,40,28,43,213,78,11,11,23,292,6,27,106,75,29,16,65,11,78,81,46,87,119,6,18,8,8,6,10,41,10,14,25,104,7,11,21,53,20,37,92,20,52,162,15,46,20,9,10,3,8,22,4,11,50,8,26,70,312,82,54,6,17,27,29,42,91,93,31,68,27,23,26,130,75,18,25,36,8,8,53,109,13,24,58,30,2,22,40,29,4,14,22,25,69,22,11,15,79,14,19,30,7,260,11,40,14,7,3,77,14,24,2,134,39,16,38,18,10,28,31,34,5,7,5,20,7,6,25,63,11,23,45,53,58,1,8,31,6,43,9,8,13,3,61,49,20,61,36,47,84,46,16,108,17,61,14,133,25,16,67,8,59,11,27,10,11,15,35,46,24,3,32,26,32,30,17,10,14,124,115,51,19,17,30,15,129,49,8,14,11,45,52,61,13,29,53,14,6,97,24,17,69,10,50,4,34,35,56,25,19,35,15,116,14,83,38,15,107,43,48,55,7,68,11,25,19,54,16,129,12,91,11,53,9,7,9,16,25,28,9,60,29,8,26,32,32,26,28,16,23,15,13,9,32,62,40,15,17,5,32,25,38,35,9,2,18,13,12,4,27,18,17,40,52,12,39,10,13,31,38,77,13,41,23,18,6,97,29,4,17,24,61,26,46,68,65,14,9,25,42,16,4,50,28,10,10,3,39,7,34,65,18,37,17,15,12,13,19,33,12,16,10,176,74,6,9,27,14,9,30,13,42,32,12,5,10,27,100,16,51,11,26,10,15,20,35,38,22,17,30,106,31,11,52,35,77,16,10,1,42,49,76,35,7,25,25,20,19,31,34,75,78,14,11,14,20,24,26,32,42,28,24,82,15,36,99,21,33,76,25,21,23,29,15,49,19,27,23,26,23,83,112,23,22,17,26,13,12,17,18,21,26,7,32,26,40,15,13,15,24,8,26,37,63,34,15,49,14,12,11,86,42,41,5,10,5,21,58,16,52,18,3,72,44,21,15,99,19,44,37,10,22,38,22,6,56,10,10,12,18,30,45,48,35,54,41,22,11,30,7,6,25,19,10,22,33,24,53,11,10,15,350,56,9,17,30,18,16,71,42,15,30,14,21,14,32,12,8,7,29,19,22,27,10,77,60,65,22,2,14,12,14,17,44,33,12,13,14,30,9,5,34,17,19,29,15,10,21,30,10,24,35,24,9,14,32,34,17,30,12,5,13,3,22,13,60,40,32,42,16,7,12,19,19,21,52,10,21,23,3,7,25,37,33,21,19,14,6,28,13,92,19,38,17,6,24,21,16,24,18,13,16,35,10,3,21,2,20,20,19,7,17,16,28,6,4,26,27,21,37,21,31,17,19,6,51,13,28,34,7,35,24,18,10,27,24,32,14,21,23,14,49,20,13,5,15,46,59,36,17,9,6,7,15,20,10,18,4,12,20,38,10,19,6,16,23,14,2,14,20,14,27,18,4,10,33,4,15,7,8,27,4,17,21,16,14,11,23,32,46,23,12,12,10,15,35,19,18,26,22,9,42,55,79,33,12,2,16,42,15,29,3,18,14,12,10,22,13,32,7,23,20,10,6,11,43,11,13,9,17,19,6,2,9,14,8,12,5,9,10,34,12,25,17,1,16,20,21,14,20,8,17,23,16,10,18,18,10,7,7,20,35,8,12,17,2,22,14,17,11,9,4,15,16,9,20,6,17,10,33,6,16,9,9,17,18,10,11,12,11,11,14,5,10,6,3,14,40,23,8,47,9,4,20,8,7,3,5,3,10,36,12,13,5,12,3,1,47,17,3,8,15,36,12,19,7,13,6,4,19,22,15,1,15,11,15,16,6,19,18,34,3,10,9,5,4,3,4,5,12,3,6
corporation,0,4,7,94,4,8,9,40,1,4,4,2,2,51,2,11,8,20,2,0,4,31,11,26,48,25,12,5,2,12,0,142,77,8,66,24,3,4,30,0,12,4,0,4,37,11,20,26,165,4,34,23,11,17,3,1,21,2,0,3,3,0,2,2,15,3,80,3,3,26,39,0,3,5,128,10,32,2,50,34,38,4,5,16,196,40,14,1,21,0,10,5,10,12,64,29,15,1,24,9,8,30,12,10,16,12,11,3,13,3,10,16,3,37,9,17,1,9,90,147,48,15,36,50,7,4,4,1,5,1,8,1,2,52,16,75,15,2,10,2,18,49,13,3,2,56,25,28,21,15,117,0,6,4,2,90,50,24,1,6,14,4,10,2,22,20,4,46,22,11,13,81,42,3,6,7,141,2,15,52,35,4,14,33,7,65,32,21,32,29,2,6,7,0,2,5,9,14,13,61,120,8,2,0,8,1,8,42,10,21,79,6,16,5,7,6,0,11,8,4,4,18,3,12,24,194,46,16,3,39,11,13,16,58,37,5,30,16,27,14,61,30,8,13,24,17,4,30,69,13,5,35,11,5,12,10,4,4,4,12,17,3,10,4,1,28,6,6,7,8,65,14,23,5,0,0,16,11,8,3,35,31,5,26,4,0,1,4,25,1,3,3,16,2,7,4,23,13,4,33,32,23,4,3,19,9,25,5,13,1,3,54,8,10,30,25,10,44,70,13,13,9,23,3,96,12,16,14,4,46,2,15,10,7,10,31,12,9,33,4,6,2,8,6,6,14,42,24,36,2,12,31,6,42,30,13,5,4,29,36,44,5,10,30,5,3,43,13,8,20,8,15,3,14,37,13,11,10,30,8,53,12,39,8,5,33,10,15,22,11,33,2,10,1,17,7,28,10,32,6,9,0,3,2,8,54,6,0,21,4,8,1,8,36,0,3,3,4,6,1,27,13,33,12,1,10,3,43,2,9,13,1,0,4,2,0,0,0,3,3,45,13,13,0,0,2,14,4,31,7,21,1,0,5,43,2,0,8,35,41,18,12,30,67,7,1,8,10,11,3,12,24,10,0,0,81,1,8,26,8,9,12,0,5,11,7,6,0,21,1,35,13,0,1,4,2,2,5,3,39,15,8,2,28,23,53,23,32,11,20,2,17,10,39,26,17,10,20,83,28,5,41,32,56,25,10,42,1,26,32,28,13,14,31,11,20,17,27,41,83,10,7,11,13,19,7,7,15,19,15,33,3,20,27,15,18,46,12,11,9,8,12,28,5,11,18,17,7,37,61,12,3,8,6,10,5,6,7,4,26,3,6,7,18,11,15,6,10,4,6,13,19,6,7,100,2,13,6,1,20,9,4,0,0,1,3,1,14,23,4,28,39,3,2,43,4,20,16,11,1,11,8,1,24,4,6,2,4,7,28,15,9,66,30,34,10,39,15,6,13,19,4,28,22,0,4,10,2,30,23,1,11,1,4,6,13,29,29,6,3,2,1,2,0,3,0,0,5,7,7,16,2,0,59,4,11,3,0,0,7,7,29,6,3,5,4,19,6,1,1,7,5,3,1,4,4,3,0,15,11,0,12,3,8,4,2,13,3,5,8,0,6,7,10,9,0,0,4,6,1,5,10,6,9,0,4,5,2,7,4,11,17,4,10,3,0,1,2,2,0,14,1,2,4,0,9,2,12,4,2,11,8,14,2,7,0,10,4,1,12,15,12,0,4,10,17,3,4,12,4,2,0,3,11,1,7,31,3,0,8,0,0,10,24,18,4,8,0,8,11,3,9,1,1,52,9,21,5,0,0,2,2,6,0,5,3,8,6,9,0,8,2,0,4,3,2,6,0,4,9,0,3,0,14,1,3,6,6,14,2,16,0,15,4,1,6,1,13,4,4,0,6,11,2,6,15,16,3,4,10,11,26,13,10,1,6,11,10,11,4,2,9,9,1,8,3,6,7,8,16,28,4,9,20,13,3,0,0,3,0,0,4,2,1,5,0,2,5,0,5,0,4,2,0,1,1,0,0,6,0,6,0,0,9,4,1,0,5,4,14,10,31,13,8,7,3,0,4,1,4,3,2,1,6,0,1,0,0,2,0,4,7,1,4,2,1,8,2,5,1,1,7,5,0,12,9,19,17,27,1,1,5,4,6,0,3,2,0,15,3,7,2,0,0,3,1,2,0,0,0,3,0,5,4,1,0,0,7,14,2,0,6,0,15,12,13,8,3,0,3,4,2,0,2,0,12,3,1,0,2
obtain,14,37,11,234,9,10,10,37,4,6,40,15,14,106,4,9,9,24,1,10,9,53,9,34,32,17,17,14,12,33,10,268,184,11,65,58,65,13,21,10,14,15,17,4,61,27,30,21,455,32,77,15,12,52,8,5,70,37,4,16,25,5,5,19,13,13,85,7,7,11,41,7,6,5,111,18,22,4,100,21,49,2,29,13,391,34,30,1,65,10,31,7,3,48,65,38,30,2,46,22,10,47,52,19,29,37,12,5,30,9,26,12,11,21,4,38,11,7,84,231,47,33,27,99,16,5,5,9,6,2,21,8,6,56,37,50,25,24,10,8,4,57,36,3,6,100,15,20,28,21,90,1,35,7,5,20,44,8,15,23,19,1,7,12,4,15,8,49,43,9,46,134,42,0,9,21,254,7,14,60,30,13,4,28,10,37,41,32,64,70,3,6,8,1,4,5,15,11,22,19,59,0,4,15,34,10,6,48,31,25,105,8,47,12,4,2,0,3,22,0,2,38,9,20,45,167,33,39,17,3,24,34,18,24,65,16,57,11,10,9,117,56,9,10,44,7,12,39,45,3,18,26,24,15,13,18,26,4,14,21,10,37,34,12,11,75,17,17,17,7,192,11,58,7,10,2,23,16,21,5,83,19,3,30,19,6,7,11,23,5,10,12,31,11,11,14,82,14,15,35,34,37,0,5,9,3,18,3,5,0,7,42,38,3,54,20,22,81,19,10,88,7,59,15,92,16,10,37,18,46,10,16,22,5,12,19,19,31,4,13,15,21,22,10,6,6,60,82,36,7,24,14,5,71,42,14,3,7,34,39,29,8,13,25,7,2,72,12,11,26,9,22,5,18,20,31,7,7,21,8,98,2,68,19,6,43,20,67,42,4,69,7,18,20,50,17,98,4,56,5,35,3,4,4,7,15,16,6,31,13,1,12,9,35,12,27,10,10,5,5,6,9,32,23,1,8,5,15,25,18,20,8,15,23,4,5,1,31,11,9,32,35,10,33,6,9,16,10,49,7,28,14,8,8,77,9,5,26,12,44,19,35,35,45,12,3,27,20,12,2,28,7,3,5,3,31,5,18,32,11,7,20,7,11,12,22,18,14,18,5,122,70,1,6,26,12,8,19,25,15,22,7,12,1,13,38,13,24,19,7,3,20,22,18,19,34,7,19,6,21,7,41,17,32,19,14,49,26,1,31,21,13,8,15,21,19,21,13,59,32,4,7,5,29,9,30,8,26,20,21,40,5,6,81,7,11,60,10,7,24,38,12,29,1,22,17,14,21,65,78,10,11,26,4,6,14,20,6,7,16,15,27,25,21,14,9,8,13,10,18,32,51,20,7,31,9,5,2,118,33,46,4,4,18,12,38,14,32,17,11,53,45,15,11,84,18,48,10,23,10,10,15,9,36,5,17,7,19,27,25,30,37,41,26,9,7,24,10,6,24,28,8,11,26,14,32,8,17,15,258,29,8,7,9,6,16,44,16,13,14,8,8,23,28,26,30,1,16,34,31,34,9,118,73,51,12,6,13,4,12,5,41,27,11,13,9,17,7,14,14,13,25,24,16,13,4,13,16,18,24,13,6,9,18,7,15,33,9,7,9,4,11,5,39,20,19,10,9,21,12,14,17,8,28,3,18,12,3,11,17,14,29,11,8,15,9,17,8,49,7,29,17,3,13,12,11,25,6,5,22,12,9,5,21,8,15,13,21,5,28,28,22,5,6,22,21,28,16,12,23,7,1,5,43,9,19,14,4,10,9,4,17,15,9,13,17,16,6,10,27,11,20,5,8,21,14,20,19,6,11,10,18,8,6,4,5,7,13,36,10,10,6,14,20,12,20,11,11,6,22,6,4,3,8,9,4,8,13,19,7,15,11,12,5,16,13,13,45,14,22,20,18,14,18,11,12,16,13,13,23,28,41,15,14,7,10,12,14,11,1,11,14,9,3,19,13,7,6,16,22,6,14,15,25,18,11,13,26,15,8,11,11,5,8,18,7,14,5,3,17,3,10,1,11,23,11,4,5,13,8,7,17,8,10,19,3,8,20,8,22,3,23,10,28,10,11,15,10,4,10,9,5,12,16,7,15,13,40,11,7,8,7,11,16,9,3,6,18,15,18,3,24,7,5,2,29,13,13,56,11,2,4,2,2,22,6,1,3,37,10,2,6,8,12,2,20,12,3,2,11,10,9,9,7,13,8,8,9,13,3,14,18,10,7,12,15,9,10,26,3,13,3,7,1,0,6,1,10,5,4
therefore,19,62,24,341,26,15,12,81,17,9,44,14,14,155,15,21,10,50,8,7,6,88,19,49,55,28,32,25,24,31,25,448,269,24,131,117,89,31,32,17,11,19,6,10,78,38,69,32,643,30,120,14,41,79,19,16,202,75,5,31,36,27,6,27,47,19,216,18,31,40,17,13,16,13,249,45,39,16,178,49,129,11,32,12,507,36,39,3,70,9,14,12,10,60,113,25,29,17,64,44,41,61,88,22,29,88,33,13,32,8,42,10,23,30,7,50,21,13,141,410,107,34,30,165,9,8,4,8,5,4,29,12,18,109,60,84,31,8,10,15,13,64,66,9,6,136,13,34,37,35,179,5,29,16,14,56,72,17,45,20,35,15,30,12,12,10,6,41,44,20,35,232,47,4,16,20,377,5,30,76,65,39,17,38,16,65,70,65,70,131,8,17,17,3,3,9,35,19,21,55,101,1,10,35,59,21,11,92,30,68,192,10,69,24,6,3,8,20,39,9,27,54,19,29,118,244,60,82,7,19,44,33,50,62,83,73,82,25,35,10,175,88,23,6,25,10,13,72,105,15,34,69,51,26,29,48,27,12,13,33,7,62,41,10,13,102,8,16,38,14,320,24,94,24,11,0,45,48,25,9,140,13,4,38,21,5,22,23,50,7,4,6,39,17,11,27,85,16,20,39,61,137,6,10,23,8,41,20,22,8,4,28,79,14,83,29,57,79,34,17,100,16,67,24,133,14,20,71,6,65,18,28,26,16,33,45,41,10,6,26,23,22,37,34,13,13,106,126,39,19,27,25,16,84,64,23,12,23,32,79,56,13,21,51,15,3,83,28,13,24,14,40,10,39,32,65,30,15,37,18,179,5,127,34,6,75,29,57,77,9,66,12,33,33,77,26,140,12,74,3,57,2,15,2,15,25,25,4,59,29,9,25,27,46,16,22,3,10,14,6,22,31,43,41,9,9,7,37,33,46,41,15,4,26,9,10,6,23,43,20,31,54,27,43,3,12,26,17,106,21,43,11,8,16,120,34,3,29,23,64,27,59,68,70,13,12,40,24,18,1,32,11,8,8,12,64,15,33,54,22,21,31,19,15,17,29,32,7,9,9,169,96,9,13,27,20,12,35,24,31,27,12,11,10,24,55,19,30,11,11,10,18,9,19,44,59,13,27,16,32,7,57,29,63,27,15,76,32,31,1,32,27,11,37,19,19,36,24,102,56,20,11,8,34,20,20,8,38,41,15,97,14,19,107,15,24,60,6,17,25,52,11,57,10,34,39,33,36,72,84,24,23,36,8,19,9,37,16,14,53,16,55,36,50,22,24,16,29,12,33,63,87,18,11,82,21,17,21,103,35,60,4,15,13,10,61,21,82,7,18,73,46,36,14,99,23,40,16,26,25,27,24,13,40,10,17,20,35,24,68,39,55,84,58,24,11,26,22,12,29,41,9,50,44,18,76,15,12,14,356,43,7,22,9,26,23,82,55,21,42,15,9,26,45,11,14,4,31,29,30,52,28,123,103,64,14,17,13,14,21,18,62,39,28,27,23,35,13,16,31,36,20,36,36,15,20,25,10,35,46,5,5,19,14,23,14,47,18,16,6,15,16,17,61,53,62,23,13,16,24,19,21,22,64,9,27,25,12,17,25,28,35,23,16,20,10,32,10,94,27,34,16,11,20,33,14,43,21,14,15,34,27,5,35,27,31,21,29,17,38,34,38,17,15,42,37,30,17,29,28,14,10,10,42,7,40,33,13,40,30,9,15,33,18,34,15,22,82,24,36,14,30,8,19,52,54,14,12,8,24,15,11,20,23,17,7,19,11,54,15,33,7,20,22,15,17,10,19,13,26,24,7,18,25,8,20,10,26,17,14,26,17,21,15,18,26,21,60,21,15,11,23,10,29,15,24,21,8,12,40,42,70,26,23,9,15,28,32,11,5,10,14,14,11,15,27,21,11,20,31,10,21,16,27,12,11,14,35,30,4,7,16,5,9,25,13,13,12,18,11,11,22,1,7,19,12,14,19,11,9,11,27,6,18,17,3,10,27,7,51,9,16,16,40,46,10,7,10,10,20,22,15,18,33,12,18,10,51,15,27,19,7,21,14,17,8,15,15,14,20,8,26,25,23,27,49,29,51,99,8,7,14,10,16,13,10,9,16,41,14,7,16,15,10,7,22,12,4,8,15,12,23,10,8,23,15,4,18,27,11,14,27,17,17,19,9,24,8,27,6,18,11,9,0,5,12,12,14,2,3
unless,3,20,12,132,9,11,2,36,4,6,11,2,6,81,2,13,8,17,3,6,2,34,14,29,20,15,23,17,7,29,11,166,118,14,47,64,56,12,18,4,5,9,5,7,43,24,27,11,234,25,55,36,13,45,23,11,50,11,4,16,19,14,1,8,32,18,111,6,8,16,15,6,7,3,151,15,34,10,98,25,63,4,15,9,192,20,12,2,24,1,12,6,5,49,44,37,20,3,52,6,6,30,29,10,9,31,17,7,13,3,21,1,12,19,16,37,3,9,110,204,38,39,48,93,6,3,5,7,10,1,28,8,7,46,36,66,14,1,4,6,8,44,19,1,2,79,12,14,27,12,68,5,18,8,14,42,36,8,12,27,10,4,8,1,1,16,5,25,13,11,10,108,31,1,10,14,140,6,7,70,21,11,7,19,5,32,38,28,43,48,5,10,5,1,3,3,17,8,6,17,37,5,7,9,32,12,5,29,20,21,81,20,39,9,3,12,4,6,15,3,5,14,0,28,34,114,24,26,3,7,8,12,30,23,31,33,34,5,9,10,79,41,6,13,14,7,10,45,66,11,8,19,23,7,9,15,13,4,6,15,3,42,8,4,5,36,4,13,18,2,100,7,15,4,4,1,33,18,7,5,59,18,3,7,13,3,9,13,22,9,1,6,29,6,3,6,43,8,11,17,26,29,1,3,13,4,23,6,4,2,6,19,42,7,36,17,19,44,12,11,53,12,38,3,84,7,12,27,8,16,9,10,13,2,10,23,20,9,2,18,14,18,12,23,1,2,53,37,19,11,16,16,5,31,27,11,4,7,14,34,24,9,13,23,11,4,37,5,15,26,6,24,4,12,10,19,9,6,30,4,108,3,50,14,14,28,3,31,25,8,31,7,12,11,17,7,30,4,65,2,24,4,7,2,3,14,4,4,13,8,5,10,6,13,25,11,4,14,16,7,3,18,23,23,3,5,2,8,19,14,5,5,0,10,9,9,3,6,13,12,14,16,16,12,1,4,26,7,32,7,20,8,4,0,43,16,3,20,10,32,20,22,29,61,16,4,24,12,7,1,24,22,1,0,8,41,3,14,30,6,15,12,7,8,10,6,10,6,8,2,101,44,4,5,13,5,8,20,3,15,13,5,4,2,12,10,8,17,20,10,3,7,4,13,17,19,6,10,8,12,7,26,10,27,13,9,35,28,21,32,1,15,11,14,14,6,12,15,57,14,9,4,8,12,13,15,1,9,11,8,26,8,16,52,17,8,35,9,7,9,12,9,28,4,8,18,10,15,29,34,15,4,13,2,8,10,5,7,5,16,2,20,13,16,8,20,6,8,5,11,23,36,11,3,32,1,12,4,19,26,39,1,6,2,8,27,5,19,12,4,24,38,5,4,39,8,17,8,17,5,5,3,2,40,5,7,4,7,16,31,10,21,37,25,16,5,16,8,8,9,14,4,8,26,5,14,4,2,10,111,25,13,4,9,4,9,37,26,9,15,8,7,21,7,8,3,4,7,7,4,15,9,39,54,13,5,2,6,2,6,7,20,8,14,7,6,9,7,4,12,12,24,15,11,6,7,8,11,10,15,7,12,4,12,6,10,18,9,12,2,1,4,8,19,28,59,18,7,8,11,10,3,10,33,8,8,8,1,8,4,16,17,3,8,8,10,42,5,18,10,12,3,1,19,13,4,9,10,5,5,18,6,4,9,8,15,10,10,6,7,10,9,6,1,25,4,2,7,3,9,14,1,10,11,4,11,8,6,11,11,2,8,14,11,9,5,8,26,8,26,12,3,1,5,17,25,10,10,2,2,4,5,17,2,12,1,5,2,19,3,7,3,9,7,7,9,7,13,2,15,7,1,5,9,1,9,12,6,6,5,13,5,6,10,7,4,11,19,23,0,1,7,13,9,7,3,12,10,3,12,42,29,19,1,1,5,5,6,8,5,2,3,6,4,6,6,4,4,10,9,2,4,6,5,3,3,2,18,15,13,1,15,9,7,4,1,11,7,10,1,4,1,3,1,13,5,7,4,11,13,5,5,12,7,5,6,4,12,1,17,4,8,1,8,8,6,3,7,12,3,4,3,8,5,0,5,4,15,2,2,5,7,5,3,4,1,4,8,11,7,6,14,7,5,10,14,17,13,32,4,7,2,6,2,3,10,0,6,16,7,5,1,4,2,1,19,6,2,10,3,10,4,12,5,2,3,4,8,3,3,6,3,3,5,11,10,6,7,25,5,2,3,0,1,3,12,4,3,2,4
mind,4,10,10,60,12,16,4,26,4,4,13,13,10,75,4,19,6,23,14,3,7,27,21,25,17,6,15,9,12,11,6,112,88,19,46,66,50,8,5,8,9,8,1,3,22,11,16,6,89,26,20,7,12,31,24,10,31,6,5,16,8,6,4,12,22,4,85,9,14,7,8,1,6,8,86,12,17,2,52,20,33,3,7,11,107,16,7,1,13,1,1,5,2,10,24,7,7,4,13,19,2,18,17,21,8,35,4,1,7,3,13,5,5,9,7,15,1,4,17,80,40,19,17,24,5,9,6,0,1,3,17,1,5,31,23,51,8,2,9,8,7,32,11,4,5,41,7,16,4,8,46,5,2,5,1,13,26,5,8,15,8,1,8,0,0,12,3,21,19,5,8,65,19,4,10,3,118,3,5,21,8,8,6,22,1,28,27,16,17,25,5,5,4,1,3,3,16,6,7,19,27,3,3,4,15,10,3,24,5,17,54,14,6,2,3,9,2,1,8,1,1,16,2,15,16,66,15,23,7,6,7,6,8,15,19,3,19,11,7,7,28,24,3,11,16,3,7,56,19,10,9,14,11,5,3,12,6,2,0,14,5,18,8,0,4,12,8,12,10,3,100,4,13,8,5,2,12,6,5,1,35,11,0,21,8,2,11,12,13,6,0,2,12,3,0,3,6,2,2,9,18,14,0,0,14,4,14,6,10,3,0,5,14,9,18,10,16,20,4,8,17,11,22,17,47,1,18,23,2,13,5,3,10,5,9,6,17,3,4,6,7,2,11,8,1,3,29,20,7,12,9,14,6,16,12,0,7,4,10,20,11,5,8,12,3,2,12,5,11,20,3,19,12,25,15,8,2,2,23,3,30,3,31,10,11,16,7,18,19,11,25,6,5,1,19,16,23,2,25,4,18,6,0,3,2,19,4,4,13,10,1,3,0,17,0,11,4,3,6,9,7,7,17,7,3,7,5,5,8,10,7,0,0,5,4,3,1,4,8,4,10,9,1,3,0,0,12,3,27,3,23,2,7,3,36,12,4,1,6,12,11,30,23,51,10,7,19,5,2,1,28,6,4,10,4,38,5,15,15,9,8,9,1,5,7,5,7,5,8,0,52,19,9,5,10,3,6,10,6,11,10,3,7,3,2,7,8,15,6,1,4,4,2,7,15,16,3,10,12,11,6,27,8,10,8,5,7,13,13,27,15,1,3,14,4,10,8,12,25,15,3,4,8,9,8,4,3,11,5,1,21,5,5,25,4,3,9,2,4,2,11,2,8,5,16,9,10,8,16,17,4,6,7,3,5,1,5,3,4,4,4,3,11,14,13,2,2,6,1,8,24,19,4,2,26,6,8,6,3,9,13,0,1,0,0,18,3,7,4,2,19,15,3,6,19,6,11,5,10,0,12,7,5,10,0,6,5,7,12,19,8,16,29,17,1,3,17,3,3,4,14,12,5,9,3,4,2,0,4,37,14,2,5,4,4,5,14,16,4,7,4,2,1,8,3,0,0,2,3,3,12,10,5,14,6,0,2,2,0,6,1,16,6,4,6,7,10,9,2,1,6,11,6,3,2,4,2,0,5,10,1,0,2,3,4,5,10,5,1,0,2,3,6,13,6,12,5,4,3,8,3,13,3,7,5,4,4,2,2,5,9,10,5,8,4,0,11,8,11,12,9,4,1,4,5,3,9,10,4,2,11,0,0,0,0,2,3,13,2,8,9,4,0,1,6,8,22,2,5,4,8,0,5,11,3,8,3,4,11,6,3,9,9,7,6,5,5,4,1,4,4,12,4,3,12,6,4,3,2,3,3,2,1,0,10,5,8,2,7,3,1,1,1,1,2,1,5,4,0,7,2,1,2,3,1,3,3,2,13,4,5,0,14,8,10,6,4,18,7,2,0,10,1,4,5,3,3,3,2,12,3,7,5,2,6,4,7,1,5,3,3,6,4,2,4,5,3,1,9,6,0,2,3,8,2,3,0,6,10,1,0,0,0,2,4,1,6,2,3,4,3,1,2,1,2,0,1,1,1,12,1,6,2,6,6,0,0,5,3,16,2,1,3,1,5,1,2,3,1,2,4,2,5,1,1,5,2,4,1,1,4,1,3,2,1,1,3,1,5,13,9,35,3,0,1,3,6,1,8,2,0,4,6,2,0,3,0,0,5,4,0,1,6,2,0,3,0,0,1,2,5,7,2,9,2,3,3,2,5,1,1,7,2,8,4,5,9,4,1,5,5,2,1,3,2,1,1,1,2,4
attack,5,23,4,39,6,11,1,11,5,3,10,5,8,49,1,7,7,5,5,5,0,23,11,16,10,7,16,12,7,17,27,131,89,11,40,53,32,0,3,6,2,12,1,7,10,5,8,2,117,49,40,8,4,51,7,1,9,9,10,11,1,8,1,5,10,7,45,4,2,69,5,9,5,3,64,6,8,3,41,20,18,2,5,11,55,3,6,1,10,1,10,3,4,19,13,0,14,1,39,1,2,23,11,7,2,23,1,11,7,2,8,6,6,5,2,15,0,2,50,158,16,18,7,34,7,3,3,2,4,3,8,6,4,30,15,30,5,1,4,10,7,18,17,0,0,49,9,10,10,13,40,2,7,1,0,6,22,11,1,23,4,3,13,4,2,10,10,13,14,4,10,73,26,2,5,4,91,2,7,39,19,1,9,13,1,15,14,10,7,18,3,1,0,4,4,1,17,14,6,11,19,1,3,4,8,3,1,8,1,20,31,15,10,5,6,9,2,5,5,0,0,20,1,12,19,39,4,17,10,4,6,5,8,8,24,3,8,13,2,4,37,23,10,7,14,1,1,28,25,2,8,5,7,1,0,9,6,1,1,19,2,54,6,2,3,7,5,12,4,3,62,3,2,3,5,2,37,1,7,2,28,11,3,9,1,1,2,2,13,2,9,3,8,3,0,3,13,2,4,6,17,13,1,2,1,2,13,2,3,3,5,3,23,13,9,8,2,9,15,5,22,8,28,3,35,3,12,38,2,43,4,1,5,3,7,6,9,1,0,4,8,17,8,7,1,14,16,28,3,6,3,4,3,33,22,5,3,3,7,12,9,5,8,17,2,2,19,6,6,22,4,21,2,8,11,13,1,0,9,3,32,3,22,5,10,9,13,15,12,2,8,3,3,0,13,8,11,5,15,1,7,8,9,6,0,5,3,0,6,8,2,7,0,6,3,24,3,12,3,17,8,6,11,9,4,4,1,5,10,8,0,1,0,7,4,0,3,8,21,3,10,17,3,7,2,2,14,14,10,4,24,3,8,1,4,4,4,10,10,5,5,11,9,29,12,3,13,4,13,2,22,10,1,4,1,14,3,4,10,7,15,7,2,4,5,3,1,11,5,1,122,12,15,4,7,4,0,5,6,11,5,9,0,2,1,3,0,8,1,4,6,2,3,3,3,2,4,3,4,8,3,29,2,8,13,6,25,14,8,11,11,3,1,2,4,7,6,10,15,6,10,3,8,1,1,4,2,6,7,2,11,5,3,15,6,2,6,4,3,2,3,0,5,3,10,1,2,2,24,16,4,2,2,6,2,1,0,4,2,15,0,10,13,9,2,4,0,0,0,2,10,8,6,2,19,2,1,3,7,5,6,3,5,1,3,7,4,0,5,1,12,6,4,1,21,5,4,0,6,1,5,0,3,7,3,2,2,7,1,12,1,15,10,14,13,2,7,5,6,9,6,6,10,20,4,8,0,2,5,66,10,4,4,0,4,8,10,3,15,10,2,4,2,2,3,0,0,4,4,2,11,3,19,10,6,5,1,0,1,1,1,23,8,2,1,4,4,4,1,21,3,7,6,0,6,3,6,1,9,1,7,2,1,6,4,7,8,6,4,0,0,4,3,10,7,29,31,3,1,4,14,3,12,14,3,5,11,4,3,4,11,5,0,4,2,25,28,9,10,2,14,9,2,15,7,1,3,3,1,2,14,0,0,7,2,4,0,4,1,0,0,8,0,0,9,2,13,2,1,2,5,0,0,11,2,3,2,0,11,3,4,2,5,0,5,2,4,5,2,3,3,0,1,2,0,3,1,7,1,2,1,8,4,1,12,2,6,7,4,5,0,1,6,4,0,2,2,4,11,6,1,0,4,2,2,2,6,5,2,2,4,5,3,23,3,0,4,11,3,5,3,0,2,4,4,0,3,9,1,10,5,22,1,0,3,1,6,0,0,1,3,9,0,4,7,1,13,3,7,2,3,0,0,0,2,1,3,4,8,4,0,1,7,5,3,0,1,2,11,0,8,14,0,1,2,3,9,3,3,20,8,2,5,8,0,3,1,0,0,10,1,0,6,1,2,14,3,2,2,0,7,0,2,1,6,4,4,8,4,0,3,5,2,5,2,2,0,0,0,1,0,2,0,0,0,1,4,3,0,7,1,6,2,1,1,0,3,8,12,0,0,3,2,1,0,15,16,3,0,7,78,4,3,2,5,1,4,2,3,6,4,3,5,0,1,0,0,4,2,1,1,4,6,2,2,0,2,6,0,18
merely,1,21,8,85,15,6,4,34,2,6,20,7,10,70,2,22,4,21,6,4,1,29,15,31,33,13,21,15,12,10,12,173,98,15,60,55,49,4,5,4,9,12,2,4,29,13,32,9,192,9,33,14,15,38,15,0,85,11,1,8,12,3,4,15,25,7,110,12,5,11,8,1,8,6,120,16,30,2,57,23,50,3,12,8,174,31,11,0,26,0,4,9,2,28,57,24,14,7,21,16,9,25,14,10,12,32,6,0,15,5,14,5,3,16,0,26,3,7,50,187,48,24,40,49,8,3,3,4,5,3,13,9,6,40,28,56,13,4,9,6,11,20,17,1,6,59,8,20,17,6,69,1,10,5,12,16,50,6,7,8,12,5,16,2,1,12,7,35,24,12,8,104,32,2,4,7,150,4,11,43,44,7,1,22,4,51,37,31,42,32,3,4,3,3,1,3,11,7,7,31,51,2,0,15,18,9,5,35,4,22,96,11,17,23,13,1,2,2,17,1,11,20,8,20,32,102,21,45,3,5,19,12,9,36,44,45,31,6,8,12,79,21,6,8,26,2,6,33,58,4,7,33,15,8,8,12,7,1,1,14,8,26,15,4,10,50,18,9,12,5,103,4,23,7,4,8,16,8,7,0,59,20,0,35,6,2,1,11,21,5,4,2,10,9,1,7,27,9,7,24,22,18,1,6,19,6,17,15,15,1,3,33,21,6,31,8,16,34,9,9,22,10,34,16,70,6,11,27,3,21,6,20,12,9,11,15,20,6,7,7,8,1,11,17,5,8,33,35,16,3,10,11,10,32,24,2,1,14,11,26,20,7,13,22,3,2,22,20,3,20,0,18,5,18,15,37,14,7,21,5,52,2,42,12,15,15,7,15,34,4,29,5,12,11,26,14,40,5,25,2,9,2,1,1,9,25,12,6,25,6,2,9,3,28,4,7,2,8,5,0,10,12,23,21,4,4,1,18,8,18,6,2,2,7,2,2,1,5,2,7,10,23,7,8,4,3,15,4,34,6,18,7,2,4,47,20,1,10,21,28,16,37,30,65,10,4,12,8,3,1,26,10,4,8,8,69,1,9,32,11,13,7,3,8,12,13,8,9,9,5,61,24,3,6,3,3,6,8,3,14,24,2,6,1,4,28,1,13,4,8,13,9,2,9,15,11,4,13,17,9,3,23,9,40,12,3,25,31,15,37,14,14,2,1,12,14,13,18,55,37,12,4,5,16,8,5,15,22,7,6,44,5,14,34,8,12,21,4,9,14,15,1,11,6,16,13,9,8,31,33,11,4,8,2,5,6,19,10,5,21,3,8,14,22,9,13,7,6,8,8,22,27,8,5,44,5,16,5,33,24,8,3,4,7,5,18,5,20,6,11,29,13,9,7,41,2,23,8,17,3,11,3,2,18,3,13,1,6,25,32,0,12,42,17,5,4,23,5,5,8,25,7,29,16,2,9,6,1,10,83,9,6,4,4,13,8,23,19,9,14,3,5,6,10,8,5,0,6,6,12,23,13,21,45,11,13,7,7,11,4,2,27,4,6,9,10,12,5,0,10,9,16,11,5,6,7,3,4,33,13,4,3,5,11,11,6,9,5,2,2,9,7,9,14,11,23,2,5,6,7,11,15,8,26,7,4,5,2,1,9,5,11,2,7,3,3,40,4,17,7,16,4,7,24,7,6,11,7,4,9,15,8,2,5,6,7,10,3,2,17,20,13,0,6,12,16,12,4,9,9,7,5,6,10,2,20,7,3,8,8,1,5,13,5,18,5,11,0,11,10,3,20,6,9,32,25,9,6,1,7,3,9,4,1,6,2,5,3,25,3,14,4,10,9,4,3,8,3,4,9,2,3,6,5,2,5,7,7,2,4,3,9,17,6,6,5,9,17,7,5,1,7,7,10,3,1,5,3,9,8,11,21,13,14,5,1,15,3,9,1,5,3,5,2,4,5,3,4,4,7,10,10,2,4,10,3,0,8,6,4,4,4,9,6,2,4,6,2,0,5,7,4,0,2,7,2,1,4,6,8,3,5,5,6,4,0,2,6,6,16,2,7,6,4,14,3,3,1,6,2,8,5,7,20,4,5,5,2,4,7,6,9,4,4,5,4,3,7,8,9,6,22,1,1,10,15,9,2,27,1,4,3,8,3,2,3,5,2,9,1,3,0,10,0,1,12,5,4,7,7,7,12,5,8,3,6,1,4,7,2,2,7,3,0,9,18,12,2,12,3,2,3,2,2,2,5,3,3,2,0
determine,3,14,14,181,7,4,9,34,3,7,8,6,22,55,7,22,15,5,6,7,3,29,13,30,21,9,18,15,7,23,7,160,83,10,51,41,45,9,10,7,6,8,3,3,30,4,35,37,248,21,39,16,8,40,7,7,55,24,6,19,16,5,3,13,31,17,98,9,6,27,17,5,6,3,85,8,11,7,59,21,42,1,18,8,191,9,16,1,31,1,6,0,4,30,40,20,11,6,34,14,11,23,38,9,6,18,4,3,6,6,14,2,12,12,4,21,4,5,72,101,36,20,13,66,6,2,5,5,8,6,25,2,11,55,26,69,4,7,10,12,2,22,21,1,5,59,6,21,10,16,41,6,10,9,3,27,29,6,11,13,35,2,5,7,4,7,1,17,22,4,15,57,31,5,4,5,211,9,11,50,19,18,11,11,7,29,22,23,68,48,5,6,10,3,1,5,21,12,4,11,21,2,2,15,27,16,4,40,3,31,83,4,14,6,3,3,11,13,23,2,6,8,4,23,39,85,25,19,5,12,9,8,22,21,17,13,33,8,14,7,54,22,2,4,18,10,2,22,64,5,21,9,16,8,6,12,12,2,4,23,11,17,26,6,5,63,15,7,10,3,106,7,39,4,4,4,15,14,14,5,44,9,5,13,4,3,3,6,9,3,9,7,14,7,7,5,31,8,5,19,20,49,2,7,10,4,11,7,5,2,7,21,27,5,25,7,12,42,12,7,44,4,21,3,62,9,12,33,8,25,6,7,3,7,8,17,16,8,4,11,8,9,12,14,8,3,39,54,20,12,15,14,4,40,19,12,13,1,18,13,26,8,12,24,4,3,25,5,8,7,3,22,10,7,21,36,8,3,10,7,105,3,49,7,3,32,8,14,24,2,26,6,13,15,34,8,63,6,23,5,9,4,7,3,4,3,10,0,15,12,1,4,13,22,15,16,8,3,2,3,5,6,25,11,4,7,6,9,7,23,5,10,2,10,1,5,5,10,10,12,20,23,10,8,0,5,10,4,28,13,12,4,4,2,56,18,0,4,9,28,9,18,29,19,6,13,17,22,24,1,13,5,8,2,5,18,4,13,23,11,8,12,8,6,7,25,7,4,7,7,39,41,1,1,16,6,3,8,5,6,12,6,6,0,7,9,6,9,14,2,3,1,12,9,12,22,6,16,6,9,2,14,10,28,1,10,20,11,21,19,14,4,4,12,1,8,15,6,48,20,11,12,4,9,11,19,3,6,22,9,42,2,5,41,6,18,23,4,3,5,18,2,23,6,13,11,11,5,31,21,6,13,15,0,9,5,17,8,1,22,1,16,9,9,7,3,5,4,6,14,23,19,15,6,22,3,4,5,66,18,28,5,2,3,11,26,8,26,36,4,20,46,18,4,33,8,10,3,13,7,8,5,4,21,2,16,0,8,11,29,3,17,61,24,15,7,13,8,2,4,5,4,7,14,8,23,6,11,7,145,17,8,4,1,6,8,30,7,8,16,4,11,20,29,7,6,10,10,12,5,26,10,26,55,44,1,4,8,2,2,8,34,9,16,7,11,17,10,3,13,18,17,9,8,8,22,6,9,15,19,4,10,4,3,8,3,13,3,2,7,11,17,5,23,21,23,3,6,12,11,2,7,4,27,2,8,3,6,6,6,11,11,3,10,9,13,22,5,35,8,16,5,3,12,15,5,4,5,9,9,5,5,4,16,3,10,3,17,6,15,10,6,5,6,10,24,14,7,12,20,9,7,6,18,2,22,3,5,19,10,7,3,14,2,10,6,5,12,6,17,7,9,3,7,13,19,31,9,2,11,13,5,11,9,2,8,4,6,12,4,11,1,11,8,5,3,6,17,0,4,4,2,6,15,21,4,3,8,5,1,8,3,8,7,3,8,6,27,12,15,1,18,7,18,7,10,5,12,4,8,26,25,5,5,9,4,13,4,7,1,5,9,5,3,5,9,8,7,8,20,12,5,6,5,6,4,7,7,6,4,20,6,6,4,22,6,17,4,4,9,2,15,5,2,4,9,6,1,6,9,3,9,4,5,12,6,2,3,10,22,5,4,1,8,8,10,3,9,9,8,5,6,4,8,11,8,5,10,2,5,10,5,16,2,1,0,7,3,4,8,3,9,6,7,2,19,9,15,25,4,3,6,4,9,3,9,7,4,30,2,3,7,7,14,3,15,9,4,11,4,5,7,0,10,5,2,8,9,5,3,23,5,7,4,3,4,5,7,8,1,8,3,1,1,5,1,3,8,0,3
draw,0,14,5,60,11,7,5,26,4,5,7,9,5,47,3,10,6,21,3,2,3,17,22,22,15,8,16,23,5,18,8,120,106,20,32,57,32,5,6,11,5,10,2,5,26,13,9,7,156,29,39,9,7,39,5,5,41,21,7,17,13,10,6,8,12,2,67,2,7,16,11,0,3,4,63,7,17,5,53,21,30,0,11,8,131,28,27,1,20,2,8,9,1,22,38,12,14,3,19,13,4,11,10,9,5,15,4,4,13,7,13,2,4,15,4,9,1,2,36,97,26,17,5,60,6,7,3,2,1,2,8,4,7,34,23,39,5,2,6,10,6,29,16,1,2,39,9,9,12,9,41,0,12,8,1,11,31,8,8,18,4,4,4,4,0,15,6,18,16,5,18,51,24,2,12,2,101,1,9,33,20,11,4,11,3,17,27,19,33,14,3,3,8,2,3,2,14,3,3,16,31,5,3,7,22,8,10,25,5,16,47,11,11,6,3,3,1,2,13,3,9,5,1,11,30,74,16,20,6,3,5,9,11,15,25,14,20,7,10,8,46,22,4,5,14,0,3,24,28,6,7,18,13,9,14,9,5,2,2,22,5,26,9,2,0,31,7,9,12,4,69,17,35,6,5,2,12,8,9,1,60,6,4,25,9,2,5,8,19,2,1,11,7,4,4,4,30,3,8,15,20,20,0,1,7,6,15,7,1,0,1,14,16,6,48,10,15,19,9,4,17,6,26,5,48,4,9,29,10,26,6,7,6,3,11,7,15,9,7,9,7,12,17,6,5,8,17,25,11,8,5,9,2,25,12,3,5,0,13,31,12,1,3,9,10,4,30,9,9,22,2,26,3,12,11,26,6,1,10,7,32,4,31,11,11,16,8,17,19,6,12,3,7,5,22,6,27,3,13,4,11,6,7,2,5,13,6,3,10,12,2,4,8,17,5,10,3,9,3,7,7,5,12,8,4,5,4,13,11,11,19,2,5,11,3,0,2,5,14,5,16,11,1,15,0,6,9,8,16,14,21,4,8,1,46,6,3,11,5,19,15,23,24,46,16,2,19,9,9,3,14,10,3,4,3,30,4,4,23,9,5,13,5,4,6,6,8,7,6,4,75,29,2,10,16,4,8,7,7,11,6,6,1,3,4,20,7,16,11,7,5,4,4,4,10,20,9,8,7,10,6,14,3,15,9,4,19,20,19,19,6,10,7,14,8,1,5,10,27,10,3,2,4,10,10,3,7,7,10,1,29,5,5,27,5,2,12,1,6,6,14,1,15,1,10,14,4,0,16,13,5,3,15,4,5,3,4,3,3,9,5,5,9,14,7,5,5,2,3,10,8,21,6,5,20,4,3,1,34,9,12,0,4,7,2,13,4,14,2,6,10,10,8,9,25,9,11,2,3,1,11,0,7,19,3,4,6,8,11,19,43,25,28,12,10,2,13,5,5,9,6,2,5,17,1,15,1,2,8,101,6,10,6,4,2,15,26,12,2,7,5,4,12,16,7,6,2,9,8,6,12,9,10,21,19,4,3,3,2,3,7,15,15,6,5,4,10,0,2,13,8,13,16,5,5,2,8,1,11,5,0,6,2,4,12,2,9,4,3,4,4,9,5,18,11,28,12,5,0,5,5,4,3,17,3,10,3,5,2,4,10,17,3,1,2,6,7,5,14,7,3,2,3,11,6,6,6,4,5,8,6,2,8,12,8,8,4,19,3,9,8,9,3,5,12,11,9,4,11,8,11,2,0,8,4,8,10,1,7,9,8,7,7,9,6,9,4,11,5,12,6,6,1,4,4,10,1,3,4,1,2,4,3,5,9,2,5,5,18,5,4,0,2,9,6,5,5,3,2,2,0,3,5,8,6,3,5,1,2,5,8,4,12,3,7,8,5,15,5,6,3,5,2,9,5,4,6,6,8,6,20,15,4,7,0,4,6,8,4,0,4,1,3,2,4,10,2,3,9,6,2,1,13,11,2,8,5,4,7,2,5,4,5,2,7,3,5,8,3,5,6,2,0,2,3,2,6,0,4,5,4,10,7,8,1,4,0,10,2,18,4,3,2,3,4,10,8,2,3,1,5,3,5,11,5,8,2,2,3,7,3,2,3,3,2,2,7,4,3,10,0,11,3,3,9,22,6,6,41,1,3,1,2,3,2,1,2,5,6,3,0,0,2,1,0,4,5,5,3,3,14,10,6,10,1,1,6,6,3,3,2,7,4,4,2,1,4,3,9,9,5,7,5,1,0,7,6,4,2,4
proper,11,29,3,190,7,2,2,42,2,8,16,9,7,46,10,5,7,12,3,4,4,42,8,9,27,5,4,14,2,11,14,178,83,7,50,36,50,6,3,1,3,4,6,2,29,17,26,10,298,3,35,5,9,14,1,9,61,24,0,15,12,7,5,15,19,1,63,5,9,10,3,9,4,6,56,8,14,0,59,18,29,0,18,5,220,18,6,0,36,0,6,8,0,23,50,5,10,2,22,6,21,17,40,13,8,24,1,2,8,1,14,8,4,2,0,24,11,6,83,153,36,12,5,42,4,5,2,3,4,0,4,2,3,51,16,27,6,4,6,7,3,26,23,2,2,59,12,7,8,15,91,1,12,4,4,12,10,2,7,4,4,2,6,2,0,2,5,18,25,8,13,59,14,0,0,14,140,0,11,33,31,17,2,15,13,14,32,22,40,54,6,7,6,0,0,4,12,4,4,16,10,0,3,20,18,9,6,32,19,33,80,4,32,9,2,0,2,0,13,2,2,10,7,12,48,117,17,13,2,1,10,5,13,12,25,19,35,6,3,4,76,31,1,9,8,2,5,19,48,4,9,9,18,10,10,65,14,1,4,8,6,30,45,6,6,34,3,7,12,7,198,13,17,10,3,0,18,15,22,8,41,7,0,24,4,0,3,11,17,1,9,4,5,4,2,10,43,8,8,13,14,35,1,4,10,0,12,4,3,0,1,16,29,3,15,19,11,28,15,5,52,9,22,1,63,11,4,28,5,18,3,9,14,3,4,22,12,5,4,13,10,9,11,18,2,7,51,49,20,3,19,17,7,15,26,6,3,3,13,25,17,3,2,12,7,1,47,6,0,9,3,9,5,4,11,22,7,1,23,7,92,1,62,11,1,51,3,13,30,4,27,3,11,14,40,8,84,9,40,3,27,1,4,0,3,7,3,3,19,11,1,6,2,17,4,10,3,5,8,0,7,17,24,18,1,5,2,14,16,17,8,9,4,12,1,4,0,29,12,7,17,26,5,8,0,2,7,7,32,4,15,16,4,3,45,4,1,15,11,26,8,23,21,20,8,5,7,20,12,0,9,6,6,1,3,13,3,12,19,5,5,17,3,6,9,7,6,4,9,7,83,47,4,1,5,15,3,16,9,9,10,3,0,0,8,6,3,14,11,4,3,5,11,9,13,19,4,23,7,10,3,13,13,33,13,8,31,17,21,36,12,8,6,13,15,5,1,3,47,26,7,1,2,3,10,19,6,25,13,19,60,15,4,44,7,6,32,4,2,3,30,7,29,2,19,15,13,8,40,31,8,18,23,5,3,5,5,7,6,15,5,19,8,10,13,4,1,11,4,8,29,33,7,2,12,3,8,2,50,20,35,2,5,6,10,34,9,18,2,2,18,15,18,4,41,10,29,1,11,7,9,0,2,25,1,5,13,15,19,29,1,19,48,22,10,2,10,7,5,18,6,0,16,39,11,27,3,10,6,182,14,8,12,10,8,12,32,8,10,12,5,11,41,25,15,12,3,13,12,16,29,6,69,20,24,9,5,19,2,5,11,32,16,13,9,10,9,4,4,19,22,8,18,13,5,11,14,7,24,70,3,6,15,6,8,11,13,8,6,5,4,4,13,36,24,41,7,15,11,5,14,4,8,20,1,7,5,2,3,12,9,7,3,2,13,11,22,3,57,9,11,12,3,11,13,3,19,3,1,5,17,9,1,12,3,12,4,17,4,4,7,13,8,0,20,4,13,4,3,15,8,6,2,13,12,13,5,1,16,13,3,6,19,4,4,4,5,38,6,10,5,12,4,7,12,18,7,7,3,10,8,7,9,9,2,0,9,3,20,8,4,4,13,15,5,7,7,5,10,7,11,3,4,2,18,7,1,7,1,4,12,4,9,12,4,5,24,28,11,12,20,14,3,12,4,5,8,6,9,21,26,28,9,11,2,7,7,8,6,0,7,5,1,1,4,5,3,4,5,14,3,4,4,1,6,3,8,17,20,2,3,6,5,10,10,11,11,5,3,6,3,12,0,6,13,9,6,8,1,4,2,15,6,7,5,3,3,10,1,25,2,5,3,15,18,5,3,3,1,2,13,9,7,13,0,18,2,41,3,3,8,8,23,14,14,3,4,7,4,11,0,10,3,1,4,8,11,19,38,10,5,3,4,3,7,5,2,5,24,5,6,2,6,9,0,16,2,0,0,7,6,10,6,5,11,8,0,9,13,5,7,4,8,1,6,1,13,1,22,0,5,0,3,0,0,2,0,12,2,0
wish,13,34,9,98,14,6,9,24,3,6,29,15,8,98,7,10,10,29,9,9,4,38,30,50,21,30,19,17,13,21,5,185,123,15,58,112,54,2,11,7,13,10,6,5,44,7,30,14,158,38,63,18,23,53,22,10,51,11,11,14,13,11,3,10,22,16,110,3,10,12,6,3,10,13,123,15,22,5,54,80,31,1,20,18,209,27,18,3,17,2,16,4,5,21,69,9,17,4,32,14,4,19,13,13,14,19,7,2,10,2,13,4,5,7,1,23,3,8,60,142,45,32,7,33,2,6,2,5,2,1,16,5,8,27,20,46,14,2,8,9,7,39,16,4,1,78,8,25,14,16,65,6,14,10,8,14,41,6,11,21,12,6,16,1,0,11,3,36,19,7,14,87,39,4,13,2,128,8,10,43,48,19,8,22,6,48,44,23,30,36,4,11,3,2,7,1,17,6,6,16,69,13,4,9,30,14,4,38,5,25,77,8,21,6,6,1,0,7,12,3,4,22,8,14,20,63,22,31,3,5,13,14,11,16,45,5,38,9,11,12,49,27,2,10,12,1,8,32,39,12,8,20,37,4,2,27,5,1,0,11,6,35,10,2,10,18,6,15,20,3,116,5,11,5,5,4,15,2,9,3,69,10,1,23,3,2,4,12,22,1,0,3,21,4,1,2,22,7,8,22,23,17,3,1,14,1,23,6,9,0,3,28,18,9,17,5,22,27,10,4,29,6,31,6,65,2,17,25,3,28,12,9,11,4,13,13,15,5,2,11,14,10,14,19,8,10,22,52,18,6,3,10,7,40,16,17,6,6,14,36,31,3,30,17,3,1,40,12,15,38,4,24,3,16,16,15,14,6,23,6,81,3,31,8,15,37,8,16,21,11,36,6,15,10,25,9,27,6,37,4,19,5,2,4,11,20,6,11,21,6,6,18,1,13,10,6,7,11,11,8,6,9,26,15,4,11,0,20,9,19,3,0,0,9,8,5,1,12,9,4,10,8,8,13,4,5,21,11,31,8,17,6,8,7,44,6,6,9,13,25,22,35,33,57,4,17,15,16,9,4,12,12,3,6,1,40,1,16,35,6,7,11,10,3,19,15,11,10,12,0,33,42,4,7,9,3,4,13,4,13,22,16,1,2,3,12,15,14,8,10,4,0,4,22,9,22,8,27,9,13,5,19,8,25,10,6,34,27,13,24,15,12,10,18,6,10,3,1,56,38,3,12,8,18,15,13,18,16,12,9,43,8,3,27,10,14,16,5,3,20,13,3,10,5,18,9,8,8,26,49,7,2,9,2,6,5,7,2,9,10,1,9,18,30,8,11,6,13,2,30,21,39,11,4,35,8,13,11,16,41,12,8,4,0,3,18,2,16,9,2,26,8,5,4,20,2,17,9,12,6,12,3,2,10,1,7,5,4,21,28,3,21,39,23,8,3,21,1,2,3,6,6,20,15,10,13,0,7,8,82,34,11,6,13,11,7,15,7,12,9,6,3,9,10,0,5,5,6,20,12,11,7,19,13,13,2,3,2,2,4,5,37,15,3,10,7,17,3,7,5,10,19,10,11,4,6,11,1,8,17,3,7,1,5,9,5,19,12,2,2,13,4,9,15,17,12,13,8,9,13,2,9,9,8,2,4,11,6,2,10,5,14,3,8,7,7,4,9,23,1,20,6,3,10,6,14,6,14,2,6,7,0,0,3,0,15,2,8,3,5,4,22,1,1,17,4,14,7,10,5,8,6,4,10,2,8,2,3,6,7,3,4,16,16,22,9,6,4,1,9,6,2,2,2,37,25,13,3,5,1,7,7,9,3,11,21,6,5,10,4,7,7,3,3,2,5,2,13,4,14,7,0,11,7,0,5,12,9,7,9,10,7,10,3,9,9,13,25,7,1,7,3,2,7,1,1,16,5,3,12,11,19,6,3,2,2,3,3,7,0,7,5,12,5,4,2,5,3,6,12,4,0,3,2,4,6,6,7,23,6,0,4,2,2,7,2,4,10,1,4,1,10,3,7,1,7,5,2,2,11,7,5,3,16,11,1,15,9,6,23,5,6,7,3,18,4,2,2,1,4,5,9,3,8,2,3,3,10,3,2,2,7,2,0,2,2,4,3,10,15,4,6,1,2,0,7,5,3,7,1,1,7,2,2,3,0,2,5,2,7,0,1,2,0,2,2,4,0,13,4,4,6,10,8,3,8,2,2,1,3,3,5,6,2,4,8,4,4,4,1,2,6,3,2,0,0,6,2,3,7
become,29,117,42,406,15,23,18,101,14,21,73,29,47,267,20,41,37,61,29,25,14,119,49,80,70,42,32,25,27,72,30,523,410,41,185,206,148,40,39,10,33,29,22,9,99,78,72,33,1003,89,155,20,49,138,51,38,212,54,16,52,57,25,12,36,82,20,411,18,15,44,44,15,17,16,371,55,65,18,253,82,140,8,80,38,767,87,59,4,108,12,33,19,10,89,182,41,53,24,110,53,26,86,103,40,38,114,20,16,49,13,62,23,32,53,13,80,31,13,206,523,134,81,47,247,35,6,15,17,14,5,54,20,42,149,86,167,37,26,26,32,15,128,102,15,16,192,40,94,56,44,198,15,72,30,22,68,129,15,50,64,46,16,47,9,22,42,27,61,99,31,67,292,73,17,17,30,544,12,46,105,79,38,33,49,18,88,113,68,142,158,11,33,31,6,13,19,47,23,22,70,91,20,7,26,84,33,31,95,33,78,221,16,95,37,6,16,4,9,58,14,14,63,20,40,118,373,108,103,19,34,54,52,40,77,119,74,91,31,28,31,193,81,37,31,62,14,26,74,160,25,32,91,82,28,20,42,32,13,10,75,14,96,66,21,33,132,33,33,61,30,485,28,76,16,15,6,75,32,33,6,234,42,14,55,41,11,21,44,51,12,18,18,70,18,17,33,129,23,16,95,120,92,2,15,42,13,97,23,44,15,8,72,86,22,112,60,71,121,40,23,227,32,116,38,178,20,45,91,18,87,18,44,31,18,33,27,56,28,16,60,36,40,62,44,33,35,131,181,56,36,45,30,18,109,82,21,20,27,54,107,87,31,46,70,13,6,139,22,19,66,13,64,18,56,44,78,36,21,62,31,228,14,208,31,12,131,24,61,98,35,84,13,53,43,98,40,176,20,130,13,49,12,18,9,16,39,37,15,74,38,20,45,12,48,37,36,14,34,20,9,27,58,56,56,3,18,8,73,36,61,33,17,8,39,13,21,3,37,26,20,68,89,33,68,12,14,50,35,129,33,47,10,18,18,190,25,9,49,25,89,32,74,93,106,19,27,48,53,44,11,78,20,14,19,10,109,30,40,73,27,46,43,22,23,35,30,37,26,17,14,242,98,9,18,41,27,8,59,25,39,65,21,11,2,26,65,22,34,28,26,15,12,41,13,38,55,21,51,31,25,22,91,29,66,27,29,75,41,59,102,57,25,15,55,48,27,47,56,1,68,22,15,24,29,27,19,31,73,44,20,128,17,18,136,21,35,87,18,16,26,72,18,78,14,60,62,49,44,105,94,38,24,46,8,27,24,13,23,16,49,10,42,50,48,32,31,22,42,16,29,74,107,32,19,110,44,32,17,151,64,62,11,27,15,20,66,24,90,30,31,103,46,19,25,108,35,66,10,38,21,31,21,12,81,16,17,25,32,45,109,66,74,117,92,33,17,38,30,10,39,48,13,27,87,31,74,17,13,23,581,81,15,27,15,26,30,135,57,36,41,13,30,48,57,34,16,7,29,25,37,62,35,183,62,88,22,13,19,19,31,17,76,55,41,51,44,49,26,21,48,51,42,49,66,18,26,48,21,34,42,35,20,19,24,26,19,40,18,12,20,31,24,38,72,67,77,16,46,37,22,40,29,31,70,14,36,25,14,17,36,27,48,19,18,30,7,55,23,122,44,53,37,20,29,26,12,44,26,19,44,36,9,12,24,12,42,29,43,22,48,48,60,10,13,66,62,34,23,27,32,23,30,19,74,14,66,34,14,83,47,30,25,47,22,23,26,38,96,26,48,14,18,5,17,48,59,18,25,15,31,14,20,40,19,27,11,23,23,61,15,22,23,22,30,15,13,17,52,14,48,17,3,12,32,13,15,11,43,38,16,30,20,36,27,15,29,23,103,38,26,17,18,16,38,20,39,35,31,7,35,66,61,25,18,15,21,30,40,22,11,27,16,35,13,14,17,32,24,19,19,17,14,42,53,18,15,12,36,33,32,5,22,17,19,38,9,31,19,28,9,19,45,6,18,26,22,15,13,9,14,23,15,15,47,28,7,28,53,13,64,21,19,17,30,45,12,16,21,18,13,39,19,16,36,18,32,13,39,11,14,22,9,13,21,19,7,20,9,20,26,16,53,14,15,28,66,75,20,87,10,9,19,18,14,19,21,15,27,50,31,13,26,24,10,13,40,19,12,18,30,27,18,17,23,18,15,14,31,16,18,24,33,29,43,19,20,22,13,34,7,14,7,9,4,3,12,9,17,18,3
public,7,37,27,248,20,13,11,41,3,10,10,5,20,94,15,12,13,36,11,1,12,53,14,40,69,18,14,17,6,28,18,321,169,20,106,64,24,40,72,5,16,11,7,8,57,20,47,38,326,8,105,13,30,27,23,2,64,43,2,15,19,5,2,23,49,11,157,12,19,20,43,12,8,9,166,32,38,11,116,64,77,4,26,15,352,51,35,4,61,6,17,10,4,60,130,49,32,12,65,38,34,56,51,14,37,50,10,17,19,14,41,18,17,37,4,47,8,15,99,250,82,25,12,112,13,9,4,5,7,3,39,1,9,96,39,123,20,13,8,15,7,61,40,7,7,111,19,16,47,39,145,4,19,26,21,94,73,12,7,11,25,24,18,4,14,18,8,41,45,12,29,172,55,11,3,14,326,4,26,87,61,19,12,48,17,80,66,54,65,54,1,21,9,2,5,13,32,10,23,40,129,12,9,12,43,16,16,92,18,64,142,3,47,14,8,1,2,7,49,15,12,44,8,28,79,300,59,57,9,32,22,22,46,87,68,42,60,19,13,14,118,61,14,14,22,14,3,39,103,10,32,41,21,18,19,34,16,2,7,23,53,21,31,7,18,84,4,8,21,11,269,22,88,23,8,0,33,31,15,7,100,20,5,39,22,7,33,31,23,2,2,4,24,12,4,21,62,15,12,27,38,69,10,0,27,4,23,17,29,10,7,76,63,10,55,49,52,72,39,17,49,17,48,16,104,11,19,40,9,41,12,25,13,15,22,34,28,10,13,22,32,13,26,18,24,8,68,65,29,20,28,17,12,98,39,34,5,7,33,48,55,18,34,58,9,2,58,14,7,40,12,27,11,20,37,78,11,13,24,25,114,2,95,25,10,281,14,47,45,9,55,9,13,8,47,14,92,10,59,12,33,4,8,1,12,32,30,2,30,23,4,3,9,44,4,11,10,6,11,2,17,21,47,29,7,15,6,33,9,20,40,17,12,6,6,3,0,1,8,12,35,22,19,10,0,2,23,13,74,13,30,6,9,9,111,8,1,10,24,45,17,38,45,69,8,0,35,43,33,3,21,25,4,10,3,81,6,32,40,19,22,23,9,8,22,13,21,5,12,8,63,76,2,7,13,13,9,31,17,26,45,11,8,6,30,87,15,34,11,21,15,9,9,32,30,30,12,31,68,16,3,27,28,66,16,8,78,83,32,56,14,15,6,37,20,10,26,38,68,1,15,1,21,15,31,15,12,31,34,22,39,9,14,71,21,19,59,19,14,23,37,18,42,8,20,45,30,25,56,84,18,8,34,14,14,7,8,12,10,28,12,20,29,29,23,17,10,17,5,23,22,59,29,8,66,20,22,32,17,34,34,9,6,0,7,42,5,48,24,10,69,74,16,16,76,16,34,34,28,7,30,34,8,39,18,17,16,9,28,42,22,43,60,44,22,1,41,18,7,26,16,0,23,42,16,30,29,11,26,135,5,19,21,7,19,17,56,30,10,24,11,3,4,19,6,4,2,27,34,20,34,10,14,43,17,16,6,13,2,11,9,51,19,13,19,23,20,11,6,7,19,13,32,8,13,32,20,4,26,23,4,8,12,23,19,14,34,11,9,7,6,8,10,36,30,16,3,11,4,15,11,15,7,26,6,10,31,10,11,20,20,30,33,11,27,7,8,13,29,10,28,4,17,11,0,18,25,21,16,12,17,27,14,16,3,20,12,15,13,11,9,35,2,13,31,26,20,31,20,27,8,13,6,23,8,25,20,16,7,15,3,11,20,14,29,15,18,6,18,30,12,10,2,6,127,45,55,12,6,10,7,9,18,10,12,10,30,13,34,6,15,2,7,17,5,6,12,7,12,24,2,6,7,19,22,5,8,15,17,6,19,9,22,3,7,12,7,36,20,11,6,12,9,25,26,19,32,23,16,21,15,51,17,23,7,7,23,59,5,3,5,13,14,5,10,8,11,8,11,38,19,10,6,13,8,15,4,6,8,0,2,11,16,8,15,5,14,8,8,9,4,14,3,5,10,8,2,5,13,2,15,8,0,12,1,1,2,14,13,29,21,35,10,27,18,7,4,8,11,5,8,10,7,6,4,10,2,5,6,32,10,9,14,12,7,13,19,22,10,33,7,17,22,13,12,53,45,36,89,8,4,7,8,16,14,17,4,3,34,14,57,2,4,8,4,16,19,3,4,10,10,4,14,11,10,4,2,12,16,1,19,13,11,24,19,10,22,4,7,0,11,3,12,0,3,10,5,12,1,0
abandon,3,4,1,52,10,1,2,13,3,2,7,8,2,37,3,2,3,8,6,6,2,20,5,10,5,4,9,4,4,13,7,73,72,3,26,43,22,4,4,1,1,5,3,0,28,7,18,4,145,19,22,10,5,26,2,0,22,15,2,8,3,5,4,9,8,8,58,0,3,21,6,5,1,2,51,6,10,5,34,15,17,0,8,8,105,8,5,0,12,1,5,5,1,17,24,11,7,3,31,7,3,19,18,4,9,9,0,1,4,2,16,5,1,10,2,13,2,1,24,93,22,8,5,31,2,3,3,2,4,3,7,2,3,16,12,21,1,0,7,3,0,11,18,0,0,21,3,9,10,6,39,2,8,4,5,7,13,5,6,8,9,4,4,0,3,1,5,18,20,8,13,44,18,0,1,3,86,2,6,14,4,5,1,10,1,13,13,16,12,29,2,5,4,1,2,2,7,1,3,17,16,0,1,12,21,8,2,23,2,20,44,3,9,4,3,1,0,0,6,4,2,12,2,10,16,55,8,9,1,1,6,2,13,37,7,13,16,6,7,6,48,31,3,3,7,3,1,14,27,2,8,12,10,1,3,14,2,1,1,10,3,16,14,3,3,2,2,6,10,3,73,4,7,7,3,0,14,2,3,1,21,5,6,8,2,0,3,2,11,2,2,2,9,2,0,9,22,2,5,9,20,12,0,1,5,2,9,0,8,1,3,15,14,4,10,6,12,17,9,1,19,4,20,1,33,1,2,20,7,16,0,2,7,2,5,13,6,2,1,9,6,7,15,9,0,6,17,26,9,2,4,6,3,16,17,5,3,4,9,16,9,5,6,12,4,2,15,3,4,5,3,14,5,8,7,8,2,0,4,6,42,3,17,3,1,27,2,18,20,3,7,2,1,4,13,10,31,5,8,3,8,6,5,0,2,12,5,0,17,4,2,6,6,13,4,11,2,3,1,3,1,3,8,14,3,3,5,9,6,9,6,1,1,2,1,8,3,6,7,1,10,16,5,4,5,2,11,3,11,3,8,3,4,3,35,9,1,8,3,19,4,10,15,8,3,1,16,15,7,0,3,4,2,2,5,8,2,5,5,6,9,5,5,2,5,4,9,2,1,0,39,12,4,1,5,3,3,6,3,8,7,1,2,0,6,11,7,7,3,2,5,1,3,5,11,9,3,7,3,10,3,9,7,18,5,3,14,10,4,20,9,3,10,12,11,3,7,3,22,15,1,1,1,4,8,2,2,9,9,2,14,2,3,24,2,6,21,3,2,2,9,0,15,0,8,9,9,5,14,18,3,5,2,1,1,4,3,1,0,5,7,11,17,13,8,0,2,2,1,7,21,19,6,5,12,4,1,2,28,13,12,0,2,2,1,20,1,5,6,1,12,9,2,6,12,3,13,3,1,8,6,3,6,9,2,5,5,7,3,15,5,12,13,12,6,2,9,4,3,3,7,3,0,6,8,17,4,1,4,88,9,3,2,1,8,6,20,7,5,7,4,3,8,24,7,4,0,3,2,2,15,3,14,5,21,2,1,4,0,2,1,21,11,4,4,4,4,2,2,7,6,4,9,3,1,6,4,2,9,7,4,3,5,2,0,2,16,1,7,1,2,3,4,10,9,9,2,5,4,2,8,4,3,12,1,7,6,6,1,5,6,6,5,1,3,5,13,1,12,10,5,5,2,10,9,2,5,6,6,3,6,1,0,2,0,5,4,5,3,0,0,5,2,0,13,6,7,7,5,5,4,0,3,6,1,5,2,3,16,7,9,5,4,0,5,2,4,4,3,8,5,2,0,0,5,13,2,2,2,1,5,0,3,0,8,1,6,0,11,2,4,7,4,3,4,3,0,9,10,7,2,3,0,3,0,6,2,2,2,6,6,2,5,5,2,3,6,10,9,2,1,2,5,4,5,3,3,3,1,7,9,12,6,10,0,0,5,6,7,0,7,6,2,0,8,4,1,0,5,5,0,1,2,2,0,1,1,10,5,3,0,5,3,3,4,1,1,2,7,0,1,4,0,4,2,3,4,1,5,10,7,4,2,5,4,1,7,7,1,7,2,0,5,2,12,2,4,8,4,1,4,5,2,8,3,2,2,7,1,4,0,6,4,5,2,2,3,2,2,4,0,3,1,2,0,7,0,3,9,4,0,3,5,2,2,1,0,1,2,3,0,7,6,3,1,18,5,0,5,4,17,2,3,3,4,3,0,5,6,6,0,3,5,5,2,1,4,2,13,1,2,0,3,5,1,0,1,2,0,2
international,0,9,15,51,3,7,5,23,6,0,17,14,8,70,3,3,0,5,2,2,3,9,10,8,8,8,5,7,1,2,3,54,63,4,17,33,17,3,6,1,5,4,1,4,10,3,23,7,115,27,10,9,7,70,6,3,10,9,1,8,6,12,1,4,3,2,20,0,5,1,6,0,1,4,30,1,12,0,26,4,33,2,5,6,50,4,4,0,14,0,4,2,5,7,14,1,9,1,20,3,3,12,7,1,3,6,3,1,3,0,8,3,9,8,0,4,7,0,18,25,5,34,1,24,1,0,1,0,4,2,8,4,1,32,4,29,1,1,6,2,2,17,10,3,2,45,3,9,2,4,23,2,3,6,8,3,4,18,4,20,1,1,1,6,0,2,1,17,2,1,13,22,12,0,4,2,44,0,2,12,6,1,5,1,1,10,13,3,15,12,1,1,3,1,1,4,4,4,6,2,12,3,3,4,9,2,4,5,5,15,33,3,9,8,2,1,0,6,4,2,4,6,4,3,10,17,15,4,2,8,11,7,7,12,9,2,9,1,9,4,19,7,0,5,8,3,1,2,42,2,8,4,6,2,1,3,3,0,0,7,0,9,12,8,2,10,1,8,5,3,36,26,5,0,1,3,4,7,4,1,10,0,10,9,0,5,3,3,4,1,4,15,1,1,7,2,5,1,4,7,0,11,0,4,6,0,14,0,1,0,4,2,28,15,5,6,8,16,10,6,8,1,5,3,12,4,6,5,0,30,0,1,3,2,0,5,11,6,2,11,3,5,4,6,0,0,8,12,5,3,3,5,1,10,5,1,2,1,7,12,15,11,12,6,1,1,8,4,5,7,1,16,0,3,5,3,5,1,4,2,29,1,9,15,3,2,1,3,5,3,20,0,2,20,16,6,12,0,7,2,10,5,0,0,2,6,2,3,37,19,4,2,11,9,5,4,6,1,1,0,2,9,12,3,2,5,4,2,1,6,2,5,0,10,5,3,0,7,3,0,0,5,6,11,2,1,5,0,9,0,6,7,1,5,22,11,0,2,3,8,5,5,12,6,2,1,5,5,5,1,5,4,2,2,0,5,3,9,11,0,2,3,1,2,3,4,7,2,1,0,19,8,0,2,6,2,4,4,2,5,5,1,2,0,4,26,0,2,3,3,1,0,1,5,2,4,1,4,3,3,3,4,3,6,1,5,11,7,7,11,4,4,3,4,12,2,1,12,15,1,1,1,2,2,5,2,1,4,6,1,2,1,2,19,15,0,8,1,3,5,3,0,11,4,5,1,4,0,12,13,2,3,9,1,5,1,4,0,0,14,3,2,8,5,2,2,0,0,2,0,5,9,2,3,15,1,3,0,22,5,16,6,0,8,4,0,1,6,5,0,8,23,13,2,5,4,4,1,8,1,0,0,1,5,0,1,2,1,2,15,5,4,2,7,8,0,8,1,1,2,2,4,2,4,3,4,1,7,0,115,0,3,1,1,1,2,12,12,1,6,3,1,45,15,8,7,14,4,3,4,7,2,9,63,5,1,3,2,1,0,2,7,0,3,6,7,5,4,0,1,6,5,3,8,4,7,0,6,1,5,11,6,2,1,1,2,2,0,2,4,5,4,2,7,2,2,1,1,7,2,4,2,2,3,0,2,1,0,0,2,1,8,3,1,0,0,7,1,3,5,2,0,3,3,1,1,2,32,0,3,1,1,10,6,1,4,1,14,7,0,0,2,3,7,8,2,11,2,6,9,1,1,2,6,2,6,2,0,1,2,0,1,1,0,15,2,0,0,0,2,6,4,2,3,0,1,0,4,3,2,2,2,0,11,0,2,0,0,5,2,4,1,2,2,0,2,0,9,1,3,0,0,55,9,2,0,0,7,0,1,0,0,10,1,2,1,4,5,1,1,2,1,0,9,0,0,2,22,0,4,4,5,1,0,0,1,2,1,0,5,3,1,0,12,1,3,3,4,4,6,18,0,0,1,1,2,3,9,9,6,4,4,1,2,8,2,2,1,0,3,0,2,0,5,1,11,2,0,3,1,0,0,2,4,0,7,0,14,2,4,10,6,2,1,2,7,3,2,0,4,1,5,2,9,10,2,6,1,5,3,3,8,2,0,0,1,1,2,3,3,0,2,0,0,1,8,2,5,1,2,1,0,0,1,2,3,0,1,7,1,0,0,0,4,1,4,1,0,2,2,0,1,0,8,1,0,0,2,0,0,0,1,0,2,0,0,3,7,8,1,1,1,3,8,1,0,0,2,3,4
strike,0,16,7,39,7,7,1,17,1,1,2,0,4,38,0,4,5,10,2,2,1,17,8,14,12,7,9,14,7,23,6,46,44,8,25,44,7,0,2,4,2,4,5,4,12,8,4,2,69,20,28,6,5,25,11,3,4,6,6,7,3,3,1,6,6,14,39,2,2,3,6,3,2,2,64,5,27,0,17,9,14,1,1,7,53,8,5,0,7,0,5,2,0,10,20,2,6,3,18,11,1,8,12,6,5,7,1,2,6,1,12,6,3,9,2,10,5,0,30,55,12,13,2,44,8,3,2,0,3,0,7,2,0,24,16,25,5,6,1,3,2,21,12,2,0,36,12,5,6,1,38,2,2,2,1,12,36,1,4,22,6,0,6,4,0,6,1,10,15,4,5,54,13,1,5,10,48,4,0,20,25,1,7,10,0,14,6,5,11,17,2,3,3,3,0,5,1,4,6,5,20,2,0,2,7,7,2,9,3,7,25,10,5,0,16,2,1,2,4,0,4,11,1,9,14,43,11,37,2,0,1,6,7,5,17,2,13,1,6,4,36,9,5,6,11,0,0,15,18,3,7,12,5,1,1,4,2,1,0,9,17,22,4,2,2,7,1,9,6,1,44,3,1,4,0,1,11,1,1,1,19,3,1,9,6,1,3,2,9,8,0,2,9,6,1,2,18,4,2,8,9,7,3,0,13,1,7,2,2,0,0,15,11,6,12,11,25,18,4,2,17,5,22,1,27,5,6,21,0,13,10,4,3,0,1,3,11,1,3,6,1,4,3,3,0,6,13,6,4,5,1,5,2,10,4,1,3,2,7,15,16,5,5,8,0,4,14,5,8,12,1,17,3,8,9,9,2,0,7,0,25,0,6,4,5,12,8,10,7,1,8,3,11,6,4,6,4,0,18,4,5,4,0,7,3,8,2,0,5,2,1,0,2,4,4,5,4,3,2,9,6,5,9,6,1,5,1,0,5,3,3,3,0,3,3,2,1,4,8,3,12,3,1,10,0,2,15,8,24,1,10,1,11,0,26,4,4,4,5,5,11,11,10,27,0,3,7,2,1,6,17,4,1,0,0,32,1,9,7,2,12,8,2,3,4,3,4,6,5,0,36,3,1,3,6,2,4,11,1,3,10,0,1,2,0,2,0,2,2,3,1,3,0,3,7,3,4,4,4,8,2,17,5,5,1,4,14,11,5,8,8,8,8,5,4,4,2,8,24,21,1,2,1,6,1,2,4,3,8,1,10,2,5,9,4,4,8,2,6,3,1,3,7,3,2,4,3,0,3,8,3,1,1,2,1,2,0,1,1,6,2,3,8,4,2,0,1,0,2,6,10,5,6,2,56,1,5,3,4,2,0,1,1,0,1,2,1,6,5,2,13,5,2,0,16,1,3,1,2,0,1,2,1,10,3,4,0,1,3,8,5,4,11,13,4,2,9,0,3,6,17,1,6,2,1,1,8,1,2,35,2,3,3,3,3,5,7,8,3,6,0,1,2,2,2,0,2,7,1,1,6,4,20,17,0,6,0,0,0,0,1,11,4,0,2,0,4,2,0,2,7,9,8,4,1,5,3,2,2,3,2,0,2,1,2,3,4,5,3,0,1,4,0,9,2,9,4,2,4,5,2,2,2,5,3,1,9,1,4,4,2,7,1,2,1,1,8,2,8,3,5,2,0,14,8,0,4,6,7,1,6,0,0,2,0,5,6,6,1,2,2,16,1,3,4,3,6,3,0,2,4,3,3,4,1,13,1,6,3,2,0,0,9,1,16,3,1,13,3,3,3,0,1,1,2,3,6,2,2,0,0,1,4,0,6,3,2,2,7,1,0,2,0,2,0,0,1,8,0,9,1,4,1,3,3,1,2,0,5,1,8,1,0,8,4,3,2,7,3,0,0,1,3,6,11,2,2,6,1,7,8,7,3,0,0,1,4,1,4,4,0,0,3,1,4,0,5,1,4,2,8,0,4,6,2,1,1,5,1,1,2,3,0,3,4,2,3,0,1,1,4,4,0,0,2,1,1,1,9,6,2,0,4,2,0,1,0,0,0,6,0,1,1,1,3,0,2,2,0,2,1,4,1,0,0,0,0,2,3,0,0,0,1,3,0,2,1,3,2,0,0,5,0,0,1,8,4,6,6,0,1,1,0,0,0,0,4,0,6,0,2,0,1,2,3,3,1,0,15,0,9,1,3,9,0,0,2,3,2,0,0,1,1,4,1,1,0,3,2,2,1,4,1,3,0,1,6,0,1,8
farmer,0,4,4,49,1,10,3,13,3,14,7,7,27,82,2,1,2,25,1,1,0,44,5,22,13,11,14,14,4,11,3,149,162,11,45,38,5,30,98,4,14,5,2,11,18,8,11,9,108,33,24,14,19,45,26,1,47,7,7,14,3,0,5,12,16,11,70,19,14,14,18,0,4,3,274,9,24,6,35,34,125,5,4,21,167,20,33,1,20,10,1,7,8,7,43,26,17,12,38,37,1,39,16,11,37,28,12,2,27,3,12,3,13,21,10,33,1,5,20,144,43,17,22,82,14,1,2,7,1,14,36,21,17,46,19,87,1,6,3,11,5,43,10,5,2,51,12,31,26,15,46,2,14,6,71,27,23,4,12,46,35,9,10,5,15,15,6,15,33,4,28,77,27,7,14,11,139,2,3,61,21,5,33,29,0,53,39,23,14,17,1,3,47,0,2,4,15,3,11,9,70,11,4,10,24,9,8,35,8,17,55,6,13,25,6,5,0,7,4,3,2,32,3,7,25,32,29,31,9,13,8,7,22,15,53,8,46,27,58,2,30,43,27,10,19,20,3,29,35,13,5,79,16,6,10,18,1,1,2,37,8,18,2,1,24,124,34,4,5,5,59,8,14,3,2,4,38,8,3,4,44,3,37,13,18,13,9,14,15,3,1,2,9,5,4,5,30,2,1,20,22,7,2,2,16,9,15,9,48,9,7,34,33,18,37,16,49,38,22,4,12,7,16,34,22,0,51,28,2,9,0,10,1,0,5,3,7,13,9,5,10,6,9,13,9,10,17,27,29,15,13,3,4,57,30,8,5,4,25,23,18,17,23,24,5,5,11,19,6,18,1,24,13,19,20,11,10,25,7,6,35,1,42,13,8,34,6,25,22,5,3,3,3,1,14,3,16,2,20,10,4,7,3,1,4,33,7,0,16,18,5,20,26,37,1,2,1,10,3,4,17,4,33,6,10,9,6,4,2,5,6,6,0,4,13,1,1,2,5,5,14,12,6,20,1,8,15,0,38,20,13,1,13,6,19,4,0,1,8,11,11,21,29,39,26,0,24,25,6,3,44,6,2,4,2,54,0,9,21,8,9,13,0,6,5,2,8,0,4,1,39,28,0,4,18,2,10,7,6,5,10,4,17,2,4,26,161,10,10,4,5,2,1,6,12,6,1,11,10,13,1,9,6,8,9,1,20,13,29,34,12,9,1,16,9,10,3,18,29,15,4,2,6,1,63,2,3,22,3,8,7,0,0,10,29,8,31,6,12,2,7,3,9,5,5,9,6,3,22,16,4,1,8,1,7,1,50,4,4,18,43,10,21,7,3,8,20,6,6,24,14,10,14,1,75,26,15,17,0,0,5,1,7,1,3,19,13,7,10,3,40,4,3,1,10,5,2,10,0,2,8,2,2,6,16,7,0,7,21,29,12,12,16,15,13,2,49,17,1,2,43,9,0,2,1,17,5,3,3,40,0,8,8,1,0,7,26,18,2,8,5,6,1,0,1,0,0,1,7,6,19,3,2,2,1,24,4,2,0,4,0,20,2,5,2,0,2,4,6,1,5,10,4,1,5,2,0,0,10,4,1,2,1,4,1,20,13,4,1,0,1,0,2,7,4,8,1,2,4,8,7,5,2,3,6,13,3,3,3,8,12,18,43,11,1,3,2,16,2,20,12,0,5,3,3,0,19,13,4,7,3,2,0,4,13,17,32,8,5,23,54,14,1,13,22,37,48,10,172,0,18,5,15,5,0,4,23,5,0,5,0,0,10,15,31,5,4,2,6,10,0,8,2,1,13,16,8,8,0,0,3,3,1,3,3,2,3,2,11,1,23,0,0,1,13,1,2,3,1,8,0,2,9,23,0,0,6,3,4,13,7,0,2,2,7,3,0,12,3,5,0,3,0,5,19,1,8,4,4,6,3,2,1,9,16,2,19,14,1,5,0,5,1,4,2,0,6,2,2,5,0,2,6,24,19,3,0,0,1,1,0,1,2,0,0,6,3,2,1,0,3,6,0,2,1,0,6,6,9,4,12,0,1,3,0,3,0,5,0,5,4,9,0,5,1,0,13,1,4,2,1,2,2,11,0,3,0,0,1,5,6,6,3,3,0,1,8,8,0,18,3,10,3,0,28,13,10,16,10,2,0,9,1,8,2,0,2,0,14,0,7,1,3,0,11,2,0,2,3,1,5,0,33,11,1,0,2,7,3,1,3,8,3,7,6,11,8,14,0,2,11,16,0,2,2,28,26,0,4,2
market,0,7,4,92,1,7,3,12,4,2,1,1,15,48,1,5,7,28,5,7,3,31,3,16,15,17,9,13,6,11,2,144,102,16,67,70,18,45,108,6,10,6,2,10,29,14,18,13,186,34,38,13,22,113,13,1,70,18,8,14,12,8,4,10,22,8,101,16,4,11,34,2,9,5,126,13,33,5,85,31,88,10,11,11,131,46,43,1,28,3,10,7,5,33,47,24,16,15,49,42,17,22,29,7,14,21,11,10,30,5,14,10,26,32,42,34,1,5,48,191,40,32,21,113,8,0,5,10,4,3,10,2,5,54,17,67,2,9,5,12,3,59,24,1,2,74,4,34,27,12,31,13,15,10,7,13,33,14,2,38,29,4,12,7,6,23,9,24,45,7,30,60,36,5,8,3,191,6,13,47,20,11,17,20,13,60,40,21,18,28,2,8,90,9,5,7,19,6,8,10,50,12,10,9,33,4,11,62,19,49,85,14,23,15,3,15,9,6,16,0,14,8,12,9,49,81,19,28,6,28,15,20,48,22,35,34,35,27,46,4,62,67,16,11,21,15,8,29,48,12,16,76,18,9,11,12,7,3,5,21,4,14,9,2,15,24,6,5,18,7,117,15,56,5,2,4,26,11,9,1,65,8,30,23,24,7,13,12,8,9,5,1,6,11,4,18,31,7,5,22,38,36,2,3,29,3,12,2,4,5,8,8,40,11,57,16,29,57,23,4,19,1,35,8,26,1,22,37,3,20,0,10,8,0,4,19,20,6,6,15,8,8,22,5,10,7,41,39,20,14,6,8,3,40,9,16,7,2,15,19,25,8,20,14,7,3,22,8,15,11,6,27,6,12,12,8,4,13,9,16,42,3,48,11,8,104,0,31,25,3,7,6,11,2,22,8,46,4,26,7,8,4,6,3,6,10,8,2,86,21,1,15,48,16,22,5,2,7,3,3,4,10,23,8,4,3,9,4,2,15,15,13,6,4,5,3,0,5,3,7,11,12,4,37,6,9,27,4,31,23,23,6,16,8,42,7,1,3,5,41,14,20,17,18,9,12,66,35,6,0,17,10,6,7,4,10,1,8,30,11,6,21,2,3,7,3,14,4,6,0,45,36,1,4,37,2,7,7,4,9,10,5,6,8,10,29,57,23,19,10,12,9,4,9,21,6,11,13,12,10,6,10,13,9,9,4,24,19,9,20,13,8,1,8,11,10,10,15,27,31,8,5,1,63,1,12,6,15,5,1,4,4,1,46,12,8,45,9,9,1,14,2,16,6,20,15,19,11,27,50,9,6,6,1,6,6,32,10,4,22,38,11,25,11,8,1,8,5,7,10,16,18,12,5,44,15,11,24,18,11,18,5,11,3,5,19,6,5,7,5,26,9,0,14,17,7,10,19,9,4,18,13,3,20,7,10,6,12,7,35,39,12,14,7,7,5,4,5,1,7,18,2,1,12,3,26,21,2,6,116,42,18,9,2,6,15,57,17,2,24,8,4,3,18,2,1,0,11,3,7,18,10,10,2,8,3,0,5,3,6,4,37,3,11,11,1,4,7,7,14,7,22,8,4,2,7,8,0,15,12,19,1,4,3,7,10,12,7,6,3,5,8,7,24,23,0,2,3,2,4,16,3,1,6,3,14,10,1,7,10,8,31,41,3,16,1,7,10,24,13,15,8,5,12,8,3,10,19,17,11,11,10,5,10,3,10,7,11,5,39,42,16,7,10,18,86,7,6,36,7,17,6,11,7,3,11,25,2,3,11,5,2,10,40,12,14,11,8,5,13,5,1,0,4,11,13,9,6,3,0,3,7,9,3,4,2,9,2,9,5,39,4,11,6,11,0,8,6,5,2,5,4,2,11,20,7,3,4,6,8,10,5,3,3,4,16,2,20,3,5,3,3,0,3,15,11,13,13,4,3,5,21,2,14,8,3,10,47,4,2,9,4,5,8,8,6,6,2,3,10,0,4,32,30,6,8,0,2,2,2,1,4,5,2,3,4,5,7,2,7,8,7,6,1,5,4,2,2,11,1,7,1,1,7,2,2,1,18,13,4,2,23,2,12,12,2,9,7,5,2,7,5,4,25,8,3,2,2,4,6,3,6,10,7,9,6,9,7,4,11,2,9,14,8,36,22,17,24,52,4,1,6,3,4,3,12,2,5,21,3,51,8,5,2,3,6,6,2,1,8,2,10,14,5,1,2,2,8,5,1,2,4,10,40,3,8,1,23,5,1,2,5,4,0,21,9,19,4,1,2
delay,6,25,8,139,4,4,6,20,4,0,18,19,14,39,7,3,5,7,3,3,8,44,2,23,23,15,7,7,4,19,1,159,82,6,46,28,20,6,6,1,8,6,3,5,36,10,25,16,193,8,27,6,10,17,8,1,38,33,2,26,8,3,2,16,15,1,50,1,8,9,4,8,4,5,50,14,11,8,79,15,35,1,20,3,126,19,9,1,35,1,17,2,1,23,21,7,13,5,22,9,22,16,47,7,10,19,4,6,9,7,3,7,10,8,5,24,10,5,39,99,21,11,6,43,7,2,1,5,2,2,14,2,1,36,7,57,11,3,2,5,0,16,22,6,5,64,6,11,12,16,38,6,20,11,4,37,17,2,3,5,19,7,9,1,1,9,2,16,21,8,13,45,18,4,2,8,139,3,16,39,22,12,7,11,3,10,28,18,20,56,2,11,8,2,5,2,38,4,5,8,29,2,3,13,11,9,6,30,12,14,65,4,18,7,5,5,2,2,12,7,2,14,1,15,32,71,16,25,3,5,8,13,8,20,22,3,33,4,10,2,96,19,6,1,10,4,7,11,44,5,25,17,23,1,10,26,8,2,5,8,0,19,25,3,2,34,2,1,6,6,104,5,25,4,2,1,12,5,10,6,27,4,1,6,5,0,3,11,15,2,6,5,23,4,2,7,29,6,3,15,35,31,1,2,11,0,22,2,3,2,3,22,25,4,24,10,11,48,7,1,48,3,22,6,28,7,6,31,4,20,4,12,8,3,4,13,5,8,1,13,13,5,13,8,10,3,26,49,6,4,8,13,2,25,11,3,0,1,16,18,19,4,7,13,1,5,32,6,7,4,6,5,1,2,9,14,6,1,11,4,60,0,49,9,4,23,9,25,20,1,35,5,13,30,25,5,61,2,31,4,20,1,3,1,4,4,5,4,9,7,2,6,8,8,4,9,8,5,4,0,0,4,28,10,2,2,0,6,13,4,2,7,4,8,5,8,2,19,9,5,15,4,3,7,1,5,1,3,23,6,3,3,2,9,48,9,1,6,2,29,8,14,18,10,2,0,8,15,7,2,8,6,2,4,3,6,0,10,14,6,12,12,1,5,5,23,16,1,3,9,38,37,0,1,4,3,8,17,5,7,8,3,3,0,4,2,5,12,14,6,5,6,17,2,17,16,9,9,6,7,3,14,9,12,2,8,26,7,30,20,15,4,4,5,19,3,19,13,19,15,2,2,2,2,12,1,1,12,17,7,25,4,10,40,4,5,23,2,5,11,12,6,24,7,15,17,9,14,24,26,10,7,24,9,1,6,5,5,11,11,4,11,11,7,9,3,7,7,1,13,9,19,14,5,16,5,0,3,74,15,20,3,13,24,19,16,5,24,10,0,16,39,14,2,32,5,13,0,9,7,13,0,5,13,1,4,4,9,12,15,4,26,14,12,4,1,6,5,3,7,8,2,10,8,14,22,4,5,13,114,7,4,10,13,5,6,17,8,8,14,7,2,29,20,16,32,2,8,25,11,10,8,35,97,51,8,4,9,2,9,2,42,14,10,8,7,11,4,5,7,16,11,9,10,4,21,7,6,10,12,1,2,7,6,4,10,18,10,3,3,3,7,3,26,12,8,11,3,12,3,7,5,3,6,1,7,5,1,7,6,7,15,0,2,8,4,12,3,32,3,11,6,5,10,7,2,11,5,2,5,8,0,1,6,0,11,5,7,4,4,3,18,6,3,10,11,17,4,2,18,5,4,0,9,2,20,6,0,8,9,6,2,12,1,6,8,3,1,3,8,12,9,3,3,6,12,8,7,2,10,5,5,8,14,6,1,4,7,29,7,3,1,5,11,3,3,2,10,3,11,19,3,7,8,7,3,4,14,2,3,6,10,6,1,11,1,14,35,8,9,20,9,16,10,6,10,7,13,2,10,16,14,5,0,2,3,4,5,5,2,10,3,1,3,7,11,6,10,4,12,3,5,4,8,11,6,9,15,10,4,8,15,6,8,18,6,10,6,6,3,0,12,1,8,11,8,5,6,4,3,3,11,1,5,10,3,1,19,3,22,2,1,3,7,12,3,3,10,1,0,6,6,2,9,0,14,3,35,12,5,3,6,5,3,5,3,3,4,5,11,0,6,3,2,0,12,14,7,9,9,6,6,3,4,5,3,3,2,21,4,1,10,6,6,2,14,6,0,2,5,4,7,6,0,7,2,0,4,7,0,7,7,7,4,7,5,6,1,20,0,0,0,5,1,1,2,1,11,0,0
revolution,2,11,1,33,12,3,8,15,3,3,39,4,7,60,3,20,7,3,4,0,2,23,15,7,6,21,8,12,18,8,7,56,74,6,22,77,40,4,6,3,1,17,0,2,10,4,5,11,281,26,23,7,19,50,3,0,13,36,3,12,5,8,2,3,20,6,56,3,6,21,2,1,2,4,52,9,15,4,49,36,10,0,20,6,186,6,4,0,87,1,4,11,0,11,61,0,9,1,18,2,4,8,8,10,8,8,1,2,38,21,6,6,1,5,0,16,58,18,14,96,5,41,2,85,23,4,4,1,1,0,9,5,3,11,22,14,7,7,3,25,6,28,40,5,19,41,7,12,3,0,65,2,9,1,3,7,9,1,46,3,4,0,1,35,0,1,4,15,11,12,41,53,14,0,1,7,72,1,4,9,5,22,0,10,4,7,21,12,53,63,18,8,3,1,0,5,2,2,19,6,3,0,2,8,33,2,1,16,6,17,51,8,7,1,4,1,0,0,3,0,1,24,2,10,29,19,27,20,0,1,3,22,3,4,31,2,26,4,6,1,39,13,5,6,15,1,5,38,5,3,0,8,16,2,4,4,24,18,1,20,0,86,1,17,2,9,3,8,13,5,142,3,8,1,4,0,44,1,3,0,30,2,2,13,7,0,4,2,3,0,70,2,3,1,19,6,37,1,2,8,29,6,0,51,5,3,7,2,7,1,2,9,6,3,3,6,8,25,10,2,23,2,12,0,29,1,4,29,2,7,3,0,6,3,9,4,14,9,3,54,5,8,3,1,3,4,28,23,12,2,4,1,2,4,3,3,5,1,8,8,5,1,4,11,3,5,19,10,3,7,1,7,0,1,7,3,2,1,10,5,21,2,6,4,2,74,1,59,14,1,13,3,3,3,9,9,9,3,68,4,12,0,4,1,2,4,4,1,5,5,5,7,2,7,4,6,1,6,0,3,0,2,7,42,0,2,4,4,27,42,24,69,4,107,1,2,1,9,4,3,11,6,1,21,3,2,5,4,15,7,4,5,2,8,23,3,1,10,3,20,15,18,11,17,2,3,5,25,2,0,37,2,0,5,1,12,4,7,28,4,6,7,4,2,8,4,7,7,9,19,132,17,1,18,4,1,2,6,11,6,8,3,3,0,1,3,3,10,2,0,1,4,4,3,29,6,2,16,5,6,2,27,5,30,4,3,32,7,8,8,1,3,2,15,3,7,6,18,31,12,2,1,4,3,6,1,1,10,10,22,23,0,2,10,0,1,13,0,0,2,3,2,3,0,12,1,12,0,15,9,11,9,2,0,1,6,0,4,2,5,1,3,3,10,12,4,19,3,0,9,7,11,2,0,10,5,0,0,35,15,3,2,3,1,4,3,1,8,3,0,13,3,3,12,5,6,14,0,4,0,5,0,2,8,0,4,1,2,4,31,2,1,13,13,3,2,3,1,0,3,3,1,0,20,4,8,0,42,1,231,12,2,0,1,4,4,10,14,30,27,7,6,16,10,1,1,0,3,13,6,6,2,57,0,9,4,0,1,100,0,22,14,6,1,2,2,8,3,0,1,1,8,3,0,3,3,24,3,3,3,3,0,4,1,0,2,8,1,0,2,15,103,2,18,2,7,52,12,2,1,2,1,3,3,1,0,6,2,1,10,3,23,3,0,5,0,3,2,13,8,5,1,3,17,2,2,5,1,4,2,16,4,0,103,0,10,12,15,1,1,0,6,41,0,11,6,27,1,2,3,2,5,2,1,3,18,5,1,4,7,0,2,8,6,3,1,6,28,3,12,4,1,0,2,23,4,2,1,2,0,4,2,3,0,6,3,1,4,7,2,1,5,0,4,0,3,2,2,4,3,5,0,0,0,0,4,3,5,3,3,2,1,8,1,4,3,9,22,2,3,3,1,1,0,1,3,4,1,0,4,7,4,5,2,0,0,3,2,1,1,2,5,2,2,1,1,4,3,21,0,0,0,1,5,9,6,1,9,6,0,0,4,2,3,1,1,1,2,2,5,18,5,1,4,6,171,6,0,0,3,1,3,3,10,1,121,14,4,4,8,0,2,4,5,9,36,0,1,1,1,5,7,1,0,0,3,3,19,2,3,0,0,0,3,3,1,0,7,1,3,2,7,0,3,1,7,11,3,4,3,0,4,2,0,1,2,0,0,5,2,0,0,2,0,1,55,0,0,5,0,3,1,3,0,2,1,0,5,2,1,0,2,0,3,1,0,5,2,10,0,4,2,2,0,0,0,2,8,5,4
afford,12,23,10,205,14,15,7,45,5,9,36,20,14,110,9,11,9,25,7,9,5,63,19,32,34,19,13,16,10,14,10,254,245,10,107,64,65,19,27,9,17,8,9,5,46,33,59,12,378,31,76,8,28,46,41,10,125,30,3,33,30,17,5,27,23,9,159,20,12,14,25,11,5,9,126,22,31,11,119,27,115,6,22,7,329,38,16,6,46,4,14,24,4,38,88,23,16,8,55,35,22,33,43,20,11,42,8,18,24,8,29,18,20,22,14,61,5,8,82,350,71,48,53,83,8,4,13,12,7,7,28,10,8,94,27,61,10,7,4,11,5,47,50,2,3,97,13,25,24,22,94,3,21,15,13,27,48,9,14,28,27,10,21,3,13,16,6,26,52,15,27,115,37,3,10,27,220,5,21,63,40,25,15,25,15,51,45,33,67,62,3,13,12,2,6,5,36,12,14,18,45,11,16,18,49,16,6,83,34,44,122,11,27,34,4,40,11,9,18,3,5,35,15,22,65,126,43,56,6,19,19,22,28,17,92,92,46,13,16,7,123,54,23,11,31,31,13,43,69,15,24,46,29,25,27,26,32,5,7,27,6,39,49,9,15,66,7,11,26,9,219,17,59,13,7,2,40,23,15,5,92,12,10,32,25,5,39,32,31,8,6,6,27,9,3,26,63,19,6,42,40,47,6,4,21,2,37,6,6,6,6,15,51,12,66,30,23,65,25,12,111,12,45,12,88,16,19,49,12,41,6,18,17,10,10,19,27,14,14,16,20,18,23,18,13,11,83,65,42,33,19,28,8,57,27,12,7,8,26,38,27,16,24,35,12,7,55,13,18,24,8,21,16,27,13,34,18,16,27,15,92,1,52,16,8,58,11,49,40,7,30,5,16,8,62,30,88,11,55,9,34,7,6,2,13,17,26,6,51,31,5,19,8,34,13,21,8,13,9,2,6,12,17,14,7,8,7,21,17,22,40,7,0,10,5,5,0,23,21,5,26,82,17,25,3,3,13,12,47,21,28,12,7,13,75,11,0,15,11,42,22,36,48,23,11,13,55,17,10,2,28,12,11,13,4,35,7,15,31,21,16,31,6,6,18,12,18,3,4,1,91,63,4,10,33,16,6,19,6,18,11,9,8,14,10,61,6,34,5,4,22,12,10,11,31,27,10,14,21,15,6,42,14,39,8,7,42,15,26,38,9,11,6,22,6,7,25,16,73,31,9,4,3,22,15,12,10,1,28,11,51,7,9,77,8,20,66,16,9,15,42,0,32,4,25,28,16,8,63,50,21,22,19,2,8,16,17,12,8,14,24,23,36,24,19,3,6,12,3,20,41,54,28,8,42,9,29,9,69,38,28,1,10,1,12,38,7,33,8,15,51,28,10,19,40,22,41,14,6,11,29,17,10,44,9,13,12,15,23,45,26,27,53,26,12,8,17,14,7,30,24,9,16,31,17,30,10,10,5,213,36,8,17,7,20,20,79,23,12,18,11,12,24,32,15,6,3,16,16,24,30,15,96,22,44,6,9,15,2,7,13,29,22,13,22,13,27,9,7,19,20,65,28,29,13,16,19,3,32,15,8,11,14,7,18,12,23,11,5,5,12,16,10,35,37,37,10,16,11,10,16,12,8,31,3,14,13,8,7,30,15,30,16,12,13,12,32,18,46,21,20,8,6,23,28,7,34,11,8,14,22,14,5,4,7,10,12,19,7,38,34,24,4,10,44,28,32,13,27,12,20,2,15,29,10,24,14,4,14,18,12,7,18,11,6,13,24,30,19,21,14,16,14,6,10,32,17,13,9,4,13,6,12,7,15,3,13,13,21,11,11,1,22,14,14,9,9,8,3,15,10,13,6,11,11,2,11,7,24,12,13,10,32,13,9,13,27,32,13,9,14,21,11,14,14,7,18,10,8,6,17,34,11,28,7,5,14,22,12,1,15,10,17,5,4,28,10,9,6,21,9,6,9,22,6,6,13,10,21,5,3,2,9,10,12,7,5,6,6,11,7,19,16,12,29,7,16,10,4,3,16,10,12,15,10,3,3,19,6,30,12,11,9,10,19,3,11,21,5,6,20,16,8,46,3,8,8,27,6,19,6,6,13,14,6,5,33,8,14,24,6,32,8,11,20,45,20,17,65,14,6,12,6,6,7,4,5,15,24,12,5,11,3,4,3,16,10,3,8,11,8,10,19,10,14,22,6,22,13,8,13,9,12,22,12,12,23,4,19,5,7,3,14,0,13,11,7,7,5,3
arise,17,50,14,151,7,1,7,39,2,6,34,26,4,73,2,4,10,18,3,5,5,50,7,25,30,9,5,7,5,19,16,212,154,9,57,57,48,13,9,3,6,3,11,4,33,18,28,21,435,20,50,6,10,31,2,12,90,39,1,16,47,21,2,18,16,9,68,3,40,21,20,12,8,6,81,8,6,13,112,24,46,0,21,10,378,21,12,0,38,3,13,6,0,43,58,8,18,7,41,8,23,27,64,10,16,38,9,6,15,4,11,6,4,18,1,29,6,8,91,190,34,21,18,67,9,4,3,6,8,1,15,4,6,53,29,26,16,5,9,13,2,57,51,5,3,81,2,13,21,20,84,1,26,7,8,38,27,5,10,3,13,2,7,5,5,2,3,19,29,21,30,96,17,1,1,11,231,1,15,28,43,8,0,11,9,14,28,32,113,78,4,11,4,1,2,3,16,7,9,17,38,1,5,15,20,13,4,35,8,29,58,9,29,6,2,0,5,4,24,3,5,22,5,31,63,155,14,26,7,14,19,18,14,31,26,43,41,3,3,16,85,40,4,7,17,10,4,17,61,5,18,23,22,11,20,22,17,1,11,19,6,28,36,14,4,60,4,6,5,11,228,6,43,10,6,0,15,17,30,2,44,11,6,26,12,3,2,12,12,0,6,4,20,7,3,9,47,3,13,31,36,47,1,3,25,1,23,6,10,1,4,11,39,3,39,18,18,37,11,11,87,13,28,2,97,18,13,24,10,27,4,8,15,7,8,10,22,17,4,24,18,10,17,11,14,8,70,63,14,6,19,12,18,24,36,12,8,7,24,34,26,3,13,19,11,0,53,8,4,20,5,28,9,15,18,16,10,2,26,10,117,0,52,19,1,26,16,24,31,4,46,6,14,31,44,10,93,9,28,13,40,1,8,1,4,5,13,5,25,10,12,12,5,27,13,11,5,7,3,0,8,7,25,9,2,10,3,17,13,11,17,5,5,11,9,8,0,29,10,9,29,27,5,7,3,5,2,12,33,10,12,8,0,5,103,13,1,11,8,51,15,31,45,40,3,0,10,12,4,1,14,3,6,1,3,23,7,19,19,9,5,19,5,14,6,14,23,5,10,4,73,61,4,4,13,12,9,20,12,17,11,4,8,1,14,40,0,16,7,3,4,8,5,13,14,29,4,14,1,13,5,32,13,36,21,14,28,19,20,41,11,5,7,7,22,10,13,12,44,34,9,6,8,3,5,17,10,28,1,14,54,13,12,73,14,7,31,12,7,16,32,6,47,6,28,21,20,12,48,41,12,14,21,10,6,9,12,5,7,17,6,13,12,13,10,17,3,13,7,15,33,62,13,9,31,8,14,1,138,15,29,6,6,11,9,24,12,32,9,5,41,29,18,9,80,10,31,3,10,11,19,10,11,26,1,17,11,18,13,33,15,30,36,22,18,6,23,13,4,19,18,2,12,27,13,25,8,7,5,265,19,4,7,14,4,21,39,17,11,19,12,8,33,65,15,11,18,21,48,15,34,20,36,59,135,10,6,10,4,5,3,32,31,14,16,17,16,6,8,22,20,14,26,22,15,10,14,16,15,20,11,13,8,15,8,6,35,9,10,7,5,10,18,26,23,14,2,18,11,3,12,8,8,20,0,6,12,2,5,19,13,19,9,7,19,4,19,8,51,8,16,8,2,8,15,7,14,3,9,17,14,6,4,14,4,22,15,14,4,15,13,24,6,3,22,24,11,7,8,32,5,10,4,34,8,29,18,6,11,14,11,7,16,11,12,14,6,3,10,17,11,6,1,9,26,22,4,10,6,8,12,4,15,14,6,4,16,4,25,5,12,12,12,11,5,4,8,11,7,14,17,4,8,13,3,7,6,9,17,3,17,7,13,5,11,10,19,54,13,7,10,18,14,22,13,17,15,10,10,36,33,40,10,11,5,10,9,21,11,2,12,9,12,5,4,13,5,8,22,16,3,3,14,12,7,8,14,18,15,6,17,5,8,7,13,9,4,4,6,9,7,6,0,4,26,24,5,8,4,2,6,6,3,14,7,5,22,9,6,19,2,11,8,23,18,8,5,6,4,4,10,35,5,20,11,24,8,28,27,7,9,5,19,11,9,4,7,8,5,7,1,15,5,11,10,21,12,33,43,15,1,7,4,17,6,5,8,11,31,7,2,6,10,11,2,25,10,2,8,10,12,10,1,7,6,12,2,13,9,5,14,13,4,14,6,8,10,3,14,0,3,0,2,0,0,5,1,2,4,1
connection,4,18,8,112,3,6,1,12,0,0,17,12,7,28,4,8,5,14,5,0,5,23,1,21,36,13,6,6,6,7,2,124,74,3,36,24,14,2,4,0,4,4,3,3,13,14,15,10,228,8,19,3,6,9,8,1,31,24,2,8,11,0,1,10,10,6,28,4,2,21,11,5,5,4,42,9,9,5,32,15,32,0,15,2,190,13,8,0,29,5,13,2,3,14,39,18,9,2,16,9,17,29,19,6,12,31,3,2,10,3,7,6,10,6,0,13,7,5,42,100,24,11,3,32,4,1,2,0,8,3,7,1,4,41,6,39,9,6,2,1,1,20,12,1,1,42,8,8,15,18,48,0,5,13,3,12,16,4,7,6,10,1,5,6,1,4,10,13,21,4,13,64,15,1,1,2,101,3,7,31,13,9,4,15,4,7,23,21,37,30,2,1,5,1,1,3,19,4,8,10,24,2,2,8,15,3,3,30,7,17,47,0,22,2,1,0,0,3,11,6,0,15,6,6,23,93,32,10,7,16,9,9,9,21,22,24,12,8,8,7,35,24,4,2,6,7,2,12,38,3,12,16,6,3,7,7,10,3,8,18,11,16,17,5,7,40,0,4,7,7,101,13,14,5,6,1,15,15,22,2,24,9,5,15,9,0,2,6,11,2,8,1,13,6,7,7,24,5,4,9,16,27,4,7,11,1,22,1,4,2,2,26,10,8,23,9,17,23,19,4,25,7,21,3,45,5,3,9,1,22,1,7,10,10,5,18,9,7,3,9,5,8,6,13,3,6,29,31,20,2,7,7,10,46,27,6,0,4,8,17,24,5,12,14,10,0,25,3,12,12,6,15,3,14,7,36,8,3,6,6,37,2,34,13,4,35,12,22,10,5,19,2,4,7,36,5,48,7,19,3,10,1,2,0,7,4,3,0,11,6,3,16,1,18,6,5,2,6,1,0,1,4,10,10,0,4,2,19,6,10,10,6,0,15,1,2,0,10,5,4,11,8,9,8,0,4,3,5,27,2,13,7,0,1,39,6,0,3,10,14,6,16,16,23,5,7,8,18,10,1,13,5,4,0,4,9,1,10,14,7,3,2,8,3,2,6,12,1,4,3,42,35,0,0,8,3,2,18,5,10,8,5,4,1,12,35,3,8,4,4,5,3,7,12,8,16,4,7,4,2,2,13,9,27,8,1,24,15,21,15,8,1,2,6,9,1,19,9,20,22,2,1,1,8,1,7,22,11,14,1,34,3,2,32,5,10,21,3,9,9,24,5,25,2,5,15,14,3,23,44,6,8,17,2,6,4,15,9,6,9,1,10,14,11,3,4,9,6,1,11,6,30,13,4,25,2,6,1,19,20,18,6,2,2,4,18,2,17,3,5,31,25,10,5,24,4,10,7,13,1,5,3,4,13,4,8,10,13,14,25,8,39,23,14,8,3,10,11,3,4,7,0,9,16,9,24,2,10,4,124,6,1,6,11,1,5,29,11,2,11,6,2,6,18,7,3,5,8,13,8,13,6,8,27,30,5,6,6,10,2,11,8,9,13,8,7,14,1,1,19,6,8,13,19,7,5,9,8,12,13,21,5,8,16,14,4,7,3,1,1,2,12,0,20,16,15,9,8,6,4,4,3,6,27,4,6,5,4,4,7,13,8,2,4,5,5,11,2,14,11,11,2,2,9,1,2,11,9,1,1,7,6,8,12,2,8,12,12,12,24,17,11,9,7,9,6,13,4,7,6,4,4,3,10,2,10,5,2,8,4,2,7,5,5,7,6,4,0,5,11,7,15,4,5,29,7,16,2,1,6,3,3,5,2,0,3,7,6,15,5,4,4,5,4,1,3,5,7,3,7,2,2,2,10,6,4,5,7,5,3,4,5,21,1,4,3,5,10,6,3,4,5,4,6,3,15,9,5,7,11,6,15,5,4,1,9,8,1,4,0,6,6,7,3,3,6,3,7,8,16,1,6,5,10,8,4,0,12,7,8,3,3,4,1,9,1,1,3,1,4,7,4,0,1,5,14,1,3,5,1,4,2,1,9,10,9,6,5,6,19,3,16,5,7,8,6,4,6,1,2,4,3,1,8,2,5,0,12,1,3,8,1,3,4,3,1,6,5,2,8,1,6,9,1,10,12,11,6,32,1,2,1,0,3,5,1,5,10,14,3,5,1,1,5,1,6,4,0,0,4,1,2,5,3,3,5,4,3,14,4,8,5,2,4,8,5,5,1,10,0,1,4,3,0,0,2,2,4,1,0
constitution,20,283,114,833,22,13,12,482,8,17,80,35,14,116,48,74,37,53,25,18,13,172,54,125,54,26,58,63,32,74,27,441,338,27,160,157,94,7,9,11,22,57,1,1,111,51,89,37,1778,41,138,14,36,36,14,4,231,31,8,43,44,2,14,30,80,23,696,29,22,21,18,20,24,19,244,32,32,9,245,52,56,1,23,11,790,70,17,1,71,3,11,28,0,86,132,6,37,4,77,11,55,63,128,34,20,84,4,5,32,9,73,29,9,67,1,67,20,3,403,584,66,19,31,120,22,18,6,11,8,0,17,5,15,117,92,95,25,8,32,35,13,76,61,16,11,195,25,21,20,23,536,1,63,9,7,188,87,9,54,8,7,7,22,8,0,7,12,46,51,51,36,341,42,0,8,33,558,22,39,53,70,88,0,23,19,43,105,41,164,76,7,11,4,0,2,9,26,9,32,70,36,3,3,42,89,37,25,105,25,41,212,14,178,33,6,13,1,2,75,3,10,80,13,50,206,531,43,80,9,12,32,25,21,96,97,48,98,8,6,19,298,100,15,25,53,10,15,50,215,40,36,35,43,16,37,48,35,5,20,57,1,57,111,21,14,74,11,29,43,19,471,9,38,38,17,0,94,17,48,8,172,18,2,68,40,3,2,36,62,13,8,5,125,4,3,23,63,13,62,62,78,114,0,13,40,5,41,15,16,1,1,90,67,19,37,28,36,104,33,32,114,22,114,3,292,63,15,79,11,143,132,27,37,13,37,89,32,13,11,58,31,22,45,51,12,8,199,159,43,11,50,59,28,72,91,2,53,10,57,47,89,12,6,40,15,6,143,43,13,75,13,89,14,13,31,40,37,4,65,21,521,29,154,24,4,60,26,60,126,14,86,11,135,89,98,45,222,21,74,6,68,5,14,3,20,18,21,3,16,57,1,37,0,48,18,29,4,18,2,1,14,18,79,89,3,18,10,28,66,57,35,9,12,28,7,8,5,5,24,20,41,58,15,10,5,5,6,9,87,26,50,41,15,18,98,54,9,122,28,97,35,83,92,66,13,8,32,25,17,1,45,3,8,12,2,27,25,125,34,11,44,41,10,25,12,72,17,13,28,18,123,131,6,14,16,22,5,27,27,47,41,19,11,0,6,102,1,78,15,39,9,34,41,31,67,100,17,36,8,40,9,79,65,233,81,19,82,33,40,97,26,21,11,44,42,29,60,43,128,39,14,2,10,7,4,25,23,51,54,34,1,54,38,212,21,26,52,14,31,41,93,13,124,7,57,44,56,37,127,100,55,32,45,38,11,46,6,27,30,37,10,39,21,69,42,6,16,24,35,36,99,83,25,9,37,16,19,5,42,45,135,9,11,44,2,66,14,171,9,29,52,31,47,15,123,33,95,5,40,11,32,21,4,67,2,11,10,14,54,144,35,58,113,180,38,9,13,12,7,42,34,10,55,120,9,25,10,10,49,458,21,9,25,123,23,36,167,53,47,30,64,27,176,14,11,22,6,22,20,20,55,25,67,163,62,43,3,12,1,10,5,89,34,16,30,49,63,10,21,7,66,16,39,14,9,13,44,28,60,84,0,21,8,16,44,16,35,12,31,38,39,12,25,122,67,36,10,26,31,8,48,22,23,87,1,28,7,3,20,65,33,38,3,17,10,11,18,21,196,36,18,10,5,9,6,17,35,8,12,21,43,6,1,9,2,35,42,29,15,4,3,18,22,2,67,36,20,17,6,10,19,1,0,73,17,45,13,7,1,47,0,21,40,6,35,7,20,119,29,37,13,64,17,14,28,85,8,27,2,34,9,11,83,32,13,6,29,12,53,12,9,3,14,23,1,9,15,9,18,66,23,18,1,5,1,36,4,83,25,24,12,7,67,35,43,43,29,44,47,28,18,135,54,55,17,14,19,8,5,32,60,154,38,30,5,14,15,11,52,4,11,43,24,10,14,10,23,58,33,11,3,41,10,37,23,35,0,19,61,1,0,10,10,17,1,5,10,9,6,31,2,20,0,3,7,9,7,60,7,12,21,24,9,27,186,7,4,14,3,68,19,19,34,5,106,17,3,15,9,9,37,12,33,58,3,52,0,17,3,19,16,5,46,23,42,4,4,21,7,25,16,30,1,5,11,34,31,11,76,7,1,25,24,9,18,9,16,10,68,8,0,18,19,1,11,11,2,1,126,17,29,70,12,14,12,9,0,41,11,49,0,27,23,35,17,27,42,3,14,0,9,6,12,0,0,2,0,18,6,2
execute,2,25,2,107,7,2,1,20,3,0,8,5,4,21,5,1,1,8,1,4,4,22,2,13,6,4,4,3,2,11,9,99,55,6,31,18,22,1,6,0,1,2,3,2,17,10,14,8,182,5,20,1,1,8,0,4,58,11,1,4,9,6,0,7,4,2,44,2,2,3,2,2,6,7,22,7,5,4,40,15,14,0,9,0,128,7,5,0,12,1,2,0,0,15,16,4,5,5,16,2,15,12,12,7,2,16,1,2,5,1,10,5,5,21,0,16,3,5,89,58,20,7,1,16,3,1,2,4,3,0,3,3,0,19,13,16,3,5,3,2,1,15,14,1,1,47,5,1,4,7,53,0,12,2,0,9,10,2,5,1,2,1,2,1,0,1,0,7,10,4,3,39,8,0,0,4,79,2,5,7,10,4,7,7,11,6,15,11,12,20,1,5,2,0,1,0,8,0,3,9,9,0,1,11,21,6,5,19,4,10,44,3,35,2,0,0,0,1,9,3,0,6,4,6,27,147,8,10,1,3,6,7,2,15,18,6,15,6,0,4,35,14,1,2,4,0,5,6,19,3,9,8,6,8,8,12,8,3,2,10,0,13,16,6,3,17,0,3,3,2,95,5,8,2,3,1,16,2,7,4,19,5,3,10,2,0,2,14,8,1,4,3,24,0,3,2,28,6,3,15,9,15,0,1,2,0,7,4,1,1,0,3,9,1,8,7,2,8,6,1,27,7,12,1,41,8,2,11,4,16,7,3,7,3,5,16,7,9,4,7,6,7,2,5,1,1,19,36,18,1,4,10,5,17,12,2,4,3,3,3,10,3,0,5,2,0,26,0,3,14,0,9,1,1,6,18,14,2,7,2,43,3,33,3,1,20,7,6,13,0,22,2,16,13,22,12,35,2,39,2,14,1,0,2,3,1,2,0,9,1,1,4,1,5,7,4,1,1,2,0,1,6,10,6,0,2,1,8,7,6,9,1,0,12,2,4,1,2,3,7,19,13,3,5,0,0,4,1,9,2,3,6,0,0,15,6,1,16,1,16,4,8,21,8,4,1,2,5,6,1,5,1,1,1,0,6,3,13,12,4,1,4,2,2,3,9,3,0,5,11,42,16,1,5,3,9,0,8,7,4,2,2,1,0,4,8,0,4,1,2,2,4,7,7,9,16,1,6,2,5,3,7,5,20,4,3,15,3,5,14,8,5,5,5,2,5,15,8,17,9,2,1,2,0,4,4,0,7,13,3,54,1,7,25,3,2,7,4,6,4,12,6,27,4,12,7,5,3,21,13,9,4,6,12,5,1,1,1,2,9,3,12,8,5,9,0,0,4,2,3,11,21,9,1,5,0,0,0,51,9,14,1,4,5,6,8,10,22,5,5,18,12,12,1,20,5,14,0,5,2,7,4,0,17,2,1,4,4,10,25,2,10,18,19,8,4,4,3,3,12,4,2,3,14,5,15,0,2,9,106,5,4,5,13,5,6,24,7,6,10,2,2,6,5,5,4,0,5,3,6,14,3,28,25,13,6,0,8,0,2,8,22,12,1,4,8,14,8,2,8,6,2,13,4,4,11,2,5,10,12,4,8,3,5,12,3,5,5,8,3,2,5,4,8,10,14,12,8,3,4,17,2,7,29,1,11,4,1,2,4,4,5,1,1,2,2,12,1,30,4,3,2,1,4,5,4,5,6,8,7,8,2,0,3,1,7,7,6,3,1,1,10,1,0,16,7,1,5,4,6,1,1,0,16,1,6,3,3,1,2,5,5,5,3,4,1,4,30,2,11,0,9,1,2,2,7,5,7,4,3,2,4,11,2,3,1,6,0,7,4,5,2,6,8,2,3,6,4,4,4,9,2,3,11,3,3,0,8,3,3,5,3,4,7,9,3,8,12,6,3,5,4,4,10,4,4,7,6,6,10,8,21,11,6,0,3,4,2,9,2,2,2,8,3,7,4,2,2,6,4,1,2,1,0,3,5,6,7,7,0,5,1,5,2,9,3,4,0,2,8,1,6,0,3,5,10,3,2,4,3,2,10,5,5,0,1,0,8,3,10,7,1,8,5,10,3,2,9,1,0,11,3,3,3,2,16,1,20,1,2,5,1,7,4,5,3,1,2,3,6,1,7,0,2,1,9,2,0,18,6,6,1,1,2,5,4,2,2,25,3,2,1,5,2,1,5,0,0,6,3,2,5,1,2,2,1,1,1,4,2,5,3,9,3,3,1,5,1,15,0,3,0,2,0,0,0,0,6,2,0
statute,3,29,8,119,1,0,3,18,2,2,7,4,3,21,4,4,0,9,0,2,4,32,2,31,13,1,6,1,4,13,5,142,49,2,25,10,8,8,18,0,6,2,2,2,15,9,14,10,246,9,24,3,5,6,0,0,25,8,0,6,10,2,0,8,11,3,26,7,0,11,1,7,2,6,35,3,7,2,34,15,14,0,2,7,86,11,7,0,19,2,1,3,0,20,35,18,10,3,23,13,14,16,24,10,6,25,3,4,8,2,7,7,7,21,0,16,3,7,67,101,25,5,23,40,6,1,1,1,5,0,4,3,0,29,10,21,5,4,12,2,0,26,17,4,1,49,6,8,4,10,37,1,8,1,1,68,19,0,3,2,10,1,3,4,1,4,1,9,14,4,7,50,13,0,1,7,114,7,6,20,14,9,0,17,4,13,11,8,23,37,3,4,4,0,0,5,5,2,12,6,27,0,6,10,10,5,0,17,12,8,46,4,27,5,2,0,2,1,13,2,2,17,4,6,17,172,25,21,0,3,6,11,15,32,13,8,13,2,9,10,68,15,3,9,8,5,3,8,57,6,8,10,7,6,7,6,1,6,5,17,13,23,18,4,2,19,0,0,3,2,75,9,15,1,4,1,15,7,9,4,29,2,0,13,6,0,2,2,12,1,3,1,12,1,10,5,23,5,9,17,10,41,0,4,9,0,7,4,1,2,1,10,15,5,20,22,8,34,16,8,20,0,18,1,34,15,5,17,3,28,3,10,5,10,4,9,6,4,0,10,7,5,7,9,2,0,46,24,8,3,26,26,2,24,10,11,5,4,11,22,30,5,3,18,3,2,24,13,10,10,4,8,5,5,17,22,11,3,12,1,71,2,23,7,5,26,13,11,12,2,23,1,6,10,11,6,38,2,37,2,15,0,0,0,5,1,8,0,26,2,1,12,0,9,1,8,1,4,3,0,5,2,21,17,0,6,3,9,3,14,10,7,0,10,1,1,0,3,5,7,17,12,3,0,2,0,5,3,18,3,3,1,2,0,27,24,1,16,6,31,4,10,17,29,4,7,2,12,5,1,12,3,1,1,11,16,0,8,13,5,9,3,1,6,7,13,7,3,3,16,14,22,0,2,6,2,1,12,2,17,12,1,3,0,19,4,1,13,6,0,1,9,0,8,4,8,1,3,58,5,3,13,8,15,11,5,36,20,6,19,16,5,3,14,5,5,4,3,18,14,3,2,5,0,1,10,2,9,12,2,38,7,1,41,11,13,17,3,6,9,16,8,38,5,11,8,4,10,55,36,6,1,4,15,3,4,2,5,6,13,4,10,4,4,4,0,4,2,2,5,15,17,6,6,23,2,10,0,26,10,17,1,1,0,8,19,4,21,11,0,23,28,10,2,64,6,11,25,11,3,5,3,1,21,1,7,2,8,13,31,7,14,26,11,8,3,8,8,3,11,7,3,23,14,7,24,2,2,22,134,19,3,3,14,7,6,34,14,5,7,1,10,8,8,8,0,14,1,2,7,8,5,5,186,20,2,7,4,1,7,1,6,4,3,3,3,12,2,1,6,15,12,22,6,11,5,6,7,16,12,0,7,5,14,4,6,6,0,35,2,6,8,1,9,15,4,0,4,8,6,4,3,4,24,1,3,5,1,8,5,7,13,3,5,7,0,15,3,19,1,14,5,3,9,12,0,12,1,2,1,4,4,3,9,4,7,5,1,0,17,14,7,5,3,16,8,3,12,6,5,1,1,3,27,5,9,4,2,4,6,1,3,9,7,4,3,5,3,4,10,8,6,3,4,8,20,8,10,2,9,1,5,5,3,2,0,2,3,11,3,0,2,9,3,4,0,2,5,0,13,0,3,2,13,0,4,2,11,1,0,3,0,5,3,4,4,2,13,2,2,1,8,25,16,2,28,11,11,7,11,25,21,25,5,1,5,3,5,25,5,3,7,4,1,2,5,0,4,5,17,8,19,7,8,1,4,4,2,5,1,0,5,0,4,12,4,0,6,2,5,3,7,0,1,7,6,0,2,5,2,6,1,3,4,8,3,3,1,6,11,5,2,5,0,10,7,3,4,5,3,2,3,2,1,1,5,0,4,1,0,8,7,1,2,2,2,2,2,5,6,2,17,3,0,2,7,7,5,19,4,1,6,1,3,2,2,7,1,12,8,2,6,2,5,3,24,0,3,1,3,1,2,1,3,2,0,0,3,7,4,3,8,3,6,3,5,1,1,4,0,3,6,2,0,0,3,1,4,1,0
within,28,101,41,540,23,27,37,158,20,14,67,46,44,231,25,38,22,69,19,20,23,172,47,83,63,46,41,55,27,108,29,625,433,42,176,206,166,57,47,22,33,22,16,14,117,70,80,65,1415,94,168,27,69,118,36,27,225,127,10,76,78,30,12,60,91,32,342,26,34,58,61,38,24,14,275,34,68,22,307,78,219,7,61,25,838,63,33,6,173,18,60,25,9,141,184,66,102,27,141,39,52,95,152,44,44,100,42,17,68,24,61,21,29,68,11,113,21,26,246,550,161,65,80,401,32,11,17,15,37,14,44,20,44,219,80,171,34,20,23,21,17,172,95,14,10,247,31,43,62,82,328,9,55,26,14,137,121,24,29,51,44,11,37,15,21,33,19,59,100,44,75,327,65,7,22,33,556,18,52,117,93,58,36,56,32,71,121,72,137,187,10,25,25,9,10,27,52,19,55,45,76,11,9,47,93,41,21,119,49,115,281,29,86,46,10,16,14,30,62,13,29,60,21,56,171,439,105,105,22,38,51,76,92,127,172,137,107,30,22,34,285,155,25,27,57,19,26,108,172,30,34,61,58,53,54,55,32,17,14,101,13,95,65,22,20,155,23,41,60,9,527,40,182,33,22,16,73,90,63,4,234,31,5,69,52,20,35,41,46,10,16,18,42,40,25,50,124,24,21,78,89,109,8,23,57,14,95,30,20,9,8,84,76,22,127,60,61,141,57,18,179,27,129,20,280,89,30,89,19,116,24,64,30,15,30,85,71,28,17,71,48,39,50,59,24,21,189,207,88,55,75,37,23,90,101,29,23,18,60,126,91,38,21,69,29,6,129,26,36,53,13,94,19,45,29,82,28,8,46,28,307,19,165,40,15,222,22,71,114,15,98,22,45,37,122,43,225,10,145,23,73,19,19,10,40,25,30,16,76,53,12,32,6,60,59,46,22,41,14,15,10,31,72,62,10,27,15,50,36,60,61,39,29,45,16,26,7,49,44,24,57,118,27,38,3,19,49,33,160,46,80,29,27,16,179,48,10,52,24,121,52,75,121,89,24,23,76,47,66,3,62,16,23,12,13,37,21,51,66,22,32,64,24,23,27,29,50,28,22,17,241,175,8,19,47,43,18,53,26,38,69,18,19,10,40,96,8,40,46,11,19,31,42,33,68,84,29,42,16,22,32,62,31,129,44,33,99,27,81,107,52,25,15,34,41,27,44,27,136,71,24,19,9,10,46,40,10,77,73,32,212,25,41,1,24,37,108,22,22,30,82,20,92,9,59,53,49,30,126,108,65,32,64,20,22,13,26,31,30,92,25,50,53,72,35,22,18,30,21,46,56,125,44,37,104,37,30,14,153,67,75,9,25,21,26,81,28,104,37,26,89,91,32,32,154,32,86,14,36,27,48,45,11,84,16,20,40,35,55,152,48,81,107,85,29,10,31,41,12,41,41,33,36,122,33,110,19,21,30,756,95,47,18,21,32,63,154,81,24,60,18,34,56,65,24,29,8,35,47,44,56,44,122,132,150,27,9,17,21,31,53,99,54,42,46,43,39,23,28,54,61,48,75,60,19,53,43,27,65,57,15,17,20,28,23,33,49,17,10,23,15,44,33,87,255,68,35,25,19,18,46,14,19,80,4,45,31,5,22,40,32,71,29,21,37,28,70,22,246,63,38,31,23,51,43,14,59,33,10,42,41,37,22,58,33,71,29,41,35,93,83,42,17,26,92,55,46,27,22,49,25,17,18,86,18,51,30,12,98,46,71,22,45,15,36,30,25,67,44,57,34,61,20,16,49,61,27,35,25,19,18,29,49,27,24,12,20,31,58,31,32,15,54,27,13,26,18,31,26,48,17,19,33,50,37,14,13,25,28,23,34,28,30,16,27,35,38,83,68,29,21,37,25,27,13,56,27,37,21,48,99,135,27,26,12,27,34,54,25,15,27,32,25,15,30,31,23,20,39,41,21,26,48,33,17,32,22,33,31,8,21,41,18,12,74,21,26,29,61,22,17,52,7,8,28,33,24,20,49,13,20,31,19,37,30,16,19,37,23,75,18,31,32,57,57,29,21,41,15,8,28,23,12,44,10,20,17,34,21,36,20,23,17,45,45,20,31,31,22,54,13,64,38,49,18,64,65,78,152,22,7,25,19,16,19,34,76,32,85,18,58,35,23,20,18,117,16,30,20,32,16,28,33,27,14,20,14,44,31,37,50,29,24,36,20,29,27,22,86,7,13,17,26,6,3,16,4,22,5,22
organization,7,9,15,133,1,6,5,47,0,1,10,11,11,58,3,6,4,7,2,2,4,27,0,18,19,6,6,13,7,5,23,122,84,13,39,21,33,1,8,7,2,5,2,5,28,15,26,17,186,6,24,14,9,72,4,1,42,36,5,13,11,4,3,11,15,10,33,5,13,13,8,2,3,1,86,11,8,4,51,24,54,0,9,5,144,3,20,0,14,4,5,9,0,19,31,3,15,7,22,18,6,27,12,10,8,25,5,2,5,1,10,3,13,28,2,5,1,2,64,104,33,19,6,36,1,1,3,4,2,1,6,2,1,39,7,56,4,5,4,4,4,25,26,5,2,60,4,9,20,6,38,1,1,7,3,56,15,6,2,19,5,5,3,3,1,5,6,15,23,9,13,56,19,3,3,7,108,2,4,42,27,3,5,10,0,15,22,24,31,32,0,6,6,0,0,1,27,14,7,7,43,4,4,15,16,6,6,27,8,19,54,3,10,9,2,1,3,3,18,5,2,13,3,13,33,75,18,18,4,2,18,14,11,24,23,5,28,8,7,6,53,26,4,2,19,8,5,25,69,2,14,14,15,2,13,7,7,3,1,14,6,26,18,2,4,80,8,4,2,5,92,8,9,3,2,1,10,8,5,12,41,3,6,16,5,2,10,5,5,3,4,3,1,2,3,5,25,8,4,17,21,36,2,2,24,1,37,3,7,5,10,22,25,15,10,30,10,30,23,8,34,4,13,1,42,5,26,25,2,13,8,14,6,1,2,3,11,9,2,13,3,5,12,5,10,7,31,30,14,2,6,3,6,22,13,2,1,5,14,20,15,15,23,7,1,2,24,3,9,12,10,27,1,18,25,44,13,10,9,1,32,2,50,12,3,18,1,10,11,5,15,5,10,13,23,7,37,15,49,3,8,1,2,8,10,2,5,3,58,18,2,3,5,24,3,3,2,6,2,1,6,3,18,6,7,3,8,19,7,10,5,3,1,8,16,3,0,1,20,5,11,9,7,8,5,5,9,3,36,3,16,2,6,1,18,13,0,2,10,33,19,11,43,43,6,8,8,3,0,0,8,4,1,0,2,6,3,22,25,9,1,9,1,5,14,9,13,1,8,6,74,26,11,0,3,5,3,10,5,7,9,5,0,2,12,17,21,5,5,5,4,3,7,14,22,13,7,14,9,8,2,10,8,13,6,10,21,15,7,15,17,4,6,8,6,5,7,10,21,21,2,15,4,29,12,4,0,8,14,5,21,3,11,24,1,9,37,6,9,14,16,4,30,15,13,10,6,7,28,34,6,5,12,6,10,2,11,7,3,8,10,14,9,7,3,2,5,2,1,15,15,24,6,6,88,0,4,2,17,9,18,5,5,2,1,12,3,37,18,0,9,46,12,7,19,14,19,3,7,7,10,1,1,12,9,5,1,9,5,38,0,26,25,43,40,3,14,8,4,5,10,1,12,32,6,38,8,10,6,111,21,2,7,2,5,12,31,7,10,3,4,5,7,2,5,2,2,7,3,3,24,13,8,31,16,13,8,5,2,5,6,18,18,10,7,7,4,4,2,4,10,5,13,3,8,11,6,1,9,7,2,3,0,0,18,7,15,10,3,2,1,4,4,20,12,52,9,3,3,26,6,12,2,37,6,4,11,1,6,19,14,11,3,3,3,3,23,7,23,8,7,1,3,10,6,4,9,15,5,3,5,0,5,13,2,6,6,21,4,2,0,16,1,5,8,7,9,2,36,11,8,2,3,7,6,9,5,1,8,7,2,4,12,4,10,7,3,2,2,11,4,12,4,5,1,12,3,3,4,4,5,5,14,3,4,12,5,1,11,1,6,1,0,4,0,3,4,10,4,2,3,1,10,29,3,4,8,10,5,0,6,2,18,4,8,9,12,17,3,3,5,5,11,6,2,1,6,16,7,9,12,30,6,3,10,16,5,0,2,5,2,1,1,23,3,2,1,5,8,16,16,3,2,5,3,5,0,5,3,4,1,3,12,3,10,2,6,5,1,7,3,2,3,5,3,4,6,10,5,9,4,7,10,6,0,2,2,7,6,15,9,1,6,1,3,3,5,3,5,7,2,7,4,2,5,8,0,3,6,2,4,2,0,3,3,1,6,1,0,11,6,2,5,0,7,2,3,10,4,0,20,1,5,9,3,2,2,3,6,0,0,0,1,2,4,2,5,8,5,2,2,3,0,2,1,2,9,4,12,2,4,9,4,0,2,3,10,11,2,5,1,10,3,0,5,2,3,3,2,0
practice,7,42,17,101,7,5,1,21,0,6,8,4,5,65,1,7,4,9,5,3,3,31,7,14,20,13,15,9,14,14,11,153,82,10,67,52,52,7,13,2,5,5,5,5,54,18,20,21,210,12,57,1,8,23,5,5,70,22,1,6,17,4,3,13,15,3,60,14,10,9,12,6,1,5,56,14,27,9,62,16,35,4,2,4,187,19,7,0,36,1,8,8,1,18,52,13,8,5,35,16,5,21,16,11,14,31,3,2,8,3,14,7,12,9,2,18,1,7,36,121,40,15,10,47,4,5,5,1,1,0,5,7,6,51,35,35,5,4,5,10,3,29,17,1,1,39,3,22,13,16,65,5,9,6,4,20,26,8,9,7,19,7,14,0,3,20,4,17,15,8,19,82,19,5,7,20,150,9,16,43,21,18,6,15,3,39,29,22,31,50,4,1,6,0,6,2,20,4,4,20,40,8,1,9,25,6,5,37,8,17,72,5,20,8,1,7,0,2,34,1,1,17,11,12,48,133,23,28,3,7,20,14,14,19,33,22,28,12,8,7,61,54,2,8,22,6,3,37,65,3,13,21,19,5,16,16,9,0,4,20,16,31,13,0,6,50,5,3,18,5,117,7,15,8,2,0,24,6,9,5,57,13,3,10,12,2,12,13,11,5,1,3,23,5,2,15,24,6,7,22,26,23,3,0,20,2,19,11,2,2,7,11,33,8,37,16,22,31,10,5,39,6,38,3,41,7,6,29,3,17,6,22,10,3,8,9,11,3,7,5,6,6,14,6,3,12,51,43,8,4,12,10,7,44,16,3,5,6,4,29,31,13,11,21,1,1,31,18,12,10,3,11,5,9,10,58,17,9,23,0,53,2,50,9,5,35,15,23,23,3,28,5,10,9,24,15,48,10,34,2,20,5,4,2,9,11,10,7,29,12,4,3,3,19,4,6,1,12,6,3,7,9,13,11,3,2,3,14,12,15,16,3,2,9,2,3,2,3,1,1,15,15,6,6,0,5,17,7,24,8,9,4,4,5,51,24,2,10,7,35,16,17,36,53,12,2,13,11,7,1,14,7,5,1,4,28,10,12,27,7,5,17,0,5,6,7,12,1,5,3,70,34,1,2,5,2,2,13,7,18,13,13,2,7,2,25,2,16,6,3,6,6,6,16,21,15,3,14,6,13,5,9,12,23,5,6,33,18,11,24,8,3,2,12,18,2,6,14,35,19,6,0,4,8,8,5,1,20,7,10,26,2,13,37,9,1,34,7,4,8,18,1,16,8,13,16,15,10,26,43,12,7,14,7,4,1,9,11,7,12,8,14,20,19,5,7,6,6,4,15,31,28,13,5,29,6,9,4,26,19,20,2,4,0,3,10,5,29,21,10,14,27,16,6,38,7,27,10,10,3,13,4,1,14,6,14,6,9,16,29,8,15,27,23,7,2,15,4,2,10,5,3,17,10,5,22,5,2,8,107,4,9,7,16,8,8,28,16,4,7,5,0,4,15,2,1,3,6,5,7,8,7,19,32,14,5,1,5,2,7,16,17,16,7,7,12,11,1,2,11,13,15,15,15,5,4,7,4,15,11,2,6,5,5,28,8,10,7,6,1,10,1,2,23,15,31,4,6,9,12,4,4,10,42,9,1,3,3,7,8,10,32,6,12,4,8,21,6,35,10,15,3,10,34,23,7,9,5,5,7,9,6,1,6,1,9,5,7,3,10,6,13,0,2,14,27,5,13,7,6,7,2,1,16,3,12,4,4,10,10,10,9,16,3,4,6,7,10,11,14,5,7,1,10,16,26,3,1,1,18,7,2,8,13,0,6,5,7,13,8,16,1,9,2,2,4,6,1,3,12,1,6,2,7,1,4,4,8,5,2,8,13,15,5,4,10,9,26,8,14,4,7,6,6,8,8,5,7,1,13,19,16,6,6,4,7,16,3,12,0,5,3,14,4,8,11,1,13,5,10,5,4,3,8,4,6,2,0,11,1,0,1,6,2,10,1,2,7,4,6,3,7,0,1,5,1,1,3,5,5,6,4,4,7,6,1,0,9,14,20,7,2,7,6,12,0,6,10,4,1,6,4,4,8,6,3,4,6,3,10,7,4,2,3,11,4,7,5,2,9,5,13,3,4,7,21,14,7,42,1,2,12,1,7,3,2,2,8,10,5,2,3,6,2,1,21,4,5,4,7,3,3,2,1,4,4,2,4,10,4,1,9,5,8,3,5,10,0,5,1,4,2,7,1,0,3,2,2,2,1
commerce,15,25,15,308,21,6,20,61,7,5,58,20,20,235,21,21,22,21,12,8,10,108,7,35,49,18,27,24,12,19,20,414,419,27,117,164,118,15,24,11,35,25,24,6,82,50,52,29,836,74,116,17,47,132,13,18,162,82,5,48,81,39,10,50,36,14,134,7,32,33,18,37,8,6,204,42,54,19,131,56,201,4,40,14,479,32,46,2,102,1,17,17,2,70,176,61,37,29,92,78,60,84,57,32,27,57,13,6,38,4,45,12,11,28,2,99,10,7,156,380,90,83,32,126,21,9,25,13,13,5,37,11,15,124,41,115,13,7,17,24,3,95,80,7,9,167,14,37,51,28,251,4,34,39,25,53,60,13,43,20,32,12,19,11,6,16,11,52,55,34,70,214,49,1,11,24,406,12,29,118,42,38,10,38,17,67,93,44,89,142,6,15,34,4,5,12,32,11,18,38,97,6,8,41,74,7,6,83,42,85,196,17,45,30,3,2,2,5,30,10,12,44,20,33,81,231,65,68,11,11,46,25,41,76,103,64,79,23,31,21,139,110,26,6,55,15,24,51,109,23,21,84,47,13,28,39,25,5,18,37,26,53,43,10,22,195,9,14,47,26,346,13,52,43,12,1,70,30,48,11,151,18,7,52,43,5,15,24,26,0,20,13,19,14,10,28,122,17,20,45,57,78,3,5,60,3,62,2,10,12,10,71,72,24,43,64,53,117,52,22,129,15,78,6,155,29,22,56,13,40,3,25,29,11,21,42,45,24,18,22,23,19,46,22,27,49,106,136,65,7,37,39,18,70,69,44,2,13,49,57,46,31,30,57,37,7,98,14,12,34,12,42,16,18,28,67,18,15,35,18,123,4,133,28,12,50,3,60,66,14,63,9,27,46,82,31,142,11,80,13,72,8,10,2,17,28,23,41,204,68,9,44,33,62,50,42,24,22,5,7,10,31,53,21,3,11,8,48,32,28,26,17,5,19,13,17,1,69,27,7,67,119,14,75,14,16,44,18,103,27,47,19,7,17,183,22,5,48,29,84,21,51,80,42,19,2,39,76,50,0,47,15,10,6,4,33,19,33,28,14,21,34,23,21,27,19,53,15,12,5,188,101,3,11,40,18,21,32,21,32,25,18,11,5,16,33,17,30,26,12,17,12,20,50,38,35,18,37,49,22,10,66,66,75,30,20,76,46,60,60,35,9,6,21,23,12,32,16,87,59,21,8,8,31,45,23,13,66,31,21,52,7,17,108,37,34,1,26,28,16,55,10,68,14,34,37,45,18,92,111,24,21,43,11,28,26,50,15,12,45,84,48,54,40,26,7,13,19,16,36,75,102,22,18,139,19,13,13,219,53,36,12,9,11,13,60,13,35,11,38,69,160,36,24,77,25,68,13,33,21,27,12,24,24,9,35,32,27,35,84,18,52,47,60,16,16,37,14,15,54,27,5,11,37,32,80,22,9,20,517,81,10,21,11,21,28,78,54,14,36,19,19,60,72,60,36,5,19,24,38,58,30,150,37,53,22,17,28,12,10,26,127,37,37,42,17,26,15,18,107,26,36,40,98,19,28,15,12,39,28,46,16,23,18,27,21,72,19,9,13,4,17,17,75,47,26,6,20,21,25,15,6,22,34,5,39,31,5,9,38,25,34,13,16,8,15,110,12,52,31,26,21,12,81,116,9,48,43,15,20,23,5,5,24,8,33,34,41,31,27,28,20,4,3,79,66,31,14,63,24,28,14,2,37,15,34,18,6,6,22,6,13,31,6,26,38,12,33,12,37,30,11,13,14,92,49,59,18,25,8,22,18,32,8,10,6,28,18,49,21,44,31,75,21,51,18,8,18,12,19,17,6,28,28,9,23,13,12,11,12,31,31,14,13,36,20,29,66,44,27,21,12,13,13,17,38,20,31,18,29,83,97,15,31,10,14,41,12,22,0,26,15,14,14,12,22,6,14,17,25,29,19,19,30,4,14,16,63,27,27,1,14,5,31,18,14,11,14,27,15,15,61,1,22,32,12,9,1,8,8,12,18,11,22,1,13,20,51,21,50,16,16,17,16,29,8,12,157,6,12,22,17,15,39,22,15,29,63,20,6,18,15,21,13,16,8,24,13,17,36,10,28,7,12,13,29,16,16,59,17,1,10,7,11,9,4,32,46,38,15,2,29,10,16,5,125,21,1,3,75,25,13,16,14,11,56,2,21,35,9,21,20,8,12,13,13,31,21,53,5,13,8,11,2,1,5,0,22,16,4
operate,0,7,4,53,1,3,1,20,1,2,4,1,5,23,2,0,0,15,3,0,4,22,2,12,8,4,1,7,2,9,4,71,54,3,24,28,10,4,12,2,8,6,2,1,18,7,10,7,128,5,22,7,3,7,5,0,45,12,0,4,4,2,0,9,13,2,31,6,2,19,9,3,3,1,40,3,5,4,33,13,32,6,4,5,124,9,11,1,9,1,3,4,4,21,29,18,4,3,22,10,8,6,14,5,9,9,4,2,11,2,6,10,4,8,3,15,1,4,45,129,21,11,15,25,1,1,0,0,5,4,3,2,1,20,4,21,4,2,3,2,1,10,15,0,0,26,4,4,9,13,30,2,7,1,5,22,8,1,2,14,12,2,5,0,3,6,4,12,9,2,13,42,18,1,2,1,83,5,9,17,7,2,3,11,3,13,21,7,10,17,1,3,1,1,1,2,4,5,4,10,18,5,2,3,25,9,6,38,7,16,31,1,8,4,0,1,2,4,8,5,3,3,0,3,24,66,15,18,3,2,13,4,12,30,10,19,16,2,0,6,32,13,5,6,3,6,2,3,22,4,7,21,6,4,6,14,2,3,1,8,4,14,7,1,6,23,3,2,2,4,65,5,12,3,3,0,11,5,5,2,16,8,0,5,5,1,6,10,2,1,3,1,5,5,3,8,10,1,6,17,17,12,2,0,10,0,11,2,0,6,3,9,19,5,32,12,10,21,9,7,11,2,6,6,20,2,4,7,2,7,3,9,1,4,2,8,7,3,1,3,7,2,8,5,6,7,22,16,7,3,6,5,1,23,8,7,1,0,6,7,9,4,2,16,2,0,29,4,4,14,4,7,6,5,8,20,2,3,7,1,18,0,20,3,1,32,3,5,6,3,11,1,1,1,15,5,19,4,15,2,4,0,3,1,2,9,5,1,17,3,2,5,3,10,6,5,2,8,2,1,3,5,13,8,2,3,1,5,5,5,7,2,0,7,1,1,0,3,4,2,11,15,5,1,0,3,6,3,14,8,10,2,5,3,14,1,0,4,8,11,2,8,7,8,4,1,7,6,2,0,6,1,2,0,3,4,0,7,10,2,4,6,1,0,4,3,13,2,1,0,19,13,1,3,4,4,2,14,5,9,6,3,0,0,11,23,6,10,6,4,5,5,6,8,9,7,5,3,20,7,0,14,11,11,2,1,25,12,10,6,9,2,4,4,4,1,4,5,18,19,3,1,2,6,9,2,0,16,12,3,14,4,3,22,6,7,26,1,10,2,12,0,16,0,7,8,3,2,15,24,12,5,4,1,2,3,10,4,1,4,3,13,8,6,2,1,2,0,7,2,10,17,8,0,10,2,4,5,4,7,10,2,0,1,1,8,4,14,7,3,16,10,2,4,21,7,7,7,1,5,10,3,3,13,4,5,5,5,4,12,6,9,15,11,6,1,6,4,1,4,7,0,6,11,3,9,2,1,6,59,6,3,5,6,3,5,19,3,1,3,3,3,5,0,2,0,0,3,5,9,3,10,11,9,10,2,0,3,2,3,11,16,6,2,1,2,4,3,1,4,5,2,6,1,3,4,3,0,17,9,1,2,2,2,12,2,4,2,2,0,1,2,10,8,8,4,2,3,4,2,4,4,1,12,1,0,10,1,0,8,4,10,7,8,4,4,7,3,8,4,4,1,1,4,6,2,7,5,5,5,2,4,0,2,1,5,3,6,3,12,12,5,0,2,11,9,4,2,9,2,4,0,1,6,2,4,5,2,2,7,4,0,4,3,4,2,11,0,3,11,2,2,0,4,22,8,12,3,3,1,3,3,3,2,3,2,3,4,5,0,15,2,13,5,5,0,3,3,5,6,4,2,2,11,3,3,2,0,11,4,3,5,6,0,2,8,0,26,4,2,0,3,3,7,4,5,11,8,3,2,8,14,4,8,0,5,7,8,5,1,7,1,7,1,4,2,3,1,3,4,0,2,4,14,5,3,2,3,4,2,0,2,1,2,3,2,1,1,2,1,3,4,2,2,7,3,1,0,5,1,7,1,6,3,1,2,0,5,4,7,1,5,4,5,4,2,3,6,3,1,11,3,1,6,1,1,4,3,3,2,5,1,2,5,2,1,8,3,2,6,0,3,2,1,4,6,12,5,22,0,1,3,2,2,2,0,8,1,10,3,1,6,5,2,0,14,1,1,0,2,5,0,10,4,1,1,0,7,3,2,7,1,4,6,4,8,9,4,13,1,1,1,0,0,2,3,1,1,0,2
directly,0,16,11,94,6,3,4,17,4,0,8,9,5,47,6,2,3,14,6,2,2,27,8,16,13,7,4,4,15,11,4,103,65,8,20,28,20,5,21,3,6,9,0,2,18,9,16,15,195,21,28,4,16,28,7,1,49,14,7,10,10,1,0,9,3,5,83,4,5,10,17,3,2,5,51,10,13,3,32,18,47,5,6,2,152,25,7,0,19,1,4,6,3,10,37,13,23,5,19,19,15,26,24,5,10,16,16,5,14,3,8,6,13,18,5,13,7,3,60,89,23,16,46,38,3,5,5,3,3,2,7,1,4,28,11,36,3,1,3,8,1,20,13,1,1,22,7,12,13,9,45,2,15,5,1,38,25,11,4,16,9,3,5,3,5,6,3,17,12,2,5,59,14,2,3,7,97,4,16,33,16,7,14,13,5,11,21,10,24,35,1,6,17,0,1,2,11,3,5,18,24,3,4,9,13,5,7,12,10,22,47,4,20,7,2,1,0,3,5,5,0,9,4,4,27,61,20,14,3,10,11,10,15,18,29,20,19,9,14,3,45,23,6,4,15,9,8,12,31,5,10,17,9,6,6,9,6,2,2,10,7,8,18,2,1,27,10,1,10,9,57,10,18,5,1,0,7,14,7,6,35,5,5,7,13,3,4,6,6,3,3,1,10,3,3,6,22,6,4,11,7,15,3,0,25,2,12,2,9,1,2,17,8,2,29,3,23,20,6,4,23,7,13,6,22,2,7,12,3,14,4,11,9,4,0,14,17,3,6,10,7,3,12,10,3,4,21,30,21,6,10,17,4,27,19,11,7,1,8,12,21,8,13,13,5,3,25,3,10,15,4,9,6,10,6,9,2,1,6,10,24,2,29,20,7,22,3,18,19,1,18,0,6,7,23,8,38,2,11,3,14,3,4,0,4,9,6,1,20,8,1,2,13,15,7,5,7,6,2,1,2,4,15,10,2,3,7,5,6,5,13,2,2,7,2,2,2,8,6,2,15,9,7,6,2,4,6,5,16,8,9,7,6,6,39,5,0,10,7,13,3,12,7,13,4,5,9,7,6,0,13,3,0,1,0,10,1,12,11,4,6,6,6,0,6,8,8,3,1,5,28,15,0,3,5,4,2,9,0,12,6,5,3,2,7,22,4,9,5,2,2,4,7,3,3,8,7,5,3,6,1,11,4,19,1,1,21,11,7,17,7,4,3,9,3,6,2,3,16,14,2,3,6,12,9,5,0,9,7,9,31,6,6,22,9,4,28,10,1,5,12,3,13,3,10,6,10,8,25,26,5,3,8,2,4,1,7,2,3,17,8,5,6,11,3,5,4,4,5,4,10,12,10,2,19,5,3,2,32,14,17,6,1,5,4,12,0,20,6,6,25,7,9,6,22,6,12,13,9,4,9,7,1,16,3,3,8,6,6,16,9,15,20,23,3,4,19,7,2,4,5,1,4,14,6,7,11,2,2,111,15,4,6,1,1,8,33,14,3,8,1,3,7,14,5,7,1,9,7,6,5,6,5,27,13,6,4,2,1,4,2,22,10,5,4,4,9,2,2,6,6,7,8,3,5,2,5,4,15,5,2,3,2,4,4,0,8,5,6,3,0,10,5,10,17,6,5,1,4,8,7,2,2,11,3,1,7,2,2,5,4,6,6,5,2,2,10,6,9,6,8,3,0,1,8,2,10,10,5,2,4,6,5,8,6,6,6,7,1,17,20,7,0,2,11,10,7,3,12,7,2,0,4,5,3,18,7,4,4,12,1,3,10,1,11,6,2,4,1,3,2,13,4,4,2,8,2,6,4,4,2,3,7,5,2,3,4,1,7,4,15,8,15,5,1,6,4,3,1,7,3,2,2,2,0,5,3,5,6,1,5,1,12,1,4,5,4,19,5,2,0,7,7,9,10,11,1,4,1,8,10,26,3,5,2,3,5,8,3,3,11,5,4,4,1,2,3,3,0,7,1,2,5,10,5,2,3,8,7,0,0,1,3,3,1,4,0,3,0,5,3,4,4,1,1,3,0,1,5,4,10,1,1,11,7,5,1,16,2,13,12,10,5,6,6,1,1,8,1,1,5,1,4,10,0,6,0,3,4,7,7,4,7,4,8,2,7,2,3,1,1,14,7,3,12,14,14,11,23,2,0,8,3,1,8,4,2,1,15,5,0,3,3,2,0,21,3,3,10,4,5,4,6,0,3,4,2,4,12,4,1,1,6,6,8,15,0,7,15,2,1,8,1,1,2,10,10,4,2,1
earnestly,5,37,11,180,16,1,4,16,7,4,21,7,6,53,3,8,6,8,3,2,10,22,5,18,28,21,13,5,11,19,6,152,93,8,47,32,41,7,3,2,2,4,2,3,23,8,15,7,221,16,28,7,12,32,9,4,47,32,0,12,16,3,3,6,9,4,74,2,8,10,5,5,2,0,37,12,11,1,63,18,32,1,10,6,155,13,7,0,18,2,8,4,2,19,51,7,8,3,37,7,8,25,30,8,12,28,7,2,2,1,22,6,5,4,0,26,4,2,41,111,31,11,6,44,7,1,2,3,2,0,6,4,3,41,13,27,13,6,3,7,3,23,11,3,1,62,6,12,6,14,53,5,14,4,1,19,29,1,12,4,6,0,10,1,1,6,4,18,12,10,7,58,20,0,1,2,130,5,11,31,29,13,0,22,5,23,27,19,30,35,1,2,4,1,0,4,14,2,13,6,38,2,3,14,13,10,7,29,11,18,60,3,22,7,3,0,0,4,14,0,3,12,5,9,32,111,13,21,2,4,16,13,12,11,26,12,28,10,1,2,40,24,7,6,14,7,2,18,62,0,35,10,46,2,6,7,9,1,2,14,7,18,12,1,3,28,11,4,10,2,126,5,10,8,7,0,18,6,9,7,39,6,0,14,9,1,5,10,11,2,2,6,27,5,3,6,31,11,6,18,17,94,0,3,7,2,21,3,6,0,0,18,27,1,27,10,13,21,14,5,35,15,20,3,31,5,6,11,5,11,1,17,13,2,4,19,10,8,2,6,3,6,13,10,3,6,37,38,17,4,11,5,4,23,18,4,8,3,13,24,33,8,14,16,2,0,19,3,6,6,10,8,3,7,4,28,11,5,8,6,69,1,38,9,2,24,6,25,17,2,21,3,15,13,23,5,52,5,28,7,14,0,2,1,3,9,2,5,25,10,1,7,4,12,12,1,4,6,4,3,3,9,23,4,1,8,4,4,11,13,8,3,1,13,2,5,0,4,6,13,18,16,7,8,3,3,14,5,22,5,8,6,2,4,27,6,1,13,4,13,15,17,29,19,2,19,8,9,6,2,14,1,2,2,3,16,5,20,19,4,4,9,5,4,8,9,7,3,4,3,56,40,4,5,10,3,2,11,4,14,9,2,2,2,0,12,4,12,5,1,1,7,4,6,14,17,3,6,1,11,9,17,3,16,5,5,23,9,24,25,9,2,2,14,5,6,3,20,26,23,2,5,3,2,1,11,2,15,16,9,41,4,9,30,14,8,16,2,5,1,30,14,18,7,8,21,8,5,28,43,9,10,19,6,6,2,13,6,4,9,0,11,11,9,7,7,4,13,3,9,18,26,12,4,16,3,5,3,26,21,17,4,5,4,9,19,2,19,6,2,10,16,7,5,31,4,19,5,6,5,10,7,5,16,4,11,4,14,9,15,14,49,20,14,10,4,8,6,7,14,18,3,6,15,21,44,2,11,12,126,47,7,7,5,8,10,27,10,7,15,12,4,25,8,3,3,7,11,8,10,15,2,19,25,17,2,18,7,7,4,6,24,5,19,23,4,12,7,5,11,10,2,13,22,8,11,7,2,6,12,12,4,5,10,8,4,11,1,2,5,2,6,1,23,18,14,1,3,6,9,4,8,4,29,6,8,5,5,6,12,9,15,2,6,4,2,36,9,15,6,13,4,8,11,15,7,13,15,4,8,9,5,1,6,1,9,7,8,4,6,2,7,1,4,14,12,6,2,1,11,5,0,2,15,4,7,2,2,19,7,0,5,9,1,11,7,4,16,1,9,9,12,4,6,18,14,9,8,4,8,4,6,11,14,2,3,6,2,14,6,3,5,8,8,3,3,2,6,5,9,5,2,10,7,2,0,1,7,9,0,1,7,10,2,4,6,8,22,7,1,6,12,5,7,3,3,8,3,10,6,17,20,8,4,9,2,1,4,3,1,2,8,6,5,3,7,3,6,5,30,3,5,5,11,2,1,1,5,17,6,6,5,2,6,12,5,7,3,7,2,3,4,0,3,9,2,2,5,4,1,6,6,3,7,14,3,5,7,4,11,3,8,3,4,9,2,3,2,3,2,1,11,5,4,3,3,3,8,3,3,6,4,6,2,2,1,3,9,13,7,7,7,2,1,1,7,4,6,25,3,1,2,4,5,6,3,1,11,16,5,2,0,1,3,1,16,9,2,3,5,5,4,4,2,3,2,0,6,4,5,3,4,5,6,9,3,3,1,10,0,3,2,7,0,0,2,2,2,1,0
consideration,8,63,16,437,25,2,9,67,11,7,36,23,6,103,10,17,14,23,8,7,22,76,7,29,60,17,21,20,9,20,19,348,201,17,117,76,67,18,22,8,20,4,2,3,61,40,92,25,622,30,77,2,19,27,6,17,137,99,0,22,59,14,6,38,47,7,139,9,19,27,12,18,8,6,96,33,18,17,194,44,80,4,23,12,416,37,37,0,62,7,5,6,0,57,119,27,16,7,48,33,29,46,79,24,12,65,25,2,25,2,32,13,17,20,0,62,12,6,137,354,71,15,18,99,8,3,3,10,10,5,23,6,8,118,21,53,9,3,7,12,3,50,68,2,4,107,5,23,22,30,130,2,30,11,5,50,39,11,30,2,21,14,13,8,3,3,6,23,53,18,31,142,31,0,7,18,354,5,20,41,36,25,9,28,11,17,62,39,127,120,3,7,10,0,2,7,62,6,14,24,42,4,5,30,51,10,15,84,34,65,175,6,47,13,1,0,0,5,32,13,4,32,12,29,92,178,48,59,5,14,41,19,31,53,57,42,68,12,15,6,120,62,13,6,19,30,10,27,101,7,46,40,37,17,30,47,30,10,12,22,5,40,134,13,11,87,6,8,22,13,344,17,64,9,32,1,24,25,41,9,119,11,3,24,17,3,6,14,21,3,9,15,49,14,6,19,99,19,21,37,46,144,2,8,39,6,33,8,8,2,2,20,40,9,64,36,22,74,28,12,79,21,40,6,103,11,13,37,10,60,3,24,23,26,10,29,46,10,9,23,25,19,32,18,12,11,102,140,31,5,24,26,24,49,54,15,8,15,45,38,43,14,10,43,13,1,98,10,14,9,11,30,22,20,17,57,14,7,32,16,156,1,98,24,2,70,16,55,55,14,47,9,36,39,119,29,228,11,46,8,56,7,17,0,9,12,3,4,43,29,2,23,11,34,30,12,13,11,7,2,7,20,46,29,2,12,5,23,17,23,36,7,4,20,8,12,0,39,21,13,27,45,7,32,2,2,5,7,63,19,25,8,3,22,119,16,1,22,12,76,23,27,58,39,15,6,19,29,15,0,28,2,7,2,6,14,9,43,21,8,4,18,12,9,5,18,22,5,6,5,132,140,3,4,15,22,7,42,12,16,29,9,7,4,32,46,7,25,17,7,12,13,14,23,32,33,8,27,11,18,10,31,26,44,6,10,29,8,38,52,12,11,3,15,18,14,30,13,72,37,9,3,1,7,14,12,3,42,32,24,93,12,16,82,16,18,55,12,12,30,1,12,58,5,45,40,23,10,67,88,23,33,48,3,13,46,30,18,15,27,14,30,37,23,24,15,10,19,9,26,69,89,14,12,27,10,13,7,123,49,48,9,15,12,21,64,15,63,14,13,50,59,24,18,54,21,71,8,22,16,29,21,9,64,6,29,20,49,33,55,29,76,88,36,11,3,19,12,22,27,19,3,29,43,19,64,8,15,8,361,70,11,13,16,13,27,73,32,7,28,18,19,46,66,27,14,8,24,29,31,37,26,94,42,79,11,35,22,4,14,21,53,37,34,29,20,28,8,6,28,38,25,41,31,14,20,13,6,22,53,13,7,10,16,15,18,30,10,6,15,16,18,14,78,49,44,7,13,24,24,4,9,20,63,2,16,17,3,24,15,16,30,15,12,17,12,37,12,72,19,21,8,6,23,32,12,26,8,6,24,15,13,4,19,9,23,19,47,10,36,37,19,7,11,36,44,25,17,16,27,10,2,6,33,7,37,14,6,28,38,21,27,18,12,20,21,19,22,22,22,21,37,22,19,16,38,5,18,8,14,14,12,27,19,10,4,25,9,32,13,22,14,27,15,13,21,11,24,16,20,13,10,33,29,21,7,5,30,19,20,21,9,26,5,11,24,22,36,11,23,21,25,8,14,14,18,19,11,46,29,37,42,11,14,8,9,28,19,14,4,32,4,21,6,9,26,8,21,18,42,8,9,34,30,12,7,12,25,37,26,9,5,11,17,30,13,9,12,11,25,6,39,2,6,18,20,21,11,11,3,26,22,10,15,23,8,11,23,13,49,10,5,12,27,19,10,3,16,7,5,23,26,12,30,7,18,11,29,14,20,19,15,11,16,9,12,11,11,11,24,14,19,5,15,10,36,20,12,86,14,12,6,13,11,17,5,15,9,54,13,7,20,15,6,4,27,7,8,5,17,13,24,8,3,14,21,5,18,21,18,19,12,15,28,12,7,13,5,40,3,10,3,14,0,6,6,1,14,6,0
passage,3,26,6,115,2,0,5,13,1,0,8,1,7,16,0,1,5,3,0,0,0,11,4,8,6,6,4,6,1,18,3,80,32,3,25,10,7,11,10,2,2,0,0,4,19,9,22,8,126,10,15,1,3,7,3,0,28,18,1,10,5,0,2,3,7,7,25,1,0,11,1,4,3,3,26,4,14,3,51,9,32,0,8,2,81,9,6,0,19,3,9,1,0,9,31,7,8,7,13,7,8,20,15,1,7,15,7,3,7,0,18,5,4,7,5,15,4,3,101,94,10,7,13,31,3,1,1,4,7,2,10,2,4,27,9,29,4,2,1,4,1,9,23,3,2,37,1,5,10,5,18,0,10,2,2,14,14,1,1,6,8,1,2,4,1,3,3,10,11,4,9,23,6,0,7,1,84,3,0,21,8,2,5,12,2,2,20,16,22,23,1,4,4,2,1,1,7,2,8,0,11,2,4,4,7,2,1,9,9,8,33,1,29,4,1,0,2,7,6,3,2,9,3,5,22,140,16,8,0,5,8,6,14,10,10,7,16,4,2,2,29,14,1,3,14,3,2,6,32,1,19,11,9,8,5,11,5,0,3,9,8,14,7,6,2,18,8,2,6,3,58,5,24,2,5,1,9,10,5,4,15,2,5,10,3,5,9,7,5,0,6,3,48,10,1,8,17,5,6,7,5,38,1,2,3,2,4,4,5,0,1,16,11,2,15,10,7,13,12,5,7,5,8,2,21,2,1,13,1,15,5,8,0,2,4,10,6,3,1,4,1,2,3,1,3,6,23,17,4,3,11,4,1,9,8,2,3,2,12,17,26,5,3,6,8,0,19,2,8,9,5,7,3,3,14,19,2,3,9,1,30,5,21,4,2,26,2,9,10,0,16,1,24,18,20,0,27,4,16,2,6,0,2,0,5,0,5,1,7,5,0,7,0,6,0,4,3,0,2,2,1,4,26,3,0,2,1,1,5,5,16,7,4,15,3,2,0,6,2,1,9,9,4,4,1,3,4,2,10,3,9,4,0,4,23,5,1,10,4,17,7,6,6,9,3,2,3,12,7,1,11,2,3,0,1,7,1,17,7,3,1,3,1,1,6,5,6,0,3,2,26,28,0,2,5,4,0,6,4,8,4,1,1,1,7,12,1,7,3,2,0,3,6,0,3,8,2,2,1,4,1,8,2,3,4,0,15,12,12,11,9,2,0,1,2,1,7,3,18,18,0,0,3,3,2,6,2,0,6,5,13,6,8,20,4,1,10,0,3,14,12,1,19,9,3,8,4,5,18,21,6,2,16,5,5,9,1,3,3,5,3,11,6,5,1,3,3,1,0,6,7,9,2,2,6,0,1,3,13,2,9,1,3,4,13,12,2,23,4,1,20,14,8,3,20,1,11,2,10,1,4,4,1,18,2,2,5,7,7,9,4,10,9,10,3,1,8,6,2,10,5,0,17,13,1,21,7,3,13,66,6,1,2,10,2,8,15,4,3,13,5,1,12,3,3,3,0,4,5,7,11,2,20,27,4,2,0,3,6,3,13,8,11,7,1,3,1,1,1,2,8,7,8,9,2,8,5,6,2,6,3,3,4,11,7,4,5,3,2,2,0,10,2,14,5,8,0,3,4,4,9,5,1,10,3,3,6,0,3,5,10,14,3,5,3,2,6,2,15,3,6,3,2,10,6,1,4,1,2,4,3,5,3,8,7,1,3,7,2,8,10,7,5,7,10,5,2,5,1,3,7,5,0,2,3,10,7,1,13,4,0,2,6,3,5,6,0,16,1,16,5,15,8,2,14,8,4,4,3,5,3,0,10,11,3,0,1,3,16,3,4,2,10,11,2,3,4,4,6,4,2,5,5,10,13,4,3,8,1,4,5,3,4,1,3,2,5,8,2,3,1,5,6,5,1,9,0,2,5,2,8,14,6,1,1,8,3,2,2,1,4,2,1,2,3,1,2,4,3,16,2,3,5,3,4,1,1,5,5,1,0,11,1,2,10,0,4,1,0,3,7,16,1,4,0,6,0,2,7,0,4,5,1,3,7,7,9,2,3,12,0,0,1,8,4,4,4,3,2,1,4,1,3,3,0,5,0,6,0,3,3,3,5,0,4,0,2,2,4,7,5,1,11,4,0,17,4,13,21,0,7,2,2,5,5,4,1,7,17,6,7,5,1,5,0,14,4,5,7,5,1,2,0,1,0,2,3,4,9,4,5,3,8,15,3,8,4,0,4,1,1,2,0,1,1,0,0,5,2,0
provision,15,61,20,418,13,6,18,64,4,5,39,26,11,65,7,7,9,15,3,4,7,66,8,40,40,11,14,13,3,32,21,613,202,15,83,42,39,23,12,4,20,12,5,10,66,37,51,26,689,21,74,3,12,30,24,9,151,61,0,21,33,4,10,34,36,5,127,9,12,29,35,11,12,10,90,18,29,8,113,17,92,2,33,6,406,30,34,0,81,10,24,7,1,52,90,28,30,14,56,23,30,55,71,16,17,70,14,7,23,10,36,15,13,31,0,36,18,7,345,254,53,25,26,141,7,5,10,5,12,10,9,6,10,109,20,72,14,8,10,6,3,69,66,11,5,124,12,22,25,30,108,0,39,8,1,60,54,4,13,10,25,2,10,18,6,11,9,31,53,9,45,116,27,4,3,17,334,4,15,71,44,16,10,29,7,25,39,51,97,102,5,7,12,0,1,6,26,10,17,23,47,1,8,29,38,13,14,68,27,35,152,6,73,27,0,3,3,4,51,10,9,29,6,37,121,343,45,33,10,26,19,30,28,30,53,52,61,9,16,15,122,52,9,6,19,25,13,24,143,14,21,30,25,15,12,31,15,21,7,56,18,43,59,23,4,81,11,2,10,12,298,33,72,15,11,1,41,35,30,11,74,16,12,34,10,1,17,22,21,3,27,11,56,12,18,27,86,12,22,24,38,136,6,22,27,1,39,15,5,3,10,16,51,8,66,54,33,79,29,15,119,13,46,11,104,12,14,40,3,57,15,27,8,12,21,48,33,15,7,36,14,22,32,11,10,16,108,107,27,10,36,29,13,59,57,11,1,14,28,42,60,18,12,28,9,1,76,9,14,14,9,40,10,17,13,105,23,5,18,11,134,16,92,18,5,75,7,53,45,12,41,3,34,44,83,11,146,12,55,7,49,2,10,1,17,6,6,4,67,31,1,23,10,26,14,11,12,12,4,4,4,13,30,24,2,12,8,19,17,32,24,27,10,63,3,6,2,39,11,7,46,55,15,12,2,6,12,7,56,17,23,11,3,6,124,14,1,31,12,99,10,20,51,29,15,12,24,21,11,2,30,7,9,1,6,8,2,41,34,9,6,21,4,7,9,21,23,3,7,5,104,73,1,8,17,14,4,41,21,18,15,9,8,8,30,33,11,24,18,10,15,14,26,13,38,38,4,20,11,16,6,55,17,42,14,11,49,28,29,57,28,8,5,11,23,15,29,10,78,42,15,11,7,9,16,24,3,32,47,25,124,27,38,92,30,16,68,16,13,18,58,19,1,6,41,52,30,23,64,76,17,15,44,20,19,16,29,17,8,55,13,29,21,11,17,8,13,11,16,14,45,57,31,7,40,6,3,3,169,36,49,2,3,19,19,49,6,49,21,15,38,72,54,10,97,15,30,9,20,15,29,14,12,61,8,12,8,38,23,75,16,72,47,46,26,9,20,21,11,34,20,8,19,51,19,85,12,15,35,448,51,8,13,30,7,29,55,16,14,35,12,15,90,72,25,17,15,19,24,28,44,17,69,83,105,16,17,41,22,11,22,83,24,19,26,29,23,7,17,35,30,23,27,19,20,31,16,22,41,55,22,25,12,24,19,16,40,7,19,13,13,34,16,46,37,84,27,11,24,14,21,14,10,83,7,23,13,7,17,24,20,41,11,10,20,20,36,8,104,12,29,11,16,10,21,10,29,18,11,16,15,15,15,39,18,22,15,35,19,54,47,20,22,19,59,28,25,13,25,35,10,12,7,46,10,25,6,11,43,24,28,20,13,15,20,14,19,14,12,42,18,58,26,19,12,43,19,34,8,29,9,11,44,33,5,8,7,9,34,12,21,4,41,23,4,16,8,28,6,16,16,6,25,45,23,18,2,46,14,9,20,11,21,3,15,15,21,40,15,14,23,18,14,26,17,37,25,19,15,27,37,61,13,18,7,11,22,14,15,5,31,22,24,6,18,19,6,15,12,32,13,35,18,33,11,8,22,18,34,12,29,29,11,21,44,9,14,15,12,17,7,34,1,11,12,35,6,20,26,3,14,17,4,11,32,12,8,17,18,38,5,29,10,24,22,23,11,23,2,7,9,15,11,32,15,27,15,28,6,11,23,5,9,25,11,6,16,16,5,28,4,31,18,11,9,46,37,31,100,12,11,11,14,16,16,22,12,6,71,16,11,14,9,29,7,40,15,14,8,7,4,11,6,13,10,11,10,16,16,26,18,13,18,18,9,21,19,5,24,0,5,6,4,0,6,3,0,15,3,0
effective,0,10,2,59,4,5,1,5,2,1,8,2,7,49,3,11,4,8,3,1,1,7,19,13,6,9,5,6,3,6,9,118,29,7,17,27,25,2,5,5,3,2,1,2,11,8,20,9,106,13,21,4,4,26,5,1,22,11,1,5,7,2,2,7,2,5,25,5,2,3,7,4,2,2,75,6,10,5,39,3,27,3,4,5,91,5,12,0,26,0,3,1,0,13,16,3,5,4,17,5,8,14,10,7,4,11,10,1,6,4,6,5,8,8,3,15,1,1,31,80,27,8,8,34,8,1,0,2,2,2,8,4,3,31,19,29,8,1,5,4,3,23,10,0,5,28,3,9,6,3,43,3,10,4,1,27,16,5,3,19,10,4,7,1,3,1,3,18,10,7,7,27,8,1,4,5,60,2,5,32,17,7,18,11,1,5,18,8,6,31,1,0,4,1,3,1,14,2,8,7,9,0,2,7,20,8,3,19,5,14,31,8,7,7,3,2,1,5,3,1,4,8,3,8,16,48,18,12,3,5,5,9,19,22,23,8,21,7,13,5,14,10,1,3,11,6,1,11,33,3,6,7,17,1,3,5,3,0,3,12,5,16,7,3,3,25,1,10,7,3,52,6,10,3,2,5,15,5,2,5,26,5,4,9,4,2,10,6,11,0,6,3,8,1,0,3,13,0,3,11,10,15,1,0,7,1,6,2,4,3,4,10,24,14,7,12,3,20,10,10,15,4,9,2,18,1,12,8,0,8,3,8,6,2,4,2,14,2,4,8,3,5,5,3,5,3,12,16,7,5,6,5,3,17,2,3,1,4,11,13,18,8,5,7,1,2,9,6,11,7,1,6,3,2,4,22,3,5,4,4,23,1,25,4,4,6,6,16,16,2,16,4,6,2,11,4,23,1,10,4,11,3,2,3,4,3,7,2,13,5,2,3,1,8,1,2,4,2,1,1,1,4,14,8,2,3,4,5,2,9,1,6,0,2,2,2,4,5,14,4,6,8,1,4,0,1,18,0,22,4,14,2,3,3,34,10,0,3,3,13,6,17,20,17,2,3,10,3,5,0,10,3,1,2,2,9,2,4,20,5,4,4,0,2,3,6,7,2,6,10,38,12,1,1,1,0,2,4,2,7,4,2,1,4,1,8,0,5,1,5,5,6,3,5,8,5,3,4,3,1,0,8,3,11,3,0,19,5,1,10,4,5,3,6,6,1,2,5,14,8,0,4,3,5,6,7,0,4,6,2,7,4,5,9,15,8,14,0,3,7,5,9,6,1,9,5,11,4,34,15,4,4,6,10,8,5,4,1,4,12,2,6,1,8,3,0,1,2,2,11,12,13,4,0,13,2,3,3,14,6,13,2,3,3,7,13,3,11,8,2,11,25,6,1,11,8,6,3,9,3,6,1,3,7,6,6,2,9,3,9,2,9,4,9,4,5,11,4,2,3,4,1,6,9,2,10,7,7,8,59,1,1,4,7,4,4,16,5,1,7,0,2,3,12,2,2,5,3,2,5,19,5,6,18,8,4,1,3,4,0,8,18,4,1,6,5,6,10,1,13,4,5,6,7,4,9,0,0,7,6,4,4,1,3,8,4,5,6,2,1,3,2,1,11,3,7,2,4,1,4,5,5,4,8,4,2,1,0,2,5,2,8,0,9,1,0,30,4,16,3,7,3,2,6,10,1,5,4,1,2,4,3,3,3,3,7,4,3,3,3,2,8,2,3,6,2,6,0,2,6,7,2,6,4,6,3,4,0,0,3,0,0,10,1,9,2,4,1,2,3,1,1,2,3,7,7,3,4,1,3,4,2,3,11,4,3,2,1,5,0,2,1,4,7,0,3,1,5,1,5,0,0,13,3,2,2,4,5,2,2,1,1,4,2,3,5,4,14,5,2,1,1,0,5,3,6,4,9,1,4,3,23,7,2,4,2,3,3,2,4,2,1,0,9,2,3,3,4,4,9,2,0,6,5,3,2,1,1,2,1,6,2,1,0,1,7,1,1,0,4,1,3,0,1,1,3,1,2,5,5,1,0,1,2,0,1,4,4,4,6,3,1,4,2,2,3,1,0,1,2,1,1,1,3,0,1,1,6,3,2,3,4,2,1,0,2,1,4,1,4,2,2,1,3,5,5,5,7,10,0,6,3,0,8,2,2,2,7,7,0,0,0,0,3,3,11,0,1,2,5,2,6,0,2,1,0,4,2,5,3,0,2,2,0,4,0,7,1,0,1,0,5,3,2,1,0,3,2,1,1
doubt,8,49,5,224,21,8,4,65,12,3,27,7,14,76,8,18,8,20,8,6,8,56,17,20,25,21,14,20,8,11,15,235,168,13,82,86,47,14,9,14,12,13,8,7,48,33,42,14,357,35,64,1,24,47,4,14,77,34,4,21,22,11,7,13,25,4,107,10,9,33,3,9,9,4,105,23,22,3,104,23,56,0,25,10,274,38,21,1,38,3,7,4,3,33,73,7,27,7,29,15,38,35,47,15,24,31,6,10,18,3,16,13,10,19,4,47,10,9,70,290,49,15,20,76,10,7,4,4,10,0,21,6,7,48,28,69,8,4,20,9,3,30,41,5,6,72,6,23,20,26,107,2,25,17,4,44,22,5,8,4,13,3,15,4,6,6,8,19,32,19,14,96,24,3,4,15,237,6,16,44,31,16,1,18,10,32,50,23,61,54,0,8,13,2,5,2,25,6,11,19,35,3,7,30,24,13,5,46,12,48,99,8,34,16,0,3,1,7,18,2,1,11,3,24,60,115,33,34,1,9,11,15,19,21,37,36,43,16,4,11,87,35,8,7,22,10,5,21,46,8,12,26,27,8,19,34,16,5,11,9,2,36,32,8,15,34,3,9,20,6,197,11,31,11,8,1,25,15,15,4,68,8,8,21,9,2,7,7,17,4,3,2,21,3,5,14,60,5,8,24,36,40,1,0,11,0,32,7,4,4,4,13,44,9,37,21,22,50,21,5,65,12,38,5,65,4,10,40,3,35,6,14,14,11,13,31,30,12,7,16,10,10,22,15,10,2,63,70,23,7,22,18,10,24,38,7,3,9,30,31,29,12,15,18,10,7,56,10,8,12,5,18,14,10,7,39,17,8,27,12,79,3,73,15,3,59,5,32,40,11,41,9,17,14,58,23,94,10,31,7,27,3,6,4,7,7,15,1,29,33,3,12,8,17,12,19,5,20,6,5,6,10,34,16,3,7,7,18,13,24,15,4,2,11,0,6,1,20,9,4,22,33,10,19,3,4,6,4,27,9,23,8,5,17,72,12,3,9,6,49,13,26,37,19,14,3,21,13,6,1,15,6,8,2,6,2,5,19,24,15,7,22,9,4,10,8,23,9,8,8,79,62,4,6,8,16,1,20,14,17,9,7,1,0,10,34,8,14,13,7,5,18,8,8,31,44,8,17,7,11,7,18,21,35,16,6,27,11,22,34,8,16,10,16,13,10,19,18,60,20,8,5,2,5,20,15,12,25,28,5,57,12,11,59,13,13,34,7,10,8,45,3,41,9,1,24,26,15,48,51,26,16,32,3,15,14,10,8,17,18,9,25,20,14,24,6,8,15,8,16,35,53,14,1,31,16,4,3,64,27,45,2,12,12,11,24,11,30,10,11,41,19,13,9,39,17,44,7,13,4,34,5,9,19,4,11,8,15,25,44,23,29,57,31,10,10,6,8,7,23,23,4,6,36,8,37,9,8,4,177,15,5,10,12,10,19,48,8,9,14,15,10,23,29,10,9,2,9,24,17,23,16,56,56,38,4,6,17,4,9,18,35,26,7,14,18,28,4,2,11,17,8,22,18,14,21,12,13,15,38,11,3,14,3,13,8,29,12,4,9,9,4,8,40,38,22,13,18,8,13,12,3,8,27,1,5,18,5,7,10,8,22,9,5,18,7,24,10,46,15,22,14,7,11,17,7,16,7,13,6,19,7,3,8,5,28,10,21,6,7,6,12,6,3,21,35,16,9,15,16,9,2,2,11,6,20,17,3,16,13,15,12,21,13,15,5,10,9,11,18,18,13,6,12,18,30,10,7,6,7,10,3,15,12,15,7,16,5,34,5,5,12,9,17,6,5,8,13,9,13,13,5,9,14,6,14,7,7,13,8,8,6,24,8,8,17,24,39,4,7,9,10,13,14,10,29,9,7,15,15,15,38,13,15,2,3,13,17,4,2,16,8,16,4,9,14,5,3,10,26,7,14,16,26,11,7,8,15,16,2,4,8,6,4,16,6,8,6,8,12,6,12,0,10,7,10,11,1,2,3,12,15,3,13,8,3,11,24,1,19,3,7,11,11,24,7,1,7,8,10,44,9,11,11,0,13,2,26,9,9,6,3,10,9,12,8,4,10,2,12,4,15,1,5,5,18,18,7,39,7,1,2,5,4,2,3,7,4,22,17,10,10,17,7,2,17,10,2,9,12,26,15,7,3,11,10,0,13,9,5,6,16,7,19,12,4,27,2,9,2,5,3,8,2,0,3,0,16,2,1
necessity,6,21,11,180,9,5,9,30,2,5,12,5,8,79,9,13,6,13,6,4,19,57,15,23,24,10,10,15,6,19,22,232,147,9,88,77,51,14,17,8,16,7,12,6,53,26,33,22,286,9,46,2,13,34,5,6,98,41,2,23,26,13,3,19,35,1,135,5,7,16,15,5,8,12,120,23,21,6,122,31,73,2,31,7,276,34,30,0,38,2,9,7,1,42,62,35,15,14,35,27,22,48,52,6,15,58,10,4,14,7,23,10,20,38,0,29,3,8,70,242,46,12,42,85,15,11,6,9,2,5,18,6,10,69,28,53,11,9,8,10,3,45,37,12,3,76,6,16,28,24,80,3,25,12,3,30,50,10,5,12,16,4,21,2,4,1,11,21,36,7,18,98,36,2,5,10,249,6,17,58,38,18,12,21,4,40,49,29,38,55,4,6,12,0,3,7,33,6,9,18,40,3,1,14,36,9,8,79,10,49,98,8,33,11,4,0,2,3,28,8,3,20,4,26,89,182,43,47,7,13,10,22,35,38,44,56,36,13,16,5,111,47,14,5,18,12,7,29,72,13,33,45,30,24,21,31,22,4,8,33,9,40,36,5,14,62,1,10,17,9,220,13,39,18,7,2,28,32,19,10,69,18,7,27,12,1,3,8,20,4,6,2,26,9,2,14,44,12,10,33,34,58,1,1,18,5,36,5,2,1,3,18,45,3,42,29,33,63,25,7,72,8,35,1,95,13,6,32,6,28,7,13,11,9,13,8,23,8,8,13,30,13,23,10,8,2,77,56,24,4,22,17,7,45,46,6,4,8,27,42,40,9,12,20,4,1,54,10,14,18,6,17,7,20,14,51,13,11,23,13,71,6,69,13,4,37,11,27,44,4,34,4,10,18,40,16,107,10,48,9,27,4,5,1,8,11,7,1,38,15,2,10,11,28,13,15,5,10,5,1,9,9,26,14,2,9,15,24,23,18,21,2,2,5,2,7,0,4,25,7,23,45,11,11,1,5,11,10,64,10,17,4,3,10,68,17,2,14,10,52,18,16,47,25,11,11,37,11,16,3,26,7,4,3,4,18,6,17,26,8,11,14,5,11,13,12,30,3,4,6,121,68,2,6,24,3,6,23,7,15,21,8,3,0,8,41,1,18,16,11,16,12,10,8,33,20,9,13,14,13,9,27,11,34,11,3,23,18,17,39,18,9,1,13,11,14,15,9,62,45,9,1,4,9,15,17,1,28,21,15,44,7,8,53,10,16,37,8,6,21,40,8,52,5,24,1,12,17,45,50,16,10,33,11,10,7,30,11,11,18,16,28,17,19,22,5,12,9,8,12,32,56,4,5,29,2,8,7,35,26,28,4,14,3,4,39,8,33,14,14,32,32,14,3,46,14,28,18,16,13,38,21,14,36,3,12,14,17,21,41,28,74,31,26,11,5,11,9,5,17,17,2,10,28,10,42,11,9,14,157,22,10,15,12,12,15,54,18,9,22,17,7,10,21,4,5,8,11,20,11,40,9,21,39,28,12,10,12,2,12,6,36,18,23,39,17,27,8,10,6,10,19,25,9,8,10,12,8,34,23,7,10,14,10,12,11,19,11,9,3,12,7,17,51,19,43,13,18,5,16,14,6,7,42,1,14,7,1,6,11,17,24,6,11,6,6,46,11,41,4,16,11,10,13,13,10,30,6,12,11,15,10,6,6,3,18,17,24,14,5,9,29,2,3,20,22,9,11,10,12,9,7,7,11,10,30,13,8,22,19,7,9,16,5,16,11,12,4,11,15,14,18,6,15,24,29,8,13,8,15,5,9,17,13,9,1,18,5,28,9,20,4,7,8,5,8,5,11,4,23,7,10,6,20,8,6,7,10,30,12,7,8,22,2,8,10,14,32,25,9,8,16,8,16,14,26,13,11,14,15,33,40,17,9,9,10,10,19,10,1,9,11,6,8,14,12,13,10,18,28,8,5,13,36,10,5,5,5,8,3,0,7,7,1,10,8,8,7,9,8,5,6,1,6,9,5,10,10,9,4,24,5,9,14,11,2,3,24,10,35,8,12,11,14,10,3,1,3,5,10,12,8,8,17,7,9,3,12,10,14,13,6,14,9,5,5,8,14,8,12,2,14,10,9,17,21,41,12,64,7,8,6,5,17,3,3,2,5,20,7,4,4,11,5,0,18,10,5,4,8,6,6,12,6,4,4,1,26,13,13,1,5,8,17,15,20,13,5,17,2,6,3,4,0,0,4,0,8,2,1
prove,5,17,11,163,12,7,6,47,2,4,34,11,12,78,6,9,4,26,6,5,0,48,12,34,31,10,21,20,10,22,7,158,171,21,68,70,53,11,12,8,8,11,3,3,54,26,28,15,322,26,60,14,15,49,13,14,55,28,8,17,23,7,7,14,28,7,139,8,11,23,14,4,9,3,87,15,15,8,104,26,36,2,20,2,264,25,16,1,42,0,12,3,3,37,51,11,20,9,40,12,15,31,50,15,27,31,9,3,17,6,32,7,11,21,3,31,10,6,70,162,48,29,8,88,11,8,2,7,2,4,14,3,16,61,33,44,16,9,7,10,7,60,34,4,7,62,8,20,15,9,101,3,18,11,11,38,36,8,13,10,18,3,16,5,3,14,10,31,25,14,22,98,20,1,6,20,206,6,14,36,21,18,6,30,5,21,30,32,59,73,6,5,9,1,4,4,16,12,16,18,40,0,0,11,24,8,5,51,7,25,83,9,44,9,1,5,2,1,14,2,3,24,14,13,49,106,50,44,9,4,11,11,12,19,35,26,30,6,9,23,79,39,7,13,22,14,13,28,46,5,12,24,18,11,13,22,19,1,9,24,7,37,24,3,9,41,5,12,12,7,183,12,33,8,10,1,27,11,18,2,63,8,8,29,13,3,2,12,12,1,13,1,6,4,6,5,47,9,10,23,27,28,0,2,13,3,33,4,8,1,7,23,39,12,25,21,16,50,17,14,63,12,41,2,56,12,18,35,8,42,11,8,9,6,20,9,19,12,2,18,10,15,27,14,7,6,56,32,21,10,21,22,14,31,24,7,5,12,27,40,24,10,16,12,14,3,46,15,6,14,2,15,3,20,11,28,10,5,27,15,69,1,54,20,6,30,5,28,25,9,28,4,21,8,52,9,72,9,32,10,26,2,14,4,12,14,12,4,46,12,15,18,4,24,24,14,4,11,4,3,11,13,28,18,3,8,11,27,22,24,16,9,4,22,13,12,4,24,6,6,17,29,13,16,8,5,8,4,40,13,19,9,8,5,57,9,2,3,6,33,12,46,45,55,13,6,17,16,14,1,32,6,3,5,12,36,4,19,18,4,6,11,7,7,12,14,11,12,11,2,84,47,3,9,15,4,5,16,14,15,13,10,8,9,7,45,2,24,11,7,4,9,7,12,49,23,8,12,6,13,5,33,10,22,10,7,26,17,14,33,10,10,2,9,11,4,13,8,49,30,9,4,3,6,19,9,12,16,20,14,56,5,4,49,6,15,45,3,10,8,23,4,30,11,26,12,1,15,46,46,18,23,21,7,11,11,22,9,8,13,8,13,30,23,21,22,3,11,1,13,33,38,11,7,29,9,19,2,49,21,21,4,14,3,11,35,2,17,10,3,38,17,8,9,46,9,37,7,12,8,23,8,7,40,2,9,10,10,12,41,10,25,31,31,15,5,16,10,5,25,30,4,7,34,22,34,13,7,5,165,30,6,11,3,11,21,46,18,7,22,11,6,19,22,12,2,2,8,14,24,18,6,52,20,34,14,2,12,2,9,6,45,19,15,10,11,12,9,4,14,12,9,17,25,6,17,10,2,12,17,27,14,11,12,13,6,26,11,6,8,3,9,5,30,22,29,18,9,8,11,27,12,13,34,5,9,5,5,10,29,6,24,4,12,9,9,20,10,43,4,12,9,4,14,7,5,15,9,6,11,14,8,1,13,5,23,11,12,4,5,4,16,4,3,26,19,5,9,14,9,9,5,7,26,6,16,13,9,27,18,2,13,14,2,15,10,7,24,15,8,9,7,2,9,16,26,11,12,10,5,12,8,18,9,3,12,13,10,20,5,9,5,12,12,6,4,3,16,9,9,7,4,6,11,9,10,3,6,9,3,7,5,20,3,7,31,14,31,13,10,7,9,3,6,14,16,11,3,5,15,19,27,9,10,2,3,11,5,8,1,15,1,10,5,4,14,9,4,8,14,7,10,7,28,9,12,5,6,16,10,7,8,4,11,16,12,13,5,12,9,5,13,0,8,10,9,12,4,7,6,4,12,6,11,13,5,12,13,8,19,8,19,11,15,11,9,4,11,9,4,16,13,5,2,3,6,8,22,5,9,7,3,8,8,5,11,8,10,3,7,5,15,5,8,4,19,14,20,49,12,3,7,8,7,5,9,8,9,26,10,3,7,5,8,1,16,2,1,17,9,19,4,8,5,6,8,4,16,7,8,17,12,8,8,13,8,9,8,24,1,5,6,5,1,0,7,1,16,5,9
impossible,3,17,10,92,5,3,6,25,3,1,14,8,3,57,2,8,7,13,4,5,2,25,7,26,17,10,13,7,5,14,9,151,76,11,37,22,24,4,6,2,10,0,7,3,18,13,14,29,196,9,45,5,14,20,7,3,56,25,4,6,16,1,2,5,29,7,74,3,10,9,4,1,8,3,78,15,11,14,49,18,25,4,4,6,181,12,4,1,30,2,4,8,0,13,35,3,16,3,19,8,4,22,24,11,9,28,7,11,7,3,11,0,2,5,1,32,3,3,30,140,31,28,10,39,6,0,4,1,2,1,13,4,7,22,19,31,4,5,2,3,3,32,15,8,1,61,12,17,11,7,48,2,15,2,2,55,16,4,8,8,17,5,10,0,1,9,13,10,32,6,5,79,13,1,6,9,107,2,5,24,24,5,4,13,11,12,33,22,35,29,6,7,8,1,3,1,13,5,12,16,50,0,3,3,16,8,4,34,3,10,48,3,17,12,1,0,2,8,11,2,2,22,1,7,29,96,30,19,5,9,8,10,13,23,23,9,19,8,8,19,87,30,3,12,10,1,4,21,43,4,4,10,22,0,8,4,6,1,3,11,6,26,7,4,5,20,5,2,11,4,96,0,20,4,4,1,15,2,5,4,47,7,1,15,16,3,3,4,10,0,5,0,13,3,2,6,21,5,2,12,26,19,0,0,12,3,16,2,3,7,2,31,19,3,15,7,13,37,15,8,34,6,36,8,44,10,11,22,2,21,9,12,6,5,12,6,11,8,2,0,11,12,8,13,2,3,25,29,11,2,16,9,7,18,32,7,7,7,15,13,19,3,8,13,2,0,31,8,7,8,1,13,4,5,13,25,8,1,4,4,35,2,47,9,4,14,8,12,23,3,33,2,12,15,27,3,41,5,23,1,11,1,5,0,4,2,7,2,12,8,1,4,0,21,11,8,1,8,4,2,3,11,22,12,1,5,2,14,9,7,9,2,0,2,1,5,1,11,3,4,10,20,9,7,1,2,2,3,24,1,13,2,1,4,39,7,5,7,12,11,11,21,22,18,5,2,7,3,5,1,18,7,5,0,2,13,4,8,23,4,12,11,6,3,4,9,8,2,5,14,52,39,3,3,6,8,4,16,2,13,12,1,3,0,2,22,7,10,6,0,1,2,7,7,16,11,7,10,17,5,7,28,7,23,7,6,23,7,21,36,15,8,2,8,5,0,8,8,44,25,5,0,0,3,11,14,0,8,12,3,37,3,10,30,7,10,18,2,8,5,10,5,23,4,15,17,15,1,20,34,6,5,6,5,3,3,9,9,11,12,1,13,15,13,9,4,7,8,3,12,10,31,6,6,18,10,5,14,28,14,17,4,7,3,6,21,0,13,6,2,20,27,5,2,38,10,10,9,21,7,11,10,1,15,2,4,4,7,6,29,9,21,21,21,6,1,14,3,2,10,14,1,22,11,5,17,7,2,3,95,11,3,2,7,5,6,20,19,6,10,4,1,8,15,2,2,2,8,8,8,38,6,34,102,18,9,3,0,3,2,2,25,17,5,9,3,13,6,2,4,9,7,17,4,5,6,14,6,12,8,2,5,4,7,4,4,8,6,4,1,2,3,7,12,9,6,9,8,6,8,7,4,5,17,3,3,8,4,5,15,8,8,1,5,6,0,11,7,19,3,8,3,3,7,4,3,14,6,4,6,9,1,1,2,1,6,10,6,3,3,5,17,2,0,9,15,9,12,9,7,4,3,3,15,1,13,5,2,23,11,9,5,7,0,14,4,6,8,12,5,4,8,3,5,18,25,12,7,4,15,3,5,18,7,5,2,4,7,10,5,5,6,10,3,4,6,2,9,2,8,6,1,12,7,7,4,1,5,5,1,4,6,1,0,4,7,7,12,11,6,8,5,19,8,5,4,14,6,2,15,25,25,2,2,0,4,8,2,5,1,8,2,1,0,4,9,9,1,10,11,9,9,2,12,4,4,3,7,5,0,1,4,4,2,5,4,7,3,11,4,6,3,0,1,10,13,2,7,12,6,6,4,0,8,7,0,3,5,3,22,5,1,3,0,9,3,1,3,1,2,3,4,1,5,6,12,2,6,0,9,3,5,9,2,8,3,1,5,8,7,5,8,3,0,6,4,10,12,8,2,1,5,2,2,2,1,3,2,6,4,1,2,5,1,2,11,10,3,7,7,2,5,8,3,3,4,2,5,7,1,0,7,7,7,7,7,13,5,15,1,1,3,6,0,0,3,2,4,0,0
purpose,16,76,34,488,16,16,14,136,12,11,64,28,18,181,17,35,18,48,15,13,11,106,26,94,59,30,43,44,14,47,30,619,322,36,141,140,119,50,63,19,20,41,34,4,114,35,77,39,913,73,137,25,30,107,10,9,171,83,2,50,51,15,12,47,56,19,281,23,32,50,50,24,6,11,188,35,37,18,220,63,141,4,39,18,694,91,56,3,113,5,34,16,1,92,124,35,40,17,95,32,44,91,103,21,33,103,21,11,36,13,43,28,30,69,6,88,27,17,213,478,113,33,69,180,13,23,14,9,14,4,30,11,12,168,53,121,33,12,18,22,13,90,74,14,10,185,21,28,55,71,225,3,42,27,6,74,70,14,30,19,36,12,29,11,7,14,14,70,56,36,60,221,64,1,3,23,462,17,37,117,64,46,11,43,21,63,100,52,90,168,8,16,12,2,11,9,57,29,21,41,73,4,5,39,84,28,16,97,51,86,225,12,76,21,10,3,4,8,38,5,14,50,20,39,162,343,75,74,21,46,49,41,66,63,103,107,92,23,34,10,172,103,19,13,50,21,14,59,167,15,48,60,55,31,31,54,24,4,14,62,14,99,70,19,26,148,22,19,37,14,424,44,117,19,14,1,55,72,46,19,132,30,6,55,19,8,13,25,59,5,22,9,42,18,15,29,130,28,36,60,53,134,5,16,22,3,69,16,20,4,8,42,87,28,106,53,52,110,58,26,142,25,63,20,164,21,31,94,24,64,14,31,19,23,26,55,41,29,15,51,30,34,37,37,16,10,119,146,61,9,51,42,18,136,54,23,19,9,70,103,79,27,28,63,19,8,98,27,17,28,16,54,23,28,21,93,18,21,45,28,229,8,147,42,4,137,15,49,81,6,71,14,53,44,97,31,178,21,122,15,62,11,13,5,18,11,26,10,79,36,5,22,8,31,24,44,12,17,16,7,14,38,66,57,4,14,14,58,33,48,47,18,14,47,20,11,11,51,30,14,56,99,27,45,5,3,26,20,89,23,46,18,13,18,115,22,7,46,36,101,35,63,93,82,19,15,46,33,39,0,42,4,16,5,16,31,13,51,63,16,27,43,13,15,18,19,37,18,21,16,251,107,11,15,25,25,15,55,34,30,22,17,24,2,46,61,15,48,17,13,18,19,36,14,34,48,16,23,51,25,11,59,33,77,25,22,83,37,65,72,29,16,24,31,31,16,40,26,105,56,14,12,3,22,27,24,15,63,48,23,127,21,55,126,28,26,92,15,25,28,67,18,64,34,48,45,46,20,1,138,46,25,108,18,31,23,25,14,21,61,27,58,40,39,18,12,14,25,11,47,88,83,28,16,59,12,20,10,140,62,99,11,20,11,31,62,15,80,41,25,68,71,55,18,98,26,83,38,24,20,44,37,21,88,25,39,24,42,29,119,45,57,70,70,32,10,34,30,6,53,27,4,18,70,25,83,24,30,29,514,61,14,29,24,20,36,141,51,24,63,19,13,69,50,39,22,24,39,32,38,55,38,110,68,109,17,11,36,24,25,21,93,39,24,38,24,43,23,15,54,47,30,48,41,28,40,18,22,46,45,46,17,29,21,32,32,43,22,14,24,7,21,21,97,48,80,19,22,26,32,35,22,14,65,4,20,30,7,8,43,27,41,17,11,29,17,71,16,106,14,36,26,30,28,37,18,33,31,16,32,21,33,21,48,29,42,23,46,19,49,46,35,29,18,58,47,33,18,24,60,18,7,7,43,25,41,24,10,23,37,11,13,41,13,37,19,21,49,21,42,23,30,10,16,24,72,21,24,12,27,13,21,35,17,14,9,20,19,58,15,19,23,33,29,16,15,13,39,19,39,15,12,36,42,23,25,14,35,38,7,28,25,32,19,22,26,38,90,25,26,15,31,26,33,9,21,30,29,21,31,57,116,39,34,10,21,21,41,32,6,23,14,19,18,15,27,16,21,20,48,25,16,44,38,11,21,20,37,37,22,14,21,11,16,34,18,25,17,10,21,15,30,3,7,24,40,15,14,17,12,18,19,12,35,25,17,27,30,21,61,16,33,25,59,23,19,13,44,16,22,34,34,20,53,12,20,21,73,14,32,23,14,22,32,13,14,16,34,9,44,12,40,21,19,31,61,24,56,108,16,6,12,9,23,50,15,10,23,92,28,17,13,6,16,6,58,24,12,18,27,30,23,9,9,18,15,11,23,27,13,23,14,27,34,18,16,29,4,51,3,8,15,15,5,4,9,2,22,3,10
secure,23,56,36,431,18,8,19,74,17,13,66,32,18,253,15,41,24,41,12,18,23,105,26,83,85,29,43,31,20,33,25,565,372,41,167,196,193,35,43,13,24,63,11,13,121,62,82,50,783,83,158,25,61,153,42,23,187,79,15,49,39,32,12,37,61,15,316,24,24,52,34,19,23,13,278,34,50,24,196,89,144,5,33,22,689,61,46,2,109,13,19,15,6,69,198,59,55,16,91,61,51,95,102,32,39,76,29,10,34,15,49,25,41,47,8,70,18,12,182,510,131,45,26,164,11,10,11,14,10,7,35,5,21,140,55,185,40,16,21,25,16,107,64,11,9,205,23,54,62,53,196,7,47,25,18,82,120,22,33,35,49,18,28,13,2,25,10,107,69,23,41,264,96,1,14,18,511,10,38,159,81,46,7,65,27,88,105,80,121,133,7,22,38,4,11,13,86,22,19,54,132,12,13,34,72,23,18,125,59,84,242,25,68,17,1,7,2,9,52,17,9,60,17,37,116,420,78,78,13,44,49,46,32,84,120,67,93,28,35,41,185,120,18,30,54,28,26,79,189,9,30,55,74,22,30,40,27,2,16,53,29,76,59,14,30,170,24,29,68,15,390,26,100,25,16,5,86,35,25,19,176,35,7,52,37,9,22,37,28,9,6,12,50,13,24,37,87,28,36,59,73,127,5,9,29,5,94,14,22,11,9,69,75,26,103,57,83,158,65,28,147,16,98,13,272,18,31,72,8,84,11,37,30,26,39,61,39,14,19,25,31,22,42,29,20,19,120,147,59,24,47,49,21,144,61,37,16,18,58,96,92,27,34,69,23,10,88,24,32,56,15,57,12,44,48,101,28,13,45,26,235,21,141,47,13,148,26,63,64,12,98,18,39,48,86,40,206,14,120,20,76,13,14,9,21,42,31,12,100,80,10,29,26,59,45,24,25,17,21,11,23,29,77,48,12,21,17,62,24,52,55,26,11,32,21,17,5,46,22,22,55,86,23,39,7,13,50,31,113,29,57,25,13,33,197,41,7,28,39,82,40,63,102,105,32,21,61,62,46,8,65,32,8,12,15,86,15,58,104,27,23,44,26,6,24,23,40,11,41,21,185,117,9,8,36,22,16,48,23,55,35,15,9,1,51,111,22,44,19,26,19,25,23,46,49,42,30,33,67,25,15,74,31,100,21,15,112,61,78,84,34,17,16,33,21,13,31,49,94,84,18,13,8,16,50,26,9,50,41,44,100,13,36,108,34,43,111,24,26,43,88,21,76,15,51,50,46,34,138,1,19,16,30,36,36,18,40,24,25,41,25,49,66,43,37,27,28,19,16,53,63,120,35,21,121,18,29,26,192,71,83,13,30,28,23,69,11,66,49,9,105,99,50,32,107,24,77,48,37,17,44,58,24,87,11,41,23,45,40,111,53,80,109,68,34,16,60,20,14,32,44,18,37,57,50,75,20,21,35,458,99,20,15,32,32,37,103,30,23,55,22,14,40,70,40,28,7,30,49,33,55,28,87,86,81,16,11,11,17,18,49,74,34,38,30,32,39,19,16,34,37,44,36,56,17,36,27,16,48,34,41,18,26,35,31,17,47,29,11,4,13,24,15,80,50,59,20,23,29,35,12,21,13,75,9,34,41,15,22,46,26,59,27,25,22,14,55,15,84,22,38,20,19,34,34,33,32,36,20,35,43,10,5,21,11,54,21,53,6,52,45,52,9,6,62,51,42,28,34,50,28,13,9,55,22,40,30,12,55,27,18,14,33,26,44,14,19,14,35,50,26,38,12,20,73,67,36,23,15,21,17,17,41,21,12,13,24,14,47,22,35,17,29,29,19,13,16,26,8,36,14,9,31,64,26,16,13,37,38,23,30,11,36,21,19,31,24,80,30,19,17,23,19,42,20,46,41,61,18,40,37,72,48,21,13,19,41,42,22,10,28,22,32,19,18,24,24,24,19,46,36,20,47,59,23,11,12,45,24,22,8,13,16,16,35,12,17,20,42,24,24,48,3,14,38,30,14,15,15,16,20,13,24,19,37,6,26,41,20,60,24,36,35,27,29,11,8,28,15,9,17,21,8,38,15,21,38,40,18,44,15,10,22,20,12,3,19,24,21,54,27,34,12,16,20,53,39,28,77,16,3,14,6,16,13,8,8,15,47,10,23,17,14,13,6,27,26,4,16,13,24,17,24,17,9,15,9,11,32,21,15,21,21,53,15,9,20,12,43,6,21,15,13,5,9,10,10,12,11,11
beyond,4,17,6,119,5,8,4,64,3,3,14,6,9,47,11,12,5,18,10,6,11,64,9,17,25,13,17,21,6,10,16,182,114,10,51,80,53,13,16,11,13,17,4,5,34,14,31,6,288,34,37,4,11,42,10,1,68,22,7,17,9,5,5,17,33,14,117,14,8,15,28,5,4,6,97,20,46,5,101,21,80,4,21,5,235,41,21,1,28,3,12,11,3,32,43,16,31,4,50,13,27,32,37,10,24,34,7,2,20,3,19,4,13,24,9,36,7,6,75,162,48,12,17,99,9,2,2,4,6,7,24,7,21,50,22,59,4,4,7,10,2,36,27,1,9,61,7,21,14,19,86,4,14,13,7,23,43,5,8,9,12,7,7,3,6,14,7,20,27,11,16,91,26,3,6,7,130,7,10,54,20,13,10,15,7,26,51,22,33,41,3,11,3,5,4,6,15,4,14,19,22,5,2,12,26,10,7,37,9,31,73,13,30,15,0,13,5,7,5,8,14,15,4,18,53,95,15,20,3,7,17,19,16,36,39,68,25,9,12,8,69,36,5,3,19,4,7,24,48,8,9,36,24,15,16,11,14,4,7,21,6,18,21,1,15,26,10,9,17,6,158,19,42,9,7,2,19,26,13,0,67,5,7,17,12,3,6,12,16,7,3,3,17,16,1,10,33,6,8,25,25,24,4,1,14,7,14,7,3,1,5,15,38,8,41,18,25,38,18,13,33,3,29,5,35,18,15,35,7,9,4,9,6,3,10,25,9,6,10,15,6,9,26,8,7,10,44,52,23,9,15,10,5,30,19,4,3,4,9,24,22,11,8,23,8,10,35,11,7,16,6,29,6,11,7,29,6,7,21,12,74,5,53,10,5,42,4,18,37,3,13,5,12,11,33,6,57,2,32,8,15,5,4,0,7,11,9,8,26,13,2,8,1,18,3,10,6,11,3,4,6,3,20,17,7,6,1,12,18,13,14,7,3,12,3,6,8,5,13,6,17,37,5,8,4,9,22,3,32,10,26,1,7,6,54,2,3,7,10,26,5,33,36,25,10,0,23,12,14,3,21,3,0,3,5,18,10,17,15,4,6,28,3,6,3,8,7,2,1,9,61,43,4,4,16,15,3,13,17,10,26,7,4,5,17,30,5,11,10,7,11,6,9,8,16,20,5,9,3,12,7,8,13,26,5,6,23,12,10,24,15,4,4,11,6,5,8,7,38,18,3,2,3,4,9,10,11,21,12,6,55,9,6,65,6,12,24,12,5,9,23,6,17,4,26,16,18,6,46,19,1,10,25,0,10,5,16,6,4,20,12,18,13,23,7,3,5,9,3,11,12,26,9,5,10,6,11,7,40,12,19,5,9,2,6,17,9,19,11,11,23,17,6,15,20,8,20,6,3,3,21,14,4,18,6,14,6,10,24,36,9,16,29,15,6,4,8,11,3,15,9,5,6,29,5,23,12,2,3,109,11,10,7,10,9,20,44,13,4,13,10,6,9,14,2,8,1,4,7,6,15,8,9,19,23,10,1,16,5,13,7,24,15,7,6,7,8,6,3,12,15,16,20,8,4,20,10,10,16,15,4,4,5,8,12,4,19,2,1,4,3,7,7,40,48,34,6,12,8,12,8,2,7,31,4,25,18,3,5,12,14,19,3,7,4,4,24,3,53,24,9,9,4,12,13,7,19,14,9,6,10,15,6,14,11,9,14,4,3,17,16,8,1,6,54,28,8,8,8,10,6,1,6,17,5,12,18,3,17,12,16,8,8,6,8,11,7,16,7,17,9,5,0,10,6,10,7,9,3,5,4,5,8,2,5,5,8,7,18,3,7,6,5,11,5,2,4,6,5,12,7,3,6,11,3,9,4,5,13,10,3,12,13,4,5,16,5,36,9,8,4,2,5,8,15,13,9,4,8,5,10,23,5,10,1,5,6,9,3,4,10,1,15,7,5,6,6,3,7,9,3,16,12,11,4,14,1,3,7,0,0,14,7,0,7,3,5,4,9,11,2,13,5,3,4,3,7,3,4,4,6,2,5,6,14,2,7,9,6,13,2,13,8,21,8,6,5,12,6,3,9,7,6,18,1,6,2,1,4,12,2,2,6,12,7,14,6,11,0,23,3,16,7,11,19,20,14,24,74,4,5,6,7,11,5,7,10,6,15,5,5,21,15,2,1,16,3,1,4,6,5,5,8,7,3,7,5,5,8,5,4,12,2,6,5,10,16,8,3,3,11,4,9,3,0,13,2,10,10,3
heretofore,5,7,6,124,8,3,5,38,3,2,18,11,8,29,5,8,4,12,5,3,6,32,3,26,13,7,6,4,1,14,11,123,104,7,36,30,33,12,10,6,2,4,8,1,27,14,18,9,230,9,30,1,8,17,2,7,71,29,0,11,24,5,2,9,24,2,46,7,5,16,4,3,0,1,43,9,10,2,47,22,41,0,23,4,185,15,8,0,21,0,1,2,0,33,42,4,9,2,30,11,18,22,31,5,3,28,4,0,10,1,11,4,7,9,0,33,1,5,41,82,38,6,6,58,6,1,3,1,3,0,7,3,6,42,14,25,1,3,4,4,2,29,23,1,2,43,5,9,7,9,61,0,23,5,5,14,11,0,4,0,6,0,3,0,0,0,3,13,25,5,13,52,14,0,4,8,168,2,7,16,22,12,0,7,3,14,32,11,24,40,3,3,2,1,0,3,14,1,2,10,12,0,5,11,20,7,3,30,12,30,49,0,11,3,3,0,5,0,20,2,8,10,7,13,38,55,20,13,2,2,10,11,8,12,27,32,30,5,2,3,48,22,6,3,10,3,3,5,18,4,15,12,8,7,13,8,11,2,7,15,0,13,29,3,8,41,9,4,14,6,107,7,20,5,3,0,9,13,9,3,37,9,3,9,11,1,2,4,14,2,2,5,5,6,2,8,38,3,2,17,26,41,0,1,9,0,11,2,3,1,2,11,17,7,21,15,11,37,8,4,39,7,13,3,46,4,3,24,3,12,1,12,7,3,9,12,16,11,6,5,9,4,9,7,6,2,40,36,25,1,7,10,4,14,12,2,7,4,8,20,15,9,4,15,2,1,21,7,5,4,2,19,4,3,6,31,13,3,14,12,56,2,42,11,0,27,7,23,19,3,18,4,14,9,45,10,83,6,15,5,23,0,2,1,7,5,7,2,17,7,2,9,9,12,9,14,2,7,0,0,5,7,14,9,1,2,4,12,11,16,11,6,3,3,1,5,0,12,10,7,10,21,8,17,0,3,6,4,32,6,10,7,0,3,32,6,0,7,4,18,7,17,19,3,8,0,10,13,3,0,11,0,4,2,3,1,5,9,7,1,5,10,5,5,8,7,16,2,4,3,44,41,0,3,11,6,7,9,5,9,7,4,0,0,5,20,0,17,3,8,4,0,6,3,19,20,5,9,2,8,2,13,3,8,4,3,22,3,11,23,4,6,2,4,13,3,18,2,24,8,5,3,1,1,6,7,9,22,14,8,32,4,1,32,5,7,21,5,3,10,33,2,15,4,16,10,23,5,25,16,10,1,17,4,7,5,13,8,5,15,10,12,14,12,12,6,5,8,4,4,34,43,8,6,10,2,2,5,36,20,28,0,4,7,9,18,7,31,2,8,6,9,7,5,21,8,15,4,8,9,20,3,1,15,3,3,8,9,10,34,8,33,26,20,10,5,1,6,1,11,9,2,4,17,10,38,1,1,4,121,13,5,5,2,9,15,32,20,5,9,13,6,12,15,4,8,5,8,9,14,19,8,35,9,31,4,6,8,0,4,0,20,10,17,10,13,7,6,5,12,15,3,11,7,6,14,5,5,15,15,7,3,1,2,7,5,16,4,4,3,7,6,9,21,12,20,5,8,7,6,9,1,7,31,2,7,10,3,3,7,11,13,3,4,5,11,24,3,25,11,14,11,6,6,6,1,12,5,4,12,17,11,3,3,6,10,5,18,9,13,13,7,2,1,15,16,8,8,9,6,5,1,1,18,8,15,3,4,19,8,9,6,4,3,7,2,7,14,7,14,7,13,8,7,2,11,3,7,3,7,4,4,6,8,3,1,6,3,22,6,3,1,2,4,2,1,7,3,7,9,9,5,8,11,12,1,4,7,5,2,11,8,13,0,8,13,17,17,9,9,11,7,4,8,7,2,7,2,9,10,12,17,2,5,0,6,7,4,2,1,4,6,5,2,6,10,3,4,6,19,2,9,6,10,4,9,6,8,19,10,2,4,1,4,5,9,5,5,12,8,2,8,0,6,4,0,8,3,8,0,4,4,2,8,12,1,2,13,6,15,5,5,5,10,15,6,2,6,1,5,14,7,5,5,2,7,1,9,1,7,4,1,9,5,1,8,7,7,2,10,6,5,9,4,8,13,5,18,44,4,3,2,5,4,5,8,4,2,6,6,7,5,13,3,1,8,2,5,2,4,6,4,3,1,7,3,1,11,9,4,2,4,7,3,18,6,9,1,14,0,7,2,5,0,1,1,0,7,0,1
appropriation,15,61,19,450,9,2,13,21,4,3,16,11,19,40,7,4,8,17,0,3,6,51,7,32,26,52,11,19,4,35,18,523,107,8,59,33,28,35,8,4,10,0,2,18,45,18,31,22,347,4,53,3,4,26,10,5,66,94,0,21,29,6,1,17,16,1,69,2,13,14,90,49,5,2,54,15,18,5,115,20,110,0,20,6,251,80,33,3,70,9,16,3,8,60,52,13,10,12,52,6,64,53,71,7,13,61,43,6,29,7,28,6,34,16,0,41,27,8,140,194,36,8,22,191,18,1,2,0,14,11,9,5,1,76,24,126,1,2,11,2,2,24,40,7,1,81,6,22,21,70,67,4,19,15,3,29,33,5,2,2,32,5,10,14,34,3,9,15,27,10,29,83,15,2,5,13,222,3,13,57,39,8,18,14,14,9,52,29,18,68,3,7,3,0,15,4,21,5,19,9,19,4,1,16,27,17,6,31,4,36,73,6,45,12,2,0,7,28,38,11,28,14,17,22,83,124,52,67,10,84,29,24,51,18,50,60,41,9,7,6,106,36,13,3,10,12,4,23,113,2,25,14,17,34,13,20,14,8,9,36,14,22,59,18,12,200,10,2,13,6,179,32,174,13,8,2,28,130,25,12,50,1,7,17,15,4,14,16,9,3,11,2,75,46,11,10,59,13,22,11,10,142,19,11,16,0,18,12,3,0,8,32,68,6,98,30,29,47,8,6,38,8,22,11,34,13,4,34,4,22,10,18,9,21,17,32,11,5,13,25,20,20,28,14,7,5,59,80,17,3,41,17,6,49,33,11,5,7,26,74,50,21,10,29,8,0,48,6,6,10,9,29,2,3,7,93,17,1,4,17,79,0,117,8,4,49,0,19,46,0,26,4,41,10,53,10,97,9,49,8,27,3,4,0,8,7,19,4,16,19,1,6,5,29,5,6,3,4,7,0,5,4,28,10,1,8,4,15,16,15,22,17,15,30,1,3,0,18,22,9,10,36,6,5,0,1,12,4,33,22,20,7,1,8,64,16,2,7,10,69,7,16,37,12,11,2,12,8,17,0,13,3,9,1,5,5,7,34,25,13,3,16,6,4,11,5,26,3,1,7,122,113,0,1,7,3,9,39,11,2,16,14,10,2,22,18,2,15,13,5,7,1,23,5,15,24,2,11,3,12,12,10,6,21,12,5,17,8,26,36,13,7,2,8,15,15,23,9,46,34,2,9,1,8,6,24,2,19,21,17,45,6,4,64,12,14,43,4,8,19,48,16,44,6,32,33,21,6,108,30,25,17,1,6,20,6,8,10,8,79,12,40,11,11,11,9,2,13,10,8,16,44,20,18,18,8,4,3,68,17,25,5,3,7,12,30,15,48,10,16,42,69,35,5,38,12,76,7,15,13,18,0,15,24,20,10,14,13,21,42,0,37,18,15,20,6,4,29,7,20,9,2,4,37,6,119,22,16,8,181,11,6,6,6,6,24,45,6,4,29,11,8,13,9,18,10,9,11,14,25,35,18,35,9,72,8,10,58,7,15,23,67,15,30,19,26,18,7,9,37,18,10,24,22,18,48,16,9,13,23,16,13,15,11,20,22,27,14,8,17,2,34,7,42,38,33,10,7,13,20,9,10,1,45,3,9,12,1,7,17,4,36,1,6,2,12,75,8,46,9,18,5,22,30,17,3,42,8,4,15,14,34,65,71,46,22,12,26,6,26,22,21,13,29,29,7,19,9,9,10,7,1,2,8,13,16,20,8,46,21,19,9,23,9,9,8,4,5,6,22,17,15,11,16,24,39,15,16,7,8,13,8,18,39,1,5,10,7,53,9,8,1,20,25,3,12,6,11,4,22,15,6,7,15,34,11,9,36,5,7,45,8,14,1,12,8,17,26,10,8,13,13,0,6,7,38,10,14,12,5,7,43,11,18,8,9,7,15,0,3,10,2,10,6,4,12,2,13,7,49,23,5,10,3,9,9,5,18,18,6,7,15,7,7,30,9,14,19,4,23,2,47,0,18,4,14,9,8,17,0,10,9,10,12,1,10,11,11,14,32,12,15,0,70,15,7,8,19,7,8,13,12,7,8,2,14,3,28,4,8,18,8,6,12,10,20,10,22,6,54,4,6,82,13,28,57,27,182,176,7,18,2,3,12,54,37,18,12,82,5,14,21,17,17,12,34,20,14,0,19,1,3,3,4,7,2,4,10,12,5,22,4,13,0,10,12,6,2,24,1,5,4,14,0,1,11,0,26,1,0
enforcement,4,11,6,67,3,1,2,5,1,1,6,2,3,22,0,0,2,1,2,2,2,6,5,4,11,9,7,1,1,3,2,84,40,4,29,14,8,1,0,1,6,3,5,3,11,6,8,14,121,14,26,1,2,6,6,6,22,6,4,2,6,4,1,0,8,2,26,6,1,7,2,2,2,3,47,3,4,2,17,7,15,3,0,1,103,6,7,0,15,5,3,3,2,16,16,6,7,8,19,3,0,11,10,2,2,12,0,8,1,1,11,4,8,12,4,11,3,2,39,39,16,9,1,36,3,1,0,2,2,0,3,1,2,27,3,29,3,1,1,2,1,15,6,0,1,47,5,9,1,3,15,0,4,0,1,67,17,0,0,6,0,0,2,1,5,4,3,26,10,5,6,33,13,4,4,2,47,0,5,19,11,0,1,7,0,11,14,6,14,13,0,1,4,1,1,8,1,1,5,2,19,0,3,9,10,15,0,22,1,10,20,3,18,0,0,3,1,6,13,1,0,7,1,7,31,222,9,7,2,1,5,1,3,16,19,4,8,7,1,9,22,12,2,10,17,7,1,4,33,3,2,3,10,1,1,5,4,0,0,7,4,10,3,2,0,47,4,2,5,5,49,2,3,1,2,0,21,4,1,0,28,16,5,7,4,3,8,6,0,0,2,0,2,1,3,13,6,7,1,14,15,12,0,1,2,1,2,2,3,1,7,19,10,12,2,5,3,23,5,3,38,0,12,2,46,8,6,10,1,4,5,0,1,2,5,1,5,4,1,2,7,3,6,8,1,2,22,31,13,0,6,7,0,21,1,6,1,3,14,12,20,4,9,6,4,2,13,0,16,22,2,18,3,7,8,12,1,2,4,3,19,0,14,7,13,13,26,7,3,2,40,4,1,2,11,2,40,0,27,1,11,0,0,7,2,0,4,0,12,3,1,2,2,15,2,3,0,2,3,1,1,3,13,14,2,0,0,6,3,6,1,1,0,3,4,1,0,1,1,3,21,13,1,1,1,2,2,5,19,1,8,14,0,0,15,14,0,5,5,16,6,9,8,8,10,0,4,6,3,3,13,3,0,3,4,8,3,0,6,5,8,2,1,2,2,7,6,0,2,9,16,10,1,3,1,0,2,14,6,11,11,0,0,0,2,2,1,1,2,5,0,4,0,17,9,6,2,4,8,5,2,9,1,13,0,1,26,6,4,8,2,3,6,2,0,4,5,2,8,14,1,1,2,1,1,9,0,2,10,2,38,12,15,20,6,7,11,1,2,6,3,5,20,10,3,11,7,5,18,36,0,4,6,1,6,1,3,6,2,6,3,4,3,8,5,1,4,3,1,0,4,15,8,3,17,0,2,4,21,7,12,3,6,1,4,3,1,20,5,1,5,34,20,0,23,1,6,10,1,1,0,0,3,4,0,1,1,3,0,7,0,9,12,10,6,2,17,1,3,2,0,1,0,3,2,1,5,8,21,64,3,3,9,15,6,1,14,17,2,6,1,1,4,7,3,1,1,1,8,6,5,0,3,33,9,5,0,3,3,0,3,10,6,2,6,4,13,2,0,11,5,3,3,2,2,4,1,3,7,1,8,3,3,4,6,1,8,0,7,0,1,5,4,9,5,1,0,2,2,4,1,1,2,20,3,0,2,0,6,9,8,5,1,3,1,1,2,1,19,1,5,1,0,2,8,0,6,1,8,8,9,1,0,8,2,13,1,5,6,2,2,2,1,3,4,1,7,12,2,1,6,1,3,10,3,21,1,1,3,3,1,1,6,0,5,4,2,0,0,10,4,18,6,0,2,16,3,5,0,10,1,0,6,0,3,0,0,2,7,4,0,0,3,4,1,2,7,5,4,3,1,2,4,9,0,1,5,7,0,1,2,1,0,3,0,3,2,11,2,1,0,5,6,6,2,6,2,1,0,5,4,20,30,0,4,7,4,1,9,7,2,2,5,3,1,5,2,3,2,11,11,0,1,1,6,4,2,1,3,2,1,1,2,0,4,7,2,1,22,0,3,1,0,1,1,3,2,2,2,1,1,5,3,0,0,0,0,0,2,8,22,0,4,0,1,3,1,2,4,0,4,1,1,1,1,5,1,3,0,0,7,2,3,1,0,0,0,1,4,9,0,2,0,0,0,5,3,1,18,2,0,4,4,0,0,0,1,0,1,1,0,1,1,1,0,4,0,1,0,6,5,7,2,2,1,1,7,6,4,7,2,2,0,0,2,1,4,1,4,3,1,3,1,1,0,0,2,0,0,0
direction,3,16,4,97,5,3,10,20,2,0,4,10,8,44,3,6,2,3,5,2,3,36,5,19,25,7,12,3,7,16,10,140,75,7,30,45,35,4,7,3,5,5,2,1,23,6,20,8,172,17,15,5,5,26,5,5,35,31,2,22,11,6,4,6,17,3,76,6,2,23,8,5,4,1,51,5,9,5,56,9,35,4,9,6,140,11,15,0,19,0,5,4,2,7,22,3,18,5,29,13,12,15,20,3,10,16,7,2,11,3,14,5,13,10,0,22,3,3,40,83,39,6,10,40,5,2,3,1,4,2,7,2,9,33,6,45,8,6,4,2,3,22,18,5,0,55,6,4,3,8,42,3,3,8,1,24,21,2,4,6,7,6,7,0,4,2,13,23,19,3,11,50,19,0,3,6,96,3,8,30,23,9,6,7,6,17,28,17,30,29,1,2,4,1,2,2,10,10,10,10,15,1,4,12,18,4,4,13,14,17,61,3,15,9,3,3,0,3,16,0,4,17,2,6,22,90,23,12,6,12,12,22,15,27,26,11,17,10,8,5,26,26,5,7,5,5,3,9,44,9,17,15,24,4,6,8,7,3,1,14,4,18,9,8,9,64,6,6,18,5,91,8,14,3,10,1,15,14,5,2,54,8,4,9,10,4,6,8,13,2,9,2,22,2,3,7,28,9,3,9,8,30,2,0,11,2,20,7,8,3,2,12,14,5,6,9,11,20,12,4,21,4,13,5,31,5,6,22,1,21,2,8,3,5,6,6,20,7,2,2,7,3,13,5,8,9,21,44,16,2,9,15,2,17,12,5,3,9,16,28,17,15,13,14,5,2,21,7,6,9,1,7,7,3,6,29,7,5,8,1,41,2,37,8,2,25,3,12,19,3,17,4,9,6,21,5,43,7,28,5,14,2,3,3,4,5,6,1,27,9,2,15,1,25,22,8,4,7,1,2,4,6,20,11,2,5,2,17,2,15,5,3,1,9,1,5,1,10,4,2,14,19,6,4,1,2,8,4,26,3,11,2,5,1,42,10,1,6,6,16,7,13,28,12,3,13,13,4,7,0,17,2,2,2,2,9,6,9,18,4,2,18,1,4,1,4,4,2,6,7,55,18,1,1,2,3,3,6,6,5,8,6,2,1,4,6,1,7,4,3,3,1,12,6,8,7,15,5,13,5,7,18,7,19,5,4,13,10,6,19,8,5,2,5,9,5,3,6,27,14,1,5,1,7,6,1,1,8,6,6,11,5,3,22,10,4,28,2,4,6,13,5,19,8,15,10,11,3,31,36,10,7,20,6,1,11,13,8,1,11,12,16,10,9,6,3,5,10,2,6,12,21,1,1,17,1,6,3,21,17,15,1,4,0,8,15,5,20,14,4,18,25,11,8,8,9,15,2,6,5,13,3,3,9,14,8,5,6,7,15,2,20,20,9,10,1,10,6,2,12,7,2,11,21,7,42,8,2,4,93,29,6,4,0,3,9,41,6,4,7,3,3,6,19,2,1,5,6,5,7,11,8,13,17,13,3,2,3,5,8,6,17,5,10,4,3,5,4,2,14,7,9,9,14,13,10,1,4,7,7,6,4,7,9,7,12,6,4,1,4,6,4,1,15,8,14,2,3,5,3,3,4,4,16,6,4,2,0,6,7,4,13,5,4,4,0,41,5,20,11,2,9,5,11,15,6,11,12,1,5,9,4,1,7,7,7,8,15,12,4,5,11,2,3,20,5,6,4,6,8,11,0,4,11,9,8,3,4,16,6,3,6,11,2,6,6,5,0,3,10,3,12,10,5,7,10,2,5,6,9,5,2,9,4,2,2,1,7,13,5,2,2,4,9,6,4,6,2,1,6,3,4,13,12,11,2,2,12,6,4,5,0,8,3,2,10,2,22,2,5,3,9,3,7,3,3,7,4,9,7,12,20,15,2,10,4,3,4,7,0,3,1,15,7,2,1,1,4,4,9,12,1,5,1,3,7,3,6,10,6,6,4,2,1,9,4,3,6,1,1,2,11,1,1,2,9,1,7,11,0,3,6,4,11,10,7,1,9,2,12,7,0,6,10,2,4,5,9,2,10,3,7,2,9,3,1,7,10,4,4,17,4,5,10,6,1,1,3,7,15,4,3,4,0,10,6,5,10,17,2,5,1,3,5,11,1,4,9,14,11,4,2,5,1,1,11,8,2,1,5,2,4,2,7,2,1,1,3,9,5,5,3,5,2,1,3,2,4,12,4,4,9,7,0,0,1,2,2,3,0
proposition,3,7,6,88,12,0,0,21,6,0,15,5,1,34,3,4,6,4,1,0,6,19,1,16,9,4,7,6,0,18,4,182,76,3,26,18,19,6,5,1,2,4,0,2,25,10,71,20,278,8,42,0,7,10,0,1,34,13,0,8,8,0,2,7,16,1,54,2,10,19,4,10,3,0,21,9,5,1,34,6,10,0,13,1,134,14,4,0,29,2,2,3,0,18,33,6,7,1,8,6,12,15,35,3,1,21,2,0,11,2,16,2,2,9,0,17,1,3,42,135,8,5,5,17,0,0,1,12,3,0,1,0,2,39,5,19,2,0,1,2,0,15,16,1,2,28,4,5,7,2,49,1,11,1,2,12,23,2,4,0,5,0,5,2,0,1,0,17,6,2,9,60,3,0,2,11,93,4,4,10,31,7,0,6,2,5,13,6,64,81,0,6,6,0,0,5,3,1,4,4,6,2,0,4,25,4,2,11,54,10,46,3,7,1,0,0,0,0,12,5,2,18,2,15,21,23,9,16,0,6,11,4,5,12,9,10,47,5,4,1,43,20,1,1,6,6,3,10,15,2,8,16,18,8,14,17,8,3,4,2,0,12,59,3,3,15,1,3,27,1,52,3,13,2,4,0,11,8,16,4,21,2,1,8,3,1,1,5,7,1,11,2,12,2,0,11,45,4,8,9,11,12,0,4,8,0,6,1,0,0,1,5,19,1,17,11,4,21,5,3,33,3,14,0,56,4,1,6,9,27,7,8,6,12,0,13,16,2,1,4,3,2,7,7,2,8,16,59,7,0,6,15,16,9,18,4,5,9,8,14,9,2,2,8,4,0,28,4,2,4,3,3,14,2,4,8,5,2,15,1,44,2,14,5,0,16,0,10,21,6,8,3,10,15,23,9,61,2,7,2,13,0,1,0,3,2,2,2,9,4,1,32,2,15,9,5,2,7,0,0,2,4,11,6,0,3,2,4,14,2,15,6,1,2,3,4,0,60,0,1,13,9,0,19,2,4,1,0,18,1,2,5,1,7,96,8,0,9,3,29,6,12,14,4,0,3,2,11,2,0,0,0,2,1,1,2,3,16,2,4,6,4,2,3,5,3,6,1,1,1,30,32,8,2,0,4,1,9,0,9,5,5,6,0,4,14,0,11,1,3,2,1,4,5,7,9,2,2,1,12,2,2,5,4,2,0,12,5,14,9,10,1,1,6,5,3,5,5,24,7,4,1,2,1,6,6,6,16,9,4,46,1,4,13,2,1,26,3,1,2,46,9,16,5,14,7,11,3,23,18,5,5,6,1,11,1,10,12,7,8,8,12,11,7,8,1,3,6,5,3,39,24,7,3,9,2,4,3,35,22,18,1,3,4,15,22,4,11,1,4,9,15,6,12,8,6,10,1,6,4,11,1,4,24,1,2,11,9,11,19,17,14,11,23,2,3,4,9,1,9,6,1,6,16,7,7,0,11,2,174,30,2,7,5,5,11,40,17,8,16,4,22,38,82,7,9,7,23,9,10,3,4,15,8,24,2,7,10,2,3,12,14,7,3,10,1,5,2,0,13,7,1,10,24,5,4,3,8,13,25,0,4,4,1,5,3,9,5,4,4,2,0,1,11,7,13,2,2,22,1,6,4,6,3,2,1,4,0,0,6,3,4,2,1,2,3,6,2,37,4,4,3,0,5,11,3,6,1,1,5,5,3,2,3,0,8,4,12,1,1,1,3,0,0,19,15,1,7,0,19,0,0,0,3,0,19,5,0,12,14,1,10,22,9,10,3,9,11,15,4,19,4,36,1,5,14,2,9,1,1,13,1,8,6,1,0,3,3,9,3,4,1,45,5,3,0,3,13,13,7,4,20,12,2,4,4,1,6,11,20,3,6,3,1,5,4,5,14,3,4,6,4,1,0,2,7,1,12,11,5,25,14,4,4,0,3,1,2,2,1,22,2,0,2,0,6,2,5,4,7,0,3,7,16,6,4,9,22,22,2,2,3,1,7,6,1,6,5,1,9,5,54,0,3,5,13,1,2,2,0,5,4,0,4,5,2,15,9,0,16,1,0,6,4,18,0,1,8,0,3,23,18,1,18,3,0,9,16,3,5,1,12,11,12,2,2,1,4,7,8,2,4,2,0,0,8,9,2,18,8,0,10,0,2,0,1,8,5,18,7,5,5,1,5,2,12,0,0,10,19,11,7,1,2,6,1,0,7,6,0,3,4,10,14,9,0,12,0,17,0,1,1,2,0,0,0,0,15,0,0
tariff,0,9,13,112,2,8,5,22,0,3,8,11,0,12,4,2,4,23,2,6,1,36,1,11,13,12,14,7,6,17,0,166,186,6,68,34,9,21,74,1,21,1,2,1,31,5,24,33,173,13,47,5,26,38,5,2,231,19,0,5,23,5,0,14,74,6,86,16,32,14,3,6,6,3,105,5,21,4,74,19,119,1,8,6,121,16,22,0,32,10,26,4,1,19,77,80,28,11,28,39,1,19,37,7,3,26,41,2,16,2,7,4,2,9,0,25,24,0,135,226,37,19,32,56,2,1,3,0,9,5,4,0,2,39,21,46,3,0,5,10,3,22,14,0,0,82,17,16,20,7,36,3,14,6,4,12,30,6,2,2,74,1,14,19,0,3,4,21,36,3,9,74,26,0,4,4,215,0,8,27,12,7,0,18,0,37,41,26,44,40,2,2,47,2,2,3,6,7,5,5,77,0,2,37,25,0,2,47,6,28,83,1,10,15,2,0,4,0,0,1,8,13,15,3,41,126,27,20,1,4,12,28,55,9,41,124,18,9,59,6,68,33,3,2,18,13,4,17,49,0,6,68,15,8,21,20,6,13,6,13,6,15,9,7,9,48,2,2,14,3,134,4,58,2,1,0,21,16,12,0,44,5,5,10,8,3,0,8,20,4,20,6,22,5,6,9,42,2,7,16,10,37,0,6,32,1,7,2,7,3,2,6,47,2,52,56,36,68,9,11,29,6,18,3,14,8,7,19,2,11,7,19,8,12,7,7,6,5,3,8,5,4,15,12,2,4,60,33,5,10,17,28,0,47,22,5,2,3,5,34,34,3,6,15,3,1,22,5,18,9,10,17,2,11,7,8,12,17,10,12,59,0,58,12,3,8,4,24,24,3,15,1,7,9,40,12,62,5,15,16,31,2,8,0,6,4,8,0,75,11,0,5,41,14,8,4,2,1,2,0,3,5,19,12,0,1,6,3,0,14,9,4,14,12,2,3,0,29,3,1,18,41,28,17,1,5,7,2,44,19,7,2,0,9,23,0,0,4,15,79,9,39,24,8,1,17,47,12,0,0,11,4,6,6,3,8,0,13,17,5,7,6,3,7,6,5,16,0,5,2,19,39,0,10,66,6,17,7,9,24,29,2,8,0,1,3,11,37,10,7,19,10,9,23,22,23,2,18,4,5,0,8,11,13,11,1,17,6,20,37,5,5,0,19,17,4,5,7,13,8,3,4,0,50,32,5,0,17,12,15,6,1,2,26,11,9,50,10,7,13,30,1,29,4,10,30,22,9,25,40,16,13,8,3,13,10,1,29,15,21,84,38,34,23,21,17,18,26,6,12,54,25,18,6,32,6,15,40,35,22,11,6,2,3,13,37,12,14,4,25,76,42,27,1,33,8,18,8,11,7,6,3,10,7,0,14,3,15,10,13,14,21,20,16,4,2,14,10,2,2,18,3,1,17,3,19,7,5,5,97,31,6,8,5,2,12,46,5,2,37,9,3,8,4,10,7,0,4,8,13,13,18,8,7,13,7,2,15,0,4,0,28,7,13,17,14,7,3,1,0,15,10,12,0,3,8,8,3,56,18,11,4,12,19,4,9,8,0,8,0,1,15,6,24,12,2,1,2,9,6,2,2,1,11,0,3,5,0,3,13,1,19,27,5,3,1,0,3,3,6,15,4,0,4,2,4,19,10,6,13,6,11,2,14,16,13,18,14,6,43,71,9,2,12,14,33,10,17,27,0,3,0,20,7,6,8,7,0,1,12,0,5,8,1,21,2,6,1,16,22,4,8,2,16,11,18,2,10,3,0,15,1,16,2,3,0,9,4,23,2,90,1,21,9,9,3,1,8,4,13,6,3,9,64,0,7,4,5,2,5,10,3,2,3,11,7,4,34,8,15,4,3,1,1,6,2,10,16,10,6,19,16,8,8,4,1,10,10,8,3,6,4,2,5,3,6,0,0,7,15,6,42,4,10,2,8,0,12,9,3,0,15,2,7,1,3,5,7,0,5,1,3,0,2,12,2,0,0,5,1,16,5,0,3,1,4,2,13,48,30,3,8,0,15,11,6,2,5,1,2,4,11,3,61,12,2,2,3,12,8,6,0,16,15,3,7,0,10,6,10,5,14,11,9,19,14,5,7,50,2,0,2,0,4,1,17,0,1,8,6,0,0,1,5,13,8,2,3,5,2,0,5,5,5,0,3,6,1,4,0,3,15,3,7,8,30,6,7,9,0,1,20,4,0,1,7,3,3,0,0
wholly,3,9,4,57,7,5,2,7,2,2,12,3,3,36,4,4,6,11,0,0,1,20,7,14,21,9,9,3,8,10,7,105,71,7,25,22,25,1,14,2,9,6,2,1,25,8,12,19,176,8,35,3,4,12,3,1,41,8,0,5,11,4,6,8,18,1,48,6,3,11,3,2,6,2,34,6,12,2,43,12,38,0,13,4,117,14,9,1,20,5,4,5,0,9,23,10,8,5,16,10,10,19,24,6,6,17,5,4,15,5,13,2,2,14,1,21,1,1,43,102,24,3,7,34,3,4,1,2,1,2,11,0,1,21,18,29,12,3,4,5,0,16,12,9,1,41,5,14,12,9,43,1,4,5,2,29,14,1,3,5,17,7,7,1,6,3,2,10,19,2,5,56,15,4,1,12,94,4,5,18,16,6,0,9,2,14,24,19,30,37,2,7,3,0,6,5,9,5,4,4,22,0,1,9,17,9,4,22,12,17,47,2,14,9,0,0,0,0,8,4,5,10,2,7,27,60,20,15,2,6,4,11,12,18,29,9,24,9,6,4,52,27,6,2,17,3,2,11,29,1,5,16,18,7,5,10,7,5,3,15,3,12,15,0,3,25,3,1,11,1,67,6,21,2,4,0,16,7,7,3,30,10,1,15,22,0,1,10,7,4,7,6,3,5,3,6,17,7,4,11,14,13,3,2,13,0,9,5,2,0,5,18,16,1,33,11,12,23,3,1,28,10,20,3,39,8,7,14,0,11,2,9,6,5,0,6,10,4,0,6,10,3,5,15,3,9,19,34,8,4,5,9,8,28,20,3,2,2,5,13,14,6,2,12,2,0,15,6,3,12,1,11,8,4,9,15,8,7,6,4,22,1,17,5,2,20,2,15,14,3,12,2,1,5,20,7,30,3,20,4,14,1,1,0,6,7,6,2,27,4,1,8,8,12,4,3,1,5,3,1,3,5,15,7,0,3,2,10,5,6,10,2,2,2,2,6,0,10,3,8,14,16,10,2,0,1,4,5,21,6,8,5,1,1,43,7,1,3,6,14,11,4,17,16,2,3,8,6,5,0,17,3,0,7,2,7,2,3,19,4,11,9,4,5,4,1,7,3,1,5,31,23,1,4,4,2,0,9,9,12,8,6,3,7,6,11,6,5,1,4,0,3,7,9,10,4,2,7,0,3,1,19,6,13,9,2,18,7,6,16,7,3,4,10,8,3,7,2,23,12,1,0,1,4,10,5,4,12,5,9,27,1,5,31,7,11,15,4,2,6,18,3,17,1,8,11,9,9,14,24,6,8,10,6,8,12,29,1,9,17,9,7,8,6,5,5,6,7,2,2,10,20,2,3,12,3,2,2,22,10,9,2,3,2,5,11,2,8,6,4,29,13,6,5,26,5,9,10,8,3,12,2,1,8,0,4,8,5,11,22,5,16,22,16,10,1,10,4,4,7,7,1,8,8,5,12,8,2,1,102,17,3,9,5,4,8,30,11,3,8,4,3,12,19,3,2,1,6,10,8,12,4,25,35,14,3,5,4,3,3,8,13,8,6,7,10,8,3,3,4,14,6,9,11,2,4,5,2,16,10,2,1,4,5,10,1,5,4,1,2,2,6,3,8,20,11,3,3,10,6,3,1,3,12,1,3,4,2,2,5,2,11,1,3,4,1,13,4,22,3,11,5,2,11,9,1,10,5,5,3,5,2,8,5,7,3,5,2,4,12,15,9,2,0,10,16,2,6,6,11,1,2,4,14,2,12,4,4,17,5,3,4,11,4,7,3,6,4,6,7,3,10,6,5,8,16,8,2,2,2,4,6,9,5,2,4,2,7,10,3,11,4,8,3,3,4,3,1,5,8,4,6,4,11,1,3,4,2,2,4,4,4,5,2,2,6,5,12,11,6,1,2,9,2,9,7,6,3,5,7,7,17,2,4,3,7,10,3,6,1,4,1,3,0,4,4,8,2,4,5,3,1,4,2,5,5,1,2,8,2,2,5,2,1,8,3,3,3,8,3,4,16,0,2,6,2,5,1,1,0,6,5,0,4,1,0,9,8,5,11,4,6,5,7,7,1,0,3,5,7,7,6,0,16,4,5,0,5,5,2,5,3,5,3,4,3,2,4,3,4,3,7,9,3,3,7,11,14,16,3,1,7,0,5,0,2,4,5,6,3,0,1,4,1,3,8,4,2,0,7,1,2,8,4,3,3,0,4,7,4,7,7,4,3,7,9,5,2,9,0,0,2,6,0,0,1,2,3,1,0
certainly,0,21,9,62,3,4,2,31,2,1,10,2,9,41,8,3,1,11,3,3,4,16,15,17,9,16,10,4,3,7,7,92,55,2,24,47,17,1,9,2,12,6,5,3,23,10,31,14,153,6,37,3,12,16,5,3,18,7,2,10,13,6,2,5,28,6,65,7,3,9,7,5,2,5,68,6,22,4,50,11,39,1,11,7,108,27,8,0,15,0,5,1,2,18,29,13,20,4,19,8,8,23,16,6,13,9,3,6,11,6,13,4,5,10,1,20,1,3,47,178,35,9,12,32,4,7,6,4,3,0,10,0,2,24,14,26,7,1,3,4,2,22,11,4,2,41,5,13,15,9,49,2,13,4,1,23,19,4,5,7,4,5,14,3,0,8,4,16,18,4,19,67,11,6,11,6,103,2,9,20,27,7,1,18,1,18,37,20,28,37,2,8,10,4,5,3,20,2,7,10,19,4,1,6,22,4,6,28,5,14,45,2,20,4,4,3,2,3,2,2,2,16,0,18,33,47,22,26,5,12,9,8,12,20,28,14,18,5,2,7,35,26,2,8,12,1,3,14,13,4,4,11,7,5,7,23,4,0,3,12,2,15,3,3,2,10,3,1,8,2,88,1,20,4,2,3,9,12,5,1,44,5,2,6,14,1,1,6,14,4,2,2,5,1,0,4,24,1,8,14,17,7,1,1,9,1,16,1,1,2,2,17,10,5,37,13,17,23,12,6,26,7,33,6,53,6,6,20,2,16,3,10,6,1,9,10,17,5,3,11,13,7,12,9,10,3,23,26,7,7,11,5,7,29,10,0,2,2,11,24,22,4,7,12,3,0,30,9,3,13,0,10,1,4,6,9,6,3,8,3,46,0,33,5,5,18,0,8,15,4,9,1,8,3,24,5,33,1,16,1,4,0,2,1,4,2,8,2,14,7,1,8,7,3,11,6,2,6,3,2,1,6,16,14,2,3,2,5,10,8,13,1,1,1,0,2,0,2,7,5,5,6,4,16,1,4,8,7,34,4,7,5,1,6,34,11,0,7,4,21,3,19,17,16,8,11,9,5,4,0,12,5,4,3,3,14,2,8,18,6,3,8,4,5,3,3,7,2,9,3,51,32,1,3,5,3,3,3,7,16,4,9,4,0,3,28,5,7,4,7,3,7,6,6,10,11,2,8,5,11,2,9,2,16,13,4,21,4,7,14,5,4,2,5,1,3,6,9,16,10,0,0,1,4,4,11,2,8,7,6,30,2,6,30,3,7,12,1,3,4,15,3,8,4,17,11,8,11,21,25,4,5,8,2,1,7,15,9,1,5,6,5,7,12,11,3,7,7,2,7,14,26,6,1,13,5,6,4,13,9,19,4,2,3,7,22,3,11,5,2,26,7,3,4,20,12,16,5,11,0,9,16,0,17,1,7,5,7,7,14,21,10,14,18,4,5,13,3,6,7,14,1,15,13,6,14,8,1,6,67,21,3,7,12,4,13,27,10,5,7,9,2,0,7,0,6,4,8,10,10,7,5,1,40,20,5,2,5,3,5,15,12,13,4,4,6,7,7,2,6,10,5,5,8,5,5,9,0,11,5,0,3,0,4,4,5,15,2,0,0,2,6,3,32,12,8,6,4,6,5,4,4,6,7,3,2,9,0,3,10,4,5,2,3,2,1,8,8,18,13,7,7,3,11,4,4,13,4,2,3,8,4,4,6,1,5,7,5,0,10,12,10,1,3,11,16,4,3,2,3,2,5,4,10,2,10,6,4,13,4,4,1,13,3,8,4,6,1,15,6,5,5,3,7,10,29,3,7,2,1,3,8,16,8,2,7,5,3,6,4,3,3,6,7,1,4,9,7,4,9,0,1,11,0,1,7,5,8,6,4,4,3,4,1,3,3,8,16,12,3,1,6,9,3,5,9,8,2,3,3,24,14,3,4,1,2,8,3,1,1,5,7,6,3,6,5,3,3,9,2,1,3,12,17,1,6,1,5,2,1,1,1,2,0,4,3,2,3,0,3,2,4,0,2,2,4,1,1,5,3,3,1,0,6,3,0,1,9,4,19,2,4,2,9,5,1,9,3,4,2,3,1,1,5,2,3,2,1,2,10,3,2,3,3,7,2,2,6,7,5,7,7,4,3,11,11,19,2,10,4,0,4,0,5,2,1,4,5,13,6,0,1,4,1,4,9,2,4,3,10,6,5,8,4,1,0,0,4,3,3,0,0,4,15,4,6,7,2,13,2,3,0,5,1,0,4,3,4,2,0
include,5,36,25,272,10,21,9,60,4,6,24,12,28,98,7,6,12,25,11,7,14,62,29,45,42,42,28,40,12,57,16,338,189,34,102,84,51,29,38,11,25,22,7,32,55,18,57,59,475,75,57,19,14,68,28,5,79,82,19,26,22,5,7,19,34,9,121,8,7,48,158,26,9,7,140,15,33,9,108,32,197,4,21,22,305,34,28,9,116,12,28,9,17,93,100,33,25,18,80,22,41,60,55,13,22,43,24,13,67,22,47,24,26,51,20,60,20,8,136,214,62,53,53,338,18,10,7,6,13,12,46,9,10,126,26,131,14,11,12,18,6,55,60,20,5,127,14,36,38,68,86,7,26,18,10,103,73,22,11,62,51,8,11,20,57,29,12,39,59,11,53,135,29,11,12,13,189,10,12,91,46,18,78,45,8,25,42,41,34,93,8,11,15,9,15,12,51,13,31,16,57,7,24,23,33,15,27,72,22,43,121,19,63,15,7,16,20,70,42,19,84,29,12,18,69,156,65,61,25,93,26,57,60,37,42,110,47,11,29,13,90,34,10,8,17,13,10,52,106,9,23,34,24,52,42,25,11,14,10,68,20,44,40,7,9,140,34,24,24,9,139,65,235,10,6,10,43,165,18,7,75,11,11,22,15,25,41,42,25,8,7,16,30,35,31,12,66,22,11,35,27,68,34,28,28,6,32,13,10,16,14,43,53,17,108,40,29,59,29,10,47,12,41,25,70,24,13,52,5,44,11,24,16,19,10,43,22,16,16,24,6,23,23,18,14,10,62,107,45,30,27,24,11,68,32,21,13,10,21,152,52,36,23,38,4,4,32,13,25,38,9,69,15,23,12,74,5,4,16,38,77,12,43,16,23,60,12,31,88,3,24,10,18,21,32,13,68,12,60,11,20,17,9,15,11,3,19,4,41,34,3,24,18,21,14,17,17,17,12,21,4,16,26,13,4,5,9,11,10,26,57,38,37,35,5,3,8,36,36,21,26,36,11,50,15,21,37,14,27,27,51,7,16,7,83,16,6,18,25,36,17,22,43,48,20,11,47,20,23,5,33,11,4,6,8,25,5,9,45,8,12,15,9,6,7,5,26,13,7,11,132,75,1,11,20,10,5,42,16,16,31,3,18,24,23,37,15,13,15,6,11,11,12,14,14,23,12,11,12,19,7,31,9,29,4,18,26,26,16,53,16,4,15,21,22,9,15,10,49,28,5,14,6,18,22,11,5,14,17,9,37,9,13,92,8,12,45,4,17,9,27,5,55,12,18,18,13,12,61,41,20,15,79,6,11,8,21,17,5,1,19,27,16,14,2,12,11,13,33,17,22,25,22,14,39,9,5,19,72,21,30,19,7,7,11,20,15,42,11,21,43,52,20,9,36,23,22,11,10,10,16,13,13,55,13,2,9,10,6,43,21,27,33,26,19,4,19,54,9,15,21,5,15,44,9,72,15,13,24,268,45,20,7,11,16,27,50,32,5,21,7,23,27,27,16,7,9,16,15,9,23,18,76,37,45,15,7,19,26,15,38,48,14,7,11,13,18,13,23,46,28,22,29,58,10,26,12,8,26,22,14,7,11,12,22,22,26,11,15,14,6,54,5,40,49,44,18,9,14,19,9,3,4,44,4,33,18,5,5,18,11,22,8,9,12,17,65,8,65,12,26,12,12,27,22,6,47,34,7,13,10,107,83,116,98,37,11,27,22,65,60,17,29,44,58,23,24,10,19,13,14,17,7,18,15,23,30,7,11,12,9,4,14,18,25,9,9,51,29,28,10,25,13,10,27,21,5,23,4,9,10,13,25,11,15,9,11,12,28,12,21,16,29,5,3,6,8,19,4,25,8,25,12,10,27,5,11,18,4,11,60,13,12,10,10,15,10,28,21,12,7,4,11,7,18,20,11,26,6,10,33,46,12,18,7,12,5,31,6,6,12,10,18,9,4,5,11,6,14,28,10,10,31,6,8,5,3,4,14,21,3,21,4,5,19,12,6,13,7,11,9,47,9,8,10,24,9,16,11,15,13,2,21,5,14,16,7,12,33,30,11,49,7,109,9,34,10,22,5,16,4,18,9,16,4,5,14,16,7,16,15,24,6,17,12,29,17,8,3,37,9,18,78,75,37,65,27,179,243,2,13,8,9,12,15,67,85,25,51,10,32,23,7,21,13,47,7,37,10,14,19,6,20,15,18,7,33,8,10,14,32,4,10,7,7,7,9,25,29,7,4,11,10,9,3,14,21,4,12,10
manufacture,2,1,3,70,1,4,6,23,2,7,2,5,7,38,4,0,1,11,3,1,4,37,5,13,3,5,7,0,3,6,8,139,129,6,38,47,16,21,59,2,13,3,3,1,17,19,13,8,146,8,26,3,19,31,2,0,136,16,2,14,13,4,2,22,17,4,53,18,4,4,11,2,5,4,71,11,11,7,46,10,98,1,7,5,84,11,36,0,17,4,0,3,4,15,59,27,14,13,26,32,20,14,27,14,7,14,10,0,16,5,10,4,8,14,4,32,8,5,39,116,32,10,27,46,0,3,7,4,1,2,6,5,6,46,18,34,4,3,2,7,1,31,12,2,1,46,7,10,12,11,29,1,16,11,20,9,26,7,5,7,26,3,16,5,4,5,6,16,30,10,18,54,18,0,5,5,147,0,6,22,16,4,0,8,2,43,32,9,13,22,3,4,42,0,0,2,10,2,4,7,27,0,11,8,18,0,4,40,12,10,46,3,8,18,2,4,0,1,1,0,5,13,8,6,46,50,18,16,3,5,11,9,26,8,28,63,22,12,44,1,48,43,8,0,7,2,5,16,26,13,7,103,4,12,9,13,6,2,3,29,5,8,1,2,13,31,4,3,27,8,113,6,40,5,0,1,17,5,10,2,47,1,4,16,18,2,3,7,6,4,3,0,3,6,1,12,24,9,1,18,20,31,8,3,18,2,13,1,3,1,0,10,17,3,44,22,33,33,45,8,22,6,27,5,24,0,5,13,0,16,2,8,8,1,5,10,6,8,3,5,4,2,15,5,9,3,31,44,14,7,11,17,8,66,16,12,0,3,10,17,12,5,8,13,6,1,16,3,7,5,5,21,0,5,6,7,3,18,7,7,40,3,52,7,1,12,1,26,23,2,4,3,6,0,22,7,24,2,15,1,17,2,2,0,3,9,7,9,36,12,2,8,36,21,0,0,1,8,1,0,4,1,10,4,2,0,2,7,0,7,4,8,0,8,8,3,0,3,9,2,16,23,2,17,2,6,17,1,22,9,0,9,0,2,38,5,2,3,1,42,5,17,23,4,8,0,66,10,3,3,11,2,0,1,5,12,7,3,8,5,6,15,4,4,14,1,8,5,5,0,26,20,1,2,28,6,23,7,5,13,12,1,10,0,25,6,15,24,10,5,10,5,2,11,24,7,2,8,10,7,0,3,4,8,2,2,7,3,15,16,2,4,0,3,1,5,5,1,10,12,7,3,2,43,38,4,1,24,6,1,10,3,4,25,10,8,84,3,8,0,14,3,13,2,9,16,8,1,27,25,12,10,12,3,12,8,84,9,6,19,1,10,38,13,5,0,12,10,8,12,15,30,13,6,43,6,10,20,4,6,11,1,3,0,1,18,8,6,1,4,16,11,3,11,18,12,19,33,4,5,12,2,11,5,1,8,6,12,6,31,5,18,24,26,9,8,8,3,4,18,27,0,0,0,8,20,11,2,2,92,2,5,5,4,4,9,36,2,3,35,5,0,3,11,0,0,0,5,2,11,20,12,1,7,7,8,3,9,0,5,0,18,12,10,13,2,3,4,6,3,4,9,13,0,1,8,7,0,41,5,11,4,5,11,13,8,14,8,14,1,1,3,5,22,10,5,1,4,1,5,5,2,0,10,2,4,11,3,6,13,1,10,21,1,6,2,16,5,5,7,9,6,3,22,9,6,16,7,6,8,9,5,17,10,13,3,15,20,8,26,35,10,1,3,27,45,8,5,50,3,4,4,2,3,0,7,7,1,0,8,4,2,6,2,3,8,4,2,13,11,2,6,2,5,5,7,1,5,14,0,4,7,4,2,3,3,9,2,16,7,65,3,23,10,7,0,2,2,0,6,6,0,1,9,2,0,2,3,2,14,4,5,6,0,16,4,3,24,5,4,3,3,0,0,13,5,7,1,2,6,22,7,2,13,5,2,6,18,7,3,5,1,1,2,5,1,3,2,3,10,3,11,5,8,1,5,0,8,6,2,0,4,4,0,1,3,0,4,1,1,7,2,0,4,4,2,1,0,2,0,11,2,3,1,1,0,0,8,4,9,1,3,0,9,17,4,3,40,8,2,5,7,8,100,4,1,1,1,7,1,5,0,9,5,5,10,3,8,2,13,6,14,2,5,14,16,3,11,19,1,1,3,0,3,0,5,0,0,10,2,0,2,5,3,3,29,1,1,0,0,2,4,10,5,0,3,0,5,8,2,4,11,3,2,3,11,9,4,0,0,4,2,10,0,0,4,2,0,5,0
direct,19,34,11,228,8,6,3,36,9,3,24,16,7,63,8,6,8,18,2,8,9,44,7,42,31,11,8,18,7,26,18,252,128,11,61,58,47,9,19,8,11,10,9,13,33,21,32,41,417,17,68,1,15,32,12,13,81,53,9,20,25,5,2,27,30,6,90,4,8,34,20,12,3,4,88,18,25,10,80,19,44,5,28,6,276,27,22,1,53,3,23,6,1,40,56,28,28,8,41,28,26,37,45,9,15,42,9,7,16,3,19,8,26,16,13,26,8,6,110,195,62,24,6,58,5,3,3,3,5,2,14,4,8,69,20,74,10,6,9,6,4,36,39,3,5,101,5,13,15,24,96,3,31,11,3,45,26,28,4,18,18,4,13,5,8,3,3,41,34,13,21,107,27,1,5,11,232,3,17,45,22,26,14,35,9,25,40,24,35,63,4,7,13,1,1,8,24,4,3,6,24,5,2,30,36,7,5,33,23,30,130,8,32,10,3,9,3,2,17,7,9,18,9,21,65,169,30,33,4,12,12,23,22,44,39,28,43,10,14,10,81,42,11,10,21,16,16,31,42,4,18,20,17,12,13,13,16,6,5,13,4,34,38,11,16,84,16,7,19,8,176,15,57,13,5,2,32,30,15,13,60,2,4,26,4,2,7,9,23,2,12,11,15,11,7,14,64,8,15,27,16,39,2,2,18,4,31,6,4,3,7,17,38,8,37,33,15,53,26,5,66,9,26,12,50,9,22,37,5,36,10,14,10,12,8,22,27,9,7,13,18,15,19,11,6,15,50,62,38,11,17,18,9,56,26,12,7,8,21,37,31,13,11,28,8,2,56,7,5,12,2,28,3,5,13,50,10,3,14,12,106,3,81,11,6,68,11,30,39,2,18,5,23,20,52,13,97,18,77,1,43,4,5,1,6,6,6,6,43,22,2,11,9,26,17,22,2,12,7,10,4,11,35,36,2,4,8,23,16,17,15,10,2,32,2,8,1,19,19,9,24,47,18,17,7,8,7,10,37,16,19,3,5,6,54,7,1,10,11,53,10,16,26,36,14,9,24,19,8,0,18,9,2,1,6,7,7,18,26,9,5,12,7,6,14,5,11,10,8,17,128,52,9,7,9,16,10,30,12,11,9,3,4,0,25,19,6,20,8,10,2,6,21,16,11,27,14,13,7,11,7,24,18,35,13,10,32,6,27,55,20,3,10,8,16,5,19,9,42,20,11,2,3,10,11,11,3,23,13,10,39,12,10,50,14,14,48,13,5,11,30,11,29,6,25,28,13,13,58,49,18,12,40,4,16,12,38,7,5,27,10,1,16,18,7,6,8,10,8,18,30,24,15,2,33,3,2,6,54,28,33,4,9,6,12,26,16,57,14,14,53,31,32,12,38,19,26,13,15,11,18,5,5,42,9,10,25,13,18,34,9,61,13,29,17,2,12,7,4,16,11,2,8,44,8,91,14,8,6,241,36,14,9,5,4,9,38,24,8,28,8,3,15,19,12,8,1,4,9,16,20,12,81,67,39,11,4,12,6,2,7,45,15,10,21,24,8,15,6,23,24,15,32,26,14,13,8,11,31,27,10,5,11,6,17,16,23,14,2,14,2,16,7,30,23,58,22,7,7,14,28,10,7,60,1,18,11,1,5,13,10,13,8,5,12,15,28,5,39,7,12,12,11,19,17,2,21,15,12,19,21,13,0,15,9,20,9,27,4,12,16,7,7,2,24,6,10,16,14,18,8,3,2,28,9,14,3,9,22,11,6,9,9,11,13,13,9,31,14,32,5,13,3,6,16,19,9,10,5,4,10,11,7,8,8,7,4,3,26,15,8,4,27,14,2,4,12,14,14,28,13,4,6,49,10,8,10,6,7,6,13,11,20,10,14,25,11,27,11,8,16,12,11,7,8,12,20,15,11,13,25,47,14,16,7,8,11,20,13,4,7,10,20,7,7,11,4,7,9,21,2,10,7,6,8,7,9,16,14,14,3,12,14,8,26,4,13,9,12,8,10,16,2,6,3,24,7,10,6,10,10,22,14,12,22,11,11,17,8,20,18,7,5,21,12,8,4,11,4,9,14,2,7,11,2,20,4,44,7,12,18,3,14,11,11,7,15,3,8,10,6,11,17,9,9,35,11,20,75,5,7,2,6,6,17,6,10,8,29,20,11,4,12,5,5,24,12,9,4,14,37,5,4,6,11,10,0,8,17,9,6,9,7,16,6,6,11,2,20,0,8,12,16,1,1,0,2,9,2,0
advantage,5,17,10,111,7,10,3,31,1,4,20,4,15,76,9,11,4,20,5,4,8,45,10,23,11,9,24,19,8,18,11,177,201,17,57,92,36,10,23,6,15,10,5,4,40,28,26,14,281,38,69,6,14,51,6,4,100,14,7,17,13,23,3,22,25,11,104,14,5,42,8,8,8,7,113,20,32,5,88,41,67,0,16,13,225,35,31,0,27,1,10,8,0,21,55,28,24,8,45,29,19,32,26,13,19,19,9,4,22,5,20,9,6,14,2,33,3,3,46,273,63,28,36,42,7,3,5,5,5,3,17,6,3,51,21,78,7,0,6,6,6,51,17,4,3,102,7,20,36,26,54,3,23,14,12,15,46,8,10,23,21,11,12,3,1,14,8,30,35,7,12,118,34,3,11,5,166,5,11,30,33,12,5,26,11,29,44,24,33,57,1,6,24,2,1,6,18,6,3,14,33,8,9,15,36,9,3,61,9,41,101,10,19,21,6,5,0,1,20,7,1,22,9,19,58,93,22,48,6,10,21,10,14,23,51,58,30,19,14,12,80,51,14,8,24,15,10,34,57,9,11,57,19,14,12,21,10,4,4,23,8,33,19,5,15,52,15,15,27,10,156,4,38,7,6,1,23,7,9,5,73,6,8,24,20,3,14,23,19,10,3,8,15,5,1,9,36,0,6,29,35,29,0,0,18,1,16,3,11,3,3,23,32,7,41,24,54,49,11,4,43,8,49,11,49,6,11,31,4,43,6,19,11,7,13,15,16,7,4,9,14,10,24,8,10,8,32,53,21,8,10,17,8,57,33,13,10,9,16,28,28,11,16,29,10,7,42,8,13,25,4,33,7,17,12,28,8,13,17,9,84,5,40,11,8,41,7,14,29,5,20,5,8,14,34,16,45,9,37,2,17,3,6,3,6,11,17,4,34,20,3,16,16,19,13,24,7,17,6,10,8,14,14,12,6,7,8,5,12,16,9,2,1,4,4,6,2,11,8,4,24,38,10,20,3,6,22,6,51,8,20,3,9,6,61,4,5,5,13,28,12,18,35,44,10,9,25,33,13,0,22,10,4,6,11,36,8,7,20,10,8,15,10,2,9,9,24,6,5,1,61,34,5,9,12,13,8,10,6,18,15,15,9,6,7,29,11,26,10,9,14,6,9,9,30,18,4,9,7,13,5,17,14,20,8,7,26,7,25,36,13,11,13,14,9,9,8,18,50,29,17,8,8,21,25,11,3,36,12,14,21,8,4,53,9,20,54,8,6,11,37,6,21,1,20,17,30,15,40,66,13,14,11,3,10,11,34,8,7,16,38,16,1,27,11,3,8,10,8,25,28,38,18,7,47,15,12,10,42,31,17,3,9,8,6,26,7,17,8,9,26,16,11,30,34,11,31,12,11,11,15,10,6,22,2,25,10,8,9,36,17,28,37,28,14,12,14,8,4,17,19,2,9,18,18,18,3,4,8,157,28,9,11,9,4,12,46,16,13,16,4,5,16,26,10,5,2,8,16,11,25,14,26,29,15,14,4,6,7,8,10,38,19,19,10,8,11,6,5,16,10,23,6,21,3,14,9,3,31,8,11,5,5,8,15,9,27,9,14,1,1,5,11,24,17,25,11,6,6,12,15,3,6,19,3,15,12,7,4,20,9,31,8,5,7,17,25,14,21,14,11,8,13,18,12,8,13,6,9,11,20,2,0,7,6,8,8,17,10,26,25,22,1,6,29,31,16,12,22,12,10,4,4,6,9,22,8,3,7,11,1,5,15,7,11,7,14,6,14,15,9,8,1,2,21,30,6,4,3,1,7,7,11,4,16,6,3,9,23,13,19,6,29,4,6,8,5,9,10,5,8,3,1,19,6,2,4,10,9,13,5,9,16,9,12,9,9,35,15,5,3,8,10,6,9,19,15,1,4,8,29,14,4,35,3,9,10,5,8,3,15,3,2,4,7,7,3,3,9,11,5,11,9,9,9,2,2,9,6,5,3,3,5,3,10,6,5,4,7,12,5,15,0,2,11,0,5,3,7,8,15,5,12,13,6,2,9,18,3,21,4,3,6,7,15,5,2,25,14,1,15,8,9,32,2,5,8,15,4,7,9,2,1,6,10,7,7,4,3,13,8,19,2,1,7,10,13,12,29,2,5,3,3,7,7,3,5,10,10,9,1,8,5,4,2,18,13,0,8,17,30,8,14,9,5,12,4,4,17,8,4,13,6,12,3,16,13,6,11,5,10,4,7,1,1,6,5,8,5,3
always,9,31,21,136,27,21,15,74,4,9,43,9,10,172,10,18,12,26,16,15,11,57,49,61,35,22,50,44,15,38,23,226,235,42,115,180,80,8,21,22,11,45,11,8,57,32,23,25,346,129,75,17,30,108,20,8,69,16,26,30,37,21,9,17,41,23,189,19,19,26,13,4,14,9,236,28,50,8,160,57,40,4,14,23,312,19,19,2,40,2,16,22,6,49,101,22,25,7,60,28,4,35,30,21,22,45,13,6,18,9,38,5,17,27,13,48,5,4,83,220,72,77,16,98,11,13,11,6,2,1,33,10,18,60,95,87,16,10,14,29,29,51,29,4,7,109,19,30,17,19,92,2,22,9,6,31,68,10,16,49,22,3,10,1,7,21,7,29,30,17,24,172,39,5,21,18,202,11,19,78,54,22,14,41,1,63,60,47,40,70,9,8,6,5,7,5,18,17,13,30,68,0,3,13,54,24,8,47,13,45,117,25,24,17,15,19,8,6,22,3,9,34,5,20,62,136,44,41,8,19,19,13,21,27,48,19,49,13,7,25,102,65,16,15,42,11,15,80,63,8,8,18,35,5,13,33,13,1,11,29,4,51,15,3,12,33,6,42,39,9,146,9,35,13,6,6,38,19,14,7,127,16,0,30,15,4,10,23,31,3,3,14,18,8,0,13,40,2,14,46,49,17,2,1,24,1,36,12,18,5,1,25,33,15,43,20,25,52,27,9,61,14,63,6,132,6,14,63,7,35,16,26,27,7,23,14,44,9,8,15,18,17,23,29,4,16,68,78,26,21,17,16,10,47,29,7,6,5,18,37,35,10,18,27,6,12,55,26,18,50,5,53,3,39,21,36,4,5,43,18,88,11,58,21,17,36,8,33,29,11,40,16,16,10,50,17,65,12,47,5,32,15,10,8,5,16,10,4,37,32,10,22,6,20,24,19,11,18,16,15,4,12,23,15,7,5,9,28,21,21,20,4,0,13,9,7,9,19,24,12,30,26,10,25,7,4,45,13,55,9,50,11,20,5,61,24,11,7,20,22,20,63,33,54,7,17,33,21,11,10,43,9,9,17,12,40,15,14,30,9,16,29,15,17,19,16,16,17,6,8,142,37,5,20,27,8,4,16,15,25,24,14,8,3,6,42,4,18,7,4,4,5,7,11,19,23,14,24,5,13,7,25,16,43,12,7,40,18,21,50,16,14,9,22,9,14,10,30,48,29,13,5,4,7,11,7,10,24,13,11,69,5,4,72,7,19,40,6,11,9,23,5,11,8,14,19,23,13,39,43,23,12,11,8,9,7,23,6,12,14,13,18,27,1,21,17,18,14,9,19,53,69,26,10,44,9,21,19,50,37,27,6,6,4,9,33,4,17,13,9,44,12,9,14,47,12,22,13,7,9,26,17,7,30,2,6,10,13,23,30,13,15,45,34,10,7,13,5,13,9,16,9,13,19,9,27,13,3,9,180,27,14,16,11,22,20,40,34,14,15,8,8,9,19,6,5,1,9,12,17,25,17,29,32,38,16,2,3,5,9,4,22,20,11,9,5,14,8,5,6,13,36,18,13,4,7,18,4,12,13,10,7,3,6,11,17,21,26,1,3,19,2,3,23,21,31,9,10,11,16,13,13,12,30,7,16,11,4,9,19,15,9,5,13,6,3,47,9,31,11,10,12,2,21,22,15,26,8,8,5,23,8,2,8,6,15,10,10,3,5,4,27,1,1,31,15,12,14,4,6,18,6,10,19,9,16,7,3,16,14,3,4,18,2,15,4,7,21,13,13,5,8,2,5,21,39,3,7,4,9,8,9,14,5,21,6,15,9,26,6,8,6,16,6,7,5,7,17,4,25,6,9,4,3,2,7,14,8,15,4,12,12,23,13,13,16,12,32,16,5,7,6,9,13,10,5,9,3,9,12,43,19,15,7,2,7,7,4,5,2,5,8,7,1,12,12,4,10,18,9,4,11,2,19,7,13,1,13,12,5,1,8,10,6,2,9,4,5,5,2,11,11,0,5,13,6,9,3,10,25,12,9,11,19,24,1,4,12,6,31,5,2,14,5,16,2,4,8,8,5,10,9,4,15,3,11,12,11,6,12,7,5,17,9,9,4,5,16,11,15,4,13,5,3,12,17,15,5,25,5,6,7,11,9,5,2,1,8,8,7,3,2,6,6,2,21,4,6,8,13,12,13,19,15,6,17,13,11,8,10,4,10,6,12,11,9,16,14,43,6,3,4,4,5,1,4,5,0,8,12
wisdom,5,17,8,131,17,7,3,43,6,4,15,6,7,83,5,9,3,14,6,4,6,35,11,13,25,7,12,13,6,6,6,107,112,14,49,80,31,7,5,13,9,13,0,0,37,21,21,8,175,21,36,7,19,33,3,7,46,15,1,12,13,10,8,13,32,5,110,5,12,2,6,5,9,3,61,21,20,4,89,32,31,1,7,5,162,6,14,1,26,1,1,11,0,13,51,7,18,5,26,16,4,27,18,7,9,18,6,0,6,1,18,7,5,15,1,13,2,3,42,106,34,15,5,49,3,2,6,3,1,2,14,7,6,23,19,29,8,6,2,9,6,38,19,1,0,40,2,11,10,5,60,5,13,3,4,13,24,5,12,7,8,4,7,0,0,5,4,19,20,12,10,73,24,2,3,4,134,4,24,21,15,12,3,15,1,27,29,24,39,32,2,10,9,0,1,2,15,2,5,20,34,2,0,7,34,7,7,31,6,42,59,3,21,1,2,2,0,0,8,2,1,13,5,16,33,76,17,20,2,6,5,4,7,24,28,20,31,9,4,7,57,27,5,8,18,4,3,22,31,6,17,18,13,7,10,17,11,5,5,6,3,19,30,2,5,24,3,13,12,7,163,3,14,8,8,0,9,8,13,3,64,10,2,21,10,2,6,8,13,3,1,0,12,2,3,6,19,3,3,18,19,27,0,2,9,1,22,2,5,1,1,23,18,8,21,12,16,42,8,6,34,4,24,2,54,7,7,18,2,24,3,13,7,5,11,12,20,4,3,16,17,6,14,8,6,3,36,54,18,5,13,15,0,3,16,3,2,4,20,26,15,7,8,17,2,6,29,8,10,11,4,12,7,6,7,15,6,3,15,8,70,3,43,7,0,26,6,14,27,6,34,2,12,8,35,19,64,8,17,5,26,4,6,0,1,8,4,4,22,13,4,5,1,19,9,14,4,5,3,1,12,4,25,11,1,6,12,12,13,6,10,1,2,7,2,7,0,4,7,2,13,11,3,17,1,2,6,6,22,2,10,4,3,7,48,8,4,8,10,18,7,16,18,23,4,3,9,8,6,2,9,2,4,5,9,15,9,16,10,4,6,13,5,6,9,9,10,5,5,3,55,35,1,8,13,7,5,14,12,11,16,5,2,1,0,13,0,9,4,5,5,6,5,14,24,28,5,8,6,6,7,9,7,24,11,3,15,11,14,22,8,13,2,9,7,7,13,8,32,23,8,2,2,3,8,9,12,19,10,3,42,9,4,35,3,5,26,2,3,7,24,1,17,3,24,22,21,9,18,37,7,12,11,5,6,8,21,5,11,2,5,7,11,21,1,10,9,7,1,8,33,43,10,6,25,10,5,4,16,25,22,1,4,2,6,25,2,16,5,4,17,12,3,10,24,8,20,5,12,4,11,7,3,17,1,11,5,11,9,26,13,16,35,26,5,4,19,4,2,6,11,6,8,14,6,13,3,1,5,91,11,4,9,8,2,11,42,16,5,14,13,5,6,14,7,1,4,7,7,6,18,6,29,14,11,4,6,4,0,6,0,30,12,7,10,6,10,7,0,6,8,13,8,9,9,7,8,4,7,21,5,4,5,7,6,6,14,6,6,1,8,3,7,35,9,9,1,9,3,5,3,1,3,11,2,6,3,2,8,10,8,10,7,3,4,2,8,4,15,7,4,3,2,4,8,6,15,9,11,8,13,3,0,6,1,11,13,11,4,6,7,9,0,0,17,13,7,7,8,6,2,0,0,4,6,20,7,5,6,11,2,2,7,2,11,4,12,10,12,6,6,7,2,5,9,19,4,2,1,3,5,5,10,3,6,6,15,3,12,3,3,2,4,9,2,3,7,4,1,9,4,8,1,8,4,5,8,5,8,3,6,1,13,5,9,13,12,24,16,7,1,11,9,20,6,9,4,3,5,9,20,15,10,6,4,1,7,11,0,2,6,2,7,3,7,8,3,4,11,6,8,8,7,15,2,6,3,6,10,1,4,4,5,6,6,5,0,1,3,3,1,3,3,3,4,4,5,1,2,5,7,4,1,7,9,2,0,17,2,21,7,2,9,6,8,1,2,7,3,2,10,3,6,2,0,6,4,7,5,3,3,3,10,4,3,2,6,4,0,4,9,15,5,0,3,8,15,6,24,4,0,2,7,3,3,2,0,3,7,5,9,3,7,3,1,15,4,3,5,6,1,9,6,3,4,4,0,8,3,2,7,9,5,9,6,2,11,0,8,3,2,3,4,1,0,1,1,8,1,4
treat,3,4,10,38,5,1,18,20,3,11,32,8,3,80,0,7,6,6,0,1,0,10,11,22,28,18,18,8,3,13,6,121,82,13,57,67,37,2,2,12,4,4,4,3,15,8,10,5,163,20,52,8,9,29,9,14,25,8,1,15,6,5,2,3,15,2,92,5,10,19,15,0,1,2,94,12,9,0,43,30,37,0,6,4,118,4,3,0,12,0,7,4,1,11,41,12,14,3,26,10,3,14,14,3,20,10,4,2,7,9,20,0,2,8,0,12,4,8,31,92,21,30,17,41,12,1,2,0,1,3,9,16,17,33,19,24,20,0,4,11,9,39,24,1,6,37,2,19,14,4,49,2,13,8,20,19,35,4,11,10,8,1,6,1,9,10,0,23,13,4,6,83,30,0,3,11,78,2,9,34,21,2,2,16,0,16,36,27,48,34,1,3,6,0,1,1,15,8,3,29,50,0,3,3,8,1,0,26,6,21,43,5,13,7,2,2,1,2,8,2,1,20,9,12,19,80,39,20,3,10,4,7,5,14,20,10,10,9,2,21,30,12,1,10,16,8,3,23,26,2,2,20,10,3,1,6,7,2,1,12,3,13,10,3,7,10,2,2,15,2,59,6,12,2,1,2,7,6,3,3,63,7,0,8,7,0,3,6,30,2,1,4,5,5,2,8,19,5,7,17,19,10,3,0,5,1,43,3,14,0,0,10,7,2,23,1,10,32,8,8,36,4,15,2,54,3,12,14,1,15,5,11,8,6,10,12,13,2,0,4,4,5,3,11,2,6,19,36,19,3,11,7,13,9,7,3,3,13,8,28,15,1,17,21,1,0,15,10,2,26,1,4,3,17,7,6,8,4,39,2,50,3,17,15,6,28,9,7,12,3,33,3,4,10,10,6,34,1,14,1,23,2,18,2,2,8,3,9,9,7,28,16,3,9,6,4,4,10,8,0,18,10,9,18,0,3,1,27,7,9,11,0,2,3,8,3,0,18,2,3,5,12,11,15,2,1,5,10,27,8,4,1,5,3,57,9,0,2,16,18,14,22,31,65,2,2,13,13,4,2,35,10,1,2,1,84,5,4,17,3,3,23,5,6,11,7,14,1,6,1,50,13,3,3,13,0,1,7,3,12,16,2,1,1,5,6,1,13,2,2,1,5,1,4,6,11,2,3,3,4,13,15,2,3,4,2,13,15,9,24,20,2,4,13,3,5,4,11,31,17,0,2,0,8,1,3,4,3,17,4,6,0,0,22,2,7,7,1,5,7,15,3,8,0,6,5,22,4,12,27,3,6,9,1,3,1,17,5,3,12,0,6,3,17,10,1,5,14,6,6,33,39,5,3,27,2,33,7,40,22,21,2,2,9,1,5,3,41,5,1,23,1,5,3,29,4,9,3,7,0,5,2,0,7,4,5,3,3,13,18,2,5,25,18,5,7,19,8,17,3,33,13,10,9,2,11,3,3,4,105,15,3,1,1,8,8,18,21,10,3,2,5,5,15,1,11,3,8,9,5,4,8,73,16,8,3,3,1,1,3,1,11,9,8,3,2,14,5,6,2,7,1,8,14,2,5,6,2,10,2,20,13,5,5,0,6,11,8,4,1,0,4,3,11,11,21,1,16,7,11,2,10,21,14,0,1,5,6,14,7,2,7,2,12,3,1,12,4,33,8,10,1,2,2,4,0,10,10,4,14,3,1,1,2,3,7,3,8,5,6,2,11,3,0,4,3,7,2,2,7,2,0,1,4,3,9,6,2,9,7,1,1,8,1,7,3,2,52,9,14,1,13,8,7,17,12,2,0,1,1,10,1,10,2,4,0,3,6,7,4,3,0,2,4,2,1,11,3,4,3,3,1,2,6,1,3,7,2,0,2,0,6,7,0,0,10,7,11,8,4,0,2,4,3,0,6,3,1,7,9,6,16,7,5,2,2,7,1,1,2,1,2,2,1,2,5,1,2,0,6,4,1,1,0,6,3,4,5,8,67,1,7,2,2,6,1,3,8,4,0,1,3,10,1,5,0,1,3,1,9,2,1,6,5,0,4,4,2,2,9,3,1,6,1,8,4,2,2,3,4,7,3,1,0,4,2,6,14,0,0,0,1,6,0,2,2,0,4,7,4,3,2,0,0,1,6,6,1,9,0,0,1,5,3,1,1,1,0,6,5,1,2,1,1,0,1,2,0,0,4,11,4,2,6,1,3,1,2,0,1,0,4,1,2,6,8,9,1,4,2,0,1,4,1,0,4,7,1,8,5
perhaps,0,11,4,65,5,3,6,21,4,1,14,8,9,37,5,4,5,13,4,4,3,15,3,20,9,5,5,9,9,9,3,99,76,6,37,26,19,9,15,0,5,4,2,3,19,9,13,14,149,13,25,2,14,29,7,6,37,14,2,14,12,5,2,3,19,7,57,1,3,21,3,2,4,2,64,9,12,3,53,15,35,3,9,4,120,9,18,2,25,1,5,2,4,12,29,8,20,5,20,10,4,26,18,8,5,16,8,5,13,4,10,6,8,11,1,16,4,6,28,106,24,8,7,43,3,1,2,1,4,4,12,3,6,24,20,33,3,2,2,4,2,30,15,2,5,35,7,12,9,9,19,1,7,4,6,26,24,3,10,4,19,4,8,5,1,7,7,8,14,1,11,61,27,4,7,3,96,2,7,22,11,5,1,17,1,15,32,20,28,20,5,2,10,2,3,1,17,1,7,8,30,3,3,5,13,3,3,24,10,21,50,4,11,5,2,3,10,1,18,0,2,13,3,11,24,62,14,18,5,0,19,9,11,14,34,10,32,9,14,8,35,21,5,5,9,2,3,27,23,7,7,26,12,5,12,9,6,2,3,28,6,21,7,2,1,23,3,8,12,3,91,3,12,4,3,0,10,4,10,2,34,13,6,12,9,2,3,3,6,3,6,3,7,3,3,6,19,3,4,15,15,26,0,7,5,1,13,1,4,0,2,16,27,5,17,9,12,36,6,5,25,4,22,6,29,6,13,22,6,14,1,12,3,5,5,7,10,5,1,10,6,13,12,3,4,14,23,40,9,6,12,6,1,28,12,4,2,2,16,11,10,8,10,11,1,3,24,5,6,7,3,3,2,10,8,16,4,8,7,6,33,2,24,6,2,39,2,14,14,4,11,3,10,9,20,7,37,2,13,2,12,2,2,1,7,7,5,3,15,11,1,21,4,6,7,9,2,6,2,1,3,0,17,5,1,0,1,4,10,9,4,9,0,14,1,2,1,3,8,5,12,9,9,5,2,5,6,4,14,6,7,4,2,1,38,5,1,4,7,20,8,8,16,21,4,5,13,7,10,1,16,2,2,2,3,8,3,8,24,4,4,4,5,2,3,3,6,1,4,4,48,24,3,4,5,10,12,8,6,9,12,8,4,0,2,23,12,6,7,1,2,4,3,11,11,10,0,8,1,7,6,14,8,9,7,3,15,6,8,16,6,2,0,7,5,5,1,6,22,10,2,0,1,20,8,7,19,6,3,9,16,0,4,18,5,6,13,2,4,4,10,3,13,1,8,12,3,7,14,28,5,5,2,4,5,3,18,6,7,11,12,8,8,18,9,5,1,3,5,5,8,13,15,3,18,7,2,10,17,14,12,1,2,1,5,13,4,12,4,2,17,11,8,5,12,11,12,12,7,0,11,0,6,4,0,8,4,8,13,13,4,16,22,8,3,0,11,6,3,9,8,2,3,9,8,13,7,3,2,89,8,6,3,4,4,2,24,6,3,7,4,9,3,7,2,8,5,5,10,11,13,5,6,34,7,11,1,3,5,6,2,18,8,7,8,4,7,5,1,6,8,4,14,13,1,5,5,2,6,10,5,8,0,4,7,4,11,5,0,1,4,8,4,14,11,12,4,3,7,4,2,2,0,13,7,9,6,4,3,9,5,12,6,5,3,2,12,3,13,12,8,3,6,8,16,7,9,7,2,5,7,2,0,7,3,4,13,14,3,2,8,4,2,4,16,8,13,12,8,10,8,6,3,8,2,8,4,3,22,5,2,3,12,4,5,7,6,0,2,9,0,10,3,3,9,11,4,2,2,4,4,3,10,3,2,2,5,3,9,6,1,1,4,7,5,2,1,4,1,7,0,4,4,9,4,5,2,2,4,2,3,2,6,1,4,10,6,9,5,1,3,0,6,2,12,4,6,8,3,1,15,6,6,5,4,4,6,6,1,0,5,3,4,2,2,3,2,4,9,6,3,6,2,4,1,5,3,1,9,5,0,2,5,2,9,5,1,3,3,1,3,5,1,4,8,11,3,2,9,4,4,0,0,10,2,8,0,7,5,17,6,2,6,5,8,4,3,4,5,4,3,3,2,6,1,3,3,3,2,0,5,0,4,6,2,0,3,5,5,12,4,3,3,3,5,6,4,9,11,1,4,1,2,1,4,6,2,5,7,3,4,9,7,9,1,17,6,1,1,6,3,0,6,2,3,5,2,2,7,6,3,12,6,1,5,6,4,0,15,2,7,5,4,1,2,3,2,1,4,4
entirely,5,18,6,73,6,6,4,20,2,3,13,1,8,40,6,6,6,9,9,4,1,35,3,12,24,10,11,2,7,11,3,138,113,6,44,30,26,7,9,4,3,1,6,0,26,17,15,1,214,9,35,5,13,15,2,5,33,13,1,11,20,5,3,5,14,2,83,8,8,10,6,3,4,1,60,10,19,5,42,12,38,0,13,7,169,26,13,0,27,0,7,2,0,19,42,8,14,4,24,10,3,20,26,7,17,18,11,3,8,1,14,6,1,12,1,12,5,1,38,97,30,10,15,39,9,1,2,2,4,1,17,2,7,27,19,35,7,3,1,6,4,20,30,7,2,40,6,13,11,9,52,0,6,6,5,28,16,3,12,4,5,10,5,2,4,9,4,13,17,8,20,58,13,7,1,9,103,2,4,13,25,5,2,11,0,11,22,26,28,43,2,8,9,0,2,3,7,4,3,11,30,0,0,11,20,8,11,38,12,27,48,1,13,6,2,0,0,0,11,4,5,18,0,10,16,85,22,25,3,2,11,12,20,15,28,23,31,7,6,10,44,21,3,4,10,2,5,10,36,2,9,10,20,7,10,14,9,2,5,10,2,14,19,1,6,37,2,3,12,7,105,11,24,10,5,1,12,7,4,5,50,4,0,8,22,1,5,10,6,3,2,2,10,1,2,5,30,2,4,17,15,29,0,3,14,0,18,2,8,3,2,14,16,5,20,13,10,26,3,4,34,5,19,0,31,6,4,16,3,18,3,10,13,4,9,10,4,6,3,8,9,7,11,3,5,6,30,35,6,5,8,8,6,40,19,2,0,8,9,16,13,6,7,21,2,0,21,10,11,14,3,12,2,10,11,24,10,4,17,7,50,2,25,8,3,26,10,17,20,2,11,0,7,15,24,7,41,5,25,3,13,0,3,0,4,3,10,5,20,2,6,9,5,10,5,7,2,9,4,2,9,3,13,8,1,4,1,7,6,7,5,5,0,8,3,2,1,6,6,7,12,18,6,9,1,1,3,5,31,7,10,4,3,0,33,3,1,4,8,21,5,19,18,29,2,16,13,5,4,0,10,5,0,6,3,23,3,9,16,10,11,8,6,3,8,4,9,4,4,3,42,35,1,3,13,2,1,9,6,6,16,4,1,0,2,25,11,11,2,8,4,4,3,5,9,16,2,10,1,3,5,9,4,8,5,3,24,10,13,29,8,6,0,6,4,2,11,13,42,17,2,0,0,6,5,7,3,12,13,6,24,4,2,30,2,6,19,0,4,13,19,1,11,2,15,9,11,8,25,19,9,8,13,3,10,6,26,7,7,13,10,10,10,14,7,14,3,1,7,5,21,38,6,2,21,4,12,6,31,16,17,2,9,1,3,26,4,18,0,4,23,5,5,6,19,11,18,2,3,7,13,4,5,10,1,7,3,8,14,18,14,14,23,21,7,4,8,7,3,10,15,1,17,11,7,17,7,2,6,119,35,3,11,1,5,10,34,5,4,9,3,5,15,7,6,5,1,10,6,18,15,8,35,18,19,8,3,5,0,8,4,19,7,8,6,9,7,2,4,10,6,3,4,9,4,8,8,3,11,8,8,7,8,9,7,3,15,4,2,1,8,5,5,19,12,14,9,5,5,5,5,4,5,23,1,8,5,2,5,8,7,5,1,2,2,3,10,5,16,10,13,10,1,2,7,2,9,4,5,4,5,8,5,3,2,6,5,6,4,11,10,15,0,4,9,9,7,8,6,9,8,4,3,12,2,10,15,4,13,8,2,3,5,5,5,5,6,19,5,12,3,10,2,4,10,15,2,6,3,7,3,3,9,2,5,3,9,4,14,8,9,3,4,4,1,2,4,5,1,12,8,3,6,5,7,6,4,9,8,1,5,4,10,3,4,12,6,11,8,2,3,1,1,4,6,11,8,3,4,12,13,18,12,4,0,4,5,5,6,0,3,3,3,1,3,8,5,1,5,13,3,5,5,7,4,8,2,1,7,6,3,5,1,0,2,11,3,2,8,2,0,9,0,3,7,3,6,2,0,2,9,5,6,9,7,4,3,6,3,14,2,10,5,12,7,2,3,3,1,2,3,6,5,8,1,3,4,12,5,6,8,1,9,5,4,5,3,6,4,6,5,6,3,6,7,10,11,15,30,5,0,5,0,3,5,6,0,6,9,8,0,6,6,3,0,6,5,7,3,4,7,6,7,5,6,3,3,9,7,8,5,8,1,8,7,8,13,3,5,1,3,0,4,0,0,6,2,1,0,0
exclude,7,5,7,51,0,2,0,30,2,2,3,5,3,23,3,3,2,3,2,3,0,14,4,11,10,3,10,2,1,3,3,71,48,2,28,27,16,1,11,3,3,3,0,0,4,6,4,8,160,3,22,0,5,13,3,2,51,13,0,5,4,7,0,4,9,5,39,4,2,5,10,6,0,0,19,4,5,0,46,11,22,0,6,2,81,5,15,0,11,0,4,1,0,15,21,4,5,3,10,8,3,7,20,2,4,9,0,1,14,4,8,7,4,7,1,13,1,3,29,67,17,7,5,40,1,2,1,6,3,1,5,0,2,24,16,13,3,3,1,3,0,22,21,3,4,29,4,3,12,13,30,2,10,0,2,2,14,2,3,0,8,0,1,4,8,1,1,5,7,4,11,39,10,1,1,5,75,1,4,8,11,5,6,6,1,9,15,6,20,15,1,1,7,0,0,3,2,0,4,0,20,0,4,9,5,1,6,13,7,12,17,2,7,7,0,0,4,0,17,0,6,8,2,3,23,44,20,15,0,13,4,6,7,7,5,15,13,7,12,0,25,14,4,0,2,4,1,6,14,2,2,14,7,7,15,6,2,1,2,5,2,10,11,0,1,28,0,1,10,4,55,2,27,0,0,1,14,21,5,0,24,3,2,9,3,4,0,3,3,1,3,0,2,4,3,3,20,2,3,11,10,18,2,2,11,1,7,2,1,1,1,2,9,2,23,9,9,12,10,3,16,2,15,1,24,1,0,7,3,13,2,9,4,1,3,7,9,3,4,7,4,4,11,2,5,2,18,24,10,2,3,3,5,19,12,3,0,3,6,11,8,2,2,6,2,0,18,0,1,6,2,12,3,10,5,15,5,1,3,2,19,2,18,6,0,13,1,5,17,2,9,1,5,6,15,3,32,2,14,2,7,4,2,0,1,4,3,2,22,1,0,11,11,3,0,4,2,1,0,0,2,6,1,5,0,2,3,3,2,2,10,0,1,3,0,0,0,8,3,5,8,9,1,11,2,3,3,1,13,5,5,1,0,3,38,7,1,3,3,16,3,5,7,15,5,1,15,19,8,0,3,2,3,1,2,7,0,2,2,4,2,2,4,1,2,4,7,2,2,0,42,13,1,2,8,3,1,10,4,4,9,0,4,1,2,6,1,7,3,1,4,1,2,9,4,8,1,4,0,6,1,10,8,7,3,1,8,4,10,12,5,1,0,8,6,3,4,2,16,5,1,2,2,6,7,1,0,3,7,1,35,2,2,21,1,4,16,7,5,3,9,0,16,2,8,8,1,3,11,16,3,4,10,1,2,5,6,2,2,33,8,8,8,9,1,6,5,7,1,5,12,13,6,4,13,2,7,3,23,7,8,4,3,1,2,10,3,12,3,13,10,6,4,5,5,5,8,6,9,4,7,7,4,10,4,3,2,4,7,14,10,5,9,10,6,1,1,8,1,5,11,1,5,10,1,13,2,1,6,82,14,1,2,5,5,10,19,4,2,14,0,6,15,22,4,1,1,5,3,5,7,5,22,14,15,1,1,3,4,7,3,18,4,4,4,3,3,3,10,29,9,7,7,16,0,4,4,1,20,6,12,1,1,3,4,4,7,1,3,3,0,7,0,7,12,15,1,1,4,0,4,0,0,17,1,9,1,0,1,7,2,8,2,2,2,9,16,1,27,5,4,5,2,3,14,3,4,2,0,5,6,8,8,12,8,4,1,5,2,15,17,7,0,2,11,6,3,1,9,5,1,2,2,10,1,5,1,0,2,6,0,3,4,1,3,1,5,12,10,5,7,9,2,2,5,7,0,8,2,3,3,1,7,1,1,0,4,0,8,4,15,0,20,6,2,2,1,4,1,14,2,3,2,5,7,0,5,5,10,3,9,3,4,2,6,2,2,10,13,1,1,4,4,2,7,4,3,2,0,4,8,12,3,2,0,6,5,3,3,2,5,8,2,4,5,3,6,0,3,2,0,3,10,12,1,5,3,13,6,3,3,2,0,0,4,5,2,3,1,1,0,9,0,0,3,3,2,3,3,0,1,4,3,1,4,0,0,3,2,11,0,3,7,15,17,2,2,9,0,3,6,3,3,10,4,4,6,7,0,2,4,1,2,11,2,5,5,11,1,2,2,10,8,4,11,17,4,24,18,2,1,6,2,2,4,3,22,8,11,0,9,5,3,6,1,18,1,4,9,4,10,3,3,2,5,3,1,2,1,5,7,5,1,8,1,2,4,0,4,0,0,1,0,1,1,0,0,2,1,0
best,12,21,7,117,12,8,8,30,6,8,15,19,14,84,4,12,10,29,14,10,3,43,36,34,15,16,19,28,11,22,6,207,170,45,58,130,60,7,11,6,10,21,7,6,56,18,18,14,202,75,54,13,26,81,22,2,63,20,12,22,15,10,3,12,25,19,136,15,12,11,18,6,5,8,116,18,30,8,98,42,37,0,10,10,201,23,17,0,29,2,9,10,4,31,67,19,21,5,34,11,11,38,35,12,16,22,12,8,10,10,23,3,13,17,15,35,4,3,41,163,48,35,20,78,8,7,5,4,4,3,35,9,16,40,23,92,6,2,8,18,6,34,17,4,5,79,8,18,16,16,52,7,17,8,11,17,43,4,8,23,22,9,11,7,5,24,9,19,25,10,21,100,33,4,11,10,128,9,15,56,42,25,12,27,11,30,35,36,39,41,4,8,3,3,7,6,25,6,12,9,27,3,1,12,36,19,5,48,13,20,85,12,27,16,8,18,0,14,12,3,5,17,4,22,39,66,17,36,5,8,23,24,19,18,47,25,25,11,14,10,75,39,13,12,20,3,4,43,49,10,11,20,26,6,12,27,5,3,1,31,5,41,17,1,3,37,17,17,32,5,150,12,22,8,3,5,27,6,4,5,72,6,4,17,13,3,14,18,15,5,5,3,16,8,3,4,33,3,8,28,24,41,1,4,12,4,21,7,10,4,3,28,42,11,30,7,26,35,6,8,33,10,35,20,52,1,18,40,5,21,10,18,4,6,13,12,28,6,4,12,12,13,22,12,9,8,34,52,20,12,13,10,7,53,15,13,12,22,19,35,16,11,19,10,7,15,33,23,14,25,6,36,2,11,12,46,11,7,25,3,84,2,36,10,26,27,5,15,34,6,21,7,17,6,37,18,49,4,34,4,9,17,6,4,8,4,11,5,12,36,7,15,3,18,2,13,9,12,3,6,4,17,6,16,6,7,7,12,5,22,9,4,4,5,8,2,1,9,19,3,15,15,8,13,2,5,25,7,27,15,19,4,9,16,48,8,3,5,12,32,19,36,27,73,9,5,25,18,6,2,28,10,3,2,6,21,4,14,25,17,4,23,6,6,15,14,7,6,8,1,69,33,6,5,17,8,3,9,13,7,18,7,6,4,6,16,20,11,13,5,3,8,7,13,21,14,10,16,3,12,2,18,8,25,5,6,26,6,18,33,11,8,2,8,14,10,8,30,29,23,7,0,6,24,10,13,9,20,15,11,36,3,5,46,15,15,36,2,4,9,26,6,14,11,16,12,13,12,47,53,11,4,8,0,6,3,12,2,7,17,12,18,25,19,8,6,5,5,5,1,33,35,9,4,31,11,14,5,14,26,28,8,7,1,6,22,6,24,12,7,27,17,11,10,21,7,17,6,25,10,10,5,5,15,2,10,11,14,7,22,10,16,25,39,5,3,21,9,9,12,16,10,10,15,7,20,5,4,6,103,16,5,10,6,7,8,33,13,8,14,6,12,6,3,4,2,0,7,17,3,18,2,32,12,20,6,3,1,0,3,12,22,10,12,10,5,9,4,4,10,13,18,13,16,6,8,4,2,10,22,1,5,8,12,12,14,15,14,6,5,8,6,4,41,8,36,17,7,5,14,11,4,3,23,7,20,15,10,10,15,17,22,9,12,12,0,33,7,29,12,10,5,9,18,24,7,9,7,10,4,16,4,4,8,3,13,12,10,2,7,7,21,1,2,20,17,16,4,21,7,11,5,2,8,6,6,6,1,5,8,5,8,13,5,11,4,2,14,12,10,4,9,4,3,18,40,9,3,2,4,4,6,8,3,8,14,6,9,12,4,3,2,9,6,3,1,4,10,5,8,3,3,9,12,1,3,20,8,8,9,9,11,15,8,8,9,13,19,13,4,5,3,4,15,6,8,19,9,6,4,20,17,8,8,9,9,6,12,4,1,4,2,7,4,5,11,8,5,13,16,3,3,14,14,9,9,0,5,16,0,2,4,3,2,3,0,6,4,3,9,3,11,3,4,7,2,2,7,9,9,3,10,10,5,13,4,1,8,3,27,0,7,3,5,12,4,4,1,5,7,5,8,6,10,2,5,4,8,8,1,5,3,6,4,4,2,5,5,2,12,8,12,0,4,4,11,7,8,13,1,5,4,4,7,4,2,1,8,19,2,1,9,5,7,2,15,1,0,10,6,10,7,8,9,7,4,11,8,4,3,8,12,6,3,4,5,12,8,3,4,2,6,5,5,2,3,5,5,10,11
principle,14,24,21,252,31,16,8,102,10,9,43,17,12,214,12,45,14,38,12,13,5,83,27,33,42,22,34,26,25,31,17,342,259,31,115,146,107,18,10,16,17,27,9,8,66,49,73,37,641,53,102,12,18,96,3,18,132,30,9,33,50,16,13,29,43,7,220,15,32,34,11,10,9,5,242,30,33,6,139,48,76,3,21,6,488,26,10,2,50,1,9,14,3,77,128,24,22,7,59,24,24,54,69,18,24,52,17,5,32,9,37,10,13,34,5,55,7,5,153,333,93,40,53,111,19,7,7,5,5,4,30,8,19,86,69,88,14,4,13,21,10,68,59,9,5,121,8,35,18,17,162,4,35,21,15,46,56,8,23,25,28,8,11,4,5,14,3,41,50,14,30,170,36,5,9,22,432,4,17,62,42,36,9,46,6,41,53,43,82,124,2,11,9,5,2,4,32,32,21,32,60,5,7,24,94,27,10,89,31,97,140,10,38,15,5,6,7,8,45,7,9,40,9,36,85,202,48,54,14,8,31,20,43,41,70,47,64,15,18,18,139,63,9,15,39,13,11,52,73,8,25,54,43,9,22,25,19,8,12,25,19,61,61,6,23,52,12,10,42,13,239,4,42,16,13,5,37,20,17,6,135,14,1,20,11,8,10,15,38,7,14,9,31,13,1,19,64,9,20,68,51,46,2,3,22,10,60,8,9,4,5,25,44,20,45,38,39,70,27,22,101,16,59,1,207,15,18,65,5,50,13,33,35,6,24,37,52,9,10,12,19,13,25,29,10,8,96,93,26,10,52,23,23,52,48,4,9,18,34,34,47,14,22,39,3,3,63,27,23,37,12,56,26,29,17,66,14,6,44,17,163,6,79,37,8,58,7,48,46,10,81,11,31,33,67,39,114,10,43,5,54,5,15,8,8,16,15,10,26,33,14,14,8,26,14,17,12,17,7,9,24,20,30,36,4,17,11,36,23,41,22,15,1,32,10,19,8,48,15,12,26,51,22,54,0,8,23,11,54,14,35,13,12,15,126,48,8,32,20,51,34,60,61,64,9,11,37,24,15,3,35,5,9,9,6,41,18,30,25,6,14,23,22,9,14,21,25,13,12,18,139,60,9,12,28,9,6,33,22,14,24,6,9,6,6,37,5,34,11,6,11,13,12,17,37,25,7,23,7,23,10,57,30,52,16,10,37,13,32,63,23,24,10,22,23,8,29,21,74,22,21,5,10,14,16,9,7,41,33,6,99,11,15,56,15,31,75,10,10,18,69,7,45,12,35,32,33,10,88,63,12,34,16,4,12,39,54,10,14,22,15,30,28,53,33,33,8,21,12,33,1,96,22,10,57,12,32,13,100,52,76,6,10,11,12,42,35,65,15,8,47,28,17,22,70,24,35,8,13,21,18,6,6,28,6,11,6,24,35,79,11,42,54,59,17,17,20,21,13,18,44,10,17,40,25,37,6,7,11,372,36,11,20,11,20,20,77,45,13,31,13,30,50,73,22,13,16,20,9,24,36,22,45,34,75,14,14,24,13,15,11,63,30,17,21,14,30,10,3,21,38,26,20,22,13,13,18,17,35,31,13,23,11,11,28,14,36,17,14,9,17,10,12,48,26,26,14,18,25,20,17,13,14,20,3,29,21,9,23,21,8,25,6,17,11,5,30,20,64,21,17,11,5,15,33,4,24,13,12,25,24,4,1,14,5,27,18,24,12,14,15,26,11,7,49,31,4,25,7,22,19,5,6,28,15,36,7,10,9,24,3,8,28,6,30,9,14,34,21,22,20,18,17,27,12,40,15,20,3,19,25,6,28,5,8,3,17,13,36,14,10,2,26,20,14,14,7,27,12,36,8,11,28,24,4,15,11,19,18,17,9,20,33,12,27,30,32,48,25,7,15,15,14,17,15,12,15,15,15,20,66,47,13,11,6,8,15,10,15,4,17,23,10,13,7,18,17,13,18,19,1,16,4,16,6,14,13,48,25,3,10,6,2,9,8,13,13,14,8,12,3,17,0,11,24,6,6,7,9,19,14,12,5,18,13,6,2,15,12,32,9,14,14,14,47,2,6,25,13,5,17,31,11,37,3,20,21,34,13,14,7,19,21,24,8,7,10,8,7,20,14,26,4,2,12,15,15,13,36,8,0,13,12,8,6,5,8,15,23,25,3,5,12,9,3,35,3,5,23,20,27,18,14,13,14,17,7,18,11,11,4,17,18,12,10,19,39,14,14,1,16,9,6,6,4,11,5,14,5,22
regard,32,55,21,336,43,8,18,84,13,5,61,17,17,191,17,17,20,40,24,12,17,104,28,60,78,22,40,33,22,41,35,437,344,33,132,160,124,14,17,10,21,25,15,9,96,73,62,39,883,46,130,17,43,86,20,22,163,64,6,35,73,33,22,42,49,12,249,23,24,22,14,17,18,21,204,36,42,16,220,75,79,2,34,23,611,52,23,1,91,8,15,20,1,80,181,26,56,10,95,41,40,85,88,33,30,84,16,8,38,8,57,23,16,24,4,83,13,14,185,454,112,40,25,113,12,9,11,17,13,4,48,14,21,121,60,99,30,8,21,26,7,96,69,13,9,195,17,47,35,26,206,5,39,20,7,63,55,8,49,21,20,14,27,4,1,17,8,47,52,23,38,234,57,4,13,34,462,14,33,85,61,34,11,54,23,50,73,79,148,131,6,20,13,2,5,6,36,20,15,47,72,4,6,52,64,38,13,91,33,95,199,8,63,16,6,3,2,3,38,3,14,41,22,42,127,245,68,86,6,16,51,28,30,68,85,55,96,20,12,35,211,88,10,21,30,12,13,63,70,22,26,66,63,18,33,54,37,4,17,42,13,68,68,11,23,79,12,22,49,9,387,16,53,24,12,3,37,22,44,6,167,31,0,53,23,3,13,23,46,7,10,16,43,15,3,26,115,22,20,64,59,66,1,4,50,5,86,12,25,3,8,47,57,18,74,37,28,104,22,15,129,36,92,9,251,24,17,66,5,77,10,43,39,20,40,53,62,21,11,38,39,42,35,43,12,20,122,149,65,12,44,65,18,97,66,8,14,18,31,51,56,18,30,60,11,3,105,25,14,33,11,42,18,24,41,69,29,8,52,23,184,3,113,48,13,95,29,49,76,20,79,12,30,36,128,29,227,17,89,12,79,10,14,5,13,14,16,17,51,34,13,29,2,54,57,28,9,20,9,9,16,29,60,48,7,16,15,52,36,38,39,15,6,29,12,28,1,40,32,18,45,54,17,40,5,8,28,14,95,18,49,26,13,12,157,41,6,39,25,77,38,55,81,78,12,20,43,39,42,2,43,12,18,7,14,46,10,38,60,20,17,35,25,28,27,30,28,15,15,10,217,118,7,24,23,24,12,41,27,40,37,15,13,2,19,61,7,33,25,9,13,14,21,23,45,80,22,33,15,31,8,41,27,93,32,14,63,19,51,87,36,19,8,27,19,21,33,39,107,59,19,9,5,10,18,19,11,54,62,30,83,21,17,125,24,28,102,17,12,26,89,9,57,13,53,56,38,31,83,120,26,43,44,15,21,24,25,20,26,25,30,24,38,69,43,39,13,38,13,35,96,1,19,24,68,24,25,9,125,73,64,9,23,6,20,80,24,70,16,20,83,56,48,20,89,30,61,5,37,10,40,18,11,56,6,22,30,31,62,83,35,84,72,67,16,9,23,17,16,13,36,13,25,42,25,82,15,9,19,506,69,18,33,9,29,40,104,76,29,43,25,16,38,59,24,13,9,21,40,30,45,22,128,69,80,17,10,26,11,22,24,57,62,24,32,24,50,14,20,29,38,33,48,36,18,29,36,8,33,40,31,20,21,30,31,12,56,25,9,11,21,17,21,100,53,57,20,37,21,29,25,20,24,76,8,20,16,8,17,30,29,36,13,13,17,4,58,19,102,29,31,10,7,41,29,13,37,14,14,32,35,16,4,12,6,39,25,25,5,25,21,37,9,4,47,39,19,23,15,34,15,22,9,42,10,41,24,16,24,27,11,13,34,18,24,16,22,60,32,35,23,17,8,22,38,52,22,13,15,12,22,20,44,12,15,12,17,19,53,24,7,7,37,19,12,16,22,23,13,31,15,8,28,25,25,17,15,15,25,13,18,17,37,4,21,20,41,71,53,28,19,16,11,34,24,17,29,17,36,30,120,63,27,18,10,14,12,23,25,7,17,12,31,8,15,22,15,16,42,38,12,10,26,36,13,17,22,28,41,29,21,14,6,10,25,7,19,12,20,20,15,29,6,13,27,16,15,7,7,6,19,18,10,37,18,8,22,25,12,80,18,15,20,19,40,14,9,26,15,8,38,12,12,28,13,22,21,57,16,18,15,8,17,22,16,9,14,14,22,26,17,34,12,16,17,35,31,10,76,18,5,11,11,11,9,9,10,23,38,23,18,12,10,13,5,55,18,6,7,37,16,17,26,13,20,20,3,20,19,23,12,16,13,23,25,30,35,10,70,11,10,5,13,1,2,8,3,19,4,6
allow,7,25,12,110,6,18,7,27,4,5,10,12,11,65,3,6,10,20,8,6,7,31,20,26,26,28,27,26,17,37,5,201,119,17,57,95,27,13,21,5,16,20,8,9,39,13,19,22,218,57,59,13,14,49,28,0,39,18,28,11,8,8,2,12,35,10,87,11,12,12,15,7,7,6,114,15,22,6,92,34,69,6,6,10,196,19,13,3,30,6,24,4,10,37,65,23,17,7,41,14,11,14,23,21,16,30,7,13,16,7,17,6,11,23,10,39,5,6,58,157,35,38,29,104,4,4,3,6,4,2,15,4,12,50,28,64,4,6,12,8,4,27,16,0,2,90,13,10,13,19,70,4,37,6,1,19,50,9,3,36,22,2,19,3,14,22,3,22,25,9,17,112,29,5,16,9,124,4,17,63,29,8,12,30,0,38,30,30,36,45,7,7,14,5,4,8,20,13,18,13,38,3,6,9,23,13,5,37,11,14,77,17,27,7,9,25,5,9,25,3,4,22,4,8,51,129,21,27,9,8,16,14,30,18,32,14,22,13,19,10,66,31,6,12,17,8,12,43,35,7,23,19,18,8,10,18,8,3,5,35,14,34,25,9,5,33,8,24,16,1,104,11,47,5,2,5,26,13,6,3,72,7,8,17,12,5,14,17,15,2,4,9,41,8,4,11,33,4,11,14,18,30,3,0,12,10,11,5,5,3,1,22,23,14,54,17,13,37,10,5,36,6,44,11,59,3,5,37,4,31,13,20,3,8,6,26,31,4,4,8,9,13,27,6,4,5,33,47,10,28,8,13,2,67,22,5,7,6,11,42,20,9,21,40,3,5,34,11,18,37,7,45,8,24,12,24,10,14,14,2,57,2,29,7,11,40,7,16,24,5,22,7,17,8,12,7,46,6,15,3,12,9,6,8,4,6,8,4,13,10,7,11,4,12,7,21,11,7,8,14,1,7,11,5,6,11,2,11,12,14,22,3,1,14,7,5,5,16,24,5,19,18,4,8,2,3,25,12,34,8,34,11,15,2,45,14,6,7,10,17,17,29,26,31,7,9,36,5,12,2,20,9,2,5,2,23,6,8,33,12,8,4,3,5,5,15,12,11,3,4,56,43,2,10,18,6,6,26,8,11,13,7,5,7,14,43,4,22,11,4,6,5,7,14,13,17,6,9,6,14,3,18,8,20,8,9,34,6,20,18,11,4,6,8,15,6,7,11,32,29,6,2,6,14,12,14,2,28,13,13,25,9,6,44,6,13,22,8,10,12,14,2,31,4,14,4,11,6,28,35,9,8,20,8,1,7,18,2,6,22,13,15,18,26,10,5,15,6,6,9,22,19,1,6,20,2,4,18,31,14,12,3,4,5,11,21,15,13,13,4,22,21,10,10,59,8,14,23,3,5,10,18,3,36,9,8,2,10,10,18,12,17,17,20,8,1,16,12,5,5,12,6,6,19,4,24,8,5,6,127,21,12,6,4,10,13,36,8,8,17,3,2,22,12,4,8,1,9,6,13,9,4,21,33,48,4,1,6,0,8,3,26,13,7,10,4,7,2,7,13,18,16,10,0,4,10,10,7,14,11,11,4,3,13,5,2,15,6,4,1,4,7,3,13,19,31,17,3,7,6,9,5,1,24,8,11,5,3,8,4,8,7,8,9,5,7,8,8,13,9,12,6,6,10,10,11,18,19,3,17,7,3,14,31,14,10,7,11,4,40,27,13,4,11,10,32,12,13,8,9,16,4,6,19,6,8,14,4,9,7,6,9,10,6,8,9,7,0,7,10,3,24,6,0,16,13,11,5,3,1,3,2,11,22,10,4,4,7,19,5,6,0,23,13,3,4,3,9,2,8,4,7,6,13,4,7,5,13,11,4,23,7,8,2,13,7,4,27,8,4,2,3,3,4,9,4,13,11,3,6,8,16,14,7,2,6,6,8,0,2,16,2,8,0,10,8,5,15,4,10,12,1,12,15,1,1,8,19,14,5,5,13,4,5,27,1,2,2,8,6,8,4,3,5,4,5,7,1,1,15,4,2,9,10,5,2,1,12,3,9,8,6,15,14,22,3,9,13,5,6,8,7,2,14,0,3,4,7,6,15,2,3,8,6,5,9,3,6,5,8,5,10,15,2,10,42,11,13,23,7,2,3,4,4,4,5,2,2,24,5,2,1,2,13,3,26,3,44,1,1,6,5,7,12,8,2,5,3,9,2,12,6,2,12,3,4,8,10,7,3,3,4,5,10,6,9,7,8,1,6
cover,2,8,1,67,4,7,1,12,1,3,4,0,3,27,1,3,3,6,4,1,2,18,15,13,14,12,9,12,7,14,6,89,53,9,24,24,8,7,4,2,7,3,2,3,19,7,23,5,91,21,17,7,4,14,8,2,14,17,8,9,2,2,1,8,19,3,28,4,4,9,33,3,2,0,33,8,16,2,43,20,24,1,6,4,89,11,6,0,22,1,4,3,2,11,16,8,10,5,10,13,9,28,13,7,6,16,4,7,20,5,15,1,6,11,7,17,4,7,38,49,22,21,14,59,3,2,1,1,4,2,9,2,5,31,11,27,2,3,1,6,4,30,13,4,3,43,11,14,5,17,27,3,2,5,2,14,23,5,0,15,28,4,6,1,1,17,4,10,20,7,11,68,14,2,5,0,46,2,3,31,15,7,13,5,5,10,13,14,10,24,2,4,0,3,1,5,23,4,2,12,22,5,0,3,11,3,4,30,5,15,37,7,18,6,12,12,6,8,9,2,6,14,3,9,24,45,27,12,6,13,4,6,15,20,21,13,18,3,2,4,40,15,4,3,8,2,2,13,32,2,7,6,3,10,8,4,3,1,4,18,6,16,16,1,2,32,2,8,10,0,50,9,31,3,3,4,11,24,5,2,37,7,0,6,6,4,27,15,8,1,2,4,5,8,3,3,17,6,7,5,12,31,11,6,8,2,7,2,6,7,2,9,15,3,25,10,15,13,1,3,12,2,18,4,25,8,2,20,1,3,3,7,1,4,1,15,4,3,5,10,2,17,12,1,6,6,21,21,9,8,5,6,1,21,7,2,5,3,3,22,19,5,2,4,1,1,8,1,10,19,2,14,0,8,9,25,3,3,2,6,25,1,25,1,5,32,9,3,21,0,4,4,7,5,10,7,12,3,21,1,4,8,5,2,7,8,7,3,7,5,1,9,1,8,2,5,6,8,6,5,2,3,11,6,1,3,1,7,4,7,6,5,9,9,6,2,2,8,7,0,10,10,5,6,4,0,12,5,14,6,10,3,5,4,18,5,4,1,2,9,9,7,10,15,7,3,10,0,10,0,10,2,1,4,1,7,3,1,7,5,8,3,3,2,1,3,4,3,4,1,32,22,1,1,5,2,1,6,2,2,7,2,2,29,7,14,4,3,7,2,1,0,5,8,5,4,5,4,0,3,2,6,4,13,5,10,15,7,7,11,3,2,2,5,6,5,2,4,19,8,5,3,2,1,5,5,0,8,9,4,9,1,6,37,6,5,18,0,2,4,12,2,7,0,1,5,7,6,16,21,5,6,18,3,1,3,6,3,1,14,6,2,7,10,6,3,3,2,4,4,10,24,6,1,20,15,6,6,13,5,8,2,5,0,4,8,7,11,6,5,11,14,3,2,11,3,9,0,0,0,7,4,2,8,8,2,0,2,3,20,5,9,12,11,8,4,8,6,3,6,3,3,2,11,2,21,6,5,6,43,4,4,4,1,2,9,16,5,4,13,2,3,1,5,2,1,4,2,1,3,16,4,13,6,11,1,3,5,1,2,2,20,9,3,2,3,2,5,1,4,5,5,4,11,5,3,8,1,5,4,14,3,5,8,5,3,7,2,4,3,1,6,2,9,12,8,5,2,3,7,2,2,2,13,0,6,3,1,6,6,5,5,5,2,2,10,9,2,12,2,5,1,4,6,6,1,14,4,0,5,6,8,22,23,12,6,1,9,6,13,15,4,4,8,23,9,9,2,9,6,5,6,3,5,3,8,3,2,4,1,2,1,8,0,6,6,2,2,0,9,3,7,4,2,9,4,12,4,2,2,3,1,5,0,3,0,3,4,7,2,3,4,0,4,2,0,2,6,2,7,1,5,0,3,5,0,4,1,2,3,6,3,1,0,5,1,4,7,5,5,2,5,2,0,2,5,6,7,2,6,5,20,4,3,2,2,1,15,2,1,2,1,4,1,2,3,17,5,4,15,8,0,4,1,0,2,1,3,3,0,0,4,1,3,5,0,4,5,0,3,4,11,2,0,2,2,2,4,3,2,5,1,3,2,1,1,1,7,3,9,7,17,3,14,4,2,1,8,1,1,1,2,6,3,1,1,1,1,1,7,2,8,4,2,4,4,3,10,1,10,0,1,18,0,7,12,4,24,20,1,5,0,2,4,6,8,21,0,9,0,23,3,2,5,1,13,2,16,1,0,4,0,3,4,0,2,4,0,4,3,23,4,0,4,1,2,3,5,2,6,0,2,3,1,1,8,7,0,0,3
labor,10,21,25,221,6,19,12,117,5,2,19,29,15,159,6,37,8,67,8,3,8,64,41,67,132,44,21,27,11,30,5,309,301,18,143,120,35,15,69,11,28,22,11,13,69,28,24,30,473,30,66,25,56,92,104,7,82,75,9,46,54,6,9,42,43,22,179,25,30,35,24,6,12,11,332,27,49,12,127,73,165,20,21,22,399,36,42,2,57,5,17,27,13,30,142,20,30,19,46,117,26,51,54,30,32,79,8,3,15,9,42,11,23,34,11,51,8,11,142,320,108,42,29,112,20,5,14,13,7,2,21,8,30,118,44,285,26,10,13,18,32,113,47,10,10,138,25,51,36,36,131,12,56,17,22,85,85,11,10,39,47,5,24,4,3,29,9,42,77,32,31,219,80,3,16,14,381,10,29,143,90,16,8,55,14,107,118,44,109,78,2,21,63,2,1,15,32,17,16,35,155,17,5,12,31,20,1,73,27,55,187,16,32,22,0,3,3,3,28,4,14,55,18,45,76,261,62,106,11,13,28,23,50,31,74,37,76,38,59,32,146,89,19,14,77,13,9,79,96,12,19,114,32,10,16,27,11,7,11,57,68,39,21,6,24,155,25,12,45,17,233,10,36,15,17,10,47,12,14,19,125,39,21,54,25,7,27,15,37,5,9,7,23,12,5,8,68,17,7,96,67,38,6,4,60,11,84,19,63,13,8,79,62,16,98,44,44,88,242,22,74,19,78,36,224,12,111,39,4,62,2,35,57,15,23,24,38,17,7,30,18,6,37,30,7,13,79,74,42,37,36,16,8,83,60,16,5,22,48,76,79,31,35,32,9,3,47,36,22,36,11,44,10,48,95,59,18,28,56,11,143,18,112,35,44,55,19,66,52,15,59,8,25,15,41,18,82,6,93,11,27,4,11,14,11,41,29,2,62,19,17,11,23,57,15,10,7,32,8,2,54,19,31,13,21,9,17,58,6,27,7,6,4,15,23,3,0,4,7,24,44,69,11,22,3,2,18,23,230,19,27,12,9,15,86,19,4,12,63,60,45,47,92,159,28,14,59,22,11,7,77,16,11,8,5,126,8,31,55,12,21,24,5,13,28,11,40,4,44,6,66,44,9,8,33,14,13,33,20,33,32,9,10,3,31,29,45,53,35,20,12,17,14,22,34,19,12,37,48,18,12,67,15,40,12,14,49,100,31,82,32,26,19,44,22,20,12,35,110,66,12,15,56,75,44,16,10,42,31,25,37,5,23,104,88,29,139,10,19,16,27,6,40,13,31,29,29,18,59,121,10,10,18,17,17,9,32,12,13,39,43,33,47,44,25,27,18,21,13,31,57,68,20,20,1,47,37,115,32,41,27,10,9,3,8,28,14,34,21,7,65,75,29,15,80,12,24,19,15,13,22,4,7,20,8,25,7,17,15,49,33,45,98,61,84,24,73,16,18,50,92,24,59,35,15,40,78,12,26,182,80,19,14,10,10,40,49,71,35,34,11,6,23,22,15,2,8,34,19,13,47,27,15,76,51,27,12,8,6,11,20,59,34,17,11,25,17,21,10,9,24,23,18,15,11,28,20,4,26,17,16,13,10,25,23,19,32,7,12,9,4,8,13,35,38,12,5,10,16,19,15,20,8,22,15,16,26,26,6,49,11,31,11,15,10,3,8,8,41,30,36,8,8,13,11,9,26,27,13,33,13,7,3,21,12,19,19,22,11,18,20,42,5,4,41,62,38,15,70,18,25,21,31,38,6,49,19,56,14,17,13,19,27,24,40,22,12,5,11,24,16,44,28,16,43,35,27,18,5,2,11,9,33,18,9,17,9,11,39,11,19,2,5,14,12,9,11,12,7,23,6,6,28,45,12,8,15,8,6,10,36,5,18,3,14,22,8,75,15,12,6,15,7,26,20,48,12,16,8,37,42,49,21,15,11,7,43,14,6,7,6,25,11,23,14,10,12,3,11,20,68,15,9,27,19,13,2,2,30,3,11,13,3,5,32,10,8,15,4,8,4,13,0,9,7,4,8,2,3,1,18,3,7,15,2,1,6,24,12,34,9,5,15,13,14,4,9,10,16,5,8,17,7,30,8,7,7,3,10,6,14,2,10,9,7,7,15,13,2,37,6,18,5,7,20,25,30,12,32,10,0,5,8,5,5,5,3,8,22,2,2,9,20,19,5,6,11,3,20,2,11,9,16,17,6,3,5,17,40,9,12,10,5,22,15,18,31,5,12,1,21,14,9,4,7,15,23,9,10,7
soil,0,6,7,43,2,4,2,26,0,6,11,11,3,37,5,6,1,10,0,5,1,16,8,14,12,1,5,5,2,6,3,89,80,6,20,30,12,6,12,3,7,7,4,1,11,7,0,3,134,3,32,4,22,12,13,3,18,25,0,19,6,0,3,5,17,1,67,0,6,8,6,4,5,3,44,10,31,5,31,13,26,2,11,3,64,17,12,0,25,0,1,3,0,7,20,1,15,8,12,17,10,12,12,7,6,15,1,4,11,2,16,6,5,4,0,19,0,1,9,117,32,11,2,46,7,1,5,0,2,1,14,2,7,17,11,35,6,1,1,4,4,28,8,3,3,31,21,30,8,2,27,5,11,7,10,15,24,3,7,13,5,10,9,0,1,10,4,7,23,10,9,55,9,4,2,6,70,2,4,19,19,14,6,10,9,1,18,18,17,20,0,7,23,0,1,1,4,1,3,12,19,0,1,2,9,0,8,21,4,15,36,4,13,10,2,0,1,2,7,2,1,12,1,10,13,21,26,13,8,9,5,11,5,8,18,4,26,19,18,3,30,37,4,4,14,3,4,14,10,3,3,35,10,1,6,11,5,1,0,11,0,12,8,0,2,41,8,5,13,0,58,2,7,0,4,0,18,2,9,2,33,2,4,10,21,5,7,8,7,1,1,0,0,1,0,3,10,2,1,10,13,9,0,0,6,2,17,7,15,9,1,8,5,3,26,5,7,24,9,5,30,4,28,10,48,17,8,10,4,7,0,11,4,5,2,6,7,4,0,3,4,8,4,5,7,5,18,25,14,2,2,0,3,37,19,2,3,2,10,15,15,9,6,11,5,1,13,5,1,7,1,14,1,12,6,4,4,5,15,10,21,0,24,7,2,60,8,13,22,1,7,2,1,1,12,8,16,2,9,4,7,3,0,2,2,11,9,1,7,10,0,7,12,8,14,8,1,12,1,1,4,6,6,1,3,2,4,5,4,10,1,1,0,2,1,0,0,0,1,5,13,8,3,3,0,2,4,6,15,5,8,0,1,7,21,0,0,1,11,12,4,18,23,23,7,0,11,11,12,1,15,4,1,3,0,21,3,7,9,3,16,9,1,2,2,0,3,1,4,0,20,10,0,3,5,3,3,6,8,5,5,5,2,0,1,9,19,8,5,5,2,2,3,4,8,8,2,10,0,3,9,24,3,12,7,3,14,2,9,21,1,6,2,5,3,4,3,8,44,20,4,1,1,26,15,5,5,9,8,2,16,0,2,37,0,6,19,2,5,3,10,0,6,2,16,2,9,10,12,18,6,2,8,0,1,2,6,3,5,9,6,3,15,9,10,2,7,4,2,11,12,24,2,15,47,1,4,5,6,7,13,4,5,0,1,17,3,3,10,13,16,1,1,6,13,9,19,1,3,4,6,4,1,5,1,9,1,2,3,13,4,11,28,18,0,0,5,5,1,8,6,2,2,18,5,14,5,0,2,69,16,3,6,0,2,6,15,15,6,7,1,4,3,3,1,0,0,10,1,3,11,9,18,4,21,1,1,0,0,5,0,19,4,3,7,0,7,3,2,4,4,8,6,1,2,2,11,2,2,3,10,1,6,3,1,10,8,1,1,1,3,0,8,3,13,3,0,2,4,3,3,3,2,4,2,8,5,4,2,7,2,12,10,2,8,0,2,7,30,17,11,6,0,4,5,1,6,8,2,6,7,0,0,0,0,8,3,10,2,5,5,7,1,2,16,23,11,7,42,5,0,13,3,8,3,16,4,0,17,8,12,4,4,8,11,4,2,8,2,12,3,0,0,4,7,11,0,1,3,1,4,2,4,5,4,0,3,9,3,1,11,4,6,2,5,0,2,6,1,10,0,1,0,5,3,5,2,1,2,0,2,2,8,3,12,6,2,16,7,5,3,2,0,1,4,7,3,1,0,14,8,8,0,2,4,4,3,12,4,2,1,6,0,2,0,7,21,0,8,1,12,4,3,10,2,7,0,1,3,0,0,1,2,2,12,0,3,5,2,1,1,16,1,0,5,2,5,0,4,3,0,4,1,5,0,0,0,6,1,7,2,2,3,1,4,1,0,1,1,0,3,1,2,7,0,2,1,1,1,1,7,0,1,4,3,4,4,9,1,17,1,7,3,1,6,0,12,4,5,1,0,1,4,0,5,1,0,4,5,8,9,9,2,1,0,2,6,1,2,2,5,2,4,3,1,0,1,0,2,0,0,11,3,2,2,1,4,1,4,0,3,5,1,0,0,2,0,7,2,0
standard,0,3,1,52,5,5,2,19,0,7,13,5,4,50,3,6,3,7,1,1,2,22,10,23,13,6,9,11,2,9,0,96,83,8,59,39,16,1,19,5,1,7,1,4,17,11,12,14,69,17,25,11,14,39,35,5,68,2,5,17,1,4,3,9,17,1,50,37,6,14,7,0,6,3,105,13,16,2,44,15,60,3,4,5,122,39,13,0,7,0,1,5,6,1,43,26,7,0,20,20,9,9,17,5,21,5,9,2,10,1,23,4,18,12,11,16,1,7,37,110,29,23,10,42,6,3,2,0,2,4,20,3,17,37,21,17,5,1,2,5,3,39,9,1,1,40,3,20,9,4,39,6,5,8,20,18,24,4,5,14,14,2,8,2,9,8,9,18,16,5,10,73,19,1,3,7,47,5,3,34,22,10,8,21,3,17,24,10,24,19,5,0,10,1,6,9,10,12,5,12,52,2,4,5,27,1,3,25,3,7,56,5,8,51,3,4,1,0,7,6,0,25,3,11,36,62,16,24,7,4,10,8,17,12,26,55,17,6,9,12,31,25,7,6,15,4,4,41,20,4,5,28,8,13,7,6,3,1,2,15,8,7,6,1,11,5,14,8,10,0,74,6,22,13,1,7,17,8,2,2,46,3,4,11,13,3,7,4,6,1,0,2,3,5,1,8,16,2,3,26,10,12,0,0,4,2,22,0,18,7,2,13,29,15,28,6,16,24,7,12,16,1,19,22,28,3,13,13,3,27,1,15,10,3,9,4,18,2,6,4,2,2,6,1,5,6,9,16,9,13,6,20,15,24,4,1,1,8,7,24,32,12,17,13,7,3,12,6,8,12,2,21,8,21,2,16,10,3,25,2,53,1,22,20,3,7,0,14,4,4,15,6,2,0,14,6,16,2,10,4,15,4,13,1,2,10,6,0,22,7,23,4,1,4,0,1,0,8,5,2,15,8,10,5,11,3,1,19,4,12,7,1,0,0,8,2,0,0,2,2,4,26,2,12,1,1,20,2,6,3,12,2,2,2,28,7,1,5,8,12,16,33,38,57,8,5,10,4,7,4,24,4,6,6,7,77,3,3,24,10,13,8,2,2,8,3,4,6,0,0,27,19,0,2,12,3,0,8,0,2,19,3,1,0,14,14,9,14,13,0,12,1,1,8,13,6,1,1,19,9,1,8,8,14,3,4,12,13,5,17,12,8,1,16,4,3,8,13,32,22,1,3,5,15,11,0,0,29,14,6,19,0,10,30,4,9,13,4,3,5,13,1,3,3,4,8,19,5,20,29,11,2,4,2,6,4,15,2,6,5,10,2,12,21,5,33,2,12,7,14,32,25,4,6,37,4,1,14,3,11,18,2,2,0,2,8,1,9,6,10,14,6,9,10,24,6,13,19,4,2,6,11,1,10,0,2,1,6,19,34,30,3,20,22,3,7,12,6,2,8,32,6,8,10,1,2,7,2,6,33,7,2,3,1,9,10,17,18,1,5,1,3,1,5,2,0,0,2,1,4,5,10,1,16,4,2,0,2,0,2,1,13,2,9,2,3,3,5,0,4,6,9,5,5,1,2,3,0,16,3,0,10,0,4,3,9,6,1,2,0,0,1,9,19,10,17,2,8,3,9,3,15,5,13,5,2,6,4,13,7,9,4,5,10,2,3,13,5,3,14,20,1,3,13,4,4,14,7,5,8,1,1,0,0,6,4,2,6,1,21,23,9,0,9,4,35,6,4,7,0,2,1,73,4,2,8,6,5,1,3,0,3,5,7,6,5,13,0,13,7,3,2,2,8,19,9,7,1,0,0,4,0,9,0,2,1,4,1,5,4,5,1,0,5,1,2,5,0,3,9,1,3,3,5,2,1,7,0,11,1,1,1,9,2,1,10,1,12,7,1,0,1,7,14,5,5,2,8,3,2,6,5,1,11,3,2,10,5,5,5,2,0,9,2,4,2,0,0,2,4,2,0,8,35,2,3,0,5,3,1,1,1,0,0,0,3,2,4,1,4,1,0,2,2,2,0,0,2,7,4,1,4,0,8,6,0,0,6,2,10,5,2,1,2,8,0,2,0,1,0,3,5,1,25,1,1,0,2,1,1,2,3,0,6,1,0,1,3,2,9,4,15,0,1,4,12,11,2,14,1,2,4,3,2,1,1,0,4,3,0,2,0,1,3,0,9,0,1,1,2,11,4,20,4,0,2,3,4,0,1,4,4,4,31,4,1,2,12,0,1,6,3,1,0,2,11,11,0,8,1
wage,2,2,3,44,2,12,4,12,0,2,3,3,7,34,0,3,9,3,4,3,1,10,15,13,12,8,16,12,4,10,4,119,88,10,48,25,15,19,78,1,4,11,0,5,21,7,9,2,43,13,35,4,27,28,15,4,22,20,13,12,4,3,4,6,16,2,70,20,14,10,27,0,1,3,64,2,14,2,41,14,142,24,5,8,69,12,20,0,10,2,10,7,20,16,29,40,12,7,20,46,5,8,9,8,12,8,20,4,7,3,14,4,28,14,17,23,0,5,22,95,16,17,22,71,4,0,6,3,2,5,5,0,13,26,11,90,6,8,1,10,5,25,18,0,1,24,4,14,13,5,43,5,14,4,2,21,17,1,2,13,28,3,14,5,3,13,4,13,15,5,6,52,19,3,2,4,51,1,2,28,21,7,13,14,0,25,29,9,13,14,2,0,38,4,1,7,9,6,7,5,60,11,4,7,36,4,1,26,8,17,51,3,5,30,1,18,0,5,3,0,2,10,6,4,21,44,16,30,3,10,6,7,34,14,30,21,21,8,29,1,47,25,12,6,20,6,0,17,31,5,5,21,13,3,4,14,2,5,3,17,27,10,1,0,3,11,5,6,22,4,49,7,27,6,1,3,13,7,0,1,28,3,12,15,7,3,7,1,10,5,4,2,6,4,0,5,17,2,5,11,11,15,3,1,6,7,7,3,14,9,0,11,11,7,53,15,35,33,24,6,15,1,33,5,17,1,11,12,6,16,0,11,12,2,10,0,17,3,3,8,4,5,18,4,1,4,11,28,4,25,6,4,2,21,18,3,5,2,7,23,20,13,5,14,3,5,6,9,5,20,2,16,7,11,13,17,5,26,8,2,28,1,32,7,15,13,3,20,19,10,4,2,3,1,7,8,15,2,13,4,2,1,0,8,5,7,3,0,8,9,2,4,8,12,0,2,3,0,1,1,7,4,15,3,1,4,9,6,5,5,2,4,0,3,3,2,0,0,11,7,6,15,5,6,1,0,10,8,28,4,14,2,3,2,14,4,0,2,6,18,12,14,19,24,8,0,33,13,0,5,25,2,9,4,1,21,4,6,20,5,9,5,0,2,3,5,14,1,1,1,32,19,3,2,10,1,7,1,5,7,8,1,3,6,5,10,10,5,9,1,6,1,1,4,18,4,3,2,7,7,0,3,4,6,2,0,11,6,2,21,4,6,3,5,5,1,2,11,17,32,2,0,3,17,24,3,0,9,1,1,5,0,0,14,2,4,13,5,2,3,7,3,3,3,3,7,2,14,10,26,7,5,3,4,3,3,40,2,4,19,20,6,10,19,4,7,10,6,3,5,13,9,18,6,115,5,14,1,2,5,13,1,7,0,1,9,4,10,6,2,26,13,1,3,19,2,2,13,2,1,9,5,5,3,0,0,0,10,5,11,10,4,19,4,5,3,3,1,0,14,12,3,3,13,0,2,29,3,4,17,5,4,5,1,4,4,17,8,4,10,1,4,0,0,0,0,0,3,7,3,4,7,8,3,4,3,1,1,1,7,1,12,0,2,3,1,5,8,0,1,3,10,7,0,0,2,6,1,9,1,3,2,0,1,6,2,5,4,3,0,1,1,4,23,9,17,3,0,8,6,1,3,2,5,4,1,12,7,1,6,2,7,8,4,0,0,6,3,7,3,15,2,0,7,1,1,4,9,4,4,0,0,0,1,7,10,5,9,3,23,32,11,0,8,7,17,2,10,18,2,5,3,24,6,8,4,2,16,3,6,1,0,1,3,9,5,8,3,3,2,2,4,2,2,19,12,8,0,5,1,3,1,6,1,3,2,5,4,4,3,9,1,0,3,8,1,1,4,1,8,2,0,0,10,3,4,4,1,3,3,10,0,2,4,3,9,0,13,2,4,0,1,1,3,9,0,7,7,2,7,8,11,1,1,1,0,5,1,1,4,2,4,0,5,3,1,3,0,11,7,6,2,0,11,2,7,0,0,2,2,0,1,2,1,5,1,1,2,1,13,5,2,0,6,0,4,0,4,2,4,2,0,0,1,3,1,1,2,6,9,2,0,2,0,0,3,2,2,13,1,1,7,1,12,2,0,0,2,9,5,6,4,5,4,1,2,2,3,3,9,7,11,1,0,5,8,3,6,4,5,3,3,2,5,2,0,2,0,3,3,2,1,2,11,3,2,1,2,2,1,3,1,15,8,3,1,2,1,2,1,1,0,2,10,2,4,5,9,0,1,1,6,0,3,4,13,41,0,1,1
treaty,67,99,17,541,38,6,31,52,26,9,225,90,23,254,3,27,34,35,10,12,13,148,5,97,93,49,23,32,6,44,41,776,434,17,142,179,219,19,5,19,4,19,24,13,112,87,88,30,1837,112,200,15,13,100,6,23,261,73,1,49,140,49,5,107,41,17,191,6,63,71,18,17,4,24,89,37,45,16,238,73,78,0,76,16,999,20,25,0,222,16,35,14,2,126,202,3,76,1,111,26,86,91,157,19,30,86,25,4,37,10,63,13,0,31,1,116,63,23,291,466,122,106,16,167,8,25,8,14,16,6,30,4,2,146,48,64,53,11,12,11,0,121,181,10,19,236,20,62,24,38,223,9,56,12,4,53,58,13,59,11,9,2,7,10,0,15,6,81,38,27,124,242,50,1,9,50,624,2,27,40,77,45,6,60,6,41,59,87,279,430,1,12,27,2,3,9,13,9,19,13,15,0,2,101,95,21,11,29,61,82,287,10,99,16,0,4,3,1,21,14,7,59,32,67,147,218,51,71,4,11,37,62,17,74,61,50,129,20,20,34,243,91,19,16,48,7,30,22,225,15,41,52,82,18,26,50,48,7,36,41,1,82,174,64,11,70,4,2,72,18,437,19,81,8,9,0,72,11,78,8,122,10,8,59,30,7,2,19,49,2,54,105,33,23,16,37,245,52,42,57,111,107,1,11,36,1,106,12,7,4,12,15,94,17,130,35,34,169,18,9,337,14,72,8,383,39,4,88,27,72,13,19,29,10,20,64,70,62,6,54,39,42,24,68,8,26,169,338,22,16,48,43,24,72,131,2,15,14,65,67,44,15,17,47,16,0,144,26,15,28,5,30,26,16,7,34,36,0,75,29,291,33,153,62,1,100,52,100,97,2,107,14,42,328,170,22,339,7,107,17,163,6,17,2,12,12,25,43,122,28,17,24,14,24,46,41,142,44,12,7,10,23,68,37,0,11,9,67,44,82,14,44,30,96,16,28,10,187,28,15,79,120,27,65,9,29,19,28,85,18,58,58,6,25,352,42,0,81,10,166,32,84,115,15,9,7,21,91,27,2,36,4,11,0,12,5,17,48,42,4,8,61,17,24,31,79,19,15,30,14,252,123,5,7,11,41,5,71,25,10,37,5,5,2,28,13,3,59,25,1,7,17,50,25,25,61,19,12,0,36,19,114,36,92,26,35,86,1,118,103,19,3,7,33,66,34,50,16,151,17,28,22,4,0,18,74,35,69,138,19,42,51,26,153,17,26,219,4,32,26,123,13,169,14,64,35,49,28,140,192,40,36,68,21,21,35,35,22,13,72,4,54,42,50,16,40,17,31,23,14,100,125,31,13,32,6,3,2,1,84,111,8,22,216,83,73,17,131,23,22,100,104,105,32,147,47,69,16,25,19,12,0,4,43,6,18,29,21,41,114,18,65,77,85,41,18,11,22,3,43,17,7,16,67,61,63,8,45,10,1430,143,25,27,24,57,65,134,87,44,118,15,61,187,284,242,230,69,54,74,60,60,20,471,77,284,26,8,40,138,47,83,141,63,25,50,26,95,21,17,77,113,27,74,61,32,53,53,79,52,61,125,37,53,24,15,30,72,21,8,42,11,90,31,83,95,66,39,56,52,5,35,32,53,54,4,65,28,2,6,27,6,51,5,12,36,9,32,11,270,27,44,45,21,33,62,6,30,19,12,38,11,11,4,74,18,38,32,51,19,25,28,34,39,21,103,14,39,8,13,85,14,28,2,67,25,48,2,2,95,42,77,17,38,5,41,18,17,194,16,51,54,13,10,23,18,45,11,56,18,19,26,21,82,40,3,4,11,32,82,35,32,87,95,65,40,68,15,74,32,43,42,7,62,42,14,38,3,48,13,29,25,33,5,11,16,25,48,121,54,23,61,16,3,76,21,42,19,73,28,89,165,108,46,22,2,11,24,17,58,6,57,32,29,9,15,33,8,33,23,43,1,28,15,5,30,13,101,112,80,65,79,65,22,76,168,51,33,32,30,26,54,102,0,26,63,98,49,8,25,6,23,68,14,25,7,45,75,150,36,100,6,14,40,62,55,38,10,114,9,14,56,77,18,134,32,65,75,208,45,4,49,12,29,34,18,6,8,20,24,13,10,29,2,9,10,78,21,18,44,40,0,9,7,5,30,18,22,41,78,35,12,43,24,14,7,128,14,1,9,31,9,53,19,10,48,44,0,34,19,44,2,26,33,1,35,6,45,4,168,2,8,6,10,8,0,3,0,30,2,2
desire,7,20,10,206,25,4,8,55,5,5,39,13,9,129,4,26,15,29,17,16,12,66,21,45,38,26,14,20,10,19,23,313,204,12,100,148,120,10,9,8,9,22,5,10,53,27,65,24,463,40,85,11,25,79,20,18,67,36,1,28,36,24,7,25,46,12,209,8,15,14,15,7,9,5,184,29,31,6,117,64,61,2,23,10,368,29,32,1,44,2,6,12,0,40,108,9,29,9,56,27,7,53,57,21,18,34,15,2,10,5,32,11,15,24,1,34,7,8,86,252,78,29,10,56,16,2,10,11,5,0,14,8,17,70,41,51,26,3,7,8,6,58,45,1,5,98,13,26,27,24,113,3,30,11,1,22,51,6,22,21,11,8,19,3,2,4,7,41,31,14,19,123,57,2,3,15,266,4,22,75,48,21,4,41,8,40,83,50,77,89,2,13,4,4,3,4,38,9,7,29,52,7,2,31,57,20,9,40,25,65,133,5,29,13,1,0,4,1,12,11,6,29,12,27,60,167,50,39,3,10,21,13,22,43,58,44,53,17,10,19,105,55,8,15,44,15,15,56,67,12,26,27,56,10,8,25,17,1,6,18,4,39,36,4,14,39,17,15,37,11,276,13,41,10,6,2,30,21,26,16,115,19,9,31,8,4,6,8,33,9,8,3,19,7,0,14,76,11,10,40,40,46,2,7,22,4,58,7,21,4,4,16,26,7,31,17,34,69,15,7,69,26,52,3,118,10,11,47,10,50,11,17,25,17,16,21,52,9,7,8,30,23,18,16,7,12,78,99,28,10,26,15,11,55,35,9,12,17,34,50,38,10,30,41,9,3,69,17,23,18,4,31,6,16,14,34,11,7,40,18,141,5,80,29,4,38,11,50,48,11,63,3,18,17,64,26,103,6,51,2,32,3,9,2,13,10,10,18,47,24,9,32,9,31,41,14,9,24,10,2,11,20,32,26,3,11,7,25,25,25,25,8,0,19,6,14,0,37,10,7,22,37,18,34,4,2,16,13,71,6,23,11,2,10,96,20,3,10,16,30,20,34,68,31,9,10,35,27,11,0,21,15,6,2,7,35,9,22,46,17,5,35,22,11,21,17,19,3,21,8,135,56,3,10,10,6,5,22,13,19,23,10,7,9,12,52,2,31,4,3,8,11,16,11,26,31,12,24,11,16,14,29,12,26,9,5,42,20,33,35,26,9,5,24,18,9,20,41,64,34,13,5,2,0,11,15,15,38,15,20,45,9,10,67,9,19,53,7,14,21,49,2,36,6,27,26,21,14,62,71,12,20,17,7,17,22,22,10,9,21,6,28,31,37,25,22,14,16,7,26,52,73,14,5,41,7,11,5,84,1,38,5,13,17,15,39,9,59,27,8,35,31,17,18,60,13,38,8,23,12,26,40,7,46,4,18,7,19,37,42,18,29,54,38,10,10,17,10,3,10,26,7,14,17,17,44,10,17,9,295,47,14,12,14,12,14,73,40,20,38,10,12,20,41,25,15,4,14,24,19,30,18,79,30,43,18,6,12,5,10,8,41,25,12,19,7,21,9,5,12,18,28,24,18,12,8,16,7,17,29,29,9,10,9,9,16,31,18,12,10,21,7,10,48,34,13,7,21,16,10,8,13,11,28,1,8,12,3,9,15,7,10,2,8,13,3,21,16,57,10,24,8,6,14,20,10,20,16,4,15,6,6,4,9,6,15,9,19,11,13,17,23,1,3,28,15,11,16,6,27,14,4,10,27,5,14,6,5,43,22,12,11,20,9,18,7,12,30,19,31,12,7,5,4,15,42,5,21,9,16,11,11,15,6,13,10,23,19,41,7,6,10,17,6,7,11,7,16,4,17,15,5,13,9,6,8,12,10,13,10,16,14,23,3,15,19,12,52,22,7,16,6,10,13,1,15,10,10,16,26,70,39,16,8,4,6,15,5,10,4,19,13,14,9,9,21,9,5,16,23,2,11,12,20,7,15,18,12,36,17,0,7,5,18,13,11,15,8,10,14,4,13,0,11,15,5,9,2,3,5,12,7,5,32,13,4,8,13,4,48,12,18,18,12,17,3,4,11,13,7,23,17,7,6,8,10,16,33,9,30,7,11,8,7,9,5,12,6,5,12,12,14,1,2,6,16,13,11,42,9,4,2,7,10,12,3,7,8,26,20,8,6,9,5,3,22,9,2,9,15,13,10,14,12,13,9,6,10,9,10,2,9,5,15,21,5,26,6,40,4,4,7,4,2,0,5,3,4,3,4
adopt,11,68,14,359,24,4,7,80,5,6,37,16,15,100,11,19,16,24,10,13,6,71,12,51,36,22,9,16,7,28,19,272,220,10,83,65,88,16,25,9,19,9,3,8,74,42,80,33,593,18,92,11,23,46,11,12,108,61,4,27,38,19,4,34,42,8,169,12,21,18,13,8,6,3,107,42,24,5,133,35,78,5,28,8,418,36,27,2,72,3,11,11,4,49,81,26,41,12,57,29,24,45,75,11,16,43,19,7,22,11,36,10,17,27,4,54,14,7,165,343,73,27,42,129,12,7,10,9,4,8,24,1,8,89,30,56,14,8,10,14,2,61,41,9,6,114,9,20,26,24,117,4,31,14,11,48,40,16,24,19,30,11,22,7,5,8,5,36,36,17,37,141,43,4,6,15,300,7,26,50,52,23,17,23,10,21,63,35,80,87,4,12,16,1,3,4,79,10,12,31,31,4,3,28,51,14,5,104,34,94,124,2,49,11,4,5,6,12,22,10,5,28,14,21,113,168,39,27,6,11,22,22,40,49,53,55,62,19,9,13,144,63,5,4,38,11,16,27,103,7,28,37,37,14,19,43,15,2,9,32,13,42,50,15,12,75,6,9,37,10,247,12,57,12,8,4,29,30,26,16,84,24,7,25,19,7,10,12,30,6,9,17,34,16,3,21,71,17,13,39,44,92,3,4,21,1,41,4,8,3,2,46,48,13,48,27,30,80,23,11,78,13,30,15,128,13,12,40,4,63,21,25,16,14,12,32,35,16,5,27,21,17,26,34,10,7,89,91,30,11,23,21,21,59,33,18,18,13,35,51,53,19,21,35,7,4,70,13,29,17,7,37,13,14,15,44,12,6,37,17,159,5,91,24,7,105,2,51,53,10,48,6,18,28,80,12,145,8,75,4,47,2,10,3,14,8,13,10,32,34,7,13,6,21,21,27,11,10,12,1,10,14,26,24,5,6,13,31,25,32,12,14,5,22,13,7,0,22,27,9,39,55,17,35,3,6,10,7,57,12,23,24,2,12,103,50,1,32,7,82,18,38,64,34,12,5,24,21,26,1,29,5,5,2,10,18,8,28,35,4,12,25,5,7,10,16,30,8,11,15,149,72,1,10,6,11,6,17,11,18,18,10,11,2,24,28,8,30,17,9,7,14,16,23,21,43,13,21,6,15,8,46,22,45,20,9,41,9,46,60,39,13,6,8,28,12,35,12,62,34,12,16,0,5,18,20,3,28,29,18,135,14,17,75,18,20,36,10,17,17,48,9,49,13,45,28,21,17,99,83,19,28,25,12,15,18,11,9,19,30,11,33,17,27,22,21,12,17,8,28,76,64,12,8,27,13,18,13,111,38,1,3,18,18,19,60,15,57,33,12,35,43,22,8,51,19,45,6,25,12,21,5,5,38,6,19,10,27,22,76,21,48,38,49,16,6,15,15,3,9,31,8,13,50,20,55,8,10,15,309,32,16,11,25,7,26,89,34,16,28,21,14,55,48,22,11,13,19,20,23,37,24,78,51,41,18,8,22,9,11,16,58,26,18,24,10,22,9,13,17,24,22,28,17,16,25,16,16,29,30,14,22,9,7,19,14,28,18,8,12,10,13,11,114,31,39,9,21,16,22,11,3,13,40,2,17,12,2,15,22,19,18,15,21,20,5,45,7,79,13,22,12,6,9,12,13,20,20,3,15,26,11,6,19,5,22,23,19,5,14,9,15,12,3,45,34,29,22,11,32,9,8,3,30,10,29,13,4,27,28,13,19,20,3,21,13,8,58,10,24,17,20,8,15,21,50,12,23,6,11,13,10,23,17,8,8,11,11,29,15,18,4,16,15,5,17,11,19,5,37,10,6,40,11,8,14,5,16,18,12,14,9,13,12,11,20,18,45,16,9,12,28,9,12,9,16,9,20,18,14,47,38,27,13,6,8,10,28,9,5,11,7,5,8,13,18,4,14,23,57,5,14,7,25,9,13,11,46,22,6,10,7,10,11,16,14,16,11,5,6,5,32,2,9,16,12,11,12,10,5,12,13,3,23,24,12,12,24,7,47,15,21,11,8,24,14,8,18,12,11,17,12,12,35,9,22,10,38,13,14,16,11,18,17,8,7,8,14,5,45,10,26,15,4,7,20,30,31,45,13,2,10,5,6,17,18,8,5,40,19,15,10,6,16,3,29,13,3,15,11,20,10,12,8,11,10,3,14,16,15,19,8,16,15,9,14,26,8,40,3,3,1,14,1,3,8,7,14,1,1
activity,0,4,3,38,0,3,1,4,0,2,3,2,3,24,1,4,2,2,2,0,1,11,2,6,3,6,2,6,2,1,3,57,39,4,23,23,9,4,16,1,5,3,1,2,2,1,2,23,68,3,9,6,7,17,0,0,8,10,0,6,6,0,2,6,12,3,29,11,2,2,11,4,0,4,39,4,5,2,22,7,34,1,3,5,89,6,8,2,10,2,7,3,0,6,18,9,11,2,22,21,13,11,6,3,9,5,0,0,5,2,5,5,6,2,1,10,1,2,10,36,14,6,6,41,7,1,1,0,2,0,2,2,2,6,4,36,3,2,2,4,0,24,8,3,2,23,0,7,3,5,17,1,6,4,3,28,15,13,3,3,6,5,6,5,18,2,2,13,8,7,3,19,9,1,1,1,30,1,4,21,10,4,9,3,3,9,10,7,2,7,2,1,2,1,6,3,9,5,4,5,28,4,0,4,11,3,5,8,3,14,27,1,4,1,2,2,0,5,13,2,2,3,3,7,16,22,7,9,3,22,7,6,14,14,12,10,12,2,8,3,7,4,1,3,9,9,6,6,21,3,4,4,3,0,5,4,0,1,0,14,1,12,2,0,2,29,7,2,4,6,30,6,7,3,0,2,6,19,1,2,30,3,9,10,8,2,1,3,0,0,0,1,2,4,2,3,6,2,1,6,12,10,1,0,11,0,12,0,4,3,3,17,5,5,10,6,4,16,5,3,7,0,8,4,12,0,5,7,0,7,3,2,4,0,2,4,5,4,5,3,3,2,3,6,5,1,12,8,10,6,1,7,3,12,8,8,1,0,5,10,11,4,5,3,3,0,4,2,2,8,0,15,4,3,2,13,4,2,1,1,21,0,16,5,4,11,1,5,6,1,12,1,3,0,9,1,12,8,11,4,2,2,0,1,5,6,2,1,4,6,1,1,6,4,0,5,0,2,1,0,2,2,9,12,2,6,2,4,2,6,1,0,1,0,2,0,0,0,13,6,4,5,7,7,0,2,2,2,9,0,9,4,3,1,17,1,0,0,4,9,6,7,8,12,1,0,7,4,7,0,7,1,4,0,1,7,3,2,2,2,1,7,2,0,2,3,4,2,3,3,49,13,0,2,3,0,2,14,1,2,3,4,2,0,15,3,4,7,2,3,3,2,1,2,2,4,0,4,4,3,0,2,3,11,2,0,5,4,4,4,1,0,3,3,5,0,2,8,11,9,0,6,1,1,5,3,2,1,6,6,9,1,1,9,5,2,12,2,6,4,9,1,2,2,2,4,4,4,11,13,5,0,5,3,1,1,6,2,4,19,1,4,3,6,1,2,1,2,4,8,6,9,3,2,10,4,2,1,8,5,3,1,2,3,7,3,3,7,1,3,13,23,4,4,3,1,5,2,4,4,6,2,2,8,5,3,2,3,3,8,0,4,5,10,5,0,4,3,2,4,4,0,1,13,3,7,10,0,1,32,3,8,0,0,1,5,3,5,4,4,2,0,1,0,2,2,0,2,8,2,7,2,2,6,3,1,1,3,1,2,1,13,2,3,3,0,6,3,0,3,0,5,3,3,1,8,2,2,2,0,1,0,0,3,3,7,7,2,0,2,1,1,0,12,5,6,3,1,6,6,11,1,4,9,3,1,5,1,0,9,1,6,0,6,0,0,8,3,8,7,8,1,2,6,5,5,4,10,2,0,3,1,7,3,2,3,0,8,6,2,1,1,1,4,5,2,0,2,9,1,1,0,0,3,4,3,8,0,3,4,0,2,3,4,3,3,3,0,1,4,7,3,0,2,10,10,4,1,1,0,0,0,1,0,3,9,1,0,5,0,1,0,9,3,0,1,1,1,0,2,0,0,1,8,4,0,1,1,1,4,6,2,3,0,1,3,3,14,3,2,1,2,1,0,1,0,6,3,3,4,1,11,3,0,3,2,2,2,0,1,1,1,5,7,3,0,1,3,4,2,8,1,4,1,2,0,0,2,0,1,0,1,0,0,3,0,1,2,0,5,1,5,0,1,4,0,4,2,4,3,2,0,1,1,1,0,0,1,0,6,13,2,1,0,3,0,0,2,3,5,1,2,2,0,0,3,0,2,1,0,5,4,2,0,0,0,8,1,4,8,0,4,2,0,2,5,0,9,2,0,3,1,1,5,1,0,0,2,4,1,2,1,1,0,1,9,0,0,0,3,4,2,10,4,2,0,9,2,0,0,2,4,0,0,1,4,1,5,1,0,1,1,2,2,0,2,0,2,5,0
longer,4,10,4,65,7,11,0,15,1,3,7,4,7,55,3,6,8,9,4,6,6,20,15,22,18,9,4,7,3,13,2,64,74,5,26,40,42,5,3,5,7,6,2,4,22,14,14,6,139,22,29,4,6,32,19,4,36,14,2,5,8,7,5,5,19,5,55,4,6,4,9,5,6,0,66,9,12,4,54,6,18,0,8,3,100,15,14,2,17,0,2,4,0,24,16,6,13,5,23,10,5,10,16,12,11,22,2,3,12,11,14,5,4,7,6,26,3,1,25,58,20,12,8,44,6,1,1,4,0,0,8,3,19,22,2,31,2,2,4,5,2,21,17,4,9,39,8,13,9,1,23,3,7,6,4,11,13,3,7,9,4,3,2,4,2,8,4,13,17,6,4,40,12,1,2,5,87,2,2,24,10,9,8,7,2,9,20,7,28,22,1,2,7,3,0,1,11,3,9,6,16,3,0,7,22,6,1,30,5,17,37,4,13,3,6,4,1,4,8,1,1,7,3,13,20,49,11,7,7,6,11,4,4,15,21,10,19,1,0,6,36,26,6,2,11,4,8,7,27,4,7,17,7,0,9,12,4,2,2,10,1,12,8,2,7,10,4,9,7,2,63,7,1,2,3,1,11,2,3,1,38,2,0,9,9,2,8,7,6,3,0,4,7,6,3,2,27,3,0,12,19,19,1,0,6,7,6,2,7,2,3,6,12,6,16,13,11,21,2,4,26,2,22,6,31,1,12,9,3,13,3,8,14,1,2,2,14,4,2,12,4,5,13,2,6,3,44,26,7,13,7,6,3,18,11,2,6,0,7,13,6,5,6,13,3,4,29,8,9,6,2,13,2,6,4,7,5,4,9,5,25,2,31,9,1,25,2,9,18,6,12,1,6,4,7,14,26,3,11,3,6,4,1,4,1,4,7,1,20,6,4,7,2,9,15,9,1,8,3,6,2,2,12,3,0,3,2,10,9,14,5,4,0,2,1,4,0,5,4,2,14,12,0,14,2,1,11,4,31,9,17,3,7,1,27,5,2,4,2,13,8,16,19,10,5,1,19,5,6,2,9,3,0,4,4,11,2,5,12,5,6,6,4,6,7,3,5,5,1,0,49,24,4,3,9,6,2,2,4,4,3,0,0,1,5,18,5,7,6,4,1,4,1,2,7,14,5,8,2,12,9,5,6,9,3,4,10,0,4,15,6,1,5,4,2,4,5,4,27,6,2,0,1,7,11,13,3,10,6,2,11,4,1,25,5,4,9,0,1,5,15,3,3,3,12,14,14,7,20,30,9,4,3,6,4,3,2,3,2,7,3,9,9,6,4,2,2,9,3,7,10,23,4,5,9,5,2,7,22,13,18,2,1,6,6,10,1,18,4,4,18,8,5,7,14,4,12,2,2,0,8,4,2,9,3,6,1,6,7,14,15,11,16,9,2,0,7,4,3,6,4,3,3,16,7,17,2,1,2,83,12,7,7,0,1,11,22,10,5,7,1,5,2,12,5,2,1,6,9,11,13,5,15,7,12,5,1,0,4,5,2,16,9,4,4,0,7,1,0,5,5,6,3,7,2,3,8,2,3,5,6,4,4,4,6,1,9,5,4,3,3,0,10,15,11,8,4,1,2,6,6,1,2,17,0,7,1,4,2,18,0,10,6,3,1,0,9,4,22,5,11,4,3,10,5,2,6,7,4,5,9,2,0,0,0,4,6,8,3,6,7,9,0,1,13,10,5,3,5,7,0,3,3,9,4,9,7,2,4,11,6,4,4,3,5,2,2,5,3,8,4,5,0,3,4,8,0,5,1,3,1,4,4,3,3,1,1,3,6,3,0,2,2,4,6,3,7,3,4,4,2,3,2,0,3,1,1,1,9,5,0,4,15,3,1,7,6,16,6,0,2,1,3,1,1,2,5,1,4,4,12,10,4,3,1,3,3,6,3,0,3,3,2,1,4,7,9,3,4,8,2,1,5,14,6,6,0,2,5,1,2,4,7,6,2,1,3,2,4,0,3,5,9,0,7,2,2,1,1,4,4,1,7,7,8,2,1,6,2,11,2,5,5,0,5,5,1,6,2,3,6,6,0,6,1,4,5,6,2,3,3,2,4,8,3,1,1,6,2,9,3,5,2,2,5,8,5,1,16,3,3,2,4,5,1,4,3,5,4,3,4,6,0,1,0,3,2,0,3,1,12,6,4,3,4,2,0,9,8,4,0,6,4,2,2,3,5,4,11,3,2,2,5,1,1,7,9,2,2,1
ratify,3,17,14,113,1,0,6,19,1,0,41,14,3,29,1,3,4,8,0,4,6,11,1,22,9,6,5,7,3,8,5,79,40,2,20,28,31,5,2,5,0,1,0,3,4,12,24,1,257,14,36,3,3,16,0,3,20,6,0,5,11,2,0,10,4,1,27,1,10,0,2,0,0,2,19,1,9,0,42,10,7,0,8,2,119,2,1,0,32,1,3,2,1,18,27,1,13,1,20,1,4,8,19,2,0,10,0,1,3,2,6,1,0,4,0,9,5,1,41,76,11,7,1,34,2,5,0,6,1,1,1,2,0,29,1,9,4,0,3,1,1,13,28,2,1,25,3,7,3,11,22,1,7,2,0,7,1,6,6,4,0,0,1,0,0,2,0,8,2,5,14,20,8,1,0,8,82,0,0,6,9,4,0,3,0,5,12,11,13,58,1,0,4,1,0,4,0,2,6,4,1,0,0,6,5,2,0,2,7,6,37,1,20,1,0,0,0,0,2,2,1,11,5,10,22,18,5,6,2,1,6,6,5,17,12,8,20,2,1,3,44,5,0,3,9,0,6,0,34,1,3,4,12,0,0,12,8,2,3,2,0,4,28,11,0,16,0,1,5,6,34,0,7,1,0,2,9,3,8,1,17,1,0,3,5,0,0,2,8,0,10,35,6,2,1,4,38,5,3,5,9,10,0,4,4,0,14,1,2,0,1,1,12,3,11,2,2,20,1,1,29,2,11,0,32,3,0,12,0,8,9,1,1,0,3,9,3,7,2,6,4,5,1,6,0,0,18,61,0,1,4,2,1,9,10,0,4,1,2,7,6,2,0,5,5,0,12,2,0,5,1,4,0,1,0,4,7,0,14,3,39,5,17,7,3,14,0,6,14,0,5,1,7,74,15,3,36,0,9,5,20,2,0,1,2,2,1,0,10,3,3,6,2,5,0,5,18,3,1,0,0,0,11,4,0,1,1,6,10,8,1,7,4,15,2,3,0,19,1,4,5,9,6,11,1,1,0,7,15,0,5,12,1,2,25,9,0,11,5,26,6,9,8,0,0,0,4,4,1,0,1,0,2,0,0,0,0,9,5,0,1,11,1,2,3,13,5,3,3,0,35,14,0,0,1,1,0,5,3,1,0,3,2,0,0,2,0,12,4,0,3,2,6,8,2,6,2,5,0,3,1,7,4,6,3,1,5,0,18,13,2,0,1,7,3,7,6,0,15,0,2,8,0,1,3,24,1,1,11,2,44,5,0,21,2,0,11,1,5,4,12,4,19,3,12,3,3,3,11,28,2,7,7,1,0,4,3,2,3,7,0,6,8,4,2,9,1,1,1,1,11,6,5,0,3,0,0,0,216,17,18,3,6,1,15,6,2,32,6,0,13,14,13,3,9,2,6,1,5,1,2,0,0,3,1,2,3,2,7,9,0,7,18,21,6,2,4,4,1,1,0,1,2,16,5,19,0,7,5,164,13,0,4,14,2,7,20,11,14,12,3,4,75,24,45,60,6,9,13,9,7,2,69,7,27,3,1,8,12,3,6,19,22,0,2,0,4,0,5,10,19,1,10,5,3,9,4,23,3,9,7,3,4,1,2,4,5,4,0,18,1,8,3,9,17,15,4,6,16,0,11,6,5,4,0,3,3,0,1,2,0,7,2,0,1,0,1,1,19,5,10,4,3,0,3,1,6,1,1,3,2,2,0,9,1,9,4,11,8,4,4,5,9,2,3,1,10,0,1,12,0,2,0,2,1,2,0,0,17,5,5,2,4,0,7,2,0,37,5,9,6,1,1,3,3,3,0,8,1,3,2,3,6,15,0,0,1,5,6,2,2,4,3,12,5,12,0,6,0,3,7,0,10,3,2,2,0,20,0,6,1,1,2,0,6,5,3,23,5,3,16,26,1,10,1,4,2,19,2,7,27,14,3,3,0,4,2,1,3,2,6,0,1,0,1,3,0,8,0,5,0,3,4,0,5,0,10,18,9,1,7,8,0,3,11,2,4,3,0,2,6,6,0,1,6,11,1,16,5,2,0,11,1,4,10,4,3,38,1,10,0,1,4,3,13,7,0,6,2,2,12,8,1,17,2,9,6,27,8,2,5,2,8,2,2,0,0,3,0,0,2,5,0,2,0,7,2,1,7,4,0,2,2,1,4,3,1,2,15,7,4,1,3,3,1,4,0,0,8,5,0,15,1,0,17,3,0,0,2,6,0,5,3,0,2,1,9,1,23,0,0,1,4,0,0,0,0,2,1,1
pending,4,12,2,136,3,1,1,5,4,1,45,16,4,39,2,3,8,18,3,0,5,18,2,13,20,13,3,5,1,14,9,134,64,3,19,9,23,3,2,0,6,1,5,2,22,15,26,18,258,11,38,4,8,13,2,1,24,17,0,11,29,8,3,11,16,2,32,1,9,7,5,5,1,0,41,6,10,7,64,12,29,0,9,6,181,3,3,0,38,0,13,3,0,24,23,4,24,5,31,7,15,19,24,5,13,16,2,2,12,3,10,4,4,17,0,40,9,4,63,105,16,22,3,51,2,1,0,5,2,1,11,1,2,37,10,27,10,0,4,3,0,32,30,1,4,54,3,10,8,9,34,0,14,3,1,20,13,1,11,1,7,0,3,2,1,3,1,14,9,6,15,60,14,0,0,11,119,2,8,19,19,7,3,14,6,4,23,13,68,73,0,3,3,0,0,2,3,5,6,4,14,0,1,13,15,9,5,4,13,13,38,3,28,4,1,0,1,3,11,8,0,8,1,5,25,51,10,10,2,5,11,13,11,10,11,11,24,5,5,3,53,22,0,2,14,4,2,3,38,4,17,7,30,4,3,5,10,0,0,17,7,13,26,11,2,27,1,1,7,2,85,4,17,3,4,0,9,4,19,5,22,5,2,12,5,2,2,4,4,1,4,11,36,4,2,4,37,5,3,17,17,25,1,2,11,2,10,0,0,0,2,9,20,3,16,7,7,56,7,5,50,1,12,4,61,5,4,12,2,12,2,3,4,3,2,22,17,10,2,4,12,13,6,18,3,3,35,44,12,5,9,7,3,18,21,2,5,2,14,18,29,9,2,10,4,0,31,2,5,3,4,8,8,1,5,8,3,2,8,1,38,0,28,10,2,40,2,10,15,1,23,2,18,39,29,8,56,3,22,3,17,0,3,1,0,4,2,2,14,4,1,5,4,8,25,3,11,7,2,0,2,6,25,9,0,3,0,6,8,12,3,1,2,6,1,4,0,74,8,3,8,17,8,8,2,2,5,6,21,6,6,9,0,1,44,3,0,10,2,19,6,8,14,7,4,4,5,21,11,0,7,2,1,0,4,2,1,11,17,1,1,1,3,6,4,18,8,3,7,0,43,38,2,2,2,3,4,13,6,9,7,4,4,0,8,4,4,5,9,3,2,3,7,1,4,15,7,4,1,5,0,15,3,14,6,0,21,1,12,10,8,0,3,5,11,2,10,3,20,7,1,4,1,3,5,19,4,12,9,4,2,6,8,26,1,3,13,1,4,9,21,13,19,7,11,4,11,6,31,23,6,9,12,4,8,15,13,5,7,11,1,12,6,9,6,1,5,3,2,6,12,20,11,4,8,1,2,1,83,15,19,7,6,15,1,24,9,25,7,2,25,22,10,2,39,6,5,1,6,2,5,0,3,12,5,6,9,10,6,21,11,16,12,12,8,5,7,11,2,3,1,1,9,19,18,21,7,3,6,188,30,4,6,3,2,12,25,18,4,16,5,5,30,31,15,11,15,18,9,9,10,1,52,50,76,4,4,9,5,3,7,11,4,5,6,3,6,2,1,9,11,5,15,20,13,8,4,9,7,15,6,9,8,3,6,7,11,2,4,7,3,13,3,21,8,13,2,8,10,7,3,5,4,6,2,3,6,0,1,1,5,15,1,5,29,4,9,3,26,2,6,7,0,2,9,3,9,10,2,7,10,2,3,15,4,6,6,8,4,13,17,8,10,8,14,7,4,2,4,20,1,2,3,14,2,7,8,1,9,5,2,4,7,2,4,4,0,21,2,7,8,7,7,3,8,17,3,7,2,1,6,6,12,12,1,2,4,3,12,2,7,7,12,11,2,8,2,10,14,4,8,8,4,2,2,0,3,15,0,5,3,3,1,3,3,4,7,20,13,1,12,2,5,15,3,3,3,14,7,11,32,17,7,3,3,4,5,3,5,2,7,3,6,1,2,5,1,5,13,8,3,7,2,5,1,1,10,6,11,4,15,24,2,8,14,5,14,3,6,4,7,8,0,2,16,12,4,5,2,1,8,4,4,11,2,10,17,11,7,15,4,6,2,14,6,7,4,13,2,3,10,27,3,1,2,7,5,31,15,1,2,12,7,6,3,5,2,1,3,10,5,3,3,0,1,13,6,4,8,6,3,3,0,0,0,10,2,6,13,9,8,3,2,7,1,24,3,8,1,8,0,1,5,3,5,4,1,2,5,2,4,6,9,2,3,0,3,1,48,5,3,1,1,0,1,0,1,7,2,0
seem,4,24,20,248,23,4,16,55,9,4,22,14,19,114,12,16,7,34,11,5,18,59,8,46,48,15,25,12,19,20,18,310,231,14,87,94,87,16,30,14,15,12,8,3,64,30,59,34,466,35,70,13,30,56,6,8,130,54,2,21,39,17,3,32,40,12,176,8,15,25,7,14,17,6,122,34,42,13,178,39,64,1,29,12,371,59,35,0,62,12,12,6,0,51,110,18,45,9,50,20,40,49,61,22,21,81,16,7,23,6,37,11,8,21,0,53,7,7,102,444,80,32,20,115,10,6,6,15,5,3,26,6,4,89,30,78,14,5,28,23,3,67,56,11,8,112,12,32,22,31,98,2,38,14,5,47,57,5,19,10,37,11,14,4,2,13,6,38,53,18,29,140,51,4,5,15,315,7,24,68,63,21,1,36,12,40,69,47,87,94,8,11,14,1,7,4,47,9,22,21,44,3,4,25,39,20,20,63,30,49,132,15,39,10,6,8,6,2,28,7,9,36,12,42,84,180,48,59,4,15,28,30,24,47,59,44,67,15,23,21,125,62,22,11,24,16,14,24,72,5,31,38,38,19,20,39,18,5,10,39,14,30,56,7,11,99,3,9,35,10,273,15,54,13,13,2,33,28,26,5,92,15,6,31,27,6,8,19,28,6,8,2,30,10,9,17,84,6,14,26,38,81,3,6,25,8,30,10,9,3,4,25,37,7,72,23,34,72,25,16,66,16,67,7,117,21,12,33,9,54,8,22,17,16,18,21,50,11,7,17,33,23,38,28,11,11,93,97,40,5,28,24,13,87,35,14,16,9,25,45,39,13,27,36,11,3,99,13,18,26,5,22,14,18,18,42,23,17,22,15,116,3,101,34,5,66,16,41,62,5,38,10,24,20,75,20,125,15,52,4,48,4,5,3,10,8,11,5,53,16,8,28,20,40,31,10,8,19,8,7,6,14,43,21,4,13,10,20,24,30,25,17,2,12,7,7,0,18,12,12,23,56,19,25,2,13,21,15,54,14,27,20,3,6,101,18,3,18,4,49,20,25,57,34,8,8,19,26,17,6,36,6,12,9,12,17,9,27,45,21,16,21,11,11,12,13,27,6,12,11,125,74,9,8,21,12,9,31,14,27,24,8,10,1,12,56,13,40,25,8,8,10,8,15,24,41,18,34,5,14,7,41,18,36,17,8,58,3,38,61,27,18,7,18,26,13,34,18,66,42,20,0,2,19,19,16,3,38,24,18,66,8,19,81,12,10,60,8,12,19,64,12,49,13,24,39,35,21,62,69,17,18,30,3,15,22,37,11,22,20,18,26,26,33,25,5,13,26,10,22,42,80,21,8,28,17,8,9,73,39,60,3,10,6,24,1,11,42,12,6,71,19,22,14,57,19,29,2,28,22,34,13,9,58,9,21,14,37,26,46,34,50,52,34,11,8,23,18,10,17,17,8,22,44,14,49,7,7,15,265,57,15,16,10,18,27,76,28,11,27,18,11,17,37,6,6,6,21,20,24,34,18,36,88,31,15,8,23,3,13,17,59,28,25,16,13,30,6,8,36,22,35,34,35,11,26,14,8,18,24,14,16,21,16,18,15,36,16,11,7,12,14,9,81,45,39,20,15,17,10,6,8,7,47,8,23,16,5,4,20,22,23,19,22,14,11,48,9,51,16,26,13,8,17,34,14,27,23,9,14,25,18,7,13,8,16,19,15,9,49,54,22,12,9,19,44,15,22,9,20,6,4,6,33,7,38,3,7,23,23,7,14,25,10,19,18,14,10,14,23,14,21,12,11,22,29,15,9,6,10,14,9,30,10,10,6,18,8,36,20,18,6,26,18,12,16,9,18,12,25,10,9,23,30,13,20,15,12,19,12,9,9,22,5,14,21,25,42,22,9,15,11,16,14,19,23,15,8,21,16,61,44,12,13,8,14,15,12,16,4,7,15,12,5,14,20,9,4,26,36,8,7,36,39,12,17,9,17,18,8,3,17,22,3,8,6,10,7,15,14,8,31,2,10,21,9,15,10,5,4,12,11,8,21,24,0,8,24,9,45,12,8,12,27,23,2,3,19,7,16,17,15,13,18,6,11,11,18,8,17,6,4,10,18,12,15,12,13,7,25,14,18,11,10,22,36,18,22,84,8,8,4,5,6,11,12,4,21,29,10,3,12,5,14,5,27,9,12,5,15,16,10,14,12,7,12,7,15,14,6,16,13,13,15,24,12,14,4,44,8,12,7,9,0,0,9,0,11,5,4
application,8,12,4,102,2,3,1,27,6,0,7,0,9,30,7,5,4,6,2,1,6,18,6,12,16,5,8,8,4,13,5,116,61,12,25,34,15,9,1,3,1,1,2,5,16,11,23,7,168,12,31,2,7,14,1,3,33,9,4,9,8,5,2,8,18,2,41,0,6,7,5,2,4,1,40,6,10,3,33,11,26,0,9,2,132,20,4,0,24,1,11,2,1,19,35,3,7,3,18,6,30,19,24,8,3,15,4,0,16,1,16,3,10,8,1,18,3,4,31,52,26,11,1,40,7,1,5,4,2,0,8,4,4,26,16,42,1,4,4,1,2,24,15,1,5,37,1,5,3,14,58,1,8,4,6,12,11,2,2,7,7,3,2,3,0,3,2,4,10,4,10,47,8,0,6,3,110,1,5,28,3,4,5,9,10,17,19,10,14,25,1,4,2,1,2,1,10,7,4,6,18,0,0,7,8,3,6,17,4,20,53,5,6,4,3,2,1,2,20,1,6,5,2,4,29,51,13,14,4,0,11,11,14,6,13,18,20,12,5,3,46,19,2,3,8,10,3,14,22,2,9,22,14,4,4,10,6,1,1,22,1,13,9,4,10,28,3,8,4,6,63,15,22,3,2,1,4,16,5,4,27,1,1,16,5,0,2,8,5,0,5,3,5,5,2,5,26,1,4,9,10,20,1,1,8,0,11,3,2,0,1,10,23,3,23,19,8,17,6,3,16,2,13,3,26,1,5,14,2,10,4,4,4,1,2,31,15,3,6,6,4,5,12,3,2,4,17,28,18,6,16,3,4,15,11,3,0,1,9,20,13,6,7,6,2,1,19,2,8,10,8,14,0,5,2,21,4,2,9,3,27,0,26,5,3,25,1,7,13,1,12,6,9,4,17,5,51,4,22,2,13,3,2,4,1,3,4,0,5,6,1,4,0,10,3,9,6,2,3,6,3,3,18,7,1,3,2,11,3,7,3,7,1,14,3,3,2,6,9,4,4,7,8,6,2,1,8,3,27,5,8,3,7,0,16,11,5,4,8,18,5,15,11,10,7,3,10,9,3,3,12,3,3,1,4,4,2,8,7,4,1,7,4,4,4,5,4,5,2,5,29,27,0,2,8,4,3,11,3,5,6,2,2,3,9,9,7,11,3,7,2,7,11,7,7,5,1,10,4,6,0,9,8,11,5,4,16,1,14,21,5,3,4,5,8,4,9,2,24,5,1,1,1,13,6,5,1,7,12,2,14,10,4,28,3,5,13,4,0,2,15,2,6,3,11,8,2,0,15,11,9,7,15,1,5,4,12,2,3,15,8,16,7,4,2,3,4,4,3,6,35,24,15,7,14,3,1,4,17,9,15,3,1,2,9,11,1,16,5,5,13,9,9,5,30,3,17,0,4,3,9,1,2,18,2,8,7,6,19,10,1,10,4,5,1,1,9,7,3,2,9,4,1,14,3,13,2,2,1,89,6,2,4,5,7,12,19,7,6,8,2,2,5,4,2,7,3,3,3,4,16,5,16,21,14,3,0,14,1,2,4,14,8,4,6,5,5,4,4,6,11,10,8,14,5,12,5,5,4,11,9,2,5,6,11,4,13,2,0,6,4,5,6,13,6,9,6,10,7,4,7,4,1,16,2,2,7,1,19,7,2,10,3,0,6,3,19,2,31,8,6,4,1,8,5,1,8,7,1,14,11,10,1,4,4,10,8,14,4,4,1,5,6,7,15,7,5,7,15,9,5,0,3,3,2,9,6,2,7,6,1,3,4,2,5,8,5,5,7,7,4,6,2,13,7,6,11,3,2,9,1,3,8,2,7,1,7,2,18,6,5,4,7,8,2,1,7,8,5,3,4,0,0,2,4,4,2,7,3,3,8,6,3,2,8,9,7,11,5,7,4,1,4,5,3,4,2,4,18,3,11,16,3,7,1,3,4,6,3,2,4,3,1,4,4,5,0,2,5,5,13,9,7,0,4,4,2,6,8,5,2,7,2,1,3,2,9,3,2,13,3,4,3,6,1,3,1,1,1,3,5,3,4,4,0,3,0,6,1,11,1,6,1,7,14,7,5,1,4,2,10,2,5,2,3,8,2,11,2,2,3,3,8,3,9,10,4,3,1,9,0,1,11,8,13,15,10,9,19,5,1,1,2,1,10,5,6,1,11,2,6,3,5,0,4,8,2,13,1,4,3,5,3,4,4,2,5,5,5,6,10,6,4,0,5,2,4,4,13,2,5,2,1,2,0,5,1,10,6,3
executive,12,122,75,513,28,8,18,88,8,5,44,18,11,102,19,16,18,16,18,8,6,92,13,68,61,23,23,28,9,23,18,327,203,20,89,84,104,10,1,19,8,16,6,10,71,53,60,59,704,14,163,5,11,53,4,12,221,47,6,29,43,5,3,32,39,20,213,7,29,13,14,8,4,7,159,27,25,8,168,43,68,3,21,6,522,31,24,3,68,5,7,13,9,72,80,8,15,8,71,18,16,48,78,15,23,72,17,5,19,4,49,16,22,36,10,47,19,7,220,372,87,17,14,106,16,6,3,5,5,3,12,6,11,86,50,96,24,3,9,9,4,75,78,7,5,116,12,27,16,34,226,1,29,13,8,79,37,8,48,10,15,7,15,3,5,8,5,45,42,24,19,148,30,5,4,19,391,10,32,49,54,36,13,37,8,29,73,41,106,124,1,9,17,2,1,14,41,10,20,30,46,2,2,27,58,47,11,63,18,52,176,9,66,6,2,3,3,19,66,5,11,30,22,32,112,272,44,39,10,11,19,21,23,89,58,26,61,15,8,6,156,71,12,13,24,10,13,29,86,15,27,25,34,11,25,40,44,7,6,27,21,45,91,9,10,189,5,9,39,15,301,14,32,17,6,5,35,33,27,22,118,12,4,38,9,3,4,10,49,4,11,10,34,9,8,16,61,24,20,32,46,91,1,6,20,3,36,30,9,4,7,32,52,6,40,30,29,84,9,10,73,17,35,8,117,18,15,51,16,79,29,16,27,18,20,33,42,9,3,17,26,19,18,25,9,6,107,131,40,13,25,25,29,48,60,7,27,13,38,58,66,17,14,47,6,5,79,29,30,19,11,27,14,8,36,87,26,3,42,8,177,8,83,29,1,43,28,40,83,5,48,11,87,78,92,39,180,14,98,5,67,1,10,3,9,4,15,1,30,30,13,9,1,28,27,22,24,14,3,0,15,30,55,41,2,15,5,40,29,30,15,10,9,27,9,5,0,40,9,17,24,40,33,17,2,0,6,27,77,9,23,12,3,12,65,41,2,42,8,79,27,32,45,32,9,6,13,24,6,0,15,7,8,2,9,14,10,81,38,10,11,41,5,18,11,47,35,10,5,23,182,81,0,11,13,15,5,29,21,14,19,7,3,2,11,44,3,28,13,23,15,14,8,25,25,64,16,22,9,22,2,12,20,85,27,8,52,14,32,82,19,7,0,20,26,14,18,16,90,48,5,6,6,7,5,24,8,33,32,17,171,22,21,104,37,29,35,14,20,19,63,23,49,11,30,33,17,13,80,66,19,31,48,20,20,11,14,8,11,42,6,57,17,17,16,41,12,18,12,24,65,70,13,11,34,3,9,10,131,59,57,7,18,32,25,42,16,1,31,11,55,54,56,9,88,14,40,5,28,14,19,7,11,50,4,13,12,15,30,80,7,56,50,47,19,11,15,11,4,26,18,2,37,47,16,56,8,16,19,367,33,4,28,20,11,26,87,38,16,20,14,6,27,32,15,40,2,19,22,28,32,17,183,92,77,19,12,15,3,8,17,51,38,23,28,34,22,13,5,16,45,25,35,17,18,14,29,18,52,48,2,7,21,26,114,26,32,25,13,13,20,11,16,67,31,29,9,18,17,30,20,18,23,67,7,18,11,3,16,12,14,39,4,15,5,11,18,7,86,22,16,13,5,18,22,9,43,5,8,13,5,8,2,22,12,30,18,37,8,14,13,26,12,9,31,6,11,22,6,26,10,2,2,36,7,37,6,13,40,23,9,5,20,13,22,12,16,156,11,37,15,18,6,17,10,31,4,25,1,46,10,9,22,17,8,14,20,15,32,18,10,2,13,14,7,12,13,12,6,27,8,7,13,26,2,5,5,39,12,14,15,10,24,15,15,35,18,32,21,20,24,44,14,48,10,9,13,11,20,20,32,128,35,16,14,21,19,6,13,4,14,21,19,28,13,35,8,20,20,39,14,7,12,12,15,10,3,15,43,2,17,12,25,11,14,9,13,25,12,13,6,8,0,9,10,28,4,15,7,2,17,15,8,20,32,5,1,16,16,57,24,13,9,16,32,11,5,5,5,6,20,27,16,16,3,22,2,32,4,13,19,4,14,14,15,4,5,5,16,14,9,15,9,8,6,28,15,15,68,8,2,7,2,15,18,8,2,2,46,17,8,10,20,8,3,22,12,1,18,8,8,16,13,3,17,7,2,34,9,23,2,17,10,6,30,8,22,4,32,3,4,11,18,4,0,10,1,5,0,1
method,0,17,5,115,5,10,7,6,4,7,4,4,13,36,3,10,8,19,4,2,0,14,2,9,29,9,9,11,2,7,5,208,59,11,32,26,19,13,20,2,12,4,3,7,22,14,15,24,133,10,29,1,12,27,1,2,44,42,0,18,8,7,4,14,43,4,63,6,10,12,7,0,3,2,68,7,22,3,54,11,39,1,6,3,159,6,20,0,26,1,3,8,0,17,33,22,12,10,33,16,12,22,25,3,6,19,7,3,17,4,9,7,18,22,0,11,6,3,20,101,37,10,8,47,9,3,5,5,4,5,8,5,4,34,9,59,9,4,5,1,4,32,10,4,5,35,11,12,12,20,40,1,11,4,1,40,28,3,2,12,22,5,7,1,2,13,8,19,14,3,10,71,23,1,5,3,154,4,8,49,21,8,2,17,3,33,28,19,27,34,0,7,14,0,2,5,28,12,5,14,46,4,3,7,23,8,9,48,6,19,73,3,10,8,1,0,3,1,34,10,1,19,3,14,23,100,26,16,5,5,12,10,21,24,32,21,24,15,15,1,48,32,1,7,18,6,9,30,59,4,12,17,10,1,6,14,4,0,1,16,13,22,11,0,3,84,4,5,13,5,84,7,13,3,6,2,9,19,4,5,52,10,2,11,3,4,3,2,9,2,3,2,13,2,2,7,27,5,1,23,12,29,3,0,10,2,17,12,3,2,2,17,27,5,21,13,10,55,12,5,13,8,18,4,55,4,16,21,0,13,4,13,6,7,5,8,10,16,4,2,8,3,4,5,7,7,25,43,7,3,14,6,2,51,14,15,26,7,14,14,25,23,14,17,2,1,24,3,21,6,0,14,7,8,11,49,5,12,5,4,32,4,35,10,0,30,3,12,8,2,9,6,7,11,29,7,45,6,14,7,7,0,4,0,2,7,7,0,16,17,4,12,1,13,6,11,3,3,1,0,2,10,23,15,2,2,6,11,2,18,0,3,0,2,0,3,1,4,2,3,19,12,9,3,1,1,12,5,20,6,10,2,3,4,24,23,1,5,8,35,9,3,33,12,7,4,7,9,9,0,8,3,6,2,10,10,0,8,29,10,4,20,2,3,5,6,20,3,5,12,49,32,0,1,2,4,8,8,5,18,11,5,5,2,8,10,4,9,13,4,2,12,4,13,11,12,3,10,5,3,5,6,8,27,4,2,18,23,17,7,12,4,5,6,36,2,2,9,30,24,6,5,5,10,7,10,3,8,9,3,9,5,11,37,18,21,11,7,6,6,14,4,21,8,10,14,10,6,41,49,11,2,10,5,14,1,4,6,5,11,1,14,8,13,5,5,4,0,3,12,15,16,13,6,21,10,6,6,23,27,33,1,4,6,7,12,5,31,1,6,18,42,16,6,28,6,12,12,8,4,10,4,3,10,6,16,7,12,17,28,8,28,20,12,1,3,15,2,1,9,13,2,5,12,6,21,6,8,15,45,17,6,3,6,2,5,23,7,1,5,7,5,3,6,4,5,14,9,10,5,13,9,2,41,12,4,4,4,1,2,7,34,6,8,10,4,9,5,4,17,8,7,11,2,7,12,5,2,8,6,2,12,5,3,3,2,11,5,3,7,5,6,2,5,8,13,1,3,5,21,2,4,0,31,2,5,7,4,13,4,13,15,5,7,8,10,10,4,11,2,9,3,2,7,6,8,7,23,3,9,9,5,2,4,3,14,5,12,3,14,11,12,6,0,14,21,3,10,19,11,8,3,6,20,5,8,8,4,5,6,0,5,7,8,9,12,8,1,4,12,12,11,3,7,9,13,22,3,6,24,11,6,4,5,4,5,2,3,22,4,8,4,3,5,4,1,6,9,6,6,0,1,15,11,8,1,1,9,0,5,17,4,7,6,7,7,2,14,2,5,0,26,6,4,4,11,2,17,8,6,10,9,7,1,18,5,17,5,7,7,3,5,3,13,7,9,2,11,1,25,18,7,10,11,6,2,2,1,5,2,15,11,3,1,11,8,8,4,1,1,0,7,0,2,2,2,2,2,4,3,11,7,2,0,17,4,0,10,8,17,3,0,3,0,9,5,3,11,3,6,2,8,3,7,4,1,3,3,9,10,6,2,3,1,4,3,4,4,2,20,8,8,5,1,5,12,10,8,14,4,2,1,0,2,4,4,4,5,17,5,4,1,9,11,1,8,8,5,3,0,0,1,7,5,2,3,2,2,6,0,23,7,10,5,2,2,4,2,11,0,1,4,3,0,3,2,1,3,3,1
collect,0,16,3,103,1,2,3,26,0,5,8,8,4,23,2,3,2,5,1,0,0,29,8,11,9,11,2,5,3,11,4,122,74,4,37,22,15,6,12,2,3,2,3,0,17,6,19,14,154,5,21,0,2,4,1,0,112,31,1,7,11,2,0,18,18,4,64,10,4,1,5,15,4,3,37,5,11,0,47,14,58,1,10,2,149,38,13,0,34,7,10,1,0,5,42,19,3,4,14,13,14,13,15,4,3,20,10,4,8,2,10,7,5,8,1,28,10,4,46,85,24,3,50,65,2,1,2,1,5,3,5,2,2,33,10,30,0,0,7,4,3,25,11,1,1,34,10,12,33,20,54,0,7,7,2,14,7,2,3,2,21,0,2,2,4,2,2,7,12,5,20,26,7,0,0,1,91,1,4,16,14,4,1,7,2,13,25,9,14,14,1,1,3,0,2,4,6,0,3,4,16,3,0,12,18,2,3,36,5,14,37,2,10,28,0,0,0,3,10,0,6,3,5,17,43,58,20,34,2,6,10,7,28,9,21,146,10,8,6,4,37,17,10,0,9,3,6,17,26,4,3,31,0,22,21,10,7,4,6,12,3,18,12,2,6,32,6,1,4,9,96,27,75,7,3,0,10,29,8,0,31,4,0,7,8,2,0,6,8,1,5,1,6,7,1,8,36,4,2,8,13,20,0,2,12,0,10,4,1,5,2,9,15,5,57,25,21,24,4,1,23,3,15,0,11,1,0,12,1,7,3,8,4,5,4,6,7,3,6,3,3,7,12,8,2,7,23,37,14,2,15,3,7,36,15,0,3,2,13,29,9,8,1,14,3,0,25,3,7,5,1,18,5,5,3,10,5,8,9,13,29,2,37,2,1,22,2,12,9,0,12,3,5,10,21,9,41,4,23,3,8,7,4,2,1,7,8,0,14,7,0,8,13,7,0,4,4,4,1,0,2,9,11,3,0,5,1,5,5,7,12,7,6,10,0,0,0,5,10,3,7,21,4,3,0,2,4,1,16,11,14,3,0,2,28,8,1,5,7,20,1,14,23,6,1,0,14,4,9,0,5,0,3,0,2,4,3,7,12,10,10,5,1,3,2,3,6,1,3,3,32,17,0,0,2,3,10,13,8,3,5,6,1,2,0,31,0,7,1,3,17,3,7,2,16,14,4,2,2,9,2,13,10,13,8,8,3,4,11,18,4,2,1,11,4,6,2,2,31,10,1,0,2,3,5,0,0,15,5,5,29,5,0,26,0,10,38,3,6,2,13,1,15,2,11,14,3,2,25,9,11,8,16,1,4,4,25,4,2,21,4,14,9,9,4,1,2,4,13,7,8,20,4,5,7,13,10,2,22,8,12,3,4,0,2,6,5,11,6,1,18,4,9,2,18,8,19,0,3,8,9,9,6,15,4,4,3,7,10,25,17,10,13,21,4,1,0,5,1,12,11,0,1,15,4,32,3,3,2,58,3,2,1,3,2,2,28,2,7,13,7,6,5,3,5,2,0,1,9,6,18,9,45,4,11,2,2,8,1,6,1,17,8,4,5,3,9,0,9,16,3,4,21,5,5,2,11,1,26,1,9,3,3,3,8,3,12,4,6,1,3,4,7,14,12,23,2,5,5,2,7,2,3,29,0,11,2,0,2,3,3,11,4,4,3,3,16,1,23,10,6,5,0,10,6,6,15,3,3,4,7,29,16,25,22,9,2,9,1,44,44,4,1,11,24,12,7,0,9,3,2,7,1,4,2,3,8,3,5,1,1,3,8,2,2,5,8,18,7,16,3,6,1,1,2,12,0,3,2,3,3,2,7,8,2,0,2,1,8,6,33,2,23,4,2,1,3,3,0,11,1,16,3,6,0,5,0,0,7,4,10,3,9,6,7,4,0,12,5,19,6,6,0,1,16,5,4,1,3,3,4,15,4,20,3,7,6,6,4,3,12,1,9,1,4,14,10,1,2,4,10,3,13,11,4,3,0,3,5,0,1,2,0,1,3,3,5,6,4,2,0,22,4,0,3,2,3,7,0,0,6,2,6,2,1,1,4,7,21,11,8,15,1,16,8,1,12,10,2,0,5,3,0,30,2,4,0,2,1,18,2,2,4,7,2,6,5,4,1,10,1,22,27,6,33,29,15,13,62,1,0,3,1,1,2,3,8,2,16,0,0,5,1,1,3,9,9,4,1,16,7,0,0,3,5,1,1,4,4,7,4,8,11,11,2,11,7,1,2,0,2,4,2,0,0,5,0,6,2,0
fact,22,69,33,330,14,17,18,59,12,5,43,17,21,170,7,22,18,35,10,7,10,109,32,62,85,27,32,24,28,58,19,389,312,28,118,141,68,18,52,12,17,24,20,8,68,42,60,52,702,54,133,19,39,116,21,5,138,91,14,41,33,17,7,18,60,39,217,22,20,33,37,4,8,17,201,37,57,7,181,66,146,2,27,25,442,51,34,5,80,9,39,10,9,65,95,67,56,18,74,21,31,80,67,28,34,102,23,18,52,19,40,7,27,25,9,80,21,11,182,394,112,57,52,205,24,9,12,12,14,9,46,10,22,80,54,130,29,16,16,22,14,100,78,17,11,185,26,46,50,31,146,5,38,16,16,62,89,21,38,27,45,19,24,9,7,35,12,52,68,16,37,228,62,15,13,27,412,4,21,84,67,18,16,55,6,55,88,68,83,125,19,23,23,7,14,11,39,14,24,29,98,10,9,16,78,29,18,60,20,62,203,21,96,16,10,23,7,16,30,11,9,41,7,38,78,293,131,77,20,33,28,44,32,67,84,46,89,21,30,35,180,90,19,22,26,20,8,54,72,11,20,52,33,30,23,46,32,8,13,54,16,55,41,12,23,100,12,21,36,14,257,13,104,10,6,2,37,50,36,8,103,21,6,44,36,2,17,40,33,7,14,12,39,13,10,17,92,15,19,49,37,53,8,10,31,4,34,20,19,13,4,61,71,12,88,42,50,112,36,16,75,17,66,17,134,13,28,61,10,64,21,27,21,14,22,34,47,17,8,33,23,37,30,35,16,19,116,136,29,29,36,28,16,105,57,18,12,11,36,66,63,7,35,45,5,6,98,39,19,57,10,42,12,34,48,58,22,11,33,12,107,7,82,26,16,116,14,41,56,7,61,9,48,32,101,35,128,15,78,11,55,7,8,4,16,20,32,7,46,20,11,28,26,40,25,13,11,28,13,15,15,30,79,35,6,11,8,39,25,31,41,16,3,36,9,12,3,22,36,21,33,51,25,28,4,11,24,22,98,21,39,8,15,5,109,28,10,35,33,71,31,58,66,97,11,17,48,40,19,2,47,19,10,19,5,49,13,47,45,24,27,33,6,17,10,25,28,16,16,13,163,105,4,10,27,22,16,53,16,46,29,11,14,7,13,40,16,30,15,19,11,22,22,15,29,34,17,27,52,22,11,41,22,73,21,15,72,28,53,73,24,19,12,29,20,10,18,26,103,69,12,8,13,40,26,16,13,51,41,31,52,18,23,89,9,14,69,16,25,10,50,20,38,11,41,32,38,20,68,105,23,6,42,5,18,9,76,29,26,43,16,53,26,44,17,23,17,23,10,27,47,83,22,11,65,16,14,26,100,35,35,13,18,13,25,71,13,55,18,18,1,67,34,16,113,25,31,8,26,7,36,19,7,56,9,16,8,24,37,63,52,69,66,50,16,8,48,19,15,27,19,7,32,37,20,75,13,7,20,424,50,17,22,9,21,16,97,82,21,34,18,13,24,27,15,9,5,24,36,26,40,11,155,94,78,16,6,16,9,22,22,57,41,17,22,27,27,15,9,19,36,26,33,26,19,27,24,10,45,22,11,9,10,23,13,18,25,16,15,8,16,22,22,44,48,76,19,18,18,19,30,26,20,46,9,41,31,9,5,36,17,29,16,15,17,5,41,24,110,14,35,21,9,26,16,8,34,21,11,13,15,20,18,38,26,26,27,9,9,71,86,48,12,18,42,55,24,25,19,27,23,14,11,49,9,37,18,10,15,14,7,8,33,12,34,14,21,112,26,37,7,21,6,16,40,36,26,18,10,8,10,10,27,16,15,11,17,13,40,12,18,21,22,16,11,22,18,25,11,22,9,18,27,47,8,16,9,16,23,7,22,9,20,13,19,22,19,54,32,25,23,13,20,31,16,20,17,22,11,23,56,72,21,17,13,3,26,18,14,8,14,15,23,10,14,17,17,8,17,20,16,19,17,37,21,15,7,21,25,21,11,20,12,10,25,10,11,16,7,19,6,33,4,8,19,17,8,10,9,16,13,17,12,20,22,12,11,19,15,46,12,13,8,34,27,14,11,12,14,11,10,20,12,16,9,12,2,36,9,10,19,6,11,20,7,16,9,8,12,12,9,26,28,11,21,37,18,29,73,8,10,16,6,9,14,9,8,7,26,10,14,13,14,8,13,30,15,7,22,14,12,12,29,11,9,14,8,19,10,13,11,23,22,34,19,16,14,5,62,5,20,16,12,2,5,15,7,15,8,8
commission,15,60,47,441,7,11,22,17,7,2,49,41,16,77,10,21,31,26,2,6,13,48,4,42,59,44,7,14,3,18,9,458,156,9,88,52,34,10,7,1,7,7,13,10,76,22,49,63,448,22,84,13,16,25,3,4,85,234,5,43,25,5,4,26,71,16,94,21,19,36,21,11,6,11,136,31,55,16,141,40,77,2,29,9,385,26,26,1,71,8,20,8,6,55,74,119,39,16,58,36,46,92,50,8,12,58,9,12,20,5,37,11,16,48,7,65,28,5,168,201,52,33,10,111,14,0,9,6,18,10,11,4,7,107,8,217,12,22,13,5,1,57,49,6,1,136,6,26,32,38,169,0,16,8,2,103,52,10,10,12,32,9,23,16,10,12,6,24,31,9,30,135,35,9,1,5,391,10,21,113,40,14,13,60,12,27,49,36,95,105,6,3,10,1,7,9,70,18,26,9,68,4,4,23,19,18,7,96,24,23,192,7,52,12,2,4,3,5,46,12,1,26,7,24,77,288,63,29,5,26,32,41,38,84,49,9,39,7,8,13,84,66,6,15,14,17,16,34,145,7,33,22,47,13,18,21,14,8,7,47,40,36,67,23,12,133,10,7,11,8,207,5,53,13,4,0,31,18,21,20,57,21,8,28,22,6,10,11,13,10,18,28,29,10,23,11,85,18,11,25,23,131,7,17,19,14,27,24,13,6,11,64,93,7,35,45,23,103,22,25,94,11,25,5,76,19,38,29,6,54,6,24,17,16,8,35,19,16,8,24,24,26,14,13,4,19,68,87,24,5,18,13,5,54,51,33,5,11,28,38,55,18,25,28,7,8,52,5,30,18,8,22,9,9,14,122,23,9,13,7,144,0,117,19,0,71,20,22,40,0,58,19,25,37,68,9,165,22,72,11,35,1,15,6,10,3,14,1,40,15,4,15,5,45,14,15,18,21,11,3,7,13,70,20,0,5,5,34,12,24,8,18,14,43,18,12,3,28,19,8,49,31,21,10,1,3,8,12,62,7,37,15,5,3,85,37,1,15,15,88,18,21,31,44,16,26,15,38,22,0,17,20,3,7,13,17,5,38,38,9,8,19,2,3,10,52,27,2,14,64,91,88,0,2,17,11,14,33,6,22,11,6,11,2,38,14,13,30,49,5,4,5,25,48,31,44,14,21,46,12,9,31,43,75,40,19,44,39,45,46,38,15,6,13,46,10,15,8,46,74,9,23,5,4,9,39,3,28,29,25,31,12,28,91,46,27,160,10,7,16,59,14,72,25,19,32,17,27,71,99,17,9,69,34,25,15,42,13,7,52,11,31,16,12,12,1,11,5,6,17,28,56,21,14,75,1,6,13,104,31,43,23,8,14,22,19,9,54,42,4,67,1,138,14,78,29,19,12,44,17,25,0,11,37,12,25,13,36,33,67,1,68,39,30,40,13,29,15,7,30,18,2,13,28,27,73,17,32,26,320,80,10,8,13,8,20,39,16,10,33,5,13,80,42,24,23,12,18,21,11,31,14,70,88,138,10,17,26,12,14,41,61,8,26,27,15,12,11,6,37,40,20,32,43,12,67,14,15,10,29,44,14,25,16,22,22,29,12,6,28,6,32,8,32,33,45,3,8,20,24,10,7,5,60,10,8,14,5,16,15,9,35,2,7,15,8,55,3,32,3,37,2,9,27,16,10,24,21,8,10,7,0,12,45,14,20,11,44,24,22,20,24,11,21,42,14,24,12,26,38,9,9,2,41,18,25,8,10,40,19,20,1,18,9,36,13,9,16,3,46,28,10,6,6,115,28,69,26,6,60,13,6,13,26,3,11,7,14,28,14,7,14,6,34,9,15,9,29,7,22,7,4,25,54,29,9,15,22,9,2,20,4,5,3,9,14,13,34,24,13,14,5,22,30,11,17,7,83,19,36,40,102,34,3,28,20,17,11,10,8,12,5,15,7,5,13,3,26,10,98,30,16,9,20,6,8,24,12,28,0,37,30,12,16,83,13,13,17,6,11,9,30,0,5,10,34,9,25,18,5,15,8,19,15,18,13,28,24,14,54,8,8,8,14,8,16,9,5,11,14,6,10,9,13,20,13,11,30,13,10,25,20,10,9,5,0,12,10,5,24,5,18,3,3,7,17,10,14,28,13,9,7,5,10,23,8,10,19,70,5,5,10,5,21,7,69,18,8,9,8,0,7,4,4,7,5,13,8,13,5,10,11,13,0,2,9,5,4,15,1,1,2,15,5,3,0,1,12,3,2
appoint,26,79,32,284,11,3,15,32,4,0,40,15,9,50,3,7,11,13,5,2,6,58,6,34,27,15,12,13,8,32,4,266,128,27,36,34,49,2,1,2,4,8,9,5,44,9,9,35,396,20,33,5,18,24,2,3,75,90,4,22,28,1,2,26,28,3,59,6,19,18,2,2,2,8,36,9,14,8,73,23,22,0,26,9,264,19,15,0,71,6,14,3,1,39,40,12,17,10,37,8,11,34,36,9,8,34,2,0,12,3,25,9,5,18,1,22,16,10,132,87,44,20,2,68,5,1,2,6,4,1,9,2,6,59,15,65,7,2,4,5,2,34,26,8,2,87,3,16,6,17,74,1,15,3,1,32,22,2,9,8,13,4,1,11,1,8,4,29,11,7,17,116,14,3,9,7,169,5,10,31,22,11,5,19,11,10,27,15,43,97,6,1,5,1,2,5,29,9,9,13,24,0,0,25,15,14,9,36,15,10,97,4,34,3,3,1,0,1,72,3,1,12,2,19,50,134,24,14,6,3,16,48,10,24,21,17,36,5,10,9,78,29,3,5,8,8,6,18,71,10,10,11,21,6,7,16,16,3,2,19,9,24,36,13,5,72,6,9,14,6,115,11,24,2,6,1,15,2,14,33,46,3,5,18,5,2,8,11,13,0,22,13,7,6,13,12,78,12,7,27,23,58,0,8,8,3,15,12,1,1,4,15,46,4,29,13,8,49,15,7,49,13,22,7,42,8,11,34,3,51,7,13,4,11,5,7,16,15,5,13,14,12,4,12,2,7,46,83,18,7,7,27,5,28,15,2,16,9,8,25,15,12,11,7,1,2,50,4,12,14,4,17,4,10,5,45,14,4,9,8,69,1,62,16,8,41,8,13,31,2,44,8,23,44,45,5,77,6,33,5,33,6,6,2,3,2,8,3,11,8,5,10,4,14,12,18,12,6,7,5,4,10,20,5,0,4,4,16,15,18,6,12,10,50,3,6,1,35,9,4,14,23,12,10,0,6,13,4,26,5,13,8,5,4,60,16,3,10,4,49,15,15,23,22,10,3,12,22,3,0,15,1,7,0,5,3,1,42,20,1,4,16,6,4,17,16,5,6,4,11,38,36,3,3,6,9,4,27,9,4,16,4,4,3,11,20,7,7,10,2,3,5,42,10,14,21,8,6,1,9,5,15,6,41,9,8,21,3,15,36,5,3,4,9,18,8,18,5,19,16,2,13,2,3,0,14,3,10,18,10,47,12,10,32,12,16,36,2,9,7,24,8,54,6,13,14,8,5,55,50,6,7,35,20,11,6,27,6,3,20,3,32,11,9,3,5,8,5,4,11,17,48,10,3,29,1,9,1,105,17,22,4,5,13,10,22,9,56,16,9,34,138,1,15,40,6,15,1,12,14,14,1,5,19,4,5,10,11,24,50,4,35,12,34,29,2,14,8,3,14,4,1,36,35,19,47,9,16,8,249,22,8,5,3,4,27,32,13,9,21,4,5,47,34,24,22,7,13,16,16,17,13,74,48,44,4,7,31,9,5,21,36,11,17,17,14,7,9,8,23,25,14,15,16,9,34,12,20,11,26,18,10,11,3,12,15,32,2,1,11,2,26,3,21,12,34,8,7,12,15,17,6,9,64,2,20,8,4,10,11,5,31,0,3,11,20,26,4,66,15,16,7,9,8,5,4,9,7,12,7,13,9,1,19,1,18,9,12,7,8,7,15,14,5,40,4,11,13,9,21,11,7,3,23,1,13,4,6,28,5,13,4,8,8,21,7,7,40,5,24,22,66,20,7,8,9,3,7,6,56,8,7,21,17,3,6,4,5,14,12,2,8,16,23,6,12,3,14,15,10,5,3,15,68,17,8,5,26,4,6,8,5,12,3,2,7,7,41,12,10,18,16,9,18,4,6,3,17,9,15,35,45,9,1,12,19,5,2,5,8,5,1,31,10,4,11,0,5,5,35,8,6,1,7,13,3,20,12,15,0,17,13,12,10,135,13,16,6,5,8,4,25,1,5,8,17,7,47,20,6,4,8,9,20,21,19,11,11,15,28,17,3,4,11,13,14,5,7,4,3,9,14,7,13,12,20,1,85,11,2,10,3,8,9,5,0,7,8,5,15,6,5,0,0,3,13,6,5,26,3,4,4,4,7,10,8,2,10,37,3,2,8,16,15,3,9,10,1,6,2,4,3,1,3,12,2,4,3,11,9,3,8,14,1,3,0,3,6,16,1,1,16,2,1,3,0,0,8,3,3
enjoy,2,7,12,57,6,3,2,31,4,2,17,2,9,64,4,23,6,7,6,3,6,28,9,16,16,7,10,10,2,12,8,112,101,4,25,65,56,3,7,6,7,22,0,2,18,8,14,13,195,17,20,5,21,41,15,8,55,12,1,19,14,15,5,5,14,1,104,14,5,8,10,3,3,3,52,11,29,8,52,12,33,1,8,4,108,4,5,0,24,5,6,11,3,16,39,12,7,2,30,9,11,22,23,4,9,10,7,1,18,2,13,2,4,9,3,26,2,0,29,81,36,24,4,37,2,3,5,0,4,1,11,5,16,26,23,24,3,1,0,11,5,19,24,4,6,34,4,11,12,11,36,2,7,3,4,16,22,4,16,3,10,3,11,2,0,1,9,23,19,6,12,59,13,5,0,13,106,1,6,10,19,12,3,7,3,16,17,15,19,22,2,4,11,3,0,2,5,4,6,7,19,3,8,7,19,3,4,32,12,25,69,5,17,3,3,2,1,0,11,0,0,10,4,6,22,72,14,26,11,7,7,7,14,14,36,20,19,2,9,6,66,29,4,3,7,1,5,7,15,5,2,12,13,4,3,3,6,3,3,13,0,12,11,1,7,25,6,3,18,8,80,1,13,2,4,0,13,5,6,0,44,3,0,10,6,4,4,8,8,1,1,2,5,2,1,11,25,4,4,18,19,17,1,6,12,2,9,9,7,1,3,12,9,4,19,15,29,41,10,3,36,5,22,3,67,2,1,23,0,17,1,6,5,6,12,20,12,5,1,9,6,4,9,5,6,6,30,29,4,7,11,6,8,30,15,3,2,3,0,13,14,5,9,17,7,3,24,7,1,7,1,12,2,5,7,15,5,5,15,9,67,1,27,9,2,35,4,7,17,8,12,6,2,4,24,8,37,5,17,7,21,2,6,0,6,5,3,3,23,9,3,10,4,10,1,10,4,2,0,1,1,1,6,7,2,1,3,9,5,8,0,1,0,6,5,4,1,12,9,2,16,24,3,23,3,4,6,7,22,4,14,6,3,2,60,7,5,2,5,20,6,29,21,14,4,17,17,19,3,2,16,1,2,7,1,11,12,11,7,5,3,11,9,4,8,1,13,6,3,4,38,16,5,8,11,7,3,18,11,6,18,0,2,1,10,8,4,15,4,0,5,3,3,9,9,9,4,15,0,8,9,12,7,17,2,5,15,2,11,14,4,6,1,7,4,9,4,4,25,16,6,2,0,1,14,2,12,19,9,5,15,1,2,32,7,6,24,4,6,5,18,3,10,1,9,3,9,2,18,32,15,5,5,0,8,12,1,5,4,9,11,12,30,14,10,3,5,6,5,10,22,20,10,2,15,6,10,3,32,18,8,4,7,3,2,14,5,9,6,2,16,14,15,1,16,7,13,5,3,3,6,1,5,11,1,2,9,4,7,22,2,11,9,6,7,7,2,4,1,3,10,1,1,11,3,7,3,3,1,123,24,4,10,0,6,6,22,11,2,12,3,8,19,20,3,4,0,7,3,11,11,5,5,9,16,2,3,3,9,6,14,10,10,13,9,1,10,6,1,7,6,8,11,11,2,4,4,3,15,12,2,4,3,7,4,6,14,8,6,2,4,9,6,16,18,7,9,8,3,2,4,3,1,12,2,5,3,3,3,14,3,14,0,3,5,3,5,7,28,8,5,3,2,10,18,3,5,8,5,12,14,3,1,6,3,6,7,9,9,17,19,9,2,5,29,15,10,6,3,8,2,2,9,10,7,13,2,1,5,7,2,8,7,3,1,4,6,0,9,12,6,2,6,3,1,15,3,0,3,2,2,3,4,3,5,1,10,3,14,4,5,5,28,2,4,1,2,2,5,3,5,5,1,0,1,6,2,1,2,11,5,6,23,4,3,9,3,27,9,2,4,1,5,3,7,5,5,0,2,5,9,8,4,11,3,3,4,4,3,1,6,5,5,2,3,3,0,1,5,2,2,4,8,5,2,13,2,11,8,2,1,5,4,5,4,1,2,3,4,6,1,11,0,2,5,2,0,0,1,0,5,3,4,4,15,2,4,5,2,10,2,0,28,3,7,0,2,16,1,3,6,5,2,7,4,0,5,8,0,1,4,1,1,8,7,3,11,1,3,8,4,9,6,2,3,10,7,5,10,2,0,5,6,3,3,1,5,4,2,3,3,7,8,4,1,12,2,0,2,8,1,1,6,2,4,13,1,3,8,3,12,7,1,1,2,4,9,2,2,1,8,4,8,1,4,3,0,4,1,3
case,28,98,32,325,19,8,10,58,2,6,46,36,10,158,15,31,11,56,6,6,13,103,10,68,67,24,37,8,14,39,33,535,266,18,135,95,59,9,29,7,16,11,13,12,84,58,64,37,902,27,114,10,11,47,20,20,190,83,4,31,52,24,4,22,32,19,193,12,21,53,21,8,10,15,219,26,65,16,186,46,80,1,32,21,602,38,29,0,90,4,59,21,6,82,118,60,50,20,72,27,36,54,99,16,42,80,14,5,37,13,32,11,8,32,3,82,26,15,192,506,109,41,44,118,30,3,4,9,25,4,22,8,17,151,74,77,41,23,15,21,6,146,69,2,6,195,14,37,59,28,262,5,38,7,3,93,95,2,10,30,17,4,20,9,1,13,20,58,66,22,50,243,65,9,12,26,535,5,20,103,72,36,7,52,8,71,101,70,123,141,17,11,18,3,6,4,35,16,36,46,101,3,7,33,68,24,23,58,32,55,215,15,102,13,8,9,0,6,42,6,4,62,14,37,123,440,91,77,15,23,24,40,35,72,67,44,85,18,15,44,196,95,20,32,35,27,16,47,141,12,36,53,34,23,17,47,43,6,15,70,24,70,72,21,11,108,18,8,19,10,356,14,107,19,15,8,61,14,48,9,156,24,15,72,32,5,14,22,35,9,15,9,55,11,6,26,103,17,18,72,59,100,2,6,38,9,40,16,11,8,7,46,48,9,92,45,35,137,38,12,140,34,89,13,205,47,21,51,21,72,15,57,24,18,37,61,48,27,4,23,27,37,25,30,11,11,117,104,56,15,52,34,32,86,83,20,13,16,34,53,64,22,10,58,11,1,125,26,21,55,12,46,13,31,55,70,36,10,25,12,225,14,117,44,15,82,47,86,70,8,137,12,47,38,69,18,157,17,100,6,69,10,9,8,17,13,42,5,67,23,11,17,10,58,40,28,7,23,10,4,17,42,57,34,8,15,9,40,26,33,35,13,8,19,6,11,2,19,23,8,50,88,28,26,2,15,13,25,95,13,38,18,8,9,131,51,2,29,39,60,51,76,81,76,14,3,33,29,23,5,52,22,5,9,21,61,15,52,60,8,19,18,9,19,18,61,33,9,25,19,166,152,8,7,30,15,7,58,29,46,31,14,13,1,52,75,7,48,22,12,10,36,12,21,37,67,9,19,55,22,14,75,22,95,40,23,99,43,84,99,39,19,21,41,33,25,41,20,108,76,12,5,16,10,17,32,5,40,80,24,123,20,64,154,19,38,77,21,22,31,54,20,97,11,39,46,46,38,98,107,20,21,38,23,8,8,33,26,20,36,18,38,34,47,24,29,12,19,5,21,70,89,59,11,80,13,24,19,147,60,51,3,14,9,39,57,30,88,28,18,113,78,40,16,1,29,38,21,48,15,27,28,12,70,5,35,13,29,34,66,17,76,85,78,20,8,35,20,14,40,38,13,68,41,26,59,15,22,22,552,52,16,16,17,32,20,86,55,32,43,16,7,47,52,18,21,34,32,39,40,71,32,112,312,157,19,7,12,18,14,12,70,66,19,21,30,36,12,12,22,40,24,56,30,19,23,19,15,67,41,16,26,18,39,20,19,47,13,16,10,23,28,15,53,49,34,16,16,19,14,25,18,15,74,3,22,25,2,28,30,24,35,10,13,31,8,34,17,93,14,31,16,10,27,40,14,25,17,11,30,33,14,10,30,11,35,33,28,9,51,53,51,13,4,48,26,44,21,17,39,31,2,5,78,24,52,14,6,22,22,16,19,42,13,29,23,16,13,20,69,14,67,15,17,40,77,33,32,8,23,14,8,44,27,10,11,22,14,55,8,25,7,29,17,15,29,16,24,13,49,19,12,16,30,9,25,5,24,23,13,23,18,24,13,12,14,28,67,41,12,30,17,52,76,19,27,20,30,19,51,73,98,30,14,9,15,26,19,49,2,23,18,36,7,24,9,14,17,26,28,17,20,5,11,14,4,24,45,31,6,31,34,6,5,40,10,10,18,19,19,12,20,2,6,35,24,14,13,17,13,19,11,3,13,15,12,16,22,15,36,12,14,17,37,54,10,16,9,12,4,21,26,14,23,13,19,11,40,21,20,14,6,18,20,17,11,9,7,19,17,9,35,10,1,15,49,27,12,56,29,2,12,6,21,9,8,11,6,42,6,7,7,22,16,4,81,14,28,24,13,20,15,15,10,24,13,14,29,21,10,21,41,14,12,17,13,17,1,46,2,12,2,6,0,4,9,1,3,3,0
constitute,4,16,16,86,6,3,1,43,1,5,24,12,2,56,3,8,3,18,6,1,4,34,4,21,14,8,9,8,6,7,11,110,101,6,44,32,25,11,5,6,12,3,1,1,25,16,28,9,270,10,34,3,11,27,6,2,52,34,0,11,21,4,1,6,15,1,81,2,6,7,12,2,6,1,55,10,7,2,50,12,44,0,9,2,183,10,14,0,26,3,5,8,0,31,37,10,15,3,22,6,11,16,23,12,8,11,5,3,19,9,15,4,2,13,0,26,7,4,48,172,40,8,10,59,7,2,0,1,3,1,10,0,5,24,10,29,8,7,2,10,0,25,25,4,4,39,2,13,16,13,54,0,6,6,2,42,11,2,9,2,6,1,5,3,0,1,1,8,16,4,16,81,8,3,0,6,127,1,4,16,19,11,6,5,3,12,24,14,28,40,6,3,5,0,1,5,12,5,13,10,16,1,0,7,35,9,4,34,9,11,56,2,19,7,0,0,0,1,16,3,6,15,2,14,23,61,12,26,1,3,10,19,12,27,21,26,26,2,1,12,48,31,2,1,11,4,2,14,29,8,8,15,12,18,16,5,8,6,1,14,0,21,18,5,2,22,4,4,15,2,100,15,34,10,4,1,9,14,3,2,31,6,1,11,7,4,2,5,12,2,9,2,19,9,5,9,26,0,3,17,14,19,3,1,10,2,9,7,0,1,4,17,20,4,22,18,16,27,7,4,38,4,19,1,71,9,2,14,1,29,13,8,11,7,8,7,17,5,4,10,12,6,11,13,5,4,44,40,16,2,11,9,6,30,14,5,4,6,16,19,7,5,10,12,3,0,39,8,3,8,5,8,4,4,11,11,8,3,6,9,53,1,31,7,1,47,6,9,28,7,21,2,13,20,31,12,47,4,20,2,14,2,2,1,5,6,6,1,12,18,3,8,3,12,10,3,4,3,2,4,1,7,16,14,0,5,2,11,5,18,19,10,1,16,0,3,0,7,13,7,15,26,8,10,2,4,6,3,36,8,14,4,1,2,41,10,1,5,7,19,6,12,18,15,6,3,8,2,15,0,14,1,2,3,4,6,4,25,18,2,5,6,6,9,5,5,11,5,2,7,58,27,2,1,9,7,0,13,5,13,19,8,6,0,8,26,4,11,3,5,4,4,3,1,14,16,1,7,3,7,5,17,11,16,12,7,19,4,18,23,8,6,5,2,8,9,10,2,35,16,3,4,1,5,7,5,6,22,10,4,33,5,6,32,14,7,25,7,6,4,21,1,15,8,17,14,9,10,26,24,8,8,12,1,9,6,8,5,12,23,12,19,11,12,8,4,11,11,5,7,24,30,8,3,12,9,6,2,47,13,19,1,4,2,6,19,3,14,6,8,25,29,6,7,29,1,22,12,11,6,20,11,2,22,5,3,7,12,11,33,16,13,18,27,11,3,4,14,1,9,14,3,17,16,2,14,3,3,3,131,19,10,7,4,4,15,48,16,7,9,6,4,12,12,8,2,2,11,13,12,12,10,43,56,24,10,3,2,4,10,10,24,8,8,9,10,8,6,7,16,13,8,9,13,3,8,4,6,14,9,3,5,3,4,9,8,15,4,6,1,6,7,4,30,20,13,1,13,4,6,4,11,2,14,1,19,6,2,4,7,13,8,13,6,9,2,20,6,48,19,7,3,4,8,5,5,17,7,3,10,9,6,2,6,4,9,10,16,5,12,15,7,3,7,23,14,14,8,6,5,3,3,4,9,12,11,4,2,7,11,6,3,12,8,15,6,20,42,8,17,1,10,3,2,3,13,0,8,4,10,5,3,12,9,2,4,3,5,10,5,2,3,9,10,0,7,2,10,5,13,4,4,5,19,4,8,2,5,13,4,6,5,10,2,5,8,10,27,18,1,1,8,9,6,1,5,5,0,8,6,30,20,4,9,3,5,7,9,10,2,8,4,7,2,6,7,2,6,7,4,2,8,12,16,1,6,3,6,4,1,3,1,2,4,15,4,0,6,1,3,1,16,1,2,7,6,3,4,2,0,6,0,8,10,4,2,3,12,3,23,7,8,6,12,8,3,2,6,2,5,5,5,10,12,2,6,5,11,4,5,3,0,6,12,6,3,4,5,4,13,4,14,0,5,6,14,3,23,41,2,3,2,2,4,5,7,20,10,10,9,6,9,5,0,2,13,1,0,11,8,4,8,12,0,4,2,1,4,6,11,7,8,3,13,2,11,10,3,17,3,7,4,6,0,1,0,2,1,3,0
object,5,38,9,235,14,4,4,79,5,9,34,12,5,62,16,20,4,16,5,6,12,67,10,37,23,16,18,21,4,18,20,258,203,9,107,83,69,22,20,5,19,11,8,1,75,26,54,27,455,18,63,6,24,25,8,16,136,56,0,27,26,13,5,30,27,6,145,8,20,11,17,22,11,7,96,21,23,7,110,31,72,1,22,8,346,66,21,1,64,3,11,5,0,49,103,18,29,6,39,24,21,34,61,23,13,52,18,2,15,5,37,18,10,20,0,43,6,6,103,268,67,12,15,78,5,8,5,3,6,1,15,3,10,64,27,54,11,1,10,10,2,38,39,0,4,72,8,14,29,31,151,3,21,23,3,44,37,3,10,1,22,6,8,3,0,2,6,31,42,16,26,123,27,0,7,21,249,8,22,30,26,28,0,26,12,29,42,38,55,76,2,9,7,0,3,8,40,4,8,33,38,6,2,25,35,3,9,52,15,44,108,7,34,27,1,0,3,1,16,4,12,30,14,28,64,170,22,55,1,5,31,17,34,33,79,87,66,20,9,7,114,62,11,5,40,11,13,30,52,5,21,43,30,19,35,28,15,1,20,28,5,40,35,7,3,44,4,8,17,5,316,32,63,16,11,1,29,44,28,4,89,14,1,36,15,1,0,15,12,0,8,9,20,15,5,18,58,3,23,37,33,63,0,2,14,3,30,6,7,1,1,15,30,11,50,34,35,62,16,14,70,20,48,4,75,12,5,34,10,26,7,23,11,17,9,22,24,9,6,25,25,4,23,12,8,9,90,99,25,4,61,32,11,45,37,12,2,15,90,41,38,5,7,30,9,0,84,17,9,12,11,28,8,20,17,36,9,15,32,15,114,7,101,18,1,45,3,22,49,10,38,9,23,15,90,15,124,10,43,4,31,8,5,0,11,13,6,4,35,36,2,16,6,18,12,19,6,7,5,5,7,13,27,33,3,9,5,19,25,26,20,17,4,18,0,6,0,31,18,5,31,58,4,13,4,5,7,7,44,23,31,15,1,11,81,10,1,10,9,100,19,26,79,41,12,3,20,26,17,0,20,6,11,2,5,15,4,28,27,13,13,19,7,7,15,10,17,8,11,5,106,66,4,10,12,7,10,28,17,27,19,13,5,0,10,40,5,15,16,11,13,14,8,21,28,37,10,20,17,19,5,28,20,49,20,10,44,20,48,40,17,11,4,23,10,11,29,17,66,34,13,4,3,2,10,13,14,41,31,10,95,14,11,86,19,27,68,7,12,19,71,11,30,6,44,28,37,10,83,77,20,15,76,6,15,10,18,9,16,22,19,26,31,22,20,9,12,18,8,17,35,61,14,9,24,19,13,2,69,38,45,5,12,6,5,29,17,40,12,19,31,19,15,13,38,22,1,7,15,18,18,15,10,32,5,29,9,23,33,49,15,48,45,35,9,4,11,11,4,35,29,6,6,47,21,51,12,1,6,198,26,5,14,11,10,14,53,17,6,24,18,22,23,18,23,8,3,25,25,18,34,21,87,28,50,27,9,20,4,18,15,57,28,19,17,26,19,9,3,28,27,10,35,18,6,16,15,10,28,42,5,6,15,13,22,12,38,8,11,8,9,12,21,46,46,23,4,15,8,14,23,14,17,51,3,9,14,4,13,26,14,36,9,12,23,9,38,12,65,20,15,3,2,22,34,15,32,4,7,19,17,8,2,11,5,28,17,39,3,11,11,8,2,3,32,27,18,8,12,17,11,7,5,24,7,20,13,6,42,26,25,12,33,14,11,15,14,7,14,15,17,25,9,14,14,31,10,13,10,3,18,8,21,12,8,4,18,6,23,7,28,10,16,15,8,10,9,10,5,17,12,4,15,18,30,19,7,9,10,9,25,13,35,4,20,22,19,34,11,10,13,14,14,17,11,14,23,2,15,20,26,38,10,25,2,3,13,15,13,3,17,3,14,3,9,21,10,6,11,24,9,6,7,22,5,7,6,17,20,5,6,7,9,11,27,12,11,5,11,27,4,34,1,7,11,8,10,3,5,0,15,21,6,17,9,4,7,8,9,29,5,8,17,32,19,5,6,19,11,4,21,17,11,28,3,21,5,19,12,13,10,4,13,16,20,7,6,14,6,26,21,21,8,36,18,29,36,42,89,11,8,4,8,4,26,15,10,6,50,19,9,12,11,9,0,30,18,4,11,30,15,9,5,2,8,12,1,18,24,13,13,18,14,10,8,20,24,1,26,3,4,5,6,0,0,3,0,13,6,3
competition,1,3,3,49,3,1,4,10,0,7,0,5,5,27,0,1,5,13,2,1,1,16,6,14,6,3,3,10,6,3,1,92,47,2,42,27,7,10,47,1,8,5,0,3,8,4,13,7,70,15,30,2,9,31,6,5,51,8,4,7,1,3,0,17,10,2,32,7,1,19,2,0,0,3,41,9,11,0,30,22,32,9,10,7,72,6,14,0,12,0,2,0,3,3,35,32,7,5,16,26,2,18,17,6,3,14,8,2,5,2,8,5,18,28,3,18,3,3,26,88,27,8,7,21,2,1,1,2,0,1,6,1,8,33,6,25,1,3,6,3,3,28,6,0,0,28,6,5,10,7,24,3,3,1,6,10,17,5,1,5,20,2,2,4,2,1,5,15,13,6,9,48,29,0,1,1,77,0,2,28,14,4,5,14,0,24,23,10,15,22,3,4,17,0,1,3,2,4,6,3,50,1,10,1,16,3,0,14,9,25,38,0,15,12,1,3,0,2,1,2,0,13,2,8,17,61,13,8,2,2,10,2,28,39,21,15,8,21,14,2,37,31,8,9,12,3,0,15,19,12,8,27,6,1,5,3,2,0,0,7,2,3,2,2,4,18,6,6,6,4,52,2,13,2,1,0,12,2,1,0,24,7,1,11,5,8,3,2,5,0,1,0,6,5,3,4,6,7,8,6,8,13,1,1,8,2,7,2,3,1,3,18,19,6,21,12,18,22,37,4,24,1,8,11,26,1,3,20,5,11,2,3,2,1,4,10,7,2,0,2,8,4,7,5,1,1,21,33,2,2,5,20,1,24,10,10,2,3,19,12,21,8,25,13,11,3,15,4,3,7,5,11,2,7,12,20,1,13,8,2,18,2,13,4,3,30,1,11,14,0,8,3,2,5,8,5,32,4,8,1,2,1,2,0,2,9,3,0,29,8,2,5,2,6,0,3,4,7,2,0,5,4,5,11,2,3,5,3,5,4,1,0,0,2,6,3,2,4,0,3,20,10,1,11,0,3,10,1,21,2,4,1,0,1,24,1,0,4,9,23,10,10,22,15,4,3,21,18,4,1,7,2,1,1,5,12,2,8,20,2,3,3,8,1,6,2,5,0,4,0,9,18,0,1,14,4,5,2,2,11,9,4,0,0,41,3,1,9,3,1,4,2,0,27,9,0,1,2,38,4,4,2,0,8,0,0,37,16,10,16,8,5,0,8,3,2,1,9,10,34,3,1,1,10,19,0,0,14,3,7,5,0,25,14,3,10,13,7,13,5,8,2,9,3,7,18,7,9,38,48,6,4,7,10,2,1,8,10,5,11,33,13,12,13,5,3,12,2,6,6,8,5,23,0,19,1,19,13,16,8,6,2,2,1,1,2,0,5,12,0,8,12,1,5,21,12,7,1,2,5,4,1,1,4,1,0,17,7,7,34,5,10,23,5,8,10,13,4,0,4,7,3,2,7,5,4,12,0,3,48,7,1,3,1,5,6,30,1,1,14,2,1,0,10,6,2,0,6,4,8,11,7,1,24,5,2,0,0,3,5,14,8,0,5,9,0,1,5,4,3,9,8,2,4,0,2,7,0,13,10,9,0,1,3,4,3,6,5,7,1,0,3,3,10,11,2,0,0,3,5,5,5,2,2,5,3,3,4,1,7,0,18,11,12,2,2,7,2,6,3,12,5,5,9,2,2,4,7,3,4,4,1,0,2,0,2,4,6,3,19,16,10,0,2,5,12,2,25,3,7,7,0,9,4,2,5,2,2,0,6,0,1,4,6,4,9,10,0,8,10,1,3,2,0,19,9,8,4,2,0,3,1,5,3,4,2,5,3,4,1,12,1,5,10,3,1,0,1,3,3,4,2,3,3,1,4,1,2,2,5,7,3,1,0,3,7,1,10,4,1,1,1,3,3,3,12,7,5,4,0,8,7,4,4,2,1,15,16,13,0,10,7,3,5,4,3,4,1,1,4,1,7,0,5,3,1,1,13,3,3,2,1,4,0,0,0,2,2,1,1,2,0,2,2,1,0,2,0,0,1,7,2,1,1,0,0,2,6,0,8,7,1,5,2,7,0,0,3,1,0,0,2,0,20,0,2,0,3,8,2,1,3,8,4,1,0,5,2,4,6,0,5,2,0,7,11,2,3,6,0,0,8,0,1,2,0,0,3,5,0,1,0,0,0,0,2,0,0,0,3,1,0,10,2,4,0,0,1,17,2,3,3,2,4,5,4,1,7,0,1,2,2,4,2,0,0,8,0,1,1
judgment,9,35,11,145,7,2,3,24,4,1,14,3,4,34,4,8,5,13,8,1,2,29,3,24,23,8,12,3,6,10,10,139,72,9,43,23,13,2,6,5,8,1,2,3,20,20,25,20,178,7,26,6,10,19,4,1,51,12,0,9,12,5,3,6,22,8,73,7,12,5,2,5,4,2,64,10,19,5,60,27,36,0,8,2,162,12,4,0,23,1,2,5,0,26,35,30,16,5,17,8,12,34,18,6,4,21,3,6,7,1,11,1,7,6,0,21,2,0,57,156,37,22,32,39,8,7,8,5,7,1,4,3,2,25,13,28,6,1,7,8,0,21,23,4,1,59,2,12,10,14,81,3,13,4,2,33,21,2,5,2,11,1,8,3,1,4,4,15,17,3,10,71,12,0,3,5,161,1,14,30,26,5,2,31,7,23,24,25,55,27,2,6,8,0,0,0,14,7,5,14,37,2,1,11,13,8,5,24,6,20,73,1,30,8,1,0,3,5,20,3,0,14,5,20,28,132,24,21,0,4,17,8,8,27,26,24,18,8,6,6,51,21,6,4,6,3,4,24,55,8,7,11,13,5,7,10,12,0,6,9,5,18,23,3,4,27,0,3,12,2,116,5,19,3,6,0,12,13,13,2,50,8,1,16,9,1,1,6,14,3,8,2,24,3,2,8,35,11,7,14,17,35,0,0,12,0,9,5,4,0,1,31,16,3,21,14,13,26,7,4,27,9,22,0,64,6,3,14,1,19,4,17,8,11,12,14,14,8,1,8,16,6,10,12,5,5,40,34,15,2,10,12,9,11,26,9,5,2,14,28,25,2,9,14,3,1,33,3,1,13,4,11,4,6,7,17,8,2,8,3,79,0,31,14,0,29,3,10,28,3,32,2,15,13,43,4,51,7,22,3,18,1,2,0,6,0,4,1,5,8,1,3,2,17,10,16,3,4,2,0,2,8,17,22,0,7,3,13,11,16,4,2,0,2,1,4,0,7,7,5,18,18,6,4,0,3,9,3,25,8,8,5,4,6,43,11,0,18,8,32,9,11,15,25,10,4,7,12,11,1,15,14,1,1,2,16,1,17,16,6,4,5,3,4,6,22,8,1,7,12,28,41,2,3,6,2,2,12,11,9,14,2,8,0,5,10,0,16,8,1,4,6,5,15,13,24,6,10,6,6,2,18,10,35,24,2,10,11,23,26,17,10,6,17,13,3,11,12,38,28,1,8,2,0,9,9,4,6,10,13,40,5,11,36,7,10,33,1,9,6,22,10,20,9,13,16,12,21,24,37,3,8,15,1,6,6,11,8,11,10,4,15,11,7,12,7,7,3,9,25,13,37,3,0,15,3,4,2,25,23,25,4,2,5,6,28,4,28,8,3,26,44,12,3,48,11,15,2,1,5,13,1,2,15,2,9,12,11,15,15,4,23,33,24,1,7,11,4,0,5,15,3,28,24,9,22,1,4,13,93,16,1,4,12,6,3,37,19,3,12,9,3,17,12,3,6,2,3,13,9,22,9,14,127,25,4,5,6,2,7,1,24,12,8,5,15,10,8,7,10,12,10,7,10,9,4,4,3,28,20,2,8,5,12,10,2,7,7,8,1,7,5,1,36,11,17,8,4,9,6,9,2,2,16,0,2,4,2,7,4,6,9,5,4,7,0,9,1,22,2,16,2,1,3,7,3,6,6,2,5,10,2,1,6,2,11,11,15,9,8,7,7,0,0,13,18,4,6,5,14,5,2,4,9,9,15,4,0,10,8,1,6,8,1,7,7,3,7,5,14,3,18,3,2,25,18,15,6,3,9,5,10,9,4,4,3,8,0,15,2,3,5,9,5,3,7,5,8,5,11,2,2,11,17,4,9,8,14,2,5,7,1,3,3,2,5,6,20,12,6,6,6,18,29,1,6,4,10,3,8,20,33,5,3,3,3,8,10,13,1,3,4,7,0,6,2,3,4,8,19,1,1,10,6,9,0,6,5,13,1,11,3,6,3,5,2,5,8,4,4,5,7,0,0,5,2,0,3,4,1,6,5,7,6,8,2,1,6,7,25,2,0,4,10,20,2,2,4,2,8,3,4,5,4,7,7,2,11,4,2,4,6,3,4,6,2,4,3,5,3,10,7,4,2,5,5,10,5,25,2,1,8,2,3,4,1,2,5,18,3,1,2,4,6,0,11,1,4,8,1,4,9,5,1,6,0,0,4,6,3,1,4,5,1,3,6,4,2,13,1,3,4,3,0,0,5,0,3,3,0
practicable,3,7,1,76,6,1,1,5,0,1,8,4,3,29,1,1,4,9,0,1,2,13,0,8,9,6,1,5,0,2,3,93,52,3,14,17,16,3,8,1,9,1,2,0,14,8,11,9,138,4,9,1,6,4,2,0,56,29,0,10,10,5,2,7,4,3,28,3,5,8,2,6,3,1,34,8,2,4,40,4,19,0,12,2,95,7,12,0,15,2,3,3,0,12,40,8,10,2,18,8,5,9,16,4,7,11,6,0,4,0,4,2,4,4,0,16,6,0,31,66,70,9,13,17,1,0,3,2,1,1,7,0,2,21,5,30,3,2,1,1,0,16,15,3,0,26,1,8,8,14,22,0,9,5,1,6,7,0,2,0,9,3,2,2,0,1,3,11,14,6,9,21,12,0,2,4,77,2,2,10,13,3,0,7,3,7,11,6,14,23,3,1,3,0,0,1,7,2,2,4,11,0,3,14,7,1,7,16,1,15,32,0,8,5,1,0,2,0,12,3,1,4,3,11,29,51,12,10,0,2,11,6,7,4,19,34,15,9,2,5,36,28,2,1,4,4,4,4,26,2,9,9,12,6,5,13,3,1,4,6,3,14,10,2,3,21,2,0,5,2,99,3,20,2,3,1,8,5,5,0,20,1,1,3,6,0,2,4,8,1,3,1,6,5,4,6,28,2,5,9,10,22,0,2,4,0,13,2,0,0,1,2,13,1,28,7,4,12,5,4,13,4,11,0,17,2,0,18,5,10,0,7,1,3,5,4,6,2,1,6,11,8,10,3,11,0,32,24,9,0,7,7,6,15,12,0,3,4,16,11,11,5,3,10,2,0,25,4,7,3,2,13,1,11,4,18,7,2,6,3,25,1,17,3,2,14,4,7,9,1,8,2,3,6,15,2,42,3,22,1,5,0,4,0,4,2,2,1,7,6,2,4,4,11,7,6,5,8,0,2,1,11,5,5,0,1,3,6,6,9,3,4,4,6,1,2,0,8,4,2,9,16,5,1,0,1,3,2,22,3,7,3,2,2,24,8,0,4,2,13,6,1,9,8,5,11,14,9,7,0,5,2,2,0,2,3,2,9,7,2,4,1,3,2,3,4,8,0,2,9,29,15,1,1,1,4,2,10,3,9,3,0,1,0,3,12,1,4,4,4,2,2,6,3,10,8,6,3,0,0,2,11,3,9,1,2,22,1,10,25,5,0,1,3,7,1,7,6,21,7,8,1,0,2,4,7,0,11,11,1,11,2,3,27,7,3,21,5,4,5,16,1,15,3,4,13,8,7,20,17,3,9,13,1,5,4,7,3,0,10,5,11,11,9,4,0,0,7,4,10,21,10,5,0,13,4,2,1,19,12,12,4,0,1,2,22,3,14,4,8,7,17,14,3,15,6,18,5,5,1,10,7,3,16,4,6,6,10,6,11,9,14,12,9,3,3,1,3,0,7,11,0,2,5,7,18,4,1,2,85,20,5,6,1,1,4,17,3,2,10,3,3,8,8,5,3,0,5,7,7,21,11,28,5,18,5,2,3,0,5,3,14,14,12,10,8,8,0,5,3,8,5,3,14,5,5,7,1,9,12,3,1,4,3,6,5,6,1,7,3,7,4,2,13,8,9,4,0,5,2,1,2,5,18,3,2,7,2,3,4,0,13,6,3,1,3,7,2,14,4,6,3,3,3,9,3,7,1,3,4,11,3,1,8,2,6,5,8,5,4,5,4,1,1,16,19,8,4,1,5,0,1,1,7,5,3,1,1,13,4,4,7,2,5,2,3,6,2,4,6,5,3,2,3,6,14,0,5,2,8,2,6,7,2,3,1,0,0,12,4,3,4,16,5,3,4,2,7,4,5,2,1,7,7,10,2,0,3,8,3,8,3,5,0,4,6,2,13,6,4,7,3,1,0,4,10,2,7,1,2,12,12,7,5,1,5,7,2,2,0,6,1,3,1,5,4,5,2,0,7,1,2,4,3,4,0,0,7,5,1,4,7,1,3,10,5,6,4,8,2,4,5,0,1,2,4,5,6,3,2,3,12,6,3,0,0,3,10,3,9,1,6,0,8,8,2,0,5,3,1,2,4,7,16,4,5,1,13,2,4,3,1,8,6,2,4,4,1,1,3,2,9,4,4,1,15,7,13,21,3,2,3,1,2,3,6,1,6,11,6,1,1,4,5,2,3,3,2,0,4,5,1,1,0,5,4,0,3,3,9,2,6,14,3,3,6,5,0,2,0,3,1,1,0,0,0,0,5,0,0
furnish,9,21,4,166,8,6,1,38,5,6,16,5,12,42,5,7,4,13,1,3,10,53,2,17,25,9,10,14,8,10,17,198,156,11,63,53,31,24,18,5,6,10,5,2,36,28,52,24,268,8,57,2,15,21,8,6,55,66,0,32,23,9,8,13,26,4,106,4,5,13,21,7,10,6,47,21,24,6,88,29,63,3,11,5,228,35,45,0,35,1,12,11,1,28,59,12,16,8,24,26,26,41,33,18,8,47,9,8,24,9,22,8,9,11,0,27,2,13,52,207,59,16,2,64,11,5,5,7,5,0,17,4,4,53,16,57,4,3,4,7,6,36,34,7,5,81,3,15,15,16,72,0,16,10,4,29,20,5,5,6,19,7,10,3,0,4,7,16,22,13,20,80,29,4,6,16,193,7,7,47,27,12,2,20,9,18,44,25,39,45,1,13,13,1,2,6,41,9,10,20,44,4,0,14,32,13,18,68,14,38,82,6,20,5,1,0,0,2,13,0,5,16,4,13,68,88,33,38,4,13,20,36,12,32,50,26,26,16,5,3,70,41,3,5,11,16,8,24,48,10,24,21,19,22,14,25,18,5,9,15,6,17,34,2,13,53,13,2,9,3,162,9,49,11,2,0,19,15,21,1,76,11,5,29,20,5,6,13,16,2,6,2,30,7,3,11,56,5,7,16,23,33,0,5,8,0,19,13,6,5,5,19,35,2,37,26,16,50,20,9,44,8,26,15,36,6,8,25,7,21,3,20,10,13,9,23,22,13,7,19,18,17,27,11,14,3,55,50,23,9,12,14,9,53,31,4,1,8,13,21,24,3,8,25,4,1,56,6,13,10,4,19,11,27,10,40,9,8,17,5,53,3,59,9,7,49,7,22,26,16,9,7,13,3,35,25,76,14,53,9,24,5,8,1,9,11,7,2,36,13,1,13,4,10,10,9,5,5,3,1,4,6,33,4,3,6,6,30,18,22,50,5,3,10,3,7,0,8,18,3,15,23,13,8,3,4,11,8,48,14,17,5,2,8,52,11,0,5,16,35,8,17,34,33,8,3,21,7,18,1,15,2,1,3,6,23,6,20,18,5,10,23,4,1,8,5,22,4,4,9,58,56,1,4,9,11,11,19,15,13,17,7,9,3,12,103,14,19,6,10,7,4,8,7,25,21,9,13,7,7,5,16,15,30,7,7,38,11,10,27,5,12,5,11,8,11,9,12,31,30,6,0,1,8,18,13,5,29,19,5,32,7,5,48,10,13,27,10,9,10,29,4,29,6,34,38,23,11,44,44,21,20,18,0,13,11,6,12,9,16,12,18,15,26,11,5,11,13,7,10,18,40,10,7,22,6,6,9,12,26,21,6,8,2,5,34,9,19,10,9,36,25,14,6,27,20,18,4,13,10,1,33,13,58,11,12,8,12,28,30,53,27,40,24,10,5,7,5,5,16,21,5,7,40,13,56,8,7,1,129,13,9,8,6,12,16,44,12,9,19,12,8,19,16,5,1,3,11,13,12,26,6,22,37,30,4,3,17,4,13,12,28,24,16,18,11,6,2,6,7,14,14,22,13,10,21,5,2,7,19,8,3,7,7,13,17,16,8,5,8,4,8,3,36,20,45,17,13,8,11,25,6,11,47,7,13,9,3,8,26,13,26,8,7,6,8,32,8,55,13,21,10,16,18,11,13,16,7,6,8,15,10,3,9,4,8,5,17,6,19,16,17,4,5,15,28,14,16,16,8,5,5,7,13,6,14,15,5,25,14,4,10,18,11,7,2,21,17,20,27,9,13,6,12,14,25,8,12,8,6,10,7,16,5,7,7,12,4,20,9,2,5,5,15,7,3,10,7,6,10,6,9,6,27,8,4,5,6,38,3,8,7,19,5,7,11,15,32,9,10,8,10,8,9,18,17,11,7,16,10,12,47,6,7,0,11,3,10,3,1,12,6,17,4,6,9,9,7,10,24,5,7,15,41,3,5,4,4,7,6,4,6,5,3,15,6,12,12,9,15,1,6,1,10,4,4,17,9,4,4,8,11,5,4,2,6,5,45,4,11,10,10,7,21,7,10,6,8,7,6,19,4,5,8,1,8,4,14,3,31,9,3,11,15,9,14,22,11,4,11,6,10,5,5,10,32,13,11,84,8,3,6,5,15,4,4,11,4,31,10,7,11,9,2,0,21,5,2,3,5,7,5,6,2,6,8,0,10,7,8,4,8,6,42,8,12,3,8,8,1,6,3,6,0,1,3,2,7,4,0
circulation,0,4,0,39,0,0,0,18,0,0,0,0,0,16,2,2,6,46,0,0,6,35,16,3,11,1,1,3,1,12,0,130,126,3,26,37,15,27,28,0,3,0,4,0,13,4,39,3,192,6,48,0,16,12,0,0,33,8,0,2,1,2,0,2,18,1,119,2,1,0,21,0,5,0,45,9,22,2,93,20,70,1,10,1,162,98,28,0,35,3,6,8,1,13,55,13,4,1,47,15,11,14,48,12,1,21,17,0,13,25,18,18,9,21,0,23,3,11,39,153,27,0,23,65,4,1,0,2,15,0,1,0,0,16,7,2,0,5,2,2,0,7,34,4,1,36,0,2,17,20,39,0,43,1,1,11,17,2,0,5,13,0,10,8,0,4,2,12,22,5,11,102,23,0,2,3,100,4,5,27,11,16,0,18,1,18,28,14,10,23,0,16,6,3,0,9,28,5,24,11,43,4,3,4,42,2,3,31,5,7,39,3,6,4,0,0,0,0,4,1,2,2,1,7,71,80,37,42,26,94,13,19,23,12,25,14,19,8,14,1,78,20,5,0,2,4,3,67,40,7,20,21,2,23,16,11,5,6,7,2,0,18,12,2,7,29,0,0,3,2,127,33,176,3,3,1,3,4,4,0,44,2,0,5,34,0,0,8,3,1,0,0,30,0,4,9,37,0,1,13,33,12,6,16,6,0,4,0,0,1,0,11,24,1,46,12,18,43,63,7,8,2,26,0,12,2,0,12,13,42,0,16,2,4,21,3,15,3,5,17,9,1,10,2,3,1,40,29,17,0,6,3,6,42,22,2,1,2,18,12,7,0,6,26,4,0,48,0,0,1,4,12,8,12,5,5,6,4,5,4,53,0,33,2,1,11,0,37,25,3,0,0,2,0,25,17,17,4,31,0,13,3,0,0,4,3,11,0,35,5,1,2,16,7,0,0,4,6,1,0,0,0,6,10,11,0,1,7,5,17,208,14,0,10,1,2,0,0,0,2,2,1,1,16,0,0,2,3,52,8,55,7,0,16,34,4,0,0,21,15,2,16,29,5,16,0,18,3,0,0,3,3,2,0,0,10,3,6,15,10,4,13,10,0,3,1,8,3,2,0,12,27,0,0,14,1,0,17,6,9,18,2,34,0,1,350,0,2,2,3,4,3,1,1,17,13,7,0,1,6,0,10,18,19,4,4,22,8,15,24,3,7,0,3,5,0,0,3,21,34,3,0,2,2,13,0,0,17,10,3,21,4,3,45,1,4,12,3,7,7,21,4,14,1,5,21,8,10,37,58,14,3,0,0,3,1,3,2,16,13,2,5,10,17,7,2,0,4,7,5,6,18,18,4,4,4,11,5,0,40,5,2,4,0,0,13,1,7,4,9,19,0,1,1,28,11,15,1,1,7,33,1,4,168,8,1,1,1,3,12,197,10,9,12,5,4,4,16,0,4,10,0,1,1,0,46,6,0,1,91,0,4,12,0,1,1,59,3,4,6,8,0,0,11,3,0,0,4,9,14,15,12,1,2,4,13,0,3,2,1,2,7,12,4,14,2,9,1,21,4,1,2,19,2,5,3,14,0,9,14,1,1,2,0,8,10,13,6,13,0,1,8,9,11,16,2,0,3,6,0,2,2,0,0,0,3,18,0,5,25,20,7,8,3,4,3,2,6,1,7,1,3,0,1,2,14,18,0,3,1,2,7,1,2,8,4,2,13,0,88,71,2,15,25,7,55,1,2,1,1,5,1,1,2,0,1,37,2,0,0,0,4,18,13,9,0,18,0,76,7,2,0,0,12,0,23,0,5,10,0,5,10,19,0,8,3,15,10,5,3,8,3,0,3,1,1,4,2,7,20,2,2,0,9,0,4,1,4,134,2,10,0,9,2,5,8,2,32,12,1,0,3,2,2,9,8,6,1,8,5,1,24,2,11,0,20,5,5,3,4,1,4,6,1,20,10,0,2,2,5,0,0,77,131,6,21,0,0,1,0,0,16,6,0,4,2,13,0,0,10,0,1,0,0,4,1,0,0,15,0,4,5,0,4,0,10,0,33,2,3,7,18,3,10,0,1,6,0,6,3,6,4,2,5,0,2,0,0,0,143,1,0,5,3,1,10,4,18,0,2,2,25,5,5,14,60,22,4,147,0,0,0,2,10,1,13,2,0,23,1,0,1,4,0,9,2,0,1,0,0,0,2,4,0,0,1,0,7,6,3,2,0,5,192,2,3,5,3,0,0,0,1,5,0,0,1,1,1,0,0
adequate,0,4,7,64,5,3,1,18,1,2,4,2,6,32,3,2,0,9,3,0,1,14,1,10,7,8,9,5,2,6,9,94,49,4,13,24,16,1,6,1,2,4,0,3,15,5,9,7,85,8,10,2,4,19,4,0,25,22,1,5,6,3,0,6,7,1,25,2,11,12,2,5,1,2,43,9,3,3,14,5,27,0,8,3,71,2,15,0,8,2,4,3,0,7,18,11,7,3,14,5,10,11,16,4,5,13,4,0,5,2,5,5,4,5,1,11,3,1,24,65,19,6,3,22,4,1,2,2,0,1,8,0,1,23,14,29,7,1,1,3,2,10,14,2,1,18,2,6,11,8,22,1,4,9,2,11,7,2,2,2,16,1,5,2,0,3,6,7,6,7,9,39,6,5,1,5,68,2,4,30,12,4,7,13,3,9,13,11,10,9,0,2,10,1,3,3,14,1,4,10,19,0,0,3,10,4,2,17,1,11,19,5,7,3,2,0,0,4,6,1,2,15,6,7,25,41,8,7,8,2,5,6,15,7,19,19,19,4,6,1,27,17,1,2,6,3,3,16,36,3,9,6,10,5,7,8,3,2,2,12,6,15,11,0,3,26,6,6,8,0,58,5,12,4,1,0,8,11,5,1,25,0,4,12,4,1,6,2,8,0,2,0,3,3,0,3,13,3,4,6,2,18,0,1,7,1,4,3,1,2,4,12,18,1,9,9,6,25,4,10,14,6,13,5,16,2,5,11,2,8,1,1,4,3,4,6,7,2,5,4,3,5,7,3,10,3,26,18,13,4,4,4,2,11,10,7,0,0,5,7,19,7,4,2,5,1,8,0,3,4,1,7,0,7,2,25,2,2,4,3,31,0,24,1,1,14,1,6,4,0,1,2,5,5,16,4,19,4,16,3,16,2,1,0,4,1,5,1,15,4,1,5,5,11,3,3,1,4,4,1,1,5,8,2,1,5,1,8,3,7,4,4,0,2,1,3,0,2,7,3,3,12,6,6,1,1,6,6,8,5,7,3,1,1,21,2,2,2,6,12,7,7,7,15,5,5,8,6,5,0,8,0,3,1,1,3,1,4,8,5,5,11,2,2,0,3,5,3,4,9,30,24,2,3,8,4,0,7,6,4,6,5,4,1,1,16,7,2,6,1,2,7,2,1,11,7,1,5,2,5,3,5,1,5,2,2,6,1,9,13,2,5,3,2,4,7,2,2,12,8,6,1,1,2,3,5,2,10,11,4,4,0,1,11,1,1,24,3,1,5,9,1,12,3,9,14,7,1,21,24,4,1,15,3,3,4,10,1,0,13,11,5,6,7,3,0,6,5,4,5,6,11,3,2,7,1,1,5,4,7,5,2,2,0,3,9,2,11,3,6,7,11,5,5,12,2,10,1,2,3,13,4,1,10,4,5,4,6,7,10,1,11,16,9,2,1,3,4,3,7,4,1,1,6,5,17,5,5,5,36,7,5,2,1,3,8,11,7,1,7,4,1,0,2,3,1,0,2,5,10,14,2,4,4,5,1,4,11,0,1,5,14,7,9,4,4,1,6,1,3,9,9,10,3,3,5,3,0,6,6,1,1,5,3,7,4,6,4,2,0,1,5,3,13,4,9,2,1,3,8,4,0,1,20,1,6,3,3,1,5,2,9,3,1,1,2,19,0,8,4,7,1,5,4,8,3,5,6,0,6,8,8,5,3,2,19,4,14,3,5,5,9,1,2,5,2,2,3,9,2,4,1,3,2,4,7,2,2,1,3,0,2,2,4,1,3,3,0,4,6,1,3,3,1,6,6,2,0,8,5,1,1,2,0,1,3,1,6,8,2,2,1,5,1,3,0,3,5,1,5,1,0,2,10,4,1,2,3,3,2,2,2,7,2,3,2,3,5,1,0,7,9,0,1,4,3,4,3,1,2,1,12,6,4,3,1,5,4,1,0,4,0,2,3,6,3,0,4,1,5,4,3,2,3,3,1,0,1,1,1,0,1,0,2,1,0,4,2,2,2,0,5,0,2,3,0,1,6,1,0,6,1,3,1,2,3,6,5,3,7,1,9,1,5,5,1,2,8,3,2,2,0,3,4,2,4,1,2,3,1,0,3,2,1,2,0,6,4,1,9,0,4,3,6,2,8,5,7,20,0,7,1,2,3,3,8,1,3,10,3,2,9,3,8,1,5,1,1,1,5,7,0,0,2,3,3,0,5,2,0,3,4,2,1,1,1,3,5,0,0,0,5,4,0,1,2,1,4,1,0
issue,11,37,22,266,14,10,5,53,14,1,19,6,11,81,3,9,16,41,12,6,19,91,42,56,29,22,26,38,11,64,26,338,206,19,61,107,66,35,26,4,14,9,9,6,62,33,97,20,611,47,107,13,20,49,14,5,105,30,20,21,22,6,2,14,48,23,179,15,9,25,38,2,16,6,137,23,25,9,203,39,86,3,26,7,481,90,53,1,81,20,32,12,2,65,136,48,31,13,59,24,20,50,87,22,18,81,22,15,33,14,39,22,19,52,7,43,25,15,191,370,62,45,37,157,8,11,4,8,19,8,16,8,6,91,43,75,7,15,17,16,5,41,67,5,0,139,9,10,19,40,133,8,64,18,4,38,46,20,16,28,26,2,10,17,0,22,12,30,49,24,18,135,36,2,20,9,303,13,25,70,38,17,4,42,5,34,58,30,92,78,9,20,7,4,2,12,88,16,18,22,63,7,6,22,71,18,42,54,22,30,136,26,63,14,8,19,8,4,40,2,23,38,12,25,101,231,45,72,22,46,9,34,46,46,59,34,44,11,10,9,132,46,13,11,19,24,22,59,105,12,34,31,35,43,19,42,18,17,11,36,8,62,63,32,10,76,4,17,26,8,230,45,204,9,11,4,52,17,19,8,91,13,3,25,16,3,11,27,36,6,12,11,63,18,19,20,130,11,22,34,44,49,8,17,21,4,24,11,9,0,3,23,78,14,159,43,27,69,48,13,48,14,40,9,85,18,11,56,19,62,19,23,10,13,12,28,29,18,12,35,19,27,53,27,12,9,108,77,38,15,20,24,8,99,48,0,10,10,27,68,37,9,12,62,5,5,77,9,17,30,7,51,13,31,15,33,15,5,16,13,128,3,78,15,17,53,6,57,53,12,28,8,25,12,52,35,93,23,155,6,34,10,6,8,14,12,14,5,57,12,1,5,9,7,18,18,11,12,4,10,6,27,36,23,8,7,5,21,21,41,265,46,12,43,12,12,8,30,12,16,25,27,7,18,1,6,21,20,51,32,64,11,14,39,61,26,4,29,24,60,34,35,36,36,13,7,30,10,7,6,27,17,5,6,6,21,6,29,33,9,10,24,4,8,5,24,27,12,3,11,110,79,4,14,22,15,7,50,15,19,16,8,20,4,16,239,1,27,13,7,15,8,21,7,23,30,17,8,7,10,6,33,29,47,19,13,56,24,36,40,40,10,7,18,21,19,25,10,81,39,9,5,10,6,20,13,8,44,26,13,67,17,21,84,12,14,24,13,16,16,64,18,61,7,19,36,40,15,88,87,18,15,24,4,9,24,7,8,17,55,5,42,22,30,17,7,4,10,10,15,28,56,36,8,20,5,10,3,43,46,38,8,9,3,12,58,18,50,10,15,56,37,19,11,70,22,32,4,15,16,58,168,10,1,21,3,7,19,11,55,228,31,49,39,19,10,13,22,5,17,24,2,30,58,11,95,5,11,12,369,25,9,20,8,10,32,107,25,21,18,17,7,24,24,10,5,1,18,30,19,37,22,74,115,30,20,4,11,17,2,24,36,23,10,22,8,38,6,5,13,28,28,45,28,19,13,21,3,17,32,8,4,6,10,11,22,24,14,21,10,6,48,7,33,29,52,26,11,17,5,24,10,12,44,7,16,12,2,7,28,17,28,24,8,14,10,15,10,63,10,18,7,1,11,10,18,31,5,6,12,19,31,17,46,37,20,12,16,11,130,113,18,22,40,35,67,10,6,5,17,13,6,4,44,8,39,34,5,15,18,3,12,20,41,12,5,28,82,53,29,14,35,7,12,19,31,9,9,13,9,11,17,29,9,16,9,24,11,30,10,12,12,17,24,7,9,14,17,17,37,7,8,19,31,5,8,7,34,96,10,44,14,26,13,8,10,6,51,14,12,10,14,10,21,9,27,13,16,19,14,38,76,11,10,5,13,18,25,21,7,10,17,12,6,20,19,4,10,11,31,6,8,216,133,8,8,4,8,18,4,6,47,15,8,18,8,21,13,10,27,10,13,3,10,16,32,7,21,24,8,11,20,11,4,17,12,3,81,4,30,27,38,13,46,14,34,4,4,6,4,29,13,12,4,4,11,1,21,2,87,6,11,16,7,7,11,19,15,7,5,8,48,30,18,9,87,29,28,289,4,0,7,4,35,8,37,8,2,107,12,11,6,9,8,9,21,7,12,6,5,7,5,4,9,11,8,8,28,6,3,10,3,20,104,11,11,10,19,13,6,3,4,3,4,4,2,3,13,1,8
available,0,5,1,71,0,2,2,4,1,0,5,2,6,28,3,3,5,5,4,1,1,19,5,11,12,10,4,6,3,7,3,137,63,7,19,15,14,10,7,5,4,3,1,6,8,4,25,7,62,9,13,3,4,15,5,1,10,17,3,4,3,0,3,3,6,1,40,5,4,4,20,3,0,0,51,5,13,0,32,7,32,3,5,2,60,14,18,1,9,4,8,0,4,18,23,14,9,3,12,10,12,14,8,5,7,12,2,2,4,1,9,6,11,17,6,7,1,1,32,43,16,10,11,33,1,1,0,2,3,2,6,1,2,21,6,27,0,3,7,6,2,15,12,5,0,17,3,4,16,6,29,3,6,13,2,27,10,10,2,17,8,4,2,6,8,8,7,13,11,3,9,27,11,1,0,8,52,3,8,42,15,6,15,13,0,6,14,7,4,10,1,0,0,0,4,4,21,5,8,3,18,5,4,1,10,2,6,14,7,9,27,3,9,1,1,4,2,4,5,9,9,7,1,8,18,64,13,5,7,15,6,6,6,7,17,12,9,7,13,1,23,10,5,4,9,5,2,7,34,3,14,6,7,9,4,4,2,3,0,4,0,11,9,2,2,33,9,4,1,1,72,20,21,2,3,4,8,7,2,7,15,1,8,5,2,6,12,7,4,1,2,1,9,5,1,6,8,4,0,2,6,24,4,2,11,0,9,3,3,2,2,16,23,3,20,13,11,13,15,0,10,1,8,2,8,1,7,7,2,17,0,6,1,5,0,11,2,3,4,9,2,2,8,4,6,2,15,10,7,9,2,1,3,55,5,3,1,5,7,21,8,13,10,12,1,2,10,2,2,7,3,13,3,8,5,33,7,5,1,6,22,1,31,6,4,39,1,6,14,2,4,3,5,2,10,10,17,2,18,2,4,1,1,1,3,5,1,2,5,2,1,2,4,17,0,2,2,7,2,0,2,3,3,5,3,4,2,4,2,5,10,3,1,3,2,1,0,6,5,0,4,15,11,1,2,0,12,2,15,9,4,0,1,3,15,2,0,2,3,9,3,7,11,10,7,2,13,6,14,1,10,6,0,0,0,4,2,1,16,2,3,4,0,1,1,1,7,2,0,4,30,14,1,0,2,1,2,15,2,3,0,1,2,9,3,15,10,1,1,1,0,0,3,4,7,10,5,1,2,2,0,5,1,7,1,4,10,4,5,10,5,0,3,3,2,3,1,1,16,18,2,0,3,16,7,1,0,9,1,4,2,2,1,16,9,6,9,4,3,4,6,2,8,6,4,3,2,2,25,11,6,3,20,0,14,1,0,0,1,13,1,9,2,2,1,4,0,1,4,2,6,6,9,8,8,1,0,0,6,4,6,5,3,1,5,9,2,4,6,4,9,12,4,1,5,5,5,1,2,4,11,8,4,21,1,1,2,5,5,14,7,8,2,5,4,4,6,7,0,2,2,4,1,13,0,18,6,2,5,29,1,8,4,3,4,3,19,3,0,5,1,1,1,2,1,1,1,5,6,3,15,3,7,4,3,3,0,1,7,4,4,6,2,4,2,1,3,3,1,1,6,8,4,1,12,6,1,1,0,3,0,1,2,3,3,6,7,2,4,1,1,9,0,12,5,11,5,1,2,2,2,5,1,9,1,3,1,0,3,5,6,8,5,0,1,1,12,5,11,1,6,1,7,4,3,2,5,17,2,3,5,7,9,9,10,5,3,6,3,17,7,7,5,12,15,8,3,1,10,9,5,2,3,4,3,5,14,3,4,5,1,3,5,0,5,3,5,1,1,4,5,2,2,0,1,5,1,2,2,1,3,2,2,4,0,1,2,1,3,3,3,0,1,13,1,0,5,2,1,4,0,4,7,5,3,1,3,3,2,0,6,0,4,0,1,4,0,2,2,3,1,1,0,4,0,4,6,0,0,0,3,8,5,1,7,0,1,2,0,1,2,1,6,3,2,4,0,1,2,9,2,1,9,4,2,1,1,2,1,0,1,2,5,0,3,1,6,0,4,2,2,3,5,3,0,2,1,1,3,2,3,0,1,6,1,0,1,6,3,9,6,9,2,15,3,1,4,13,1,3,1,0,3,1,1,3,0,1,2,8,6,4,1,3,1,0,4,2,0,6,1,1,9,3,2,12,5,14,35,0,4,2,3,4,5,4,4,0,15,0,9,3,2,0,3,4,4,4,0,0,5,0,3,5,1,1,3,4,3,1,2,1,1,9,2,2,1,8,0,3,4,7,1,1,2,0,6,3,5,3
desirable,0,10,8,100,2,3,5,18,1,2,11,7,7,22,3,8,5,10,0,4,2,23,2,12,10,4,6,5,5,6,7,102,81,6,33,33,29,5,7,4,11,1,3,5,23,11,20,11,175,8,28,0,3,16,5,5,53,11,1,7,22,5,4,16,20,1,42,9,15,12,6,3,1,1,37,5,25,3,57,15,49,0,10,3,148,20,20,0,19,1,2,1,0,9,43,23,16,7,19,12,8,24,34,3,8,18,4,1,13,4,8,5,2,15,0,19,1,6,26,146,26,8,69,28,5,0,3,2,2,1,3,0,7,44,5,32,1,2,3,2,0,20,13,3,5,42,2,9,3,7,39,2,9,7,2,26,27,1,1,3,6,4,8,1,0,3,4,10,8,6,8,50,17,0,1,5,116,1,6,33,12,7,2,13,4,13,25,11,33,29,2,5,6,0,1,2,15,2,10,11,20,0,0,10,15,3,7,21,7,15,55,3,20,11,2,0,1,1,9,5,1,6,9,17,25,64,14,22,4,6,14,5,14,4,16,29,19,11,4,8,43,31,3,6,10,5,3,10,45,2,2,25,8,8,14,9,5,1,5,16,7,15,7,3,5,26,6,0,4,4,117,3,26,4,2,2,7,9,9,3,23,4,1,12,12,6,2,1,5,2,1,3,7,8,0,7,28,2,5,11,23,42,0,1,13,3,12,2,2,0,2,15,22,7,38,10,13,27,7,8,20,2,24,1,27,4,4,7,0,13,2,11,11,8,3,14,9,3,3,14,7,2,11,4,5,1,31,39,13,4,15,4,2,28,12,5,2,2,13,18,26,5,5,15,4,0,21,5,2,9,0,8,3,10,3,33,6,6,8,4,47,2,31,5,2,23,3,16,19,0,17,4,11,13,31,6,50,4,24,4,16,3,5,1,7,6,0,1,15,6,2,8,6,24,7,5,2,3,2,0,1,1,14,7,2,5,1,5,13,2,0,2,3,6,1,1,0,9,5,4,9,11,5,9,8,0,3,1,20,3,3,2,1,3,27,6,0,10,3,31,7,8,23,14,3,1,12,6,8,0,8,2,1,6,2,12,1,13,27,5,0,6,4,0,6,9,3,0,2,2,35,32,1,2,6,4,3,6,4,8,7,3,8,0,8,11,3,13,9,3,2,2,5,12,9,11,6,6,1,3,2,10,9,18,8,5,10,6,17,17,7,6,2,13,16,4,5,7,17,17,5,1,4,7,10,4,4,13,17,8,11,1,7,20,5,14,35,5,3,11,29,2,12,6,11,12,9,4,39,41,14,3,10,1,8,2,14,4,7,2,8,10,25,6,11,5,8,7,3,10,11,22,8,2,25,9,2,0,18,18,19,3,6,2,6,21,8,13,16,4,16,25,5,2,35,3,29,0,9,6,12,1,5,3,1,1,7,13,10,19,6,17,19,11,8,1,13,9,5,7,15,3,5,11,5,25,5,2,5,91,27,2,4,7,9,5,18,12,1,8,5,5,5,11,5,2,3,16,5,14,16,11,5,32,14,4,8,9,1,3,0,23,4,6,6,7,4,2,4,15,7,9,9,11,4,9,3,0,24,10,6,3,2,3,12,6,6,2,1,1,1,4,5,22,9,8,1,5,8,5,4,6,2,14,1,10,6,1,3,8,5,14,4,8,6,4,17,5,9,9,6,7,1,15,10,6,2,11,5,2,5,1,3,4,0,6,2,15,6,14,14,9,2,1,16,20,15,7,3,8,11,0,0,7,4,8,3,4,5,9,7,4,2,0,5,12,0,1,11,8,4,15,4,7,8,11,4,4,0,1,2,5,3,6,1,0,3,5,11,3,13,4,11,4,9,2,4,6,2,6,1,2,8,7,7,3,2,6,4,0,4,5,5,0,3,5,8,12,6,2,4,6,10,6,1,10,6,6,9,7,6,9,7,6,1,4,5,3,2,0,4,1,3,2,6,5,0,5,5,14,4,5,6,4,0,2,2,5,3,7,7,1,1,2,9,4,6,3,3,7,2,11,1,3,7,5,2,0,5,1,3,2,2,6,3,5,0,3,2,16,3,4,4,5,7,2,2,4,1,3,5,7,4,15,3,1,6,1,1,1,4,5,2,5,6,4,5,7,3,9,7,12,1,10,4,4,6,4,16,5,2,4,1,4,5,4,6,6,8,3,3,3,3,1,3,15,1,0,6,6,3,2,1,0,2,6,4,7,4,6,4,8,4,2,1,18,8,2,7,1,2,3,5,0,1,10,0,4,1,0
communication,5,19,1,105,7,2,2,28,23,0,15,16,5,40,9,2,6,20,6,4,4,32,0,12,13,13,6,13,4,11,10,108,79,2,23,32,28,8,4,4,1,6,5,2,8,20,34,5,268,17,36,4,8,38,2,4,37,28,0,12,17,18,1,40,11,4,49,1,4,37,0,3,1,4,31,9,7,2,44,12,26,0,32,3,161,11,6,0,28,1,7,0,1,18,41,13,16,2,23,6,19,22,33,7,6,16,2,1,5,2,11,3,3,8,2,32,4,1,39,116,21,9,0,23,4,0,2,9,1,2,10,6,2,36,9,27,2,1,3,3,1,26,19,0,5,45,3,4,11,9,32,2,11,3,3,6,6,3,4,5,7,2,5,0,0,0,3,4,10,5,24,52,14,0,2,6,108,1,6,15,12,11,2,16,15,11,18,8,27,45,0,2,3,0,1,3,7,0,4,5,5,0,0,8,24,7,1,15,8,12,60,0,25,7,0,0,0,0,8,3,0,11,5,14,33,39,17,8,1,0,16,6,16,32,29,8,19,7,3,5,30,22,8,0,8,1,3,9,22,6,9,7,10,1,6,15,7,4,2,3,1,12,19,3,6,30,4,3,16,5,77,1,8,4,3,2,15,8,10,0,33,3,1,9,4,7,0,3,4,0,14,9,5,1,1,7,52,14,6,12,10,27,0,0,7,8,16,3,2,1,5,9,13,3,12,11,15,22,9,4,23,6,19,0,89,3,3,22,6,17,0,1,4,3,5,23,11,6,2,5,8,11,11,7,5,7,26,36,18,0,4,6,7,24,22,11,4,1,11,15,14,11,6,11,10,1,34,3,1,4,1,10,1,3,1,15,1,0,5,6,65,2,28,10,1,60,0,24,26,2,6,2,11,5,41,7,73,8,34,3,13,3,2,1,3,2,4,3,16,7,0,13,2,15,18,3,4,5,6,0,0,7,9,4,0,3,6,5,5,11,5,6,4,5,1,15,1,15,8,6,9,16,7,12,0,6,0,3,40,2,5,5,2,6,49,6,0,14,4,23,5,9,18,4,6,3,4,18,10,0,4,1,1,0,3,5,5,18,5,3,3,10,21,9,7,1,8,1,1,2,51,40,3,6,2,8,2,9,3,8,3,1,4,0,28,1,0,8,6,5,1,0,4,4,8,7,4,3,1,6,6,8,4,16,8,3,12,2,7,20,4,5,2,1,0,6,13,5,25,16,5,2,0,0,6,4,1,12,11,10,10,4,2,40,1,6,32,5,8,4,20,5,8,2,8,14,10,4,24,23,6,8,14,1,5,11,3,8,5,9,6,25,10,10,5,3,4,3,2,11,6,30,2,0,7,1,1,0,29,7,10,2,1,3,9,14,7,12,7,3,8,13,10,9,13,7,9,17,12,6,8,1,4,7,2,7,1,9,9,35,2,25,8,15,2,3,3,3,1,1,0,0,6,17,4,40,3,5,2,179,28,6,9,5,5,24,15,18,2,15,3,4,6,25,8,1,1,3,6,11,10,6,34,11,17,10,7,12,9,6,11,23,13,16,11,7,6,5,8,15,21,6,26,35,5,9,4,2,11,16,8,4,5,3,6,3,16,13,6,13,2,16,5,25,11,10,3,7,5,2,6,4,2,10,0,9,5,2,5,11,4,8,1,3,4,4,13,4,24,5,5,14,5,11,14,0,5,5,1,3,10,2,1,4,4,8,4,17,5,3,3,4,2,1,15,5,7,7,4,2,1,4,1,4,2,11,0,4,1,5,0,5,6,0,4,10,2,10,5,13,9,5,1,3,14,14,10,15,4,3,6,9,13,9,0,4,8,3,17,5,4,9,18,9,5,7,4,7,10,7,4,0,10,15,5,4,0,6,0,6,4,3,10,2,4,4,13,11,16,8,9,6,1,3,2,12,2,3,8,8,31,19,1,6,4,1,6,3,7,2,5,8,5,5,2,0,3,2,11,12,1,2,3,0,4,0,7,32,14,1,3,9,1,3,7,3,6,14,2,7,16,11,0,11,7,9,3,10,4,1,0,11,4,8,0,3,18,3,2,18,6,0,8,4,7,1,3,7,0,4,11,4,0,6,1,11,0,33,5,0,6,2,8,4,3,3,22,0,3,20,1,5,1,0,1,8,1,6,9,3,2,6,1,1,5,0,14,19,3,12,2,9,0,4,5,23,8,1,0,15,4,13,4,3,9,11,0,1,30,10,25,8,3,1,8,1,6,3,26,2,10,1,8,1,0,0,0,6,6,1
suggest,6,16,7,170,7,4,2,11,1,4,4,11,4,53,4,5,5,13,1,1,5,23,2,20,24,7,2,8,9,7,9,185,94,9,36,35,28,10,9,4,20,7,4,7,35,16,30,11,207,14,25,1,18,24,3,8,42,50,0,14,14,9,5,10,31,7,75,5,8,32,3,2,6,2,51,14,9,7,74,10,54,1,11,5,182,20,14,0,31,7,5,4,2,24,66,17,13,9,26,14,7,26,26,7,8,32,9,2,4,0,14,3,14,12,0,24,5,6,46,219,34,5,17,59,4,2,4,4,3,1,5,4,1,50,8,24,3,5,4,4,2,40,13,0,1,55,1,13,14,15,49,1,11,10,4,30,13,5,7,2,10,3,3,3,4,2,1,18,19,5,16,67,22,0,4,7,147,2,10,42,14,11,2,10,5,12,26,21,28,19,1,1,8,1,1,4,48,3,5,5,30,1,2,13,18,6,3,28,8,27,53,5,13,10,0,0,2,3,12,8,3,18,3,14,50,124,20,15,4,13,16,7,24,8,28,35,24,7,7,5,56,25,3,4,10,9,7,13,44,6,16,17,20,9,7,22,9,5,4,19,2,13,29,3,4,48,7,2,12,8,174,8,25,7,8,0,13,19,9,2,37,11,0,13,6,0,7,8,14,2,5,2,10,5,4,11,33,5,10,14,13,67,0,10,12,4,10,4,2,0,2,13,17,0,40,17,28,35,15,3,29,14,21,5,40,4,9,10,1,20,5,11,5,5,4,19,18,6,4,10,10,8,18,12,18,6,46,46,15,5,18,9,3,37,20,14,5,6,17,9,40,12,15,19,4,1,51,2,10,9,4,17,8,11,7,26,7,5,8,8,46,1,41,8,2,28,5,16,17,1,22,2,13,8,47,4,72,13,25,7,12,1,6,1,9,7,5,1,19,14,1,12,3,23,11,11,3,6,9,2,0,5,17,7,0,6,1,11,8,7,11,1,2,7,4,1,1,4,12,1,15,27,10,9,1,1,4,11,48,7,23,5,3,6,30,15,0,4,10,32,6,12,21,23,10,0,22,12,9,0,3,0,1,2,6,6,4,16,22,2,5,8,5,6,7,3,6,0,9,0,61,41,3,4,11,3,4,13,10,14,8,6,4,2,5,13,5,13,12,2,10,14,2,12,28,26,3,12,3,5,4,13,12,14,8,4,18,4,19,35,7,7,7,6,8,8,15,4,32,9,7,1,1,7,12,9,2,15,18,13,14,4,8,35,9,9,27,5,6,14,49,7,38,9,15,17,10,7,42,45,10,9,13,3,6,9,15,5,7,10,12,13,8,13,11,3,8,8,4,14,24,31,10,2,17,2,6,10,21,19,27,3,6,2,10,37,6,15,12,7,24,36,11,4,29,12,23,7,11,10,12,1,6,19,5,13,9,1,18,27,15,41,31,22,4,2,18,4,3,7,16,2,5,17,7,44,9,3,8,110,14,4,2,20,8,3,30,9,2,19,11,4,7,10,2,2,6,8,8,7,12,6,13,52,26,5,11,10,1,4,5,34,11,10,14,12,6,4,3,7,5,7,16,24,9,6,2,5,10,13,9,6,14,6,10,12,10,10,9,6,1,3,1,34,12,25,5,8,9,14,7,3,5,18,3,5,13,2,4,7,14,15,6,10,5,5,22,5,27,4,12,7,8,5,22,5,22,8,7,2,8,2,3,2,1,10,8,16,3,27,25,7,1,4,14,13,11,8,3,13,5,2,4,17,1,20,5,1,5,7,6,5,7,8,8,8,3,1,9,13,10,13,4,6,6,28,5,3,5,10,7,6,6,6,3,3,6,3,15,5,6,4,6,8,3,5,5,7,6,9,7,4,14,3,8,7,4,7,3,1,5,3,11,4,5,8,11,17,9,4,4,4,10,10,8,15,7,2,15,7,27,22,6,8,5,4,9,5,5,4,7,3,3,2,5,11,6,6,9,26,4,4,24,21,2,6,2,7,4,5,3,6,4,3,15,3,6,7,2,5,3,16,0,1,3,3,4,2,3,0,8,4,4,14,9,3,1,6,1,22,4,19,7,8,7,3,5,6,1,6,5,5,5,11,1,7,6,3,2,5,5,14,11,3,3,4,6,3,2,24,5,12,4,6,14,12,13,19,38,5,2,2,4,3,7,2,6,5,22,3,1,2,5,5,4,16,12,6,0,11,9,3,4,1,1,4,5,7,8,3,17,7,3,11,4,20,8,3,21,1,4,3,8,0,4,5,1,2,2,1
character,1,29,10,157,14,2,6,33,6,6,19,16,15,89,11,10,7,13,12,5,9,48,8,30,29,12,13,11,9,8,16,216,166,12,82,65,46,8,2,7,7,13,2,7,29,33,38,15,340,20,53,3,17,34,22,8,75,24,6,16,19,12,5,10,27,8,133,10,4,13,7,9,12,2,99,23,18,5,103,28,36,1,20,9,258,16,18,0,33,0,3,11,0,21,64,8,28,4,46,15,21,33,32,13,13,29,3,2,12,3,18,9,11,9,2,34,4,3,64,150,48,15,7,51,9,4,2,5,4,1,16,7,9,32,20,70,23,4,7,12,6,42,30,2,4,79,5,17,13,16,78,1,12,9,13,35,25,4,17,13,12,0,8,0,2,6,2,21,25,9,14,88,11,1,5,10,207,13,9,52,26,15,4,24,12,31,43,26,37,52,4,9,7,0,2,2,16,10,7,22,29,0,3,12,29,14,9,49,13,30,103,2,16,7,3,1,1,3,23,4,1,24,10,20,60,133,40,23,3,1,26,12,7,25,44,15,38,12,8,9,79,40,15,3,15,3,6,32,41,5,14,30,30,7,23,11,17,2,6,16,4,20,14,4,12,45,10,10,17,9,164,10,16,2,6,0,15,14,14,4,72,11,5,35,7,4,3,13,23,2,3,3,20,4,1,9,40,15,11,30,26,36,0,1,11,3,23,10,10,1,0,16,30,5,23,14,10,49,6,7,73,15,40,16,81,10,8,23,13,38,4,11,17,9,11,27,28,13,7,12,16,18,25,18,7,4,31,65,29,2,18,23,5,28,19,4,9,11,11,22,37,8,17,12,13,8,33,11,8,9,3,23,10,14,13,60,13,9,22,9,79,4,51,10,16,43,5,28,32,7,36,9,20,15,37,12,76,5,42,4,37,3,4,1,5,14,2,10,16,13,4,9,1,19,15,9,2,6,2,1,6,19,24,14,4,9,1,26,16,15,9,6,0,7,5,4,0,18,6,7,9,15,6,6,2,1,11,7,34,11,18,7,3,4,42,26,4,10,11,40,9,26,37,42,8,13,19,11,5,1,27,6,6,10,9,34,2,21,23,10,4,7,5,10,19,15,15,9,9,10,61,41,2,6,12,9,5,21,8,19,13,2,4,3,18,18,10,12,6,11,2,12,10,11,23,19,7,18,11,9,2,26,11,39,6,8,30,7,27,24,16,12,1,25,11,11,19,21,45,28,3,2,3,21,7,12,4,23,13,14,54,10,13,55,5,16,35,4,6,9,33,7,23,3,25,21,12,6,29,40,24,10,21,0,7,11,10,11,7,6,6,18,9,23,9,13,13,14,7,7,35,62,10,3,15,3,19,5,41,37,22,3,7,7,6,26,19,30,17,10,37,33,24,7,34,11,33,7,15,6,28,3,7,11,5,10,9,18,1,29,2,23,59,21,8,6,11,7,8,14,22,3,8,36,11,32,7,2,6,172,21,8,7,11,16,16,39,23,6,13,13,11,24,11,7,4,2,8,8,12,22,14,30,34,29,12,7,19,2,4,7,23,25,11,14,13,19,4,2,6,8,13,17,14,5,16,14,3,14,25,4,7,14,10,17,8,24,10,1,10,23,1,5,33,25,28,12,14,7,11,15,11,10,44,4,6,7,2,6,15,8,17,2,13,9,4,31,7,56,12,15,11,7,21,17,6,19,8,11,13,22,0,0,3,1,15,16,11,4,11,9,17,3,0,20,15,18,11,10,14,8,6,12,42,10,12,7,1,9,6,4,8,13,7,9,8,2,13,12,14,10,16,6,14,14,31,11,4,5,16,5,7,15,10,4,7,17,8,28,12,4,3,12,8,8,3,8,7,9,13,11,5,1,25,6,9,3,5,9,4,4,9,21,6,14,15,15,26,16,6,11,2,6,13,9,5,6,2,16,13,27,29,7,6,7,7,8,5,7,0,7,5,13,5,10,15,7,5,7,14,3,10,0,4,6,8,5,16,15,3,0,6,5,5,11,7,12,6,2,11,4,12,2,10,21,5,9,5,3,4,6,9,3,16,15,3,5,5,6,36,5,2,6,4,20,4,5,5,11,1,13,9,2,10,0,12,5,22,6,2,11,3,9,10,15,7,8,8,8,16,1,16,0,4,6,7,14,3,14,9,3,3,8,4,4,4,8,10,18,7,7,5,5,9,0,20,7,1,9,11,10,9,18,0,7,4,2,14,11,7,2,17,7,1,7,7,6,4,27,2,13,2,7,0,1,4,1,11,2,0
establish,15,77,21,420,23,10,14,114,14,13,81,27,26,178,16,40,30,30,14,10,12,110,23,56,50,12,25,35,12,32,32,451,368,43,128,166,126,20,39,13,16,28,8,8,70,28,61,68,829,66,89,15,34,92,18,12,147,68,6,41,53,19,17,44,46,21,218,12,25,80,50,17,13,19,161,38,45,10,179,47,168,2,69,32,559,52,37,0,87,6,18,22,19,59,109,48,40,25,84,43,22,97,72,22,43,91,14,6,34,11,47,17,11,57,9,70,21,13,272,398,74,46,26,190,14,11,15,12,8,12,28,16,14,129,45,91,21,15,15,22,12,91,74,8,12,169,12,23,45,41,194,2,27,27,20,86,35,30,33,37,36,8,24,13,8,10,16,52,66,39,86,219,51,11,7,21,376,8,28,84,57,50,37,45,23,50,67,39,90,138,8,13,15,2,2,9,45,25,34,34,72,2,12,30,115,21,21,147,30,108,193,9,85,22,3,1,3,10,70,12,8,58,13,32,94,294,47,51,8,24,28,39,47,65,71,88,67,38,30,25,156,82,24,21,34,11,13,38,132,19,26,41,44,21,25,45,19,6,12,65,10,94,47,14,15,113,35,12,35,14,353,27,69,26,10,11,67,42,27,15,114,12,4,61,29,11,22,14,28,9,19,10,29,10,15,22,84,17,23,51,60,94,3,10,28,8,53,19,26,13,9,50,69,35,77,63,52,116,40,17,121,13,54,29,174,44,18,61,12,79,10,22,22,19,22,41,53,23,16,32,21,27,31,36,18,30,112,114,50,21,31,26,21,71,49,28,22,17,43,40,72,28,30,52,15,9,83,20,24,26,7,51,18,39,22,110,37,10,20,18,182,7,112,23,15,159,31,44,64,15,71,20,35,47,84,28,142,16,97,16,61,7,15,6,21,10,16,23,73,45,12,37,19,42,27,30,12,18,12,9,17,22,57,44,9,15,14,22,20,45,26,18,7,31,16,13,3,19,14,26,25,58,16,39,14,17,26,11,94,24,62,17,11,13,123,36,5,43,24,78,31,53,95,73,25,10,44,58,25,2,49,7,14,7,10,43,12,51,42,25,20,30,22,5,31,19,34,15,11,24,169,71,6,17,31,32,9,41,16,25,22,14,8,4,31,80,26,31,15,17,10,17,23,24,47,41,17,25,20,24,13,55,26,59,16,13,45,28,25,68,31,19,12,32,29,19,29,28,109,42,15,15,8,29,35,15,31,45,33,25,144,25,31,152,38,29,84,12,16,15,55,9,75,9,44,41,41,29,119,111,36,34,42,7,15,19,13,22,14,43,31,34,36,30,26,18,13,18,14,22,79,83,18,20,49,13,34,11,114,42,76,8,14,9,21,46,10,80,28,25,63,67,50,22,66,33,49,34,15,11,30,12,10,55,14,19,35,27,29,1,47,58,78,79,40,11,12,33,5,21,28,9,16,58,33,59,11,9,25,455,64,18,18,14,18,36,112,49,24,30,17,39,46,60,25,16,15,30,28,27,43,24,107,123,74,14,20,26,8,25,18,81,29,29,34,13,25,17,30,33,40,26,32,38,16,14,17,27,30,35,32,15,17,13,36,13,38,23,17,14,19,31,19,66,59,74,21,20,16,13,30,12,19,70,11,69,21,12,14,47,17,47,11,16,15,40,33,17,161,31,30,28,13,36,37,15,33,43,15,32,29,12,9,23,11,37,28,59,25,34,30,35,14,12,124,56,39,21,38,40,9,16,7,30,15,38,29,18,66,25,30,11,22,15,34,19,27,109,22,34,15,60,19,24,21,37,24,23,11,29,28,25,45,12,14,7,18,11,51,18,23,26,52,26,14,17,9,18,21,25,10,22,29,52,29,19,8,20,18,25,13,13,43,18,18,15,25,64,38,25,14,26,13,31,18,24,27,11,14,36,59,71,23,27,10,22,27,19,30,10,15,18,20,13,11,27,9,11,21,39,22,13,8,32,10,20,8,30,23,14,6,14,9,14,33,15,17,8,31,19,15,51,1,7,14,13,13,26,13,10,16,11,18,19,17,12,24,36,14,46,39,23,26,15,29,14,17,19,10,13,24,19,17,30,14,15,11,30,15,12,14,15,9,22,14,13,35,12,5,50,11,22,17,3,28,36,22,20,67,9,15,9,11,15,6,18,31,17,50,25,31,11,13,16,13,46,17,14,13,25,33,16,10,11,11,30,5,18,17,46,54,21,12,24,17,19,20,19,47,6,5,13,10,2,6,12,7,10,4,5
gold,1,6,0,100,1,3,0,19,3,3,0,5,16,35,0,3,2,51,2,2,10,65,11,16,14,10,12,12,6,41,0,228,173,8,46,77,7,51,45,5,20,1,13,3,42,6,39,4,322,34,78,2,23,61,0,0,62,19,4,16,11,13,0,4,30,1,127,3,5,2,24,0,9,3,104,14,19,28,151,31,106,2,23,2,429,130,59,0,56,8,26,3,0,29,88,31,19,21,58,26,7,39,70,23,17,23,9,1,44,26,20,16,15,31,1,34,19,8,65,326,23,13,0,88,9,5,12,4,18,0,15,1,1,46,33,22,0,3,12,4,2,24,41,3,2,66,1,20,26,39,79,3,73,4,4,11,25,3,1,13,7,0,13,4,4,33,4,20,12,11,22,129,44,0,22,13,200,3,8,39,39,20,3,28,1,45,39,28,17,80,1,18,16,4,0,10,34,3,21,10,61,8,8,28,112,13,113,38,5,29,93,22,21,10,2,1,8,1,10,1,14,26,0,28,110,95,32,82,21,128,10,25,14,19,55,57,39,11,20,3,112,51,20,1,19,23,6,94,80,8,17,43,12,21,24,30,10,12,10,13,0,34,25,19,10,21,0,10,24,6,195,47,158,14,0,6,45,13,12,2,77,1,0,14,22,0,2,4,33,0,2,2,35,0,6,17,109,1,9,13,37,33,7,12,17,0,17,0,0,3,0,14,53,10,210,40,16,76,39,3,24,6,43,4,15,0,9,29,10,70,3,23,13,7,16,8,22,4,9,27,6,15,22,4,13,3,69,38,19,2,9,15,4,102,31,1,1,3,23,44,18,4,6,15,1,1,78,4,5,11,8,22,15,20,4,7,2,7,11,5,84,0,61,14,7,17,0,94,20,10,1,1,3,0,38,28,51,13,20,2,16,5,15,2,12,11,12,0,43,15,4,2,45,9,6,13,5,10,4,6,1,8,20,15,9,0,4,15,8,34,290,27,0,8,6,2,1,9,4,2,7,15,9,50,0,0,16,18,65,39,48,4,4,33,48,1,3,3,25,35,25,26,34,9,14,1,44,12,1,0,7,8,6,0,0,12,2,6,29,15,5,9,7,1,6,0,26,7,8,0,32,53,0,6,66,7,3,29,10,27,17,10,32,1,4,241,2,17,32,7,2,9,3,0,29,17,7,4,1,15,0,8,31,28,18,5,48,15,30,39,10,8,1,0,3,43,1,3,66,22,5,5,5,12,39,4,2,26,15,8,35,2,7,48,0,8,18,6,9,14,29,4,16,2,23,28,10,9,45,53,9,8,0,0,2,17,14,5,21,21,5,9,17,13,13,2,4,14,10,10,11,35,12,5,33,4,30,10,18,18,21,0,15,0,11,34,1,7,8,17,52,1,4,2,17,16,15,5,4,9,53,197,1,228,7,6,2,15,2,47,1,8,20,17,2,6,8,8,1,19,25,2,6,9,6,63,7,2,0,224,2,3,6,0,4,11,107,15,6,16,5,2,0,11,3,0,3,11,16,8,16,8,3,0,26,1,1,1,3,2,4,19,12,4,13,6,80,5,32,5,18,13,24,7,8,8,12,0,12,18,2,1,3,0,13,7,11,5,12,0,0,40,9,25,17,5,10,10,4,0,14,0,3,13,0,2,9,1,4,20,18,7,64,5,16,1,4,19,13,7,13,5,1,14,5,34,37,5,27,5,28,42,26,24,25,5,12,15,2,71,65,11,27,38,6,149,2,4,0,6,5,11,6,13,3,9,43,4,2,14,0,9,19,17,5,1,22,0,84,22,10,1,0,12,1,25,1,12,6,0,8,12,15,2,19,2,11,21,36,1,21,5,5,17,5,2,9,17,34,53,0,17,8,11,0,9,11,0,114,6,17,2,10,4,7,5,2,51,11,0,2,3,0,3,19,40,5,10,10,4,4,43,4,13,0,13,11,28,2,6,10,8,5,6,31,11,1,6,5,22,0,2,156,212,1,12,4,2,6,0,11,37,0,0,7,5,8,2,1,16,1,2,0,4,5,8,0,2,14,2,17,3,2,8,0,3,0,117,6,10,9,16,3,14,6,3,8,1,18,9,12,11,9,5,0,2,0,2,0,75,2,0,2,6,7,12,5,22,0,4,2,34,15,4,10,146,62,13,282,2,0,7,2,10,2,21,3,1,51,8,0,0,4,0,4,6,3,0,0,5,0,2,8,4,4,3,2,21,10,2,0,2,3,405,7,7,5,6,8,1,0,3,6,5,0,2,3,6,0,3
attention,8,39,20,535,18,6,13,51,11,3,37,23,13,96,14,16,7,29,4,7,24,62,8,36,62,46,22,21,15,28,29,337,244,14,105,61,53,9,14,10,5,8,3,16,71,22,43,29,501,13,50,6,32,41,19,8,137,176,6,36,42,9,5,34,35,11,126,12,10,40,17,14,6,7,101,15,28,12,148,29,123,0,28,19,410,38,24,0,83,5,9,12,2,58,112,31,21,21,55,25,37,69,66,17,16,284,15,4,22,10,29,10,15,22,0,49,11,10,110,246,69,15,17,102,12,4,9,5,5,6,18,5,11,106,19,82,15,8,7,5,1,102,58,9,4,111,5,40,23,32,81,4,23,18,6,51,42,7,11,8,26,8,6,9,3,11,7,29,63,7,37,146,31,0,13,20,369,10,21,91,46,25,6,32,17,35,65,32,96,81,5,8,14,0,6,4,36,8,14,16,58,10,4,25,35,16,11,79,24,42,146,13,41,17,3,5,5,3,44,9,9,32,11,38,98,250,53,40,6,5,34,33,42,27,53,62,69,22,13,19,127,59,20,8,15,12,8,38,120,5,54,33,36,15,24,39,38,4,10,61,20,44,71,8,6,173,14,6,21,15,265,19,66,22,35,1,29,47,39,16,97,19,3,32,14,2,13,20,26,4,14,4,28,9,7,11,82,44,14,30,46,102,0,6,32,2,28,16,17,4,8,31,30,16,59,43,20,67,21,12,95,23,41,5,90,14,27,26,6,52,6,22,14,12,30,27,25,17,7,17,15,14,41,17,13,10,99,96,33,9,22,24,12,61,43,13,7,9,27,54,67,19,16,29,3,5,63,7,15,15,10,30,7,14,23,103,16,3,10,17,125,4,95,32,5,94,20,44,54,5,48,10,29,24,97,16,275,20,51,16,48,7,8,2,10,9,11,3,36,23,3,15,6,64,12,17,7,12,8,3,5,12,37,22,3,8,7,21,16,22,15,17,6,25,4,3,0,16,14,11,50,60,11,17,4,7,17,12,89,14,27,5,1,11,105,23,1,11,15,68,21,19,75,43,16,12,25,10,15,0,23,3,2,4,4,22,6,30,35,11,5,23,9,6,16,9,25,8,12,17,102,99,6,2,23,28,12,32,11,24,14,11,9,1,16,22,10,25,26,8,12,14,9,24,37,44,9,24,5,7,11,29,22,32,17,4,35,9,37,55,21,16,15,12,17,25,19,21,74,43,12,4,4,12,12,26,1,27,30,39,58,10,14,81,26,15,52,9,15,49,76,10,72,9,29,74,25,21,57,80,16,33,37,9,20,14,21,16,10,27,18,61,28,15,16,5,16,14,5,16,42,84,17,9,45,11,3,4,65,29,48,4,11,7,16,50,10,56,28,10,69,68,35,11,76,13,48,10,23,14,27,10,11,31,8,17,25,41,23,58,8,1,45,30,22,4,26,10,21,28,15,1,9,47,16,161,7,14,16,296,50,10,19,23,12,29,52,15,7,23,11,10,33,39,17,5,10,16,38,32,43,18,36,94,85,7,32,30,4,8,8,50,31,53,158,28,19,8,11,29,17,13,46,26,14,25,13,6,26,41,5,5,36,20,29,19,32,12,9,21,8,13,10,55,42,58,10,9,11,24,18,12,11,76,3,33,17,8,25,31,11,44,9,13,14,8,83,13,60,21,21,12,15,17,21,5,27,14,6,17,29,23,8,28,20,36,13,49,15,27,25,16,5,7,32,18,22,29,27,26,9,4,9,34,8,28,9,12,45,31,18,10,18,9,12,35,8,11,12,25,24,49,18,15,37,28,13,40,10,15,7,11,18,23,2,7,4,12,44,15,13,2,15,18,9,6,11,14,4,14,19,12,14,42,16,13,11,20,13,3,19,17,30,7,17,14,21,48,15,18,23,25,13,14,16,23,16,14,39,21,18,48,10,7,8,11,11,13,8,4,8,5,11,6,5,14,14,8,14,92,15,14,10,24,11,10,9,20,37,11,9,10,7,13,42,7,20,20,16,9,9,25,0,5,15,8,12,7,10,2,17,11,9,23,26,6,7,10,21,30,11,7,17,16,20,7,14,13,5,11,11,15,6,19,8,18,10,21,13,13,31,6,15,18,8,12,16,11,19,48,11,17,16,4,12,28,15,27,79,6,15,4,4,13,18,7,10,7,22,6,14,9,8,21,5,44,47,11,5,7,17,7,6,9,13,7,3,11,28,11,21,17,8,10,18,11,16,4,23,0,11,9,18,0,0,4,2,14,6,3
whether,8,29,28,337,19,18,12,129,8,15,35,11,14,134,15,30,15,50,18,7,11,87,34,71,91,33,34,26,9,21,18,409,267,17,163,142,78,17,24,16,13,27,5,6,61,38,61,36,564,52,94,17,25,47,22,20,133,45,5,22,33,24,13,31,59,16,258,32,21,27,12,13,18,12,258,28,53,11,153,81,78,11,22,15,495,43,39,2,60,10,10,17,1,61,116,43,37,7,66,27,13,67,84,28,18,80,22,9,23,14,39,9,15,33,3,55,13,10,152,431,112,47,37,95,10,11,12,13,9,2,29,6,17,99,45,104,36,10,11,18,26,64,43,7,8,153,30,27,40,32,172,5,23,15,14,70,99,14,32,29,25,10,27,4,2,23,9,64,58,10,32,220,70,6,12,14,323,7,33,99,67,32,2,47,17,60,84,69,205,76,17,23,12,5,6,6,27,18,7,57,99,7,10,25,45,22,17,86,21,55,172,15,54,36,11,9,9,3,37,6,9,51,16,41,87,301,56,62,10,7,43,15,37,70,84,61,65,22,10,16,143,66,25,24,35,14,13,57,104,13,20,49,38,10,22,37,15,13,10,38,20,52,78,1,12,73,20,14,36,11,375,20,54,13,25,4,38,26,23,14,144,40,5,43,17,7,13,20,50,12,9,6,28,9,7,14,64,8,15,61,52,66,1,11,27,9,37,21,35,10,0,36,50,5,96,25,30,90,42,14,98,21,79,31,184,23,28,83,16,56,25,22,28,12,40,27,30,13,8,27,24,19,37,28,16,8,94,128,38,19,34,32,10,75,60,20,23,10,38,49,67,11,19,37,12,6,104,30,6,36,5,52,16,43,49,40,13,15,50,23,237,11,92,27,17,80,35,38,68,21,79,17,25,29,73,22,137,12,78,5,58,7,6,2,20,31,16,4,30,23,13,17,6,37,20,26,5,18,16,1,29,25,47,24,25,17,5,48,28,38,18,11,4,19,8,7,4,22,21,15,41,56,13,25,4,5,19,23,68,21,45,14,5,12,108,18,4,25,40,78,36,59,57,110,10,19,40,29,22,5,43,30,9,10,22,110,7,45,53,19,28,22,10,13,18,64,21,11,15,4,113,81,6,7,21,20,10,28,22,49,34,8,4,20,15,54,8,28,24,12,12,23,18,32,33,43,20,42,17,24,6,71,27,59,20,18,54,66,41,84,37,29,10,42,61,28,48,39,117,60,13,2,11,16,14,14,13,53,36,23,113,18,26,107,25,27,47,15,20,20,88,9,47,4,57,31,31,21,70,109,29,26,18,12,20,11,20,22,14,33,24,13,37,45,35,25,22,23,9,25,54,72,17,12,98,28,20,19,77,54,38,5,16,18,12,52,4,50,20,13,66,39,12,9,85,18,45,23,33,12,40,9,16,49,2,19,8,31,59,78,20,45,1,74,30,14,39,11,14,33,41,11,41,25,7,45,17,3,22,265,41,21,15,21,16,19,71,51,34,30,9,14,26,28,12,14,1,17,26,13,29,27,65,70,40,12,6,12,7,13,11,43,46,14,22,13,38,9,8,15,22,30,36,19,6,12,26,15,32,33,12,10,8,14,15,15,23,16,12,9,28,14,19,56,68,26,11,9,32,18,7,22,10,47,14,16,23,13,16,25,14,36,10,26,13,5,31,9,67,18,37,9,5,21,40,15,15,12,7,25,35,14,5,13,8,20,17,22,4,55,54,34,15,15,36,36,23,21,26,20,38,12,14,57,8,34,23,7,11,21,13,14,33,22,15,12,16,25,20,21,10,23,8,19,56,74,16,8,5,7,10,10,18,12,28,9,12,17,34,9,24,1,31,21,14,14,10,17,7,26,8,4,1,12,7,13,9,12,18,11,17,4,27,17,23,24,17,50,31,10,13,37,12,40,16,28,22,9,11,44,31,47,29,12,7,6,26,20,12,1,23,18,14,5,17,16,20,8,13,17,15,10,25,28,19,7,6,8,19,6,1,10,5,3,8,7,23,11,4,9,6,21,1,13,21,7,20,6,6,11,10,5,3,16,34,1,1,16,6,95,4,7,14,19,43,5,7,18,11,7,22,19,7,25,5,17,14,18,1,24,16,4,22,13,13,5,4,14,12,27,14,27,11,11,14,27,27,21,70,9,2,10,4,7,5,3,10,7,42,11,1,5,6,10,5,38,4,3,29,8,8,14,24,10,7,7,5,14,21,9,10,19,33,12,16,20,26,5,24,4,11,4,3,2,3,7,6,13,5,7
form,11,52,23,244,18,12,12,151,11,9,54,20,10,146,14,26,11,39,17,8,7,81,20,62,46,14,27,20,9,28,19,299,216,22,102,105,73,8,20,12,16,27,11,5,69,32,49,17,635,31,93,13,29,52,16,13,122,31,6,34,41,24,7,15,51,16,264,10,13,36,18,5,13,13,143,34,30,6,125,41,64,4,29,16,474,32,21,0,58,4,13,10,7,37,108,31,32,8,60,29,11,39,49,30,19,41,7,9,21,10,30,10,10,39,6,52,9,2,161,310,77,31,34,108,8,12,4,13,1,4,26,5,21,68,35,77,21,4,10,14,9,70,53,7,7,155,19,34,32,26,145,7,26,9,8,58,58,8,20,21,17,11,20,6,2,16,10,21,45,14,38,185,32,5,8,23,366,2,26,51,38,31,4,35,6,47,61,55,102,77,6,12,4,3,3,8,22,12,23,44,64,7,3,18,57,19,13,71,38,44,121,8,55,7,4,2,2,7,14,2,16,54,11,34,92,188,44,53,5,8,20,31,26,41,50,74,68,16,13,20,173,58,7,9,33,15,8,47,94,10,18,48,33,25,23,37,23,3,6,37,9,60,44,9,12,39,37,10,46,7,252,31,55,19,6,3,37,25,24,6,157,25,7,38,32,3,14,23,29,6,5,2,29,11,2,17,78,14,18,47,46,40,3,9,23,9,45,13,22,8,2,54,44,13,53,28,26,58,27,15,89,21,68,20,182,16,25,47,11,75,26,33,18,13,16,24,47,12,8,18,23,25,24,24,11,12,96,111,43,11,23,28,14,64,45,8,27,18,28,40,44,7,14,49,11,8,81,20,19,48,1,34,11,36,40,21,21,13,33,14,161,10,65,34,14,56,25,27,59,13,61,4,41,21,54,27,101,9,64,4,50,8,13,2,19,12,21,3,26,30,16,13,4,37,20,25,13,19,7,2,18,20,35,34,6,6,2,32,29,20,26,18,11,25,14,7,0,16,21,10,26,35,14,18,1,9,16,16,69,17,32,17,2,11,87,24,1,32,31,48,28,54,50,73,15,2,26,23,12,2,39,15,3,7,10,59,9,37,38,13,19,29,13,13,13,25,14,10,17,12,126,68,9,16,13,16,8,23,13,30,31,15,11,12,11,40,14,31,9,12,11,16,20,14,26,46,4,27,20,13,11,46,23,53,29,13,41,30,26,58,25,17,14,17,24,12,22,23,92,44,12,7,13,15,7,12,13,26,22,14,180,19,11,85,43,23,60,11,23,14,36,10,46,9,31,26,31,21,70,68,15,20,15,10,9,23,16,16,18,26,26,29,28,34,26,18,8,21,10,39,59,67,20,11,61,18,22,4,85,38,49,10,9,21,12,34,5,47,12,21,50,30,34,6,78,27,35,5,24,9,24,12,9,39,5,11,15,22,21,79,17,30,74,1,27,9,24,19,6,18,31,7,24,49,22,35,8,1,13,284,36,12,22,10,11,27,91,39,27,38,13,15,43,20,12,26,5,15,18,33,26,14,84,95,50,16,5,17,7,15,6,59,43,16,17,18,30,6,9,19,40,27,29,14,9,17,26,7,33,22,8,12,7,25,13,15,41,16,16,12,7,7,9,55,28,45,5,16,23,5,8,13,17,35,6,18,16,7,12,19,21,17,8,12,13,8,19,12,113,22,20,12,8,11,17,9,20,14,7,13,27,27,12,12,11,13,18,24,7,14,14,18,9,10,31,24,19,14,14,18,15,12,5,35,6,23,7,9,32,32,14,15,27,16,30,7,16,60,16,20,9,16,9,9,22,30,3,14,2,7,10,9,36,9,8,2,17,10,24,5,12,9,23,15,7,15,9,15,8,25,13,9,11,32,6,14,11,27,16,8,10,9,43,10,14,21,23,52,28,11,13,29,22,27,16,15,11,11,7,33,60,57,17,12,9,8,13,12,15,7,14,14,10,6,9,20,17,7,22,21,5,11,11,22,10,15,8,28,19,4,2,8,6,9,15,9,9,12,9,10,5,24,4,5,16,7,10,13,8,5,13,15,5,19,26,12,5,21,7,37,16,13,19,20,40,10,6,13,9,2,17,13,18,38,10,27,9,35,6,11,14,14,11,6,15,10,12,8,5,14,9,19,12,12,8,27,22,32,61,5,3,4,12,9,12,19,3,11,29,10,4,11,3,8,5,33,9,9,32,12,23,14,17,8,14,8,3,14,16,18,7,18,20,12,19,16,21,4,31,5,7,5,7,1,0,3,3,10,6,5
organize,5,14,11,136,1,6,3,67,3,6,31,17,8,54,6,13,5,13,2,1,3,31,4,13,14,17,5,13,3,22,17,154,103,9,54,33,26,2,7,6,1,3,3,3,23,7,16,12,280,10,20,4,4,28,2,0,40,23,0,17,15,2,2,4,13,8,70,3,2,33,4,7,3,8,74,6,17,5,46,13,24,2,14,2,162,10,9,0,30,3,11,4,3,20,30,6,10,5,19,10,17,36,15,6,6,21,2,6,11,3,16,4,6,25,0,9,11,2,94,115,21,11,4,64,5,5,4,4,3,4,1,2,1,62,7,46,5,3,5,4,8,36,21,0,1,45,2,18,17,14,53,3,15,6,5,26,31,6,8,15,7,0,9,2,5,12,3,17,17,7,30,56,24,0,0,8,142,2,8,34,17,7,3,7,1,12,25,19,29,19,5,5,8,2,6,3,8,6,5,20,43,6,0,8,30,8,4,36,10,11,48,3,27,10,0,3,0,2,11,5,2,10,3,15,26,88,22,23,4,10,11,9,13,24,30,13,17,9,8,10,58,22,3,1,14,5,3,10,40,5,4,10,11,3,9,15,8,1,4,31,11,33,12,7,6,51,3,4,8,5,92,8,30,9,4,1,26,4,8,7,51,7,1,14,6,3,11,6,14,2,8,5,14,5,3,4,19,4,3,20,14,25,4,0,12,0,23,3,5,0,6,25,39,3,20,16,7,17,60,10,56,4,21,8,73,19,18,13,1,29,3,7,3,3,9,9,9,9,2,13,5,11,8,17,8,7,39,38,14,9,8,16,5,19,14,9,6,6,10,21,15,9,6,17,4,0,22,6,5,23,3,12,6,9,20,49,10,8,10,5,51,6,35,7,2,31,33,18,25,3,18,5,9,7,22,2,46,6,40,8,13,3,2,2,2,5,10,0,7,11,4,10,5,23,7,5,8,4,1,0,9,8,17,8,3,1,7,24,4,6,5,2,3,16,6,1,2,8,14,6,18,14,6,7,0,4,9,7,32,4,10,6,2,3,35,6,0,16,14,34,11,11,26,38,12,4,13,12,5,0,14,7,2,3,2,15,2,17,14,2,4,7,5,7,7,15,5,4,8,5,67,33,3,3,6,8,5,12,1,4,16,11,3,0,17,27,6,12,3,9,2,5,11,3,5,8,2,6,17,4,5,29,7,32,7,5,22,34,9,24,16,1,13,5,15,10,10,8,33,22,6,8,4,13,7,4,3,12,18,8,38,8,8,29,40,7,16,6,3,10,11,3,26,4,10,11,15,6,32,34,6,10,20,6,10,2,4,10,4,19,9,17,14,10,5,5,3,7,6,5,17,16,8,8,84,0,3,5,41,10,16,5,2,6,8,11,1,19,1,4,16,40,29,7,20,11,9,8,1,3,10,5,2,19,4,8,2,4,8,40,2,22,30,27,1,5,17,17,6,11,15,3,8,21,6,20,14,3,3,138,7,4,5,1,7,7,25,14,13,15,2,5,34,9,11,0,2,11,7,8,10,3,58,43,59,10,4,14,0,9,3,16,7,9,7,10,8,5,17,19,23,12,14,9,8,10,5,2,5,9,12,3,5,5,13,10,12,4,8,5,3,7,3,14,20,38,14,5,11,13,8,8,4,36,7,30,8,1,3,10,12,6,2,7,8,7,17,3,63,9,7,7,3,11,6,7,10,8,2,7,9,5,3,7,3,9,5,12,4,12,13,8,3,2,27,6,19,8,10,10,8,2,0,21,3,4,3,6,20,7,10,3,13,4,12,2,3,73,5,14,9,16,5,4,5,23,1,7,2,3,5,3,12,8,4,10,9,3,11,6,1,8,7,3,2,1,3,4,3,11,3,6,1,14,14,2,3,3,5,6,8,3,10,9,4,10,8,18,13,4,3,10,3,4,1,3,7,8,1,15,9,27,9,3,3,3,5,8,3,1,2,2,6,6,6,5,2,5,4,8,7,3,0,5,2,4,6,6,11,8,8,9,10,3,19,2,10,5,4,2,7,23,2,5,6,15,8,6,3,6,8,4,5,9,4,10,7,8,3,14,8,2,4,3,19,5,3,3,3,1,9,7,1,9,6,7,4,12,3,3,8,3,3,5,1,1,7,6,1,18,6,1,1,0,7,6,0,15,11,4,8,2,7,6,3,2,14,6,16,2,3,6,0,2,4,8,6,2,2,4,17,2,3,4,3,0,2,7,6,10,1,6,3,1,3,2,3,2,11,1,5,4,12,0,4,3,1,10,1,1
fair,5,4,3,37,0,6,2,14,1,1,4,4,2,21,0,4,2,7,6,3,5,22,17,14,10,13,7,6,2,4,6,66,38,5,22,28,13,1,5,4,5,2,2,3,10,7,18,8,67,16,22,3,3,23,8,4,35,6,2,2,8,8,2,3,8,2,38,6,7,5,6,0,1,5,61,2,15,0,23,8,12,0,1,7,72,5,8,0,5,3,5,1,2,6,31,14,4,1,13,7,9,9,4,2,3,7,7,4,8,0,8,5,8,5,7,13,1,2,24,55,25,14,26,31,2,1,2,0,4,2,8,1,2,18,4,37,2,3,3,2,8,12,6,2,0,19,2,7,3,4,27,2,8,3,6,11,14,5,2,12,9,1,5,2,1,7,0,11,11,2,2,43,13,0,3,0,61,1,5,24,13,1,8,4,4,17,18,3,13,24,2,2,3,2,1,0,13,11,5,11,11,0,10,8,12,4,1,22,2,6,26,1,6,4,1,7,8,3,6,1,6,4,3,7,19,48,2,16,4,10,6,8,10,10,14,15,5,2,2,1,20,11,1,4,16,3,0,16,16,4,10,10,10,4,1,5,6,2,1,1,7,8,7,0,4,11,4,3,10,1,41,2,7,0,2,5,11,2,1,1,22,3,1,7,3,3,7,3,8,0,1,0,14,0,5,5,17,2,4,11,8,10,0,2,8,3,7,0,7,4,2,10,7,7,17,5,11,18,12,4,24,1,16,3,31,2,5,8,4,19,9,4,2,1,2,4,5,3,6,1,2,3,5,4,0,3,20,10,2,4,7,7,1,7,13,4,1,2,7,10,9,5,4,6,4,0,10,5,6,8,0,10,4,11,5,13,2,4,9,0,34,2,15,9,5,5,3,10,4,0,10,2,6,5,8,10,13,1,16,0,6,0,0,4,0,4,2,2,25,8,2,4,4,4,2,5,3,7,1,1,6,3,5,3,1,3,3,11,1,10,5,3,0,0,5,2,5,11,1,1,10,11,6,5,2,0,3,3,11,2,7,5,2,4,11,8,0,2,8,6,10,7,8,15,4,3,10,7,3,1,9,3,0,1,1,16,5,8,8,3,1,7,1,2,9,3,3,0,4,1,28,16,0,2,4,0,2,9,0,9,1,2,3,2,6,4,4,7,1,2,1,3,1,1,10,2,1,1,2,4,1,10,0,10,0,0,11,10,7,11,5,3,2,4,7,2,2,3,17,1,2,0,2,2,5,1,2,8,6,3,9,4,3,10,3,2,16,1,4,4,3,1,9,5,10,5,5,1,10,16,4,5,6,2,1,3,2,1,5,4,8,2,12,7,4,7,0,4,1,3,17,9,1,4,24,0,7,3,18,10,6,0,0,2,5,8,1,11,3,1,8,13,2,7,8,3,4,10,7,3,5,4,1,10,4,1,3,2,6,11,6,4,14,9,5,1,14,5,3,6,7,2,8,5,3,5,1,2,5,43,9,3,3,3,2,4,15,6,4,6,1,1,15,5,1,2,3,5,1,1,8,4,12,6,11,3,0,0,1,2,3,9,2,2,4,2,2,4,1,2,3,11,4,7,1,7,6,4,5,1,8,1,0,5,5,2,7,6,4,1,1,1,6,6,3,4,2,5,4,1,0,6,3,2,2,0,4,2,2,6,2,2,5,1,3,4,4,3,4,2,5,3,1,1,5,1,9,5,4,6,4,2,0,4,0,4,5,4,5,15,17,3,1,1,12,8,4,3,2,6,2,3,5,2,0,2,8,3,1,1,0,1,3,2,6,1,5,10,5,12,1,3,1,2,6,8,2,1,0,1,1,1,5,0,2,0,2,2,6,1,9,2,10,3,1,2,4,11,0,2,0,3,0,8,0,1,4,5,5,4,6,7,4,1,3,5,1,10,1,1,0,4,1,4,2,8,3,3,2,8,19,12,4,6,3,0,4,0,1,2,3,6,3,4,1,0,1,1,3,5,2,0,9,7,0,2,1,5,2,1,0,1,2,2,4,1,0,3,4,2,5,1,2,5,4,0,0,1,1,1,4,1,1,0,5,3,8,8,0,8,3,3,2,4,6,0,0,4,3,2,3,2,2,3,0,1,1,4,2,2,1,4,4,1,1,1,0,3,0,0,2,5,0,2,1,7,2,0,16,1,0,0,1,2,0,2,0,4,4,3,1,0,3,1,1,3,0,1,7,6,0,2,4,8,0,0,1,5,4,1,1,1,2,5,5,2,7,4,1,1,2,3,2,1,7,6,4,2,1,1
deal,0,24,16,120,7,13,12,31,2,5,8,12,12,117,3,11,5,34,13,7,3,32,11,19,52,27,14,12,12,15,6,175,118,16,50,66,39,9,9,1,13,10,0,7,38,15,24,31,187,31,31,18,8,46,16,7,30,19,2,15,17,7,3,7,29,16,101,7,14,17,16,0,8,6,178,15,27,11,67,30,40,4,6,23,270,8,18,5,23,2,1,3,1,17,66,12,17,10,49,21,7,37,30,22,31,40,11,10,9,4,21,8,5,29,3,18,6,5,55,147,57,23,16,69,11,3,2,1,4,0,21,15,11,37,20,70,7,2,14,5,12,53,8,5,6,69,19,34,12,13,90,5,16,10,30,45,57,10,9,26,12,8,12,5,8,17,2,47,39,5,25,104,39,9,8,2,135,3,24,78,44,7,20,14,3,57,43,30,77,34,4,6,13,4,6,12,27,11,6,50,76,3,7,12,16,10,4,22,5,32,101,10,24,5,4,3,5,7,8,0,2,38,8,12,25,166,39,28,9,11,13,10,12,46,38,12,41,23,14,24,65,44,13,25,47,16,5,26,42,8,15,20,20,6,4,23,3,2,0,26,15,31,13,3,12,70,16,6,13,6,106,3,6,4,5,1,13,7,6,4,66,31,2,24,14,6,9,18,37,1,4,2,22,4,0,5,20,8,6,34,21,29,2,3,24,6,43,6,25,2,1,73,29,12,20,10,22,36,26,14,34,10,46,22,60,6,44,19,4,21,2,13,13,7,5,23,22,6,4,3,11,3,13,9,10,8,36,42,20,12,12,12,4,48,28,9,2,10,28,27,36,18,33,36,2,3,23,13,6,25,2,14,10,20,23,23,7,12,24,5,77,7,44,25,7,49,29,17,21,7,31,14,10,12,19,10,51,6,43,2,17,9,10,7,17,29,6,7,17,8,14,12,7,34,12,11,4,7,5,5,23,16,39,16,3,6,4,31,5,12,6,1,0,3,11,2,1,3,2,8,22,15,11,5,5,6,20,8,46,8,11,3,3,0,58,10,3,4,15,19,27,26,39,76,19,8,15,12,12,7,38,10,2,6,2,57,3,9,34,14,11,12,1,5,8,4,6,3,12,2,30,33,7,8,10,3,3,20,4,35,23,4,8,1,6,14,24,14,4,8,6,9,7,22,14,12,12,11,6,5,8,20,9,39,17,2,30,39,24,26,16,17,7,23,13,13,10,21,38,41,9,8,9,49,4,6,3,17,23,10,13,4,8,31,14,15,37,6,19,8,19,8,20,11,6,11,16,14,34,60,8,1,4,17,10,4,14,10,13,19,8,12,14,13,19,19,11,8,1,21,20,23,16,8,73,5,12,3,11,17,15,4,7,4,7,23,9,15,15,0,48,29,14,2,35,4,11,13,11,1,7,4,3,13,6,13,3,18,11,12,8,26,39,24,17,14,1,6,6,2,27,20,14,20,10,16,9,4,22,73,20,8,11,8,2,8,27,15,4,13,1,8,7,3,2,3,4,5,17,6,14,4,7,28,9,15,4,3,5,4,10,24,8,5,7,4,9,6,1,5,7,13,10,12,12,7,8,5,9,4,5,5,8,9,9,15,12,1,3,1,3,1,1,17,17,11,6,7,4,10,4,17,4,6,8,6,7,6,8,5,4,15,5,16,2,0,15,14,12,8,9,3,3,8,10,7,14,19,9,6,14,1,0,4,1,14,22,2,2,4,4,16,1,1,13,10,22,12,29,9,4,6,13,12,4,17,11,7,13,6,5,4,9,5,16,7,9,2,5,10,7,20,8,3,21,16,7,4,1,3,8,2,9,5,9,4,10,8,14,3,5,1,3,5,6,5,5,10,2,4,3,5,9,11,2,2,15,2,3,6,3,1,10,1,6,6,2,28,5,8,2,8,10,14,8,8,7,4,3,17,6,44,14,0,6,4,13,4,3,2,2,3,9,8,5,2,6,2,11,17,10,13,2,8,5,4,1,1,11,5,0,5,3,2,10,4,7,2,8,2,4,1,2,5,2,2,2,1,8,2,6,0,2,6,6,1,1,11,2,16,9,6,5,3,10,1,5,9,3,7,3,5,7,2,1,5,0,2,1,2,10,11,9,1,5,3,6,2,8,13,4,15,0,0,7,12,15,0,19,4,1,6,11,9,0,3,0,4,6,6,5,1,5,4,3,3,10,6,3,2,5,1,15,6,2,2,12,6,12,0,0,3,2,6,3,3,4,2,13,4,9,5,2,0,10,10,2,0,1,2
addition,0,6,2,92,6,2,1,19,3,0,9,4,4,43,5,4,6,12,2,0,3,22,4,10,11,5,8,6,9,13,5,190,86,5,35,35,27,9,12,7,12,1,4,4,18,10,28,32,207,7,29,3,12,28,11,4,44,43,0,15,6,5,4,8,22,3,53,11,2,24,64,9,2,3,73,4,13,2,47,10,111,2,6,9,150,29,17,2,21,3,6,5,13,26,44,17,14,2,17,13,35,37,24,4,15,23,6,6,39,10,14,4,3,17,2,29,4,2,56,109,23,8,90,94,4,1,0,3,8,3,13,0,8,41,12,54,4,1,3,8,4,27,36,0,2,36,9,16,27,14,45,4,7,9,5,34,19,7,3,19,19,1,11,6,20,3,14,14,20,5,30,80,18,1,0,9,134,5,4,61,18,9,18,21,3,17,29,21,27,47,1,8,4,1,4,3,21,8,27,16,17,1,7,5,19,6,13,40,11,20,47,2,27,8,5,0,7,11,25,16,8,15,4,18,45,58,33,29,30,39,19,20,31,12,22,39,14,1,7,6,41,22,10,6,6,6,3,18,60,0,12,17,9,16,34,12,5,7,7,19,8,18,12,2,6,52,10,2,8,6,68,30,70,5,3,2,13,36,10,10,31,2,4,7,14,11,6,9,4,1,5,3,15,15,12,4,40,4,7,16,14,31,10,8,7,6,17,1,6,7,2,34,26,8,37,18,11,35,12,4,27,2,23,3,35,4,7,10,6,12,2,31,5,3,6,10,10,5,5,5,6,14,5,9,6,6,33,42,18,6,12,9,5,23,15,8,2,9,10,26,26,7,10,20,5,1,10,6,9,12,10,21,8,11,7,41,3,8,9,11,41,3,35,7,5,47,4,8,31,0,6,1,12,4,15,8,31,7,20,6,15,7,6,0,4,3,6,0,8,5,8,12,3,23,3,1,1,3,1,5,6,3,11,7,3,2,6,8,3,13,15,9,3,5,3,1,3,8,13,8,7,13,10,14,4,6,18,1,26,10,21,3,1,0,39,3,0,11,12,14,4,16,17,42,8,3,12,4,10,0,11,3,3,4,2,37,0,9,16,4,2,10,2,5,2,13,15,1,4,2,82,35,4,2,6,2,11,17,5,4,27,10,8,6,10,26,3,11,3,4,4,3,4,2,4,6,2,1,3,8,4,13,3,13,8,3,7,15,10,22,8,3,5,5,8,5,7,1,30,18,4,1,0,17,5,5,1,14,13,11,12,3,8,41,8,4,14,4,7,6,12,6,21,4,8,9,10,3,30,20,11,6,29,1,6,9,10,4,3,54,3,7,8,5,4,8,6,7,8,9,21,17,12,6,16,5,6,1,22,10,15,3,4,4,11,18,7,11,2,5,19,15,8,4,20,14,11,4,4,3,5,16,4,22,7,9,3,4,7,33,8,10,11,19,17,5,6,1,4,9,14,3,6,20,7,25,5,7,4,116,14,10,6,2,2,9,35,15,2,8,1,6,5,12,7,3,1,5,7,2,19,8,43,28,9,3,6,7,10,10,15,23,7,7,5,2,8,5,14,43,12,7,8,40,7,17,6,1,34,6,5,6,2,8,9,13,18,10,0,1,1,8,7,21,21,11,1,5,5,15,7,3,6,21,10,5,9,1,2,7,14,12,6,6,4,3,60,5,39,5,6,7,3,25,16,7,24,14,2,3,6,7,20,15,16,3,4,9,4,22,40,13,6,22,24,16,9,5,6,5,10,4,2,7,2,4,10,9,2,9,0,3,8,8,6,8,7,22,17,8,3,11,14,3,19,11,9,16,1,1,3,8,10,4,3,3,4,2,12,3,3,4,8,6,4,3,3,5,2,7,0,5,2,8,14,2,7,5,7,3,19,4,5,1,1,11,5,11,12,3,4,3,8,5,2,24,8,10,8,8,6,12,1,11,2,5,7,11,1,1,4,0,7,5,3,4,5,1,7,7,4,2,17,15,2,5,2,12,4,5,1,7,4,0,9,2,4,8,3,5,2,18,0,3,6,3,10,3,12,8,6,1,2,3,0,1,1,6,3,8,5,14,3,19,6,6,5,8,6,6,6,10,7,5,2,3,5,5,1,7,4,8,3,7,2,7,5,7,7,12,5,15,24,13,9,18,11,72,49,3,9,8,2,12,16,7,45,15,25,2,34,12,3,8,7,20,0,7,1,3,7,4,3,2,1,0,14,0,6,4,17,6,1,6,2,22,7,8,4,1,4,6,6,2,3,15,3,4,2,2
deserve,0,5,8,99,11,9,6,10,2,3,7,4,6,44,2,4,6,9,15,3,5,13,17,12,6,19,17,14,6,27,3,69,79,12,32,48,21,4,0,5,4,5,4,7,19,6,8,9,69,35,14,3,4,28,9,4,21,18,12,12,7,3,1,5,10,8,61,4,3,4,11,3,4,3,44,4,16,0,36,12,28,3,2,6,70,6,6,1,12,0,10,1,2,16,18,5,7,5,17,5,2,20,9,4,5,20,3,1,7,10,15,2,5,12,15,21,0,4,34,43,9,35,13,57,9,9,2,1,2,0,16,9,3,33,12,49,9,3,2,10,4,19,20,0,3,29,7,10,6,5,20,2,10,3,6,13,28,5,2,28,4,1,7,2,3,25,3,12,20,6,9,49,10,2,10,6,47,5,6,31,14,4,7,17,1,12,22,1,11,14,2,1,5,1,6,0,9,2,5,7,9,2,2,5,8,8,1,11,2,9,56,8,13,8,7,22,4,3,12,0,1,9,2,7,8,43,22,14,4,11,8,6,6,9,21,10,13,3,2,5,28,17,7,2,6,3,3,19,27,1,4,10,10,4,3,9,5,1,2,16,6,22,6,0,2,21,8,8,6,3,51,0,15,4,4,3,15,11,5,1,63,3,0,8,4,1,14,20,10,1,1,5,13,2,3,7,16,1,6,12,8,18,1,1,2,1,10,2,2,1,6,6,11,4,23,9,4,8,16,3,21,8,11,3,36,2,6,42,1,11,13,3,12,2,3,7,4,2,0,3,3,8,19,7,2,2,13,23,6,19,7,12,7,10,6,7,3,2,6,24,6,7,5,6,1,2,8,6,8,14,2,30,2,13,5,26,6,2,6,2,11,1,17,4,27,19,8,9,11,4,14,5,12,3,12,4,19,2,9,2,17,5,3,2,2,1,1,4,10,11,3,4,5,5,1,9,3,3,3,7,5,3,7,3,2,3,4,3,4,5,4,1,4,9,3,1,1,6,7,2,6,10,4,8,0,0,10,7,10,4,15,0,7,2,28,6,5,2,9,7,6,6,12,33,1,2,20,9,2,2,28,7,0,0,2,15,1,5,7,2,4,9,1,3,4,3,1,13,1,3,31,15,5,3,6,3,1,3,3,2,2,1,4,5,6,8,2,7,3,1,4,9,0,2,1,11,0,5,2,3,5,5,1,12,0,4,6,6,6,12,8,3,6,5,2,5,5,2,10,7,3,1,3,1,1,3,0,7,4,3,7,3,3,12,4,2,15,1,2,7,22,2,11,2,7,5,5,2,6,14,3,1,7,3,2,1,2,4,6,9,4,4,4,13,2,17,3,3,1,9,13,16,5,3,18,1,2,0,3,3,3,2,3,1,2,10,3,4,1,1,15,7,3,1,14,1,4,0,0,0,5,0,3,5,0,5,1,3,8,5,1,21,14,6,6,3,6,4,1,12,12,7,12,6,3,13,5,2,2,42,7,0,5,2,1,9,8,3,0,6,3,3,4,3,1,1,0,2,2,6,6,2,3,14,11,2,4,1,1,0,1,10,2,5,2,5,3,3,2,4,1,13,5,7,5,5,3,0,5,5,3,1,2,0,5,3,4,3,0,2,3,7,2,6,4,5,8,4,5,8,5,2,4,14,2,2,3,4,5,9,2,6,2,0,1,5,20,4,4,0,2,0,0,14,8,2,6,10,1,2,5,2,2,5,2,3,0,10,1,2,6,9,1,4,6,6,4,0,2,3,5,1,2,7,4,7,5,2,3,5,1,1,2,1,1,2,0,0,4,7,4,3,3,4,5,7,4,1,2,0,3,3,2,1,4,0,2,4,2,3,3,2,3,2,4,1,6,4,0,1,3,4,3,2,0,1,5,7,2,0,3,3,11,0,6,2,2,5,5,8,3,5,0,4,3,1,1,1,11,2,10,8,1,1,0,4,2,1,1,1,1,4,5,2,1,1,1,2,3,8,8,0,2,0,3,2,0,0,6,25,2,0,0,2,0,2,4,1,0,1,4,3,7,0,5,2,3,3,2,17,3,1,13,5,0,3,4,1,0,4,2,2,6,5,1,3,1,4,1,1,1,1,3,2,1,1,0,0,2,1,5,5,4,2,2,5,2,4,4,6,0,4,4,0,3,4,9,5,8,1,1,2,6,3,6,5,10,2,2,3,1,1,3,1,3,15,3,8,4,4,4,3,4,6,1,0,9,3,5,2,16,0,2,0,3,1,2,9,1,7,1,2,1,1,0,2,2,4,9,4
employ,3,40,5,140,6,3,2,27,1,1,24,9,6,43,6,6,1,16,2,1,5,35,6,23,19,9,9,11,1,8,16,183,112,9,65,34,43,13,13,2,4,5,9,1,31,15,27,8,267,12,44,1,7,26,5,7,63,57,1,18,11,7,3,15,10,5,45,5,6,12,18,11,2,3,56,5,8,10,86,15,48,3,15,3,190,34,25,0,38,0,9,4,7,20,50,7,13,6,36,17,27,36,32,11,9,31,4,5,20,4,21,6,17,19,5,32,6,5,75,165,30,23,13,69,10,5,5,4,6,1,11,2,3,50,15,53,7,3,2,10,5,25,34,6,2,49,6,10,17,17,76,3,15,9,2,10,14,7,4,1,7,3,10,5,5,5,7,24,20,16,30,72,8,0,2,19,144,1,9,22,27,19,0,10,5,13,42,16,24,42,1,6,11,1,4,1,11,2,21,11,22,4,2,12,30,7,7,37,14,15,67,7,17,16,3,0,0,2,17,4,5,12,8,15,58,100,32,22,5,8,7,23,26,24,46,18,27,5,6,2,72,30,9,4,10,5,9,29,41,14,5,29,14,5,12,22,14,2,7,66,19,53,16,4,2,59,6,1,4,7,150,9,36,18,5,1,30,11,18,5,57,6,3,25,14,1,4,9,7,2,3,3,3,6,2,10,33,4,11,22,27,32,1,2,10,1,21,8,6,4,1,11,23,5,36,24,12,48,29,6,64,2,17,6,57,7,11,19,3,27,1,11,12,5,4,9,14,8,2,10,3,13,20,5,5,12,41,54,30,4,23,15,9,48,24,17,2,5,21,30,8,11,2,13,9,0,43,7,8,7,1,20,8,12,14,74,23,6,11,4,62,1,72,16,3,22,5,24,21,5,20,5,5,5,28,5,54,8,23,8,20,3,4,0,8,7,13,2,37,14,2,8,5,15,3,10,2,2,4,2,6,6,15,15,0,9,2,16,12,10,17,6,9,7,4,3,0,8,13,8,42,43,7,11,0,3,15,3,29,5,16,13,1,8,47,11,1,11,11,24,7,25,27,42,7,2,13,9,17,0,25,2,4,4,2,19,4,5,19,7,2,9,8,2,11,4,14,3,3,6,104,39,0,3,11,13,4,17,9,8,10,8,1,1,3,53,5,13,10,3,6,4,9,3,29,9,8,8,2,9,5,32,7,18,16,3,25,13,24,29,9,4,9,8,4,9,18,3,39,26,3,2,6,2,7,7,3,30,19,4,42,12,11,41,5,10,54,4,4,14,27,10,34,3,23,17,25,10,53,32,15,11,20,2,12,9,2,7,7,15,18,16,17,9,6,3,9,10,5,12,18,13,5,6,50,8,8,14,43,10,9,4,6,1,3,17,2,26,9,12,27,30,14,3,40,9,35,4,5,7,16,4,7,17,2,7,1,7,14,21,19,28,33,18,11,6,2,9,12,1,19,2,5,27,10,53,21,7,1,157,15,9,10,4,5,18,45,13,8,9,6,5,5,19,4,4,2,10,17,18,31,8,58,15,25,5,5,10,11,9,14,32,17,2,9,10,8,4,8,48,7,7,28,25,9,21,15,11,8,25,16,6,14,7,18,7,18,9,0,6,3,4,5,28,18,51,15,8,6,15,23,4,19,51,5,17,7,1,5,17,11,28,10,8,6,7,60,13,37,10,12,16,5,16,30,6,20,9,9,12,10,8,3,20,14,16,7,19,3,13,13,11,2,2,21,16,12,4,23,15,16,3,0,24,6,12,8,2,23,17,9,7,13,4,8,10,10,5,7,13,6,4,1,8,20,12,10,9,13,4,2,0,7,4,7,3,6,8,18,6,11,6,16,10,9,3,3,9,9,17,8,5,4,15,32,3,3,7,9,5,17,12,17,6,6,3,9,19,10,9,14,7,4,10,15,14,5,5,7,18,13,28,11,3,0,6,3,4,5,1,11,9,12,5,8,15,2,1,3,13,4,4,7,12,7,4,2,13,8,4,2,10,4,7,16,4,3,6,10,11,10,17,1,2,11,6,11,7,16,3,7,6,8,8,4,3,10,7,3,19,3,18,0,16,11,7,14,17,4,3,6,4,13,13,2,13,7,20,4,12,9,3,8,10,4,3,4,5,3,17,3,10,6,8,12,15,9,12,45,9,11,1,7,8,10,1,3,15,47,4,1,4,5,7,3,68,10,1,0,12,16,4,7,0,12,5,4,15,12,2,16,7,9,7,11,2,10,4,7,1,7,8,3,1,1,2,5,6,4,0
class,4,12,7,107,3,13,3,41,4,4,17,9,8,74,2,13,3,40,2,0,1,43,15,25,29,14,20,18,14,23,15,187,135,13,73,60,22,6,16,10,26,6,5,6,40,21,19,3,155,31,31,8,13,36,17,8,75,31,10,14,9,7,6,9,24,9,142,14,5,19,5,11,11,1,141,15,26,1,64,26,63,2,5,7,228,26,15,0,35,1,4,4,4,15,56,17,12,8,32,24,15,26,33,12,25,24,5,0,10,0,27,7,9,22,3,24,5,9,51,175,43,20,44,75,6,8,4,4,8,1,19,20,20,36,31,67,12,7,6,2,11,46,13,4,2,74,8,24,15,17,86,6,19,2,23,22,47,2,4,22,12,0,9,3,0,19,11,19,35,3,10,133,27,2,15,11,198,5,16,40,24,14,3,31,6,41,52,18,40,40,2,7,14,1,3,8,16,22,11,24,45,0,6,16,12,11,6,58,6,13,82,6,21,7,8,10,1,1,13,0,2,43,4,15,49,141,37,38,9,8,14,12,18,14,41,34,27,17,8,19,43,19,11,16,29,14,6,45,49,1,6,35,13,9,8,15,4,0,2,32,7,31,13,4,17,31,24,9,28,3,154,2,28,3,9,1,30,14,7,4,70,17,3,31,14,4,4,17,26,6,2,2,18,8,2,14,53,3,9,60,20,30,10,3,12,3,35,8,17,1,0,28,16,6,45,20,38,37,31,13,50,6,47,29,90,4,21,32,0,42,9,23,22,9,14,6,23,4,7,9,6,7,18,15,2,4,43,34,7,14,11,9,15,40,31,3,2,20,31,41,27,5,12,24,2,4,32,19,14,31,2,31,5,39,20,43,20,9,30,8,75,3,42,20,11,22,17,23,24,9,37,5,11,5,20,6,39,2,20,4,16,6,12,3,6,21,13,0,19,10,28,14,4,28,5,11,4,6,4,5,32,12,15,7,6,3,7,17,4,18,12,3,7,9,12,4,1,4,13,5,28,36,6,8,0,2,20,7,37,17,21,10,5,5,61,12,3,7,23,15,18,38,60,103,15,1,32,7,2,5,47,9,5,7,11,100,4,16,19,9,14,4,6,4,7,7,10,13,8,4,62,21,3,4,14,4,3,14,9,18,28,1,14,2,1,7,14,22,14,5,8,8,3,5,9,18,4,12,5,8,3,40,8,27,15,20,19,19,28,41,14,14,6,25,5,6,6,6,48,16,7,2,17,43,18,8,3,24,18,7,34,4,7,41,10,5,27,7,5,18,19,5,20,4,23,17,30,14,27,44,9,9,9,0,7,6,18,7,14,21,27,11,19,16,11,33,8,15,11,16,44,36,12,3,92,6,32,12,17,26,31,4,4,0,1,17,9,18,13,11,19,18,4,10,38,14,29,7,15,11,21,10,4,24,2,15,0,16,22,28,25,15,41,31,15,7,27,14,12,19,1,19,20,9,8,24,5,2,6,71,8,8,8,3,4,13,39,16,4,15,7,5,1,9,0,0,2,5,6,9,21,22,8,43,18,13,7,8,2,4,1,31,10,13,14,5,10,1,0,7,8,12,16,3,1,6,8,3,27,10,13,12,3,11,3,9,24,5,6,3,5,1,3,22,11,31,9,8,9,13,7,13,2,44,9,6,9,7,19,11,10,11,2,17,3,4,30,7,12,8,11,4,3,13,10,5,18,4,9,22,9,4,3,10,4,9,13,7,1,8,6,17,2,4,17,40,16,6,22,4,12,1,7,28,3,15,6,4,8,11,0,3,11,4,6,6,7,6,13,14,9,9,5,6,5,28,2,8,1,4,9,5,15,5,13,1,6,9,21,3,2,0,5,1,10,0,5,6,2,24,5,8,4,1,4,6,7,5,14,7,9,1,10,11,18,24,7,26,10,3,0,4,11,4,9,18,4,3,10,15,7,9,12,12,4,5,23,9,6,5,2,8,10,4,5,7,7,2,1,14,9,5,11,42,3,4,4,4,6,1,5,8,2,0,6,8,10,2,3,6,4,8,6,3,9,0,1,0,8,6,3,4,6,5,5,0,0,8,3,12,0,2,14,5,23,3,5,8,5,8,5,4,11,20,3,1,6,3,2,5,3,4,4,10,6,4,5,7,16,17,6,34,12,9,2,26,23,11,22,4,1,3,5,4,2,5,5,2,9,1,0,1,1,4,5,41,1,23,7,8,22,5,10,7,5,0,2,3,3,3,6,7,6,16,4,23,21,5,0,2,6,2,9,1,1,11,2,8,2,5
race,4,6,15,30,2,13,1,14,0,1,9,21,11,28,2,11,5,18,10,4,0,10,27,24,10,6,14,19,12,9,7,85,51,6,32,68,15,1,2,3,2,9,2,4,14,6,5,5,72,38,18,15,10,23,20,5,11,3,14,14,4,3,3,3,8,3,72,8,5,4,8,3,4,8,58,6,12,1,32,20,25,2,5,7,35,3,2,1,2,0,2,5,4,14,7,5,13,4,13,4,2,12,5,7,6,9,0,2,3,7,5,2,6,10,10,13,0,2,11,34,15,17,5,43,8,12,4,3,3,0,14,6,15,16,22,44,9,5,3,2,6,26,7,1,7,23,3,17,4,1,15,6,5,3,3,13,19,3,3,32,3,4,6,2,0,11,4,11,12,2,10,66,16,1,8,9,37,2,14,31,13,7,9,6,0,27,15,9,20,21,0,3,1,3,3,0,9,5,10,20,6,2,3,2,9,8,0,13,2,7,45,12,7,8,4,17,0,9,6,2,1,23,3,7,10,48,24,13,2,7,3,3,7,7,16,2,15,6,2,7,33,18,5,10,14,1,3,19,18,7,6,1,9,3,1,5,1,1,1,13,2,14,2,0,4,1,19,15,15,1,33,1,5,3,3,4,8,2,0,1,47,0,2,7,4,7,2,8,2,2,2,3,4,3,0,0,11,0,4,10,8,5,0,0,6,1,16,4,1,3,4,8,7,3,8,4,8,14,8,1,17,2,27,21,42,2,11,26,1,11,9,6,6,1,1,3,9,2,4,5,1,7,11,4,2,1,9,12,2,8,5,3,0,16,7,0,0,7,13,27,7,2,7,8,0,3,4,7,6,18,2,16,0,21,9,2,3,5,13,0,18,7,5,5,13,7,25,7,17,5,18,4,5,1,5,4,11,1,3,4,11,8,4,3,6,9,2,0,4,5,4,10,0,13,1,12,3,13,4,6,10,1,6,2,7,3,3,7,1,11,0,0,0,3,2,3,1,4,6,2,3,8,0,3,1,0,13,4,13,3,13,0,5,1,13,8,4,1,6,3,15,10,23,18,3,6,21,3,0,4,28,3,1,12,3,28,1,3,4,1,4,4,3,2,6,2,6,4,5,2,14,4,7,5,7,2,1,1,2,18,7,1,3,3,1,2,0,2,5,1,2,2,3,1,1,2,1,4,1,6,14,12,0,5,4,1,10,4,8,9,4,12,6,7,4,2,0,6,13,0,3,4,1,9,2,2,1,9,2,0,10,2,3,33,1,3,5,0,1,3,3,0,8,1,4,2,4,1,4,18,5,2,2,1,2,1,3,1,1,5,0,2,2,9,6,13,2,1,1,10,10,13,6,3,24,2,6,3,7,7,8,0,3,1,1,8,4,2,2,0,7,2,1,1,13,3,6,3,3,0,5,0,1,2,4,3,0,2,3,9,2,1,11,7,3,2,20,3,7,2,19,1,2,7,2,2,5,2,6,20,4,2,2,0,4,8,7,7,2,1,1,6,1,2,1,0,0,0,4,4,0,0,1,5,4,2,1,0,0,2,1,5,2,1,1,2,3,4,2,0,2,7,3,1,1,2,1,0,3,3,2,1,0,3,2,2,6,2,0,0,4,0,4,12,6,4,6,0,6,0,2,4,0,6,1,2,1,5,4,5,1,5,1,4,0,1,1,2,7,15,5,1,1,0,4,1,2,8,2,2,4,0,0,0,0,6,6,0,1,4,1,3,0,3,13,6,26,5,3,1,5,5,4,10,2,7,2,0,9,6,7,2,2,0,3,1,2,3,2,6,3,15,7,1,1,7,0,2,0,1,0,3,0,0,6,0,2,4,8,1,0,0,0,2,0,2,3,2,0,6,2,0,0,1,1,1,6,1,1,1,3,1,5,1,4,6,4,9,3,1,0,4,0,0,0,3,1,1,2,11,4,4,6,0,1,2,12,0,3,0,0,5,3,4,2,1,2,0,1,0,1,6,0,0,1,4,0,1,5,0,0,0,1,1,2,1,0,0,5,0,6,3,5,2,1,1,3,7,2,3,0,0,3,1,9,0,0,0,2,1,1,1,7,0,3,1,3,0,1,2,0,0,1,1,2,0,14,0,0,0,0,1,0,1,2,0,3,0,1,5,3,4,0,0,0,0,2,5,2,0,1,3,3,3,2,0,0,0,0,0,0,4,1,4,0,1,1,2,4,0,2,1,4,11,0,1,3,1,1,1,0,3,0,0,2,0,4,5,0,4,2,4,0,1,3,1,5,0,5,6
judge,0,28,29,89,22,5,4,53,2,3,16,3,9,47,2,27,6,19,10,1,0,37,24,26,33,10,30,7,12,14,3,161,83,32,36,36,15,2,1,4,3,10,5,4,24,25,12,16,251,9,41,2,5,16,7,3,52,23,1,6,11,5,5,13,12,9,104,14,5,6,6,2,5,15,83,9,18,2,53,27,38,1,6,10,132,13,4,0,22,1,0,4,3,14,48,3,35,6,22,6,7,18,20,10,8,21,6,2,8,4,12,3,3,17,0,16,6,5,65,154,46,11,4,38,9,0,3,1,4,2,8,3,4,58,12,50,24,3,3,12,12,17,21,2,4,41,12,24,19,13,83,2,9,2,7,48,16,3,17,7,10,1,16,1,0,12,0,23,36,2,14,62,21,0,9,5,153,11,11,38,24,4,5,13,1,29,41,35,51,38,1,9,7,0,2,7,12,18,8,14,32,3,2,18,25,19,0,25,4,14,96,2,15,5,3,3,0,1,18,3,3,18,15,11,40,153,46,27,1,2,9,17,4,17,28,4,14,2,1,9,62,28,2,9,7,15,2,14,44,2,7,16,11,3,5,22,7,2,0,25,6,15,19,6,4,15,1,6,15,3,123,1,18,3,3,1,17,1,13,4,60,22,0,22,1,1,2,4,23,1,0,2,12,0,4,11,14,0,3,19,24,49,0,0,25,9,10,8,4,3,2,6,16,6,35,8,6,43,8,9,12,7,28,3,105,10,10,11,1,68,9,13,13,11,11,21,13,4,1,9,8,8,8,14,2,6,29,47,15,5,19,10,16,23,22,0,19,7,10,24,19,0,8,23,1,0,18,35,8,20,5,12,19,7,36,20,19,4,19,1,87,3,45,8,6,16,4,16,34,8,60,1,18,18,28,18,51,5,22,2,43,2,2,3,4,7,14,4,6,2,2,4,1,16,9,6,2,3,11,0,15,5,16,9,1,6,2,19,9,6,8,1,1,5,4,2,0,2,7,7,8,13,8,5,0,0,2,10,28,17,4,4,1,5,42,8,1,12,15,23,21,20,20,46,5,3,4,7,4,0,33,9,1,2,5,46,3,17,14,10,8,9,1,13,10,21,6,6,4,4,38,32,2,3,4,4,1,12,6,19,24,3,5,0,4,8,0,12,5,8,3,16,3,2,5,17,3,16,20,7,1,19,8,41,8,10,22,28,11,50,8,5,10,29,7,5,16,20,27,23,0,2,6,0,1,10,0,16,12,9,55,3,23,36,12,17,11,6,4,6,29,17,19,6,6,10,7,22,18,37,6,4,4,0,11,6,1,8,15,15,0,8,9,13,8,10,3,17,5,10,17,25,6,2,59,2,8,3,16,14,13,1,3,2,9,22,1,37,5,1,32,13,36,1,68,17,6,2,28,2,7,1,1,30,1,5,6,5,8,16,6,9,41,24,8,8,14,6,12,5,20,2,1,16,3,11,0,2,19,121,18,6,2,8,10,14,33,19,5,10,2,2,5,5,2,3,9,6,7,9,27,8,18,307,9,8,8,0,1,3,4,13,10,14,0,9,8,9,4,8,21,15,21,6,2,5,4,5,8,9,0,4,1,4,11,1,7,2,9,3,3,4,3,23,16,5,3,6,14,2,4,19,4,22,0,2,5,2,14,7,5,14,4,7,4,3,3,1,27,11,12,15,1,5,2,2,9,3,4,5,2,3,1,4,4,2,6,9,1,5,2,22,1,3,14,5,4,5,0,3,15,0,3,22,2,13,2,0,4,7,0,5,14,0,13,2,10,11,9,15,3,73,3,8,19,18,9,7,1,21,2,0,9,6,6,1,6,25,16,6,0,0,3,7,1,16,7,3,0,14,1,1,2,6,0,3,2,12,5,4,21,4,13,3,3,0,6,32,14,8,5,20,55,38,0,12,6,4,5,17,33,34,16,6,3,3,21,2,6,3,3,9,2,3,4,12,3,1,9,9,1,1,2,4,7,1,2,1,20,0,1,1,8,2,10,1,0,9,3,2,1,3,0,0,8,3,1,22,3,0,6,1,1,7,22,1,0,6,0,25,6,2,9,5,7,4,5,0,3,1,6,5,2,2,1,10,0,4,1,4,2,4,7,5,6,2,2,4,9,4,3,10,0,2,1,6,5,8,15,1,1,7,2,1,1,2,9,3,12,1,1,0,11,1,0,10,1,5,13,3,2,12,9,5,3,1,4,7,3,3,0,5,1,6,4,1,11,3,10,6,8,2,1,0,0,3,2,3,1,1
general,19,103,19,256,6,7,9,85,20,6,47,41,23,93,15,17,13,22,5,7,8,95,26,28,39,24,11,25,9,33,15,285,205,17,93,62,106,21,18,11,15,16,9,7,49,32,49,43,711,24,74,6,21,37,9,9,89,91,6,31,35,6,7,11,34,8,160,6,17,19,28,12,10,2,101,28,33,8,119,24,85,1,40,22,586,33,39,2,67,3,26,19,1,57,72,15,50,9,73,25,26,44,62,20,12,71,11,5,26,12,45,12,16,35,3,31,25,8,129,267,63,17,11,139,10,6,14,3,7,0,11,5,7,91,36,76,19,5,17,9,7,67,41,6,11,155,16,27,24,25,141,3,33,10,4,47,53,12,12,7,31,7,14,8,5,11,13,39,41,24,51,157,36,0,1,13,305,3,21,54,24,22,16,28,15,29,62,32,83,88,7,11,0,0,1,16,56,14,31,25,36,2,3,31,65,6,17,55,19,49,172,16,33,17,5,1,2,7,97,6,10,31,14,25,68,204,59,48,9,31,21,29,26,51,47,47,46,11,11,7,148,62,18,17,26,11,12,19,89,13,24,23,42,26,29,22,19,6,11,38,4,76,38,16,11,147,17,6,24,7,187,17,48,12,8,1,45,42,25,4,98,7,4,28,27,13,10,19,12,4,14,16,26,17,5,21,100,11,11,17,53,58,2,4,19,1,49,20,8,1,7,47,47,10,59,49,25,84,44,17,76,8,45,6,103,30,11,68,10,57,6,18,14,10,14,35,37,17,7,27,20,38,20,31,13,11,73,83,40,8,20,18,11,51,36,15,31,7,38,57,34,13,14,36,7,0,91,7,7,17,11,41,5,12,15,62,18,9,26,12,92,3,80,24,0,184,11,34,74,3,34,13,17,12,51,25,116,17,101,12,33,5,7,2,18,6,10,3,21,33,3,14,2,29,25,14,4,9,5,3,17,38,49,28,3,10,7,40,28,30,16,19,12,24,21,9,6,36,19,7,20,42,9,25,1,8,10,14,71,12,30,12,11,14,60,17,0,23,12,55,24,39,54,56,11,19,20,9,8,1,36,3,4,1,2,15,5,30,38,13,21,26,3,6,16,18,24,19,12,9,172,88,8,12,12,26,5,26,12,15,22,3,7,2,34,30,8,33,20,15,9,10,25,16,24,61,11,18,11,22,3,45,15,62,18,8,33,22,26,44,26,9,20,16,14,17,39,15,87,42,6,4,2,2,12,8,20,31,27,16,120,14,14,122,32,10,37,11,14,15,43,13,51,9,36,28,34,11,70,57,29,17,37,3,21,16,17,8,13,44,0,44,18,19,14,9,9,11,10,15,40,42,19,11,35,18,10,13,67,17,50,13,16,16,19,44,14,47,12,15,37,28,35,11,41,16,47,7,24,5,40,1,6,58,13,11,17,17,36,58,9,47,25,49,21,5,20,20,6,27,9,7,16,1,21,106,6,21,8,322,53,6,11,12,10,24,84,32,29,33,10,10,32,12,24,5,5,22,24,25,47,18,140,43,43,12,7,16,10,16,18,55,22,23,25,12,6,13,3,17,30,21,48,22,27,18,19,15,22,35,3,8,15,7,26,15,35,11,5,36,13,33,12,35,51,210,79,20,21,25,106,21,58,103,7,27,15,3,4,34,15,28,18,10,24,50,44,26,122,14,26,20,5,22,17,8,19,15,8,12,32,23,12,27,6,26,11,28,13,15,14,20,8,6,45,22,38,18,19,19,5,3,5,31,10,27,5,15,85,28,16,17,17,8,14,12,12,56,17,26,33,32,14,7,14,28,18,16,10,16,9,18,19,4,10,4,10,9,38,16,11,8,21,24,10,12,14,16,25,24,15,9,8,34,21,29,5,20,2,12,18,11,24,10,3,15,24,67,18,13,19,13,5,21,11,14,10,15,24,21,33,84,21,14,4,13,14,29,19,7,6,9,26,15,16,22,2,9,22,30,21,7,3,6,6,7,3,14,18,1,7,17,39,15,50,5,11,17,15,13,3,17,9,9,13,27,18,36,18,13,19,32,11,27,23,19,15,10,14,19,8,4,7,12,17,22,13,7,7,9,33,13,14,10,4,25,2,84,5,7,17,4,15,19,13,14,8,11,5,22,5,13,9,1,12,15,15,21,47,7,33,30,6,7,12,29,41,10,36,20,46,25,12,19,4,14,12,2,4,9,31,10,9,0,14,7,4,7,8,8,48,16,10,3,7,10,12,5,18,1,10,7,26,0,3,8,3,30,3,0
hop,7,8,4,112,8,1,4,14,3,5,44,8,5,53,4,1,4,3,5,4,5,31,3,8,20,10,3,5,5,7,3,119,120,7,22,41,41,6,7,3,3,4,5,4,25,17,25,9,260,19,32,3,8,22,1,7,49,30,1,23,25,7,3,10,12,4,54,2,20,13,7,3,4,3,31,11,7,2,48,18,24,1,26,7,182,13,10,0,34,1,4,1,0,20,47,7,19,4,29,10,2,25,38,5,10,14,6,5,12,1,11,6,0,9,1,37,5,1,54,102,28,10,26,36,12,2,1,3,4,3,18,3,9,21,6,19,3,2,3,4,1,34,23,4,0,47,5,17,7,4,47,0,8,5,5,8,15,3,8,13,11,6,3,4,2,5,8,19,17,7,10,58,20,3,1,3,126,1,4,17,16,5,1,9,2,9,29,28,28,63,0,4,7,0,3,3,13,3,2,11,16,0,1,21,19,0,2,26,12,25,50,3,18,8,3,0,2,0,6,3,2,24,7,9,23,70,15,11,4,3,10,12,14,10,22,10,37,6,5,7,43,36,3,5,9,7,5,8,37,1,13,14,20,6,6,10,13,3,6,15,3,22,27,5,6,29,4,3,11,4,167,4,22,5,2,0,6,7,15,3,37,5,2,10,4,2,3,7,10,0,4,3,7,8,9,8,58,7,5,21,21,17,0,5,8,0,25,1,3,0,2,14,16,2,22,13,18,50,8,5,63,13,17,2,33,8,3,16,7,14,2,11,7,2,4,6,20,10,2,6,10,8,6,8,6,4,31,57,13,2,9,8,5,30,23,6,2,0,6,17,15,9,5,13,2,0,28,5,2,12,1,7,2,3,5,15,3,2,11,2,37,1,33,11,1,19,2,11,14,3,20,0,6,14,30,5,61,5,22,3,25,2,2,0,3,4,2,4,32,11,5,7,7,9,17,9,7,13,5,0,3,4,10,10,0,3,3,13,18,11,1,11,5,15,3,11,1,29,3,2,15,16,3,16,0,4,6,14,24,6,8,9,2,4,43,6,1,11,6,33,4,20,27,18,6,1,15,20,5,0,6,6,1,4,2,9,3,9,12,5,5,9,9,4,8,10,5,4,11,3,39,25,1,4,7,6,5,7,4,11,12,3,2,0,2,9,4,8,5,7,1,4,7,4,11,13,6,7,3,2,7,16,9,20,3,2,24,0,14,18,5,3,4,2,8,1,11,10,31,16,8,3,1,1,3,14,4,17,13,9,9,5,7,33,6,5,32,3,6,21,19,1,19,2,8,10,22,5,25,50,5,10,6,2,7,7,3,5,6,9,8,8,18,9,6,2,8,7,1,7,25,25,4,2,15,5,1,0,61,17,20,3,7,5,18,14,3,16,6,4,20,27,19,3,26,2,21,5,9,7,13,0,5,11,0,5,4,7,11,33,6,16,7,22,6,3,10,7,3,10,8,2,3,21,1,14,5,5,3,168,32,5,7,2,9,15,29,14,2,13,5,3,31,30,19,8,6,7,30,17,13,4,45,27,51,4,4,13,4,4,7,34,10,9,4,6,13,11,2,6,12,6,15,17,8,10,12,4,16,11,11,9,9,7,6,4,23,3,4,5,2,6,3,21,12,19,7,5,11,6,10,4,11,18,3,11,4,3,4,13,3,9,6,2,8,4,5,3,36,5,9,3,4,6,13,7,5,4,2,7,9,0,3,9,3,7,5,14,5,12,9,14,5,3,9,3,2,8,6,20,1,4,4,8,8,6,0,1,24,13,12,12,7,1,5,5,8,15,4,7,6,3,1,4,8,5,10,6,4,4,11,7,8,4,7,5,2,2,17,9,11,8,11,8,7,5,4,11,4,11,11,4,9,5,8,4,2,8,1,9,3,12,7,2,5,11,10,39,7,10,7,5,4,12,8,6,5,10,4,4,36,14,6,10,6,2,7,3,5,0,10,8,3,4,6,7,5,9,6,6,2,4,5,5,4,9,10,15,7,13,4,9,2,7,16,11,6,6,11,3,3,18,1,2,10,11,14,4,1,1,3,9,1,7,7,3,9,7,7,14,1,4,2,7,11,5,1,11,5,3,8,21,1,8,4,9,9,32,9,3,5,5,8,9,2,3,2,5,8,13,1,10,4,4,2,12,8,8,9,10,2,4,3,1,1,8,2,4,19,7,1,10,6,11,1,17,1,0,1,11,3,5,5,1,9,8,1,11,11,4,12,7,8,2,7,5,6,0,48,0,3,3,1,0,0,7,0,4,1,0
secretary,38,59,21,459,20,4,5,39,32,8,39,16,29,88,15,4,16,49,6,8,14,99,9,52,45,60,9,40,3,48,45,557,246,15,106,58,94,46,20,22,16,12,37,9,69,41,74,50,770,23,93,9,16,59,8,3,145,523,8,48,46,5,13,55,38,5,100,12,13,35,41,23,11,6,107,23,24,25,172,43,214,2,39,13,493,57,55,2,185,13,41,5,6,87,149,22,61,22,66,25,84,85,60,15,13,93,53,11,32,10,47,13,44,37,3,55,30,11,201,281,82,25,31,278,8,6,8,8,25,5,21,4,11,140,22,127,1,3,11,14,4,62,90,13,1,174,6,32,40,60,88,3,57,16,8,27,42,19,10,22,38,10,16,16,17,14,12,46,42,11,64,126,40,1,2,15,402,10,13,82,69,21,7,41,13,13,73,43,74,112,5,6,30,1,7,9,81,11,37,17,57,12,9,33,87,9,21,95,30,67,210,7,57,23,5,2,24,8,71,18,45,20,21,37,173,252,125,66,17,35,30,81,83,39,59,105,57,15,10,15,137,87,15,7,9,16,7,67,160,14,44,24,32,73,41,36,28,15,13,84,4,74,106,22,13,329,18,4,18,8,291,67,235,11,25,2,52,148,98,18,87,8,7,28,22,7,12,35,18,4,42,16,42,49,28,24,166,31,13,29,41,194,11,26,16,2,37,21,8,3,3,16,73,7,110,113,21,84,20,11,53,7,32,15,75,11,13,48,13,50,3,46,6,20,7,49,40,24,24,52,23,45,41,9,18,22,120,107,48,12,38,16,9,90,30,12,6,19,23,133,50,29,26,39,9,5,95,15,13,14,14,41,7,11,9,167,24,8,14,38,126,6,112,34,4,154,5,36,82,2,18,14,33,11,106,21,201,64,104,32,61,14,4,0,15,17,13,5,37,37,3,19,44,62,26,19,7,15,8,5,1,25,50,24,2,15,10,46,33,37,86,40,41,60,10,13,3,34,54,10,34,56,17,24,4,12,20,15,135,20,45,11,3,15,79,5,0,17,9,72,30,22,85,93,24,8,23,22,18,1,32,4,10,1,13,13,4,40,44,6,7,23,3,4,20,8,33,4,4,10,446,204,4,8,21,17,10,51,21,15,17,16,16,3,22,57,17,28,14,11,20,6,20,11,31,71,24,18,1,15,16,41,8,42,20,25,53,4,32,76,14,4,8,9,23,15,27,13,74,30,17,4,1,17,26,22,8,30,25,24,25,15,24,110,38,22,80,9,7,44,64,21,85,10,37,42,34,17,83,75,23,38,119,1,42,7,19,12,14,72,20,91,18,27,13,11,13,17,13,20,37,82,24,21,40,14,2,2,63,44,55,7,17,19,21,49,13,56,21,32,75,73,47,7,59,14,51,4,22,18,56,46,17,95,18,25,40,44,32,59,63,161,45,35,20,5,16,25,13,53,24,2,11,106,14,1,18,26,11,375,47,15,18,14,25,24,100,19,8,39,22,10,17,21,18,9,1,17,24,30,49,24,131,28,39,14,58,31,32,8,30,75,25,41,94,27,24,11,12,62,40,21,67,56,27,45,15,7,22,46,18,25,24,11,46,46,30,19,20,46,3,81,12,70,40,222,47,10,19,56,58,14,23,141,11,39,14,8,19,30,14,67,24,8,31,24,344,12,83,15,25,16,21,76,35,13,62,17,10,16,25,95,76,132,97,66,19,41,12,113,98,27,32,50,35,47,26,15,46,25,12,6,2,35,19,27,24,14,117,26,29,10,20,23,11,26,11,60,29,64,7,18,8,27,20,33,11,70,27,26,12,17,17,17,5,6,12,14,43,21,18,13,21,33,21,17,28,27,16,22,12,23,18,71,25,7,7,40,19,4,38,25,22,6,14,17,29,68,14,31,43,6,2,15,14,38,18,21,62,20,12,86,15,18,19,36,15,34,11,9,14,6,20,6,6,20,11,18,10,138,35,17,81,29,10,4,17,11,39,9,11,39,20,14,79,18,20,72,15,16,11,32,4,9,7,20,29,33,27,10,15,42,17,29,5,22,19,27,30,59,15,23,5,80,17,35,19,15,15,11,10,8,22,13,4,35,3,71,9,44,34,12,23,15,11,25,15,29,14,44,20,29,109,45,38,77,28,191,484,5,29,18,8,25,29,50,8,18,124,18,27,12,22,11,29,101,164,29,9,15,6,5,7,5,19,7,5,10,50,13,10,8,21,42,15,14,8,6,32,1,5,8,60,1,0,9,1,27,4,2
employment,1,15,2,98,0,1,1,6,2,1,0,3,10,42,1,1,5,5,1,3,3,23,12,15,12,6,5,11,3,5,3,118,56,3,20,37,18,11,20,3,8,7,3,8,9,6,8,16,99,10,25,4,16,26,24,1,26,20,3,7,5,1,2,5,12,6,50,12,2,8,24,3,3,3,72,8,11,10,38,14,64,11,4,8,125,11,8,3,15,1,6,5,2,12,24,6,11,7,30,47,22,13,19,5,13,17,9,2,8,4,12,7,23,11,23,15,4,1,51,88,20,14,18,45,7,3,6,8,2,7,16,1,3,32,8,74,4,6,6,3,2,21,17,1,0,25,5,10,8,5,29,3,9,8,6,41,24,4,1,20,15,1,7,4,4,7,10,9,17,4,9,46,15,2,1,10,83,2,9,32,18,5,25,8,1,21,22,16,26,21,1,1,13,1,0,6,10,6,10,7,41,7,9,8,22,10,4,26,4,24,49,7,14,4,1,1,2,13,4,9,4,5,0,10,28,74,17,10,3,5,13,14,23,17,17,10,11,10,29,8,47,26,4,2,17,15,5,11,70,1,9,18,2,1,6,6,9,2,5,28,23,24,10,2,0,16,12,3,1,5,68,10,10,7,0,3,21,7,2,10,36,2,4,18,9,6,5,3,7,0,0,2,5,5,3,1,17,3,7,18,7,24,3,1,16,4,12,1,8,4,5,19,17,15,17,14,18,32,29,8,15,6,9,5,24,3,18,13,1,15,0,3,7,2,1,1,9,8,7,6,5,10,14,8,0,2,18,22,13,22,10,4,2,36,13,6,6,6,12,18,26,19,2,15,0,1,24,6,3,7,5,12,5,4,5,41,3,5,6,1,32,0,24,5,28,14,4,22,13,2,8,5,2,1,19,4,43,1,25,2,5,0,0,0,4,6,11,1,20,12,4,5,3,11,6,2,1,5,3,0,2,5,19,4,5,1,2,6,4,10,6,2,0,4,0,3,0,2,9,2,15,18,12,8,1,1,8,2,23,4,14,2,1,3,29,8,1,0,6,18,4,8,19,20,7,1,28,6,2,2,14,1,1,0,3,13,2,2,16,2,3,7,5,3,6,2,13,4,1,5,32,15,0,0,8,3,3,11,6,9,5,5,2,6,4,27,8,5,7,4,1,5,3,4,11,7,1,4,1,7,4,8,6,6,0,3,11,10,8,15,4,2,0,6,6,1,3,0,17,29,4,1,8,5,21,4,0,10,8,2,10,0,2,19,8,5,22,2,11,2,8,7,12,7,9,11,13,7,24,20,12,1,22,5,8,0,7,8,8,15,11,14,3,13,3,3,7,7,2,5,6,15,8,6,78,5,7,29,8,10,8,10,2,0,7,7,2,8,6,3,13,17,9,3,15,3,12,12,1,4,8,6,5,5,6,5,3,9,7,11,7,7,17,8,14,1,9,5,5,21,5,5,0,6,5,18,1,3,13,50,14,1,3,1,1,6,10,9,2,10,0,2,0,4,1,0,0,7,4,1,9,3,12,2,11,0,2,4,2,2,2,25,4,3,4,6,7,8,3,10,5,19,3,7,5,7,3,2,7,4,4,2,2,1,2,1,13,4,4,3,2,3,3,17,10,14,1,2,2,6,6,1,0,15,6,5,6,6,4,6,3,12,3,4,0,2,16,2,17,5,11,6,8,8,9,3,10,8,5,6,2,3,1,2,4,7,5,14,5,10,8,15,0,5,26,8,4,1,14,4,9,2,7,9,1,9,15,4,8,8,6,3,3,5,9,6,3,1,2,11,7,12,10,5,9,16,8,4,5,10,7,2,1,8,1,5,8,3,4,7,6,1,7,3,1,2,6,3,2,11,3,1,6,4,3,3,1,1,1,2,1,2,3,2,3,6,10,7,4,3,2,1,1,6,18,9,6,2,3,2,2,13,12,1,2,4,4,4,4,0,1,4,6,7,4,5,6,1,2,8,7,2,2,7,8,6,0,1,9,1,0,3,3,1,6,2,3,4,5,5,2,5,0,8,0,1,5,7,1,1,8,2,1,5,2,0,1,7,2,11,7,14,1,4,2,2,4,3,8,8,1,3,1,9,1,2,2,3,2,3,9,8,4,3,5,2,3,3,1,2,3,5,6,0,6,13,2,17,12,4,3,4,4,10,5,0,1,4,17,1,1,4,5,14,0,14,6,2,1,3,1,4,10,2,2,3,6,7,7,3,4,4,4,4,4,6,6,13,3,0,0,7,1,2,6,10,12,0,1,1
request,23,25,10,124,6,3,3,6,6,2,14,11,10,27,0,1,7,4,3,0,0,15,6,17,9,29,1,3,2,16,3,128,68,2,18,22,15,8,6,2,0,5,3,14,11,5,24,14,179,9,20,3,2,11,1,1,21,36,4,13,9,5,3,4,10,4,34,0,2,7,28,2,3,2,15,9,12,2,45,7,27,0,17,2,133,7,9,6,43,6,14,6,8,20,29,4,10,0,17,0,12,23,13,1,10,17,7,7,10,4,9,10,9,8,3,9,14,8,37,66,12,14,4,43,7,0,1,3,0,1,7,2,1,46,6,31,8,7,3,3,1,16,28,2,4,47,3,2,12,6,21,2,7,4,2,28,13,3,10,14,12,1,3,9,18,1,1,10,8,6,15,28,9,0,0,1,74,3,4,26,18,11,19,9,7,4,10,10,21,42,2,1,4,1,10,5,11,3,10,2,8,0,1,10,14,10,4,10,10,11,49,2,21,2,1,3,0,17,13,2,2,13,4,6,21,35,14,13,1,18,6,14,18,4,13,6,23,1,5,3,30,23,1,3,8,2,6,8,43,7,11,5,10,2,3,6,6,4,4,9,5,18,27,16,4,35,5,1,12,1,65,19,19,2,0,2,10,11,4,6,23,1,2,13,5,2,6,6,4,1,14,8,20,5,7,7,33,6,1,5,13,29,5,7,3,1,22,1,4,9,7,5,13,5,28,4,11,23,6,2,27,3,9,1,14,4,2,14,3,21,6,4,1,4,3,22,5,10,5,9,3,15,3,6,2,6,13,25,2,8,3,9,2,9,10,2,0,3,1,12,13,3,3,9,1,2,17,4,12,10,3,14,1,4,3,21,10,1,7,2,19,1,24,5,7,27,3,23,12,0,9,5,13,11,12,5,32,4,39,3,10,1,3,4,1,0,2,1,10,5,1,10,2,11,4,3,7,5,4,0,2,7,12,6,2,1,4,11,2,18,9,19,13,21,5,3,2,14,5,0,4,7,2,6,2,3,1,10,7,9,4,5,5,6,22,1,0,6,3,20,6,8,16,10,2,7,4,12,1,0,13,3,3,0,3,1,1,15,8,3,1,7,1,1,5,12,5,0,3,11,35,18,1,2,1,5,2,22,2,2,2,4,4,8,4,21,1,16,5,3,2,2,2,1,5,11,3,6,1,5,0,10,1,8,0,4,10,2,17,12,2,0,2,1,11,2,10,7,13,11,1,7,1,3,2,5,42,10,7,10,10,2,2,21,10,2,9,1,2,11,15,3,15,7,8,9,7,2,30,21,2,1,16,8,2,11,5,2,1,13,2,8,4,3,1,3,3,2,1,4,7,9,5,5,12,0,2,3,45,17,10,0,1,7,3,7,2,16,8,3,7,32,16,3,22,3,1,0,4,1,7,0,5,11,2,2,5,3,2,9,2,14,3,1,3,2,4,7,2,7,2,2,2,21,5,26,3,1,6,132,17,3,3,3,8,6,23,4,16,8,2,3,20,13,15,4,4,3,5,18,9,0,35,13,24,1,5,11,14,1,10,24,6,1,5,4,5,2,0,9,16,6,9,4,10,7,5,8,6,9,23,3,2,3,2,11,17,4,1,5,2,20,2,10,8,14,10,5,6,5,3,4,6,12,1,3,5,1,1,4,3,10,2,3,3,6,6,4,9,0,4,2,6,3,6,2,4,4,2,2,6,2,10,25,4,8,6,4,3,5,5,7,7,5,11,3,16,1,4,5,1,3,0,7,3,2,6,1,4,7,2,3,10,5,8,7,2,19,0,16,10,5,7,0,6,6,3,4,7,4,4,4,6,9,1,0,1,5,6,4,4,2,9,4,2,2,2,8,6,5,3,5,6,10,2,4,4,10,8,6,4,3,2,4,2,2,4,17,1,5,8,2,0,7,4,7,1,9,4,8,9,24,2,0,0,3,5,4,5,2,7,3,4,8,1,5,2,3,2,16,3,4,2,3,5,0,13,8,12,7,13,9,2,4,4,6,6,4,1,6,4,12,0,1,3,41,0,8,3,1,6,5,8,9,10,19,14,8,5,15,5,24,2,10,5,10,3,5,3,4,5,7,0,3,3,4,1,23,3,6,9,7,2,3,1,0,2,4,4,3,3,7,11,2,1,21,3,3,15,4,2,2,1,1,7,3,0,3,19,3,1,5,3,7,2,22,3,2,3,3,0,2,0,3,8,6,5,3,4,2,8,2,5,2,6,0,3,7,8,1,1,13,1,4,3,1,2,4,0,8
enact,3,21,9,237,9,4,5,17,3,3,8,4,11,42,2,5,5,9,7,1,4,24,15,6,33,12,13,16,2,11,3,124,54,13,41,26,9,8,9,0,7,3,2,15,23,8,32,16,139,14,30,10,8,18,22,2,20,9,6,2,6,4,2,5,12,5,73,7,3,7,23,2,2,3,72,3,17,4,40,12,51,1,0,6,158,6,9,5,13,2,8,4,7,17,37,20,14,5,32,13,13,27,26,4,16,20,13,4,11,2,12,8,3,23,8,22,1,1,75,118,18,12,38,71,12,3,4,0,1,4,12,2,2,43,9,51,7,7,4,10,3,25,21,5,1,46,6,7,12,4,43,5,12,4,3,52,29,12,6,20,15,3,8,6,24,12,3,18,21,6,11,63,20,2,2,1,96,8,11,53,19,5,42,18,2,13,23,18,37,34,3,8,8,3,2,3,17,7,10,11,30,8,1,9,15,13,5,27,6,22,51,5,22,6,2,7,13,16,13,3,4,10,7,3,37,229,23,8,2,12,8,14,18,24,16,20,15,6,13,4,43,19,2,5,15,8,7,16,74,4,32,13,28,3,5,6,3,0,2,13,17,9,13,6,6,41,5,6,11,3,77,9,9,4,2,2,27,9,7,6,36,9,3,10,8,2,18,14,9,1,4,2,30,7,6,9,18,9,3,15,13,41,2,1,16,3,15,3,12,1,5,20,29,5,12,7,21,28,10,10,17,4,23,9,42,10,17,11,1,17,3,13,7,5,4,12,8,8,2,8,5,3,5,7,6,9,36,27,12,16,10,16,2,25,7,8,6,4,16,21,100,11,13,27,2,0,19,10,21,12,3,13,9,6,9,20,2,5,14,1,43,5,36,11,12,26,10,15,21,3,16,5,19,13,18,6,52,2,27,2,16,1,4,5,5,6,8,0,11,8,1,2,1,10,8,4,2,3,5,0,8,5,17,11,6,4,3,8,8,7,1,1,0,6,6,2,3,5,4,3,17,14,6,3,0,0,15,3,24,6,9,4,5,4,21,7,0,11,5,23,15,10,16,20,7,9,17,9,10,5,17,3,3,1,3,17,0,7,13,4,12,7,0,2,4,9,5,0,5,2,17,27,1,1,7,1,1,8,7,9,8,5,4,9,10,9,2,8,4,3,5,6,5,11,12,16,6,6,4,11,4,10,3,18,8,1,15,30,15,14,10,4,5,10,7,8,6,8,23,26,4,0,2,3,6,13,1,5,5,4,49,9,22,30,6,8,20,6,2,12,8,13,35,8,4,14,5,3,29,35,3,4,8,21,4,2,5,1,6,24,2,6,8,9,5,4,2,6,6,6,11,19,6,6,26,2,6,4,10,9,15,1,2,5,6,15,1,19,15,2,20,26,8,1,22,3,6,3,13,2,1,1,5,12,5,5,2,8,6,25,0,16,22,13,3,5,22,4,2,1,6,6,19,8,3,11,13,6,1,65,16,6,3,11,6,3,21,14,6,6,2,4,7,3,1,4,1,11,4,4,10,5,3,32,7,2,2,5,1,2,5,22,3,4,5,6,7,4,1,5,13,9,3,2,8,8,2,2,6,11,0,1,5,5,3,5,10,3,15,5,2,6,5,29,6,3,1,4,2,7,5,5,4,14,0,4,1,1,6,6,6,11,4,7,2,5,9,6,25,1,8,3,6,7,2,4,9,10,2,7,1,2,3,4,4,13,0,4,4,13,12,7,2,17,13,14,10,7,8,6,4,2,5,14,6,10,4,6,5,6,0,3,3,5,6,0,4,6,1,6,6,21,17,5,30,18,9,6,2,4,4,3,6,10,5,0,1,5,14,5,6,0,7,9,3,1,4,8,2,5,0,4,3,10,4,2,5,12,0,3,7,1,1,3,4,3,2,14,5,2,3,11,8,11,4,7,8,3,1,2,7,16,12,4,5,4,4,4,6,3,2,8,1,2,4,4,2,5,7,21,6,7,4,4,10,1,0,5,6,0,0,6,1,5,2,5,7,4,3,1,3,1,1,2,2,4,1,5,3,0,7,4,4,2,8,1,0,3,3,14,6,3,6,4,9,3,2,8,2,5,1,1,3,2,2,2,0,1,0,4,7,12,4,2,3,0,7,4,3,7,2,7,6,2,9,7,4,11,18,1,1,6,0,5,7,4,0,0,12,3,5,0,0,10,5,4,5,4,8,0,1,6,0,6,1,0,8,6,4,2,4,4,4,1,5,5,5,3,1,3,1,2,1,5,9,2,1,2,2,1
united,204,437,136,1879,146,68,118,408,96,48,596,219,101,1260,80,105,113,185,78,71,62,504,79,369,266,140,145,155,90,231,176,2308,1695,109,571,585,757,121,69,65,57,120,109,41,355,271,376,165,10763,489,658,77,127,615,73,99,840,373,33,226,434,156,25,225,200,56,1153,60,130,232,158,93,38,62,639,141,168,70,953,287,424,0,296,73,3592,187,145,3,672,34,145,79,19,484,778,104,263,57,486,104,159,328,502,110,146,338,46,35,169,61,257,69,57,136,35,406,174,73,1236,1875,454,282,88,776,96,41,45,94,67,36,166,61,65,629,246,382,114,57,65,86,30,508,547,42,58,970,70,212,169,138,924,27,250,81,42,209,346,63,284,110,85,43,63,64,29,65,46,231,222,139,369,1077,224,25,46,147,2264,39,149,252,270,166,40,197,65,209,301,248,686,1056,49,88,112,15,19,44,111,56,91,117,159,21,23,187,463,110,73,242,220,380,935,65,417,72,34,33,11,14,152,57,56,246,80,165,559,1288,322,276,61,157,149,187,183,324,349,159,400,89,108,95,844,413,86,62,207,80,71,214,574,78,129,241,280,85,129,190,141,52,71,228,37,426,370,165,80,381,41,84,206,88,1665,83,433,64,51,18,300,88,234,33,610,55,35,228,134,47,34,82,166,31,182,143,113,52,102,152,723,89,117,211,421,437,23,67,186,29,400,44,68,12,43,142,260,78,475,182,152,555,158,65,1098,110,328,37,1061,178,72,393,71,428,64,122,128,46,92,230,293,160,46,228,113,216,174,209,62,105,645,1035,202,83,138,147,96,391,386,57,92,66,160,335,236,68,103,243,93,24,524,118,63,143,53,253,70,95,80,262,115,26,212,68,906,59,467,211,45,630,128,392,379,34,373,44,170,328,462,134,948,28,491,77,372,47,64,32,54,36,79,109,442,164,55,192,135,178,348,155,122,166,70,60,57,137,239,243,21,63,64,217,197,256,299,183,59,337,72,127,61,407,112,63,255,384,105,281,46,83,122,113,440,75,206,99,56,86,991,136,48,251,81,394,160,215,370,204,58,97,158,254,146,14,170,40,31,24,30,108,84,283,203,69,80,170,133,81,107,132,123,58,62,93,1132,456,30,89,115,131,50,269,116,97,151,50,39,12,208,312,39,206,114,43,37,56,125,83,131,197,72,83,56,105,78,366,84,307,114,95,350,23,258,356,111,37,66,83,145,101,182,82,581,135,88,115,35,40,116,114,231,213,265,124,458,106,134,756,111,107,517,59,111,126,361,66,448,59,177,157,165,95,514,458,109,121,181,64,93,174,97,102,67,268,92,241,157,180,91,105,89,119,82,103,372,506,127,43,182,69,33,17,1430,295,309,32,83,164,188,265,89,367,45,58,424,320,249,123,552,131,198,48,93,85,129,91,36,369,29,91,179,110,172,455,224,296,265,284,138,43,73,116,42,157,71,20,121,322,168,375,50,132,65,1,581,86,114,68,127,188,558,354,148,288,62,175,550,678,246,221,131,169,148,170,241,69,1212,568,749,118,35,122,269,111,170,369,235,135,180,93,228,109,94,297,302,145,233,293,152,119,151,120,200,252,193,97,125,101,105,108,211,91,71,87,62,300,102,331,297,258,162,140,226,47,142,71,171,305,23,184,106,14,35,192,82,177,72,47,131,53,213,59,827,115,144,150,48,160,222,55,134,76,59,139,111,52,46,246,81,159,93,175,54,229,203,156,116,98,361,150,183,74,81,214,76,76,22,390,66,207,83,28,193,175,111,66,163,67,185,121,89,655,99,236,116,195,95,91,75,201,72,127,68,116,83,116,206,89,39,40,72,72,251,114,147,150,433,144,64,110,58,203,127,157,127,59,197,205,75,95,28,127,79,92,118,120,127,74,76,121,166,314,192,108,181,93,83,166,89,107,92,167,80,217,444,468,155,84,40,116,70,86,198,30,177,89,132,42,85,142,65,42,143,126,61,74,151,97,49,73,210,417,196,170,163,145,55,128,277,82,114,101,131,86,126,245,21,95,149,343,92,67,78,59,50,140,77,168,80,179,123,240,94,280,79,89,124,175,201,149,71,177,45,68,160,176,90,199,117,111,140,546,107,106,107,80,119,132,67,57,66,63,102,79,49,164,34,33,32,255,113,146,342,96,20,88,46,32,51,100,141,119,267,113,77,85,62,72,44,593,47,12,63,130,81,102,95,76,145,109,16,107,142,143,102,63,105,98,98,42,127,56,610,34,58,45,62,16,5,31,14,107,18,36
island,29,40,18,184,15,4,19,25,9,6,57,28,22,86,10,31,24,20,10,4,3,97,11,55,29,28,18,8,13,19,41,342,123,16,99,110,114,9,0,4,9,14,14,13,46,48,37,52,713,39,98,20,28,48,0,27,111,54,3,44,53,15,1,23,28,9,376,14,7,33,11,53,2,3,127,15,81,28,142,41,59,0,38,34,452,4,38,0,85,3,15,5,0,60,114,1,29,20,66,25,12,44,57,28,20,51,2,5,15,11,21,9,1,9,0,61,8,4,118,291,97,64,10,93,25,5,18,14,12,4,26,9,11,96,14,72,33,1,5,8,19,51,58,8,8,174,4,27,32,13,140,20,26,16,2,8,95,0,61,33,9,3,17,4,0,19,17,61,35,29,37,145,84,1,3,18,310,25,22,115,75,18,1,41,16,38,51,53,91,105,2,3,50,2,3,2,10,7,14,9,51,0,14,41,54,26,2,38,47,44,240,27,41,22,8,0,2,0,18,3,0,25,4,40,53,121,67,41,26,3,54,48,21,58,41,29,48,27,23,19,114,87,17,35,22,20,16,38,104,11,22,58,40,5,21,19,16,2,18,29,19,62,40,13,19,31,7,3,37,7,225,0,25,13,4,0,24,12,32,6,130,18,2,14,24,11,7,4,20,1,41,18,19,7,6,17,62,13,14,23,44,47,2,8,27,4,48,5,15,0,9,13,40,7,56,14,28,83,28,4,95,15,52,8,143,22,33,38,4,70,9,8,33,9,19,62,40,12,5,17,19,76,36,36,6,16,75,111,58,5,19,16,11,38,55,2,25,27,38,67,28,29,76,28,3,2,71,16,4,8,17,22,6,19,1,43,11,5,20,7,206,11,62,34,1,66,4,42,65,3,46,5,19,47,61,25,83,3,122,11,45,5,11,12,4,1,9,6,61,5,4,28,16,49,275,8,3,9,7,0,4,14,29,24,8,10,0,19,27,46,13,9,12,9,12,25,0,37,21,16,34,70,19,35,4,14,23,23,84,11,8,22,5,16,137,40,2,10,11,50,29,42,76,67,9,280,40,19,20,5,35,19,4,2,17,25,3,32,40,8,10,17,16,16,25,11,16,7,14,31,163,57,2,9,4,15,18,29,5,7,11,6,7,0,38,0,3,30,9,8,6,2,23,15,24,17,32,29,4,10,16,46,9,80,16,16,56,1,29,43,25,14,10,9,17,6,14,34,81,5,9,0,2,0,42,7,12,36,19,6,21,5,19,95,21,4,81,6,15,47,70,6,51,1,15,22,30,11,61,99,11,13,11,3,29,30,31,17,21,45,2,36,28,27,11,15,8,35,14,16,36,69,21,4,80,16,7,5,143,47,32,3,12,13,30,57,6,33,17,3,50,80,22,24,52,19,26,7,16,20,13,0,7,25,1,27,28,14,21,64,2,50,41,36,7,9,20,14,7,15,8,4,18,53,32,47,14,17,16,581,1,23,9,10,30,28,88,44,21,27,8,19,25,89,27,9,10,33,24,12,29,15,31,33,81,14,9,8,18,50,21,79,28,24,22,13,21,12,16,78,32,23,39,72,20,36,16,13,28,20,20,12,13,13,3,14,33,16,1,8,31,47,14,73,42,27,39,16,37,27,17,13,12,54,7,72,15,3,4,18,12,26,5,10,9,6,31,9,92,12,13,66,7,28,42,7,15,45,13,11,19,5,3,21,11,17,16,50,9,34,33,45,14,13,32,12,16,15,17,17,10,10,5,17,15,20,2,1,16,12,3,16,26,0,8,21,7,12,9,11,14,5,11,13,16,30,7,13,9,10,14,19,31,6,7,13,7,8,39,33,20,7,41,36,14,10,17,33,16,45,9,7,15,37,19,15,5,13,5,7,1,10,6,2,14,10,17,39,35,11,22,20,3,9,14,23,16,23,16,32,80,98,17,3,12,19,10,0,6,1,14,8,17,13,9,6,13,10,28,22,0,8,4,3,14,11,12,23,20,33,8,17,11,10,30,6,11,6,13,17,3,33,2,8,27,37,6,82,12,8,9,15,44,35,33,7,7,9,36,48,7,0,16,10,19,21,10,6,8,10,17,20,7,22,21,5,20,39,12,0,9,11,11,20,2,0,10,11,24,16,20,13,0,0,0,7,4,15,11,10,2,17,4,4,7,14,25,25,17,12,6,12,3,7,6,87,2,0,3,24,22,24,14,14,11,9,0,14,9,33,6,5,21,0,8,2,11,2,187,4,3,10,4,1,0,2,1,7,2,0
lie,1,8,6,47,6,5,7,22,3,2,7,0,12,63,3,3,1,18,1,2,7,19,4,19,14,4,14,14,2,14,2,79,55,7,37,49,44,10,28,7,4,8,1,2,20,16,10,7,156,18,28,9,15,42,7,6,16,10,5,11,6,6,8,13,9,9,85,5,3,17,15,4,2,1,90,17,9,4,48,14,25,1,7,7,144,7,8,0,20,1,1,5,0,24,18,4,15,2,25,11,3,24,13,9,15,13,4,6,9,2,10,1,5,19,2,21,1,4,20,95,24,18,4,41,4,3,0,5,1,3,10,3,10,33,16,37,1,2,5,6,2,22,10,5,4,43,11,8,9,6,45,1,16,8,5,16,31,8,8,13,6,9,8,0,0,6,4,21,12,5,11,67,27,19,2,6,84,1,10,44,23,10,1,15,4,26,24,15,16,24,1,7,5,0,0,7,12,6,4,12,11,2,0,7,17,11,4,17,15,23,42,11,6,3,2,3,0,2,5,1,2,8,3,10,21,49,9,14,9,1,12,14,15,19,27,9,27,3,12,3,31,26,3,5,23,3,5,17,21,4,11,16,14,3,3,14,4,0,1,10,1,12,10,1,6,10,15,4,11,4,80,2,9,5,4,0,13,3,4,4,43,10,3,20,14,2,4,6,8,3,0,5,7,3,2,2,15,0,3,18,26,17,2,2,5,2,13,3,6,2,1,31,15,4,12,3,11,17,10,3,22,0,25,9,40,7,13,14,5,25,1,9,1,5,7,7,15,4,4,4,7,6,12,9,1,14,23,37,11,5,7,3,8,31,17,6,0,3,11,11,12,10,20,16,2,6,18,6,5,8,3,6,3,9,4,10,6,9,8,8,41,4,24,10,5,62,18,16,18,3,16,4,2,6,19,5,33,0,28,1,8,3,4,1,2,9,5,2,18,2,1,9,0,10,10,7,5,6,7,0,1,3,5,10,6,3,3,4,6,16,3,4,2,2,2,1,4,5,5,7,12,11,14,6,2,7,16,8,16,6,14,4,3,1,48,5,2,5,10,12,14,17,11,31,5,8,9,12,19,2,21,5,4,1,1,30,7,11,14,5,10,8,6,3,5,6,6,2,6,4,48,24,4,5,2,2,3,6,2,3,20,5,3,0,3,6,7,10,6,3,2,11,1,7,5,7,4,14,2,11,6,5,2,17,3,6,9,11,8,7,13,2,4,6,8,10,8,11,15,19,3,3,3,8,18,4,2,8,4,1,9,4,3,47,2,9,10,3,4,7,11,1,8,1,5,10,6,3,14,20,10,5,6,3,6,2,6,3,3,20,5,14,9,14,4,3,6,3,1,5,11,18,12,4,19,3,2,4,25,14,16,8,7,0,4,15,2,4,6,2,17,10,8,4,16,10,5,1,1,5,9,4,5,9,8,2,6,4,8,18,3,10,21,12,4,3,8,10,0,9,8,2,6,6,5,15,1,3,6,86,23,1,3,1,8,4,23,8,5,7,4,8,9,15,5,4,3,6,11,4,15,10,16,6,17,4,3,1,9,5,11,17,10,8,6,3,6,2,5,12,12,14,6,12,3,2,4,1,2,3,14,2,0,2,6,8,5,4,2,2,8,2,4,16,21,7,3,8,8,8,11,4,5,15,4,10,6,4,4,6,1,6,14,11,3,1,17,6,27,4,3,6,6,16,9,3,6,17,3,5,11,1,0,5,2,11,2,4,5,6,8,10,0,3,7,11,9,7,3,9,6,6,3,6,1,9,3,0,5,10,5,2,8,3,6,12,7,12,3,9,1,8,2,2,8,16,6,3,4,4,3,4,2,4,8,10,4,3,9,8,2,4,7,5,1,3,3,4,3,6,1,3,2,5,5,2,6,4,6,2,9,3,2,5,5,4,2,15,12,3,1,4,1,4,5,6,5,3,3,9,4,13,6,5,3,1,3,14,1,2,2,0,6,3,2,2,3,2,4,4,3,1,3,4,9,5,0,1,4,4,3,5,3,0,3,5,1,2,3,1,2,11,1,1,3,1,3,0,4,9,4,3,7,1,2,3,1,9,3,15,2,4,5,11,8,3,0,17,2,2,2,6,3,1,2,4,2,3,2,1,2,0,0,8,2,4,6,5,1,15,0,7,4,1,4,5,8,4,8,2,8,5,1,1,3,5,2,5,2,2,21,16,0,4,3,13,11,0,5,8,6,3,8,6,1,2,0,4,4,1,1,5,6,3,4,4,7,3,11,1,5,2,1,0,2,1,2,2,4,8
felt,6,21,6,81,11,5,2,38,6,0,8,4,10,43,10,6,6,12,5,6,4,27,8,14,18,3,12,9,10,2,5,115,119,3,42,34,32,7,15,3,3,13,7,1,22,20,24,4,209,23,54,2,6,13,1,11,71,10,0,13,5,3,2,7,15,8,87,6,11,6,1,1,2,3,34,22,15,6,55,20,22,2,11,4,132,16,14,0,24,1,8,8,1,12,36,9,20,6,19,5,6,18,20,9,8,24,5,3,12,2,11,4,2,11,1,32,3,2,33,108,32,9,9,37,3,1,2,2,3,1,25,2,7,18,10,14,2,2,2,9,0,22,23,10,4,55,1,13,8,7,49,2,8,7,4,11,22,2,9,4,7,13,5,2,1,10,3,13,15,3,11,50,10,10,1,13,113,1,9,20,12,14,2,13,1,12,19,17,27,40,1,10,8,3,3,3,9,1,11,16,26,1,2,13,28,5,9,26,3,20,47,2,17,4,2,6,3,0,4,2,3,8,4,11,25,61,17,22,0,2,5,14,11,21,24,16,39,0,7,2,62,35,4,5,5,6,5,13,19,5,11,19,15,9,13,24,9,3,2,13,1,17,19,0,7,21,3,6,6,3,78,7,18,4,3,0,19,4,6,2,56,4,6,17,5,0,4,18,4,3,2,1,15,4,3,10,23,17,4,15,17,11,0,0,13,0,10,0,7,0,1,17,26,10,29,14,14,32,9,2,26,10,29,2,38,4,4,23,7,17,2,10,9,3,3,5,16,3,1,9,13,2,10,13,8,5,33,44,12,3,6,8,4,43,15,2,2,4,9,12,15,4,5,18,3,0,36,8,1,17,1,6,6,4,7,15,4,6,11,4,21,0,22,10,6,34,5,13,29,6,12,4,7,8,28,7,42,5,29,5,19,1,3,0,4,6,1,0,28,4,4,10,4,9,18,9,5,3,4,1,4,3,18,6,2,3,3,10,8,15,11,6,0,2,2,3,0,6,8,0,8,7,3,11,1,2,4,10,23,7,12,4,5,2,44,5,3,8,6,25,8,14,25,19,1,1,13,8,3,1,16,8,4,10,0,17,1,9,11,10,7,11,1,6,12,7,10,2,8,1,47,36,3,5,5,7,0,8,8,9,11,5,2,1,0,35,12,7,3,13,8,6,10,5,14,16,3,9,3,6,2,7,6,12,4,4,17,1,7,22,4,5,4,4,4,6,12,6,27,21,2,1,3,8,9,10,0,17,7,6,25,5,3,18,7,7,21,5,6,7,13,2,13,4,10,15,11,2,29,15,7,5,6,9,4,7,8,9,7,7,5,9,11,16,9,1,3,11,2,10,20,33,6,4,14,6,3,5,27,12,11,0,7,4,6,16,4,28,3,1,22,8,5,10,16,7,14,3,4,6,8,12,2,20,4,4,9,2,7,18,6,19,15,22,5,3,11,6,5,10,8,2,2,11,7,18,3,3,3,114,9,3,1,2,13,11,35,7,4,12,6,5,2,15,4,3,2,3,11,12,11,6,21,11,22,3,2,4,1,10,5,18,10,7,10,8,7,1,0,8,10,3,10,5,4,4,7,4,11,12,12,3,8,6,12,4,15,1,3,3,6,2,6,18,11,11,3,6,7,3,4,8,7,7,3,8,6,1,3,13,5,5,3,2,3,2,11,2,12,3,13,2,1,13,16,5,10,2,9,6,9,3,1,2,4,10,5,9,1,22,18,7,0,1,10,12,3,8,3,12,4,8,1,13,4,20,15,1,7,4,1,5,11,7,11,3,16,11,6,10,5,1,0,5,3,12,2,3,3,2,5,4,7,0,6,2,9,0,7,5,5,2,5,3,4,4,5,5,3,5,4,5,4,11,2,5,1,8,13,5,3,7,15,2,3,15,10,20,4,3,5,3,8,14,8,6,13,5,4,7,11,14,6,14,1,1,8,5,3,0,7,1,3,0,7,11,4,3,6,11,1,0,3,18,4,10,1,9,15,1,1,0,4,4,4,1,8,6,0,2,2,6,0,1,5,3,3,2,3,1,7,11,1,5,12,2,0,10,3,11,3,5,5,8,6,3,7,3,2,4,9,3,7,14,2,6,0,10,3,4,1,3,6,6,5,8,3,4,5,5,7,5,4,1,2,10,4,5,23,1,2,2,6,6,2,2,2,3,6,5,1,0,5,0,0,2,1,0,6,9,5,6,9,5,5,3,1,8,9,1,0,3,2,12,10,2,13,2,10,0,2,3,8,2,1,1,0,5,1,1
amendment,4,37,17,129,3,1,3,34,1,3,7,4,6,18,5,1,0,8,1,4,9,18,8,21,7,17,10,11,3,3,7,103,50,3,20,27,4,0,2,2,3,6,3,6,16,11,37,17,191,8,25,3,1,4,2,2,19,21,1,6,10,4,0,3,20,5,60,0,0,1,7,0,6,4,25,3,9,1,39,9,21,0,8,1,142,9,5,3,13,1,1,3,1,11,8,2,5,3,14,1,6,1,11,5,19,13,1,5,8,1,7,6,5,3,0,14,2,1,59,92,17,11,13,31,6,2,0,2,5,3,1,1,1,21,5,27,3,1,2,3,0,13,13,2,0,37,2,6,3,5,46,0,10,3,0,34,12,1,11,8,2,4,3,2,1,10,1,12,11,5,6,42,9,1,0,1,73,2,4,37,21,9,2,11,5,13,30,5,23,31,2,5,0,0,1,8,7,3,8,8,13,0,1,16,12,2,4,34,6,6,37,0,31,2,0,0,1,4,22,1,1,6,0,14,32,113,18,10,0,4,7,8,12,15,15,18,16,3,2,2,32,18,2,5,11,2,1,7,59,3,11,1,7,3,5,7,0,3,1,7,7,11,16,1,1,37,9,4,4,4,86,3,8,3,6,3,18,6,5,5,20,12,0,11,7,0,3,5,2,2,2,5,28,2,2,6,8,6,9,9,22,34,0,4,12,2,6,3,6,0,2,15,16,7,12,12,22,17,8,10,20,4,9,8,58,9,2,7,4,15,15,8,5,2,6,10,5,3,5,8,3,4,3,9,0,1,22,33,10,5,10,7,2,14,12,3,3,3,11,15,28,6,2,8,0,0,11,4,12,13,3,21,5,4,3,31,1,1,8,4,45,3,25,6,2,17,11,5,11,2,16,0,22,30,24,4,31,5,19,1,15,1,5,1,7,1,5,1,8,6,0,3,1,13,5,4,2,3,1,0,3,3,17,9,1,2,3,5,9,5,3,5,1,4,1,0,0,0,0,8,8,13,1,2,1,0,3,4,8,1,7,8,2,4,25,7,0,9,1,22,5,7,17,11,2,0,6,4,3,1,8,0,0,2,3,2,3,17,9,6,5,1,1,3,0,6,5,1,3,3,20,25,0,0,5,3,1,9,2,8,5,0,1,4,0,4,0,12,2,4,4,7,4,11,14,9,1,2,1,3,2,3,6,17,4,3,30,4,9,9,9,4,0,4,1,4,10,13,15,7,1,1,3,1,2,13,1,7,14,11,123,13,14,21,2,16,11,6,1,5,16,10,30,7,12,12,3,7,24,32,10,2,6,15,0,5,5,5,12,11,4,5,9,11,8,1,4,1,5,6,11,9,4,1,10,0,1,1,24,14,25,0,0,14,3,10,5,20,6,3,9,13,3,0,17,4,11,1,12,1,6,0,1,8,3,7,5,20,11,14,0,23,21,10,1,3,8,2,2,4,3,0,8,12,2,14,1,3,11,68,10,1,2,1,3,7,18,8,9,7,13,2,19,9,7,29,3,3,4,9,9,2,7,36,11,3,5,7,0,1,5,10,2,3,5,7,10,3,2,3,10,5,8,2,4,7,1,10,11,10,0,0,5,1,17,2,3,0,8,3,2,2,4,23,9,5,3,8,2,9,6,0,1,14,0,2,1,1,4,10,3,14,1,1,2,2,4,2,11,2,4,1,0,0,9,2,7,3,4,4,4,1,0,4,0,4,7,7,6,8,9,4,4,0,12,4,6,2,5,3,2,1,0,2,2,5,0,5,6,4,1,1,2,0,1,5,1,0,12,4,9,5,3,2,1,17,0,5,2,3,1,3,9,8,1,0,1,6,8,2,5,0,8,4,0,0,3,5,0,8,3,4,2,5,0,5,2,13,2,2,4,4,8,3,4,3,6,7,3,3,2,17,9,6,5,4,8,1,9,7,15,18,9,4,0,3,3,5,11,1,2,5,6,4,4,2,3,5,3,18,0,3,0,5,5,6,4,2,3,1,1,2,4,1,1,2,1,1,1,5,1,0,1,0,2,1,0,5,1,3,4,1,0,3,30,2,2,7,5,16,2,3,3,3,6,2,2,0,2,1,8,1,3,10,2,3,0,8,1,2,14,8,6,2,6,1,4,2,1,7,1,1,2,0,3,1,4,2,20,2,0,4,1,1,5,1,1,0,10,5,0,0,3,1,0,16,2,4,11,2,0,6,0,0,1,1,1,6,0,6,5,3,8,0,2,4,2,4,0,0,1,0,3,1,1,4,0,0,0,0
ground,24,12,14,78,9,6,3,18,5,4,11,12,8,59,1,18,6,11,1,5,3,24,6,23,13,9,17,4,6,9,7,114,68,8,41,26,22,7,3,2,5,4,7,1,22,11,12,7,205,16,58,2,8,25,4,7,37,11,3,5,9,5,5,11,15,2,45,4,6,11,3,6,3,5,44,3,11,5,32,22,19,0,11,3,120,8,9,0,15,0,5,2,0,16,26,7,12,3,10,7,8,17,12,6,5,13,1,1,4,4,18,4,4,11,4,20,9,0,49,77,29,15,12,25,9,1,5,2,1,2,7,4,3,36,13,25,1,3,7,4,7,17,15,2,4,71,8,15,7,5,41,1,9,3,2,7,22,2,7,13,2,3,11,1,0,6,6,18,11,12,11,44,15,1,2,6,122,5,7,24,20,14,1,11,4,16,14,15,26,36,2,7,4,2,3,2,6,6,4,12,16,0,2,13,31,2,4,22,5,12,56,6,15,4,4,4,0,1,7,3,1,17,6,8,22,60,15,13,6,4,8,6,4,8,12,6,24,5,4,10,44,23,11,6,8,4,1,12,28,0,12,9,14,1,10,9,6,1,3,8,4,19,16,7,3,20,2,7,14,0,67,7,8,4,7,1,16,4,15,2,32,8,3,12,1,4,3,7,10,2,5,2,9,4,3,15,23,11,3,16,12,13,0,4,14,2,8,1,6,3,1,6,17,4,10,11,5,24,7,4,31,7,14,1,66,7,6,13,5,14,10,5,8,3,6,9,15,6,1,3,3,13,4,12,4,6,23,41,7,2,13,7,1,15,10,2,7,4,5,11,16,3,10,18,0,0,23,7,1,3,1,16,7,9,10,7,5,6,13,2,24,1,28,1,5,22,5,16,11,0,27,0,13,10,30,12,43,2,37,4,21,3,2,0,5,7,2,5,19,7,1,7,2,8,19,5,3,4,4,4,3,15,10,10,3,0,1,18,1,11,7,1,1,5,2,9,0,8,6,2,4,17,2,4,2,6,8,7,16,3,12,4,4,1,39,5,0,21,11,19,11,11,19,15,3,6,10,18,7,0,10,10,2,0,0,17,4,18,10,4,13,10,3,2,6,6,2,4,4,2,37,23,2,4,3,6,2,10,3,5,13,4,0,0,7,6,0,6,4,5,2,5,3,3,3,11,6,3,0,4,6,20,1,15,3,7,18,6,6,26,4,4,4,13,6,2,8,11,26,19,8,1,3,0,6,5,4,20,4,1,23,5,7,32,5,8,21,3,1,8,13,2,7,4,10,12,11,5,20,32,9,9,6,6,3,5,2,4,4,16,4,4,4,22,2,8,4,5,5,7,20,29,10,2,10,2,9,4,57,12,7,1,1,2,2,18,7,11,2,2,21,8,4,6,32,4,10,5,6,1,12,1,3,10,4,9,5,8,16,18,4,12,16,11,7,2,2,2,1,5,4,4,10,10,9,25,1,8,6,127,30,8,13,3,1,8,24,11,9,10,5,14,18,28,6,2,0,9,5,11,8,3,17,33,28,5,0,3,8,2,10,22,7,7,3,5,13,4,3,17,9,5,10,11,2,6,7,2,5,13,6,3,4,5,5,7,9,2,5,3,1,9,6,14,16,16,13,4,6,3,4,11,5,13,3,22,4,2,5,5,6,1,4,0,3,1,9,2,28,8,7,4,7,11,13,1,8,4,5,7,8,1,0,8,0,15,13,2,3,3,2,13,1,3,20,3,9,3,7,5,1,1,5,13,1,13,2,2,4,6,0,3,8,5,11,2,4,29,1,12,6,12,3,3,18,8,4,4,2,0,8,6,13,2,2,0,10,1,17,8,3,1,13,11,6,5,6,6,2,7,7,5,1,11,4,4,2,3,5,3,2,3,3,5,6,6,9,13,10,7,5,3,2,10,6,6,6,4,4,2,11,20,9,7,2,6,4,1,6,1,3,12,3,1,3,5,5,4,4,7,2,2,2,4,5,3,3,18,11,2,6,5,1,4,2,3,6,8,6,1,4,16,0,5,4,3,7,8,1,1,2,8,2,2,4,3,9,2,6,10,2,0,3,5,15,3,1,11,9,3,7,5,1,5,8,5,2,16,4,1,3,2,2,6,3,0,4,5,8,11,2,3,0,1,0,4,1,2,10,3,2,6,1,1,3,2,3,7,9,5,1,9,6,5,1,20,3,1,3,9,10,5,5,1,4,2,1,6,3,8,1,6,5,4,3,7,6,0,17,0,2,5,1,1,2,3,4,1,2,1
close,7,36,5,185,14,11,8,50,7,4,23,12,16,79,10,9,10,20,11,6,8,41,34,24,13,19,29,32,13,40,10,190,150,25,62,98,37,4,9,6,9,17,3,9,33,18,23,12,333,57,54,13,18,62,5,6,54,43,20,31,24,25,1,19,26,8,83,5,13,11,24,9,6,5,65,15,20,5,99,27,68,3,23,11,178,21,16,1,77,3,14,7,8,50,62,8,17,5,65,19,20,41,42,15,24,39,13,7,36,14,25,5,11,15,18,49,10,7,94,116,34,34,20,170,9,3,6,4,4,1,13,3,13,46,33,66,7,2,11,14,3,72,76,6,4,66,15,15,11,14,51,4,25,13,6,24,36,9,17,32,21,5,13,4,6,15,4,18,26,14,27,116,15,1,24,10,154,6,7,45,20,17,13,19,7,24,32,22,33,69,4,8,9,4,6,4,8,9,14,13,24,3,2,13,25,8,6,38,15,31,82,15,38,5,8,7,8,11,26,2,18,22,8,15,47,67,30,52,12,9,15,20,20,22,35,27,38,13,11,11,57,46,15,11,14,6,8,34,48,6,11,16,38,13,6,17,13,5,8,46,1,27,27,8,11,51,4,21,26,3,140,9,72,6,5,3,18,27,15,4,69,7,1,18,18,3,7,9,16,5,5,9,15,14,7,10,49,4,9,15,27,31,7,2,13,2,34,4,8,1,5,8,39,16,48,30,18,41,9,4,47,11,32,6,52,4,10,37,2,28,8,7,17,2,8,23,20,9,9,35,4,15,28,16,6,5,44,61,17,12,9,15,8,34,15,7,10,8,18,61,14,6,11,29,7,3,34,8,11,27,10,38,3,24,12,39,8,2,23,5,68,3,47,14,8,29,3,20,44,3,20,7,16,23,29,19,68,4,25,5,24,9,7,6,12,6,13,1,38,20,10,11,8,12,20,13,14,18,4,12,10,9,20,9,6,4,0,15,15,17,16,7,15,21,14,8,6,27,13,6,24,25,6,22,2,4,28,9,42,13,23,3,10,8,73,4,8,16,9,38,16,31,35,42,8,2,22,26,15,1,29,6,8,3,5,16,8,23,21,3,7,12,5,9,7,7,12,13,7,1,108,53,5,11,20,4,8,19,13,10,10,2,7,6,22,27,6,17,6,5,3,5,10,9,13,9,3,11,7,13,5,19,6,14,3,11,16,13,16,23,9,5,8,8,8,15,12,7,30,17,6,2,5,7,15,6,4,20,21,5,36,6,6,63,12,8,28,5,8,10,27,8,29,4,19,15,21,6,36,37,20,15,24,1,9,11,12,8,13,27,9,9,12,20,11,8,2,10,10,8,20,40,13,9,40,6,10,4,65,14,26,5,11,7,12,27,12,26,5,2,16,20,27,6,20,15,14,6,3,4,16,1,8,32,3,5,24,3,16,36,11,29,19,27,7,4,8,9,9,18,13,8,14,24,15,24,6,6,3,188,28,4,11,7,8,1,45,15,10,21,5,10,20,41,18,13,4,11,8,19,16,5,31,12,44,6,2,34,5,5,17,41,14,9,7,9,13,10,6,13,31,22,14,17,15,21,9,5,11,18,5,5,5,5,5,8,33,4,6,11,4,23,18,38,13,20,13,6,11,7,14,8,17,32,3,20,10,4,7,23,5,17,1,6,6,10,25,6,37,19,9,14,4,10,16,3,18,5,4,10,13,15,31,35,29,18,4,9,5,16,11,16,8,10,30,17,7,7,18,13,12,6,3,21,6,8,14,2,11,9,7,7,15,8,16,7,5,10,13,14,11,4,5,5,10,17,7,12,7,5,4,15,13,21,9,3,11,6,22,12,10,11,12,26,3,3,8,13,3,8,4,12,2,15,19,2,4,14,8,7,21,7,9,0,9,8,20,32,8,12,17,9,0,9,5,10,8,6,6,6,25,20,5,5,1,8,10,6,2,2,6,6,7,6,6,9,2,8,13,9,6,8,6,10,7,6,6,8,13,8,10,8,6,4,25,6,10,5,15,8,11,20,3,9,10,8,4,3,12,8,7,13,11,9,9,9,15,12,4,17,2,17,5,26,16,10,7,15,6,8,16,8,5,8,2,11,13,15,14,5,6,3,5,13,6,11,6,5,1,14,5,14,52,15,23,21,15,33,55,9,7,10,3,6,7,17,28,14,14,4,11,11,7,5,4,20,0,30,5,10,20,7,9,9,5,9,6,5,19,10,16,4,13,9,2,7,4,14,16,3,6,6,10,5,1,3,2,9,1,6
thus,28,58,37,359,23,17,15,130,8,7,58,24,20,166,11,32,27,75,15,12,11,131,17,56,62,29,23,21,15,53,37,488,362,41,162,150,124,51,70,24,25,22,10,7,84,69,96,40,1037,37,160,12,36,82,8,18,231,65,2,60,63,25,15,44,59,18,360,16,25,33,35,11,8,6,200,38,56,28,262,58,168,2,41,11,728,64,67,4,108,15,22,17,1,96,162,25,70,25,110,40,41,74,121,24,29,79,20,9,43,10,35,18,25,83,2,75,13,8,191,615,213,49,44,150,15,9,12,24,13,7,30,3,23,144,46,86,31,14,13,16,9,103,78,13,6,187,20,34,44,50,243,6,62,23,11,90,71,16,34,12,54,17,31,11,11,8,26,60,64,35,44,243,72,5,8,25,523,9,47,61,63,43,9,40,17,71,98,57,140,149,14,12,33,3,11,9,54,20,25,42,48,6,11,45,115,26,37,119,44,91,211,12,66,34,4,1,8,12,38,7,18,64,25,43,134,276,91,81,21,46,29,45,74,79,101,82,103,20,24,24,245,117,26,11,43,29,17,67,126,28,41,87,43,37,41,31,48,13,12,58,9,76,71,15,23,96,17,24,47,19,430,44,124,22,15,2,58,59,43,7,169,25,10,54,44,8,4,18,45,5,13,13,59,18,12,42,146,20,19,50,70,90,7,13,49,7,63,15,14,3,6,51,69,19,158,63,60,150,45,9,125,18,78,7,208,19,14,62,16,97,32,35,36,18,27,78,52,16,10,43,48,32,49,43,14,22,149,166,52,13,53,38,21,126,77,20,9,26,55,73,65,25,26,73,18,1,138,20,14,24,10,42,14,23,19,80,33,23,45,23,181,8,128,23,3,119,15,79,103,13,68,24,29,43,96,39,170,23,119,12,60,3,15,7,14,15,24,9,94,48,7,33,22,42,64,26,15,28,10,6,14,25,61,53,5,9,13,40,38,56,89,27,14,31,9,13,1,34,20,10,42,82,23,41,6,18,45,21,110,32,40,18,10,19,197,37,3,35,23,91,25,70,79,55,23,25,55,44,51,1,42,9,8,9,20,32,14,62,64,24,13,53,14,16,19,30,41,14,18,18,215,143,6,21,35,23,13,48,27,33,40,18,13,3,25,118,18,45,16,16,17,17,31,23,44,63,18,18,22,20,15,54,29,75,20,16,71,29,44,82,37,14,10,23,30,26,32,15,135,56,20,12,7,26,57,17,10,79,39,29,167,24,34,154,31,28,78,19,33,27,73,15,55,16,48,54,46,20,141,103,44,32,45,14,41,40,46,30,27,50,36,38,46,40,42,18,24,34,19,33,77,104,36,16,49,15,17,17,134,73,89,3,22,20,25,76,19,87,23,28,97,39,32,22,86,48,53,30,37,17,44,59,11,107,19,18,15,30,39,112,107,52,71,91,25,15,27,35,8,45,39,7,33,84,29,100,10,23,21,558,88,23,35,18,24,45,1,53,32,56,29,25,54,77,26,32,13,36,37,48,62,41,163,64,76,35,9,11,9,30,16,101,49,14,33,26,62,15,17,54,47,31,51,37,31,31,42,16,44,57,21,18,18,22,27,25,41,29,21,15,18,31,21,93,58,51,26,40,17,19,31,11,22,62,11,24,23,4,15,30,33,52,37,11,24,7,48,23,116,36,27,18,8,27,33,17,71,45,23,30,37,34,16,28,15,54,31,38,12,81,97,29,16,16,76,72,21,10,11,21,18,15,12,46,23,42,45,9,36,43,11,18,50,24,32,24,38,66,37,35,14,18,15,16,28,58,19,24,11,12,13,24,41,8,8,7,31,17,41,21,48,13,25,30,15,21,17,23,23,39,16,19,29,28,5,22,13,28,46,19,18,28,45,12,20,51,30,96,49,18,8,25,19,38,26,23,30,24,19,28,76,85,31,34,8,18,25,41,19,5,23,18,30,12,17,34,12,19,37,25,19,18,55,57,9,28,7,35,43,6,23,13,15,17,25,11,14,16,26,17,12,32,3,11,18,34,16,18,18,5,41,28,13,32,53,19,17,54,14,54,23,38,27,54,49,15,11,53,21,9,27,24,24,47,4,28,9,52,13,44,20,3,31,17,22,16,17,22,16,43,17,47,34,10,40,74,30,51,170,8,8,13,11,19,10,29,17,18,46,9,36,15,15,15,12,38,13,7,27,27,24,25,19,19,31,14,2,31,34,19,34,19,23,74,18,25,37,13,66,7,17,14,17,1,0,11,3,19,4,0
recognize,5,35,19,160,7,6,3,56,3,6,63,7,13,166,3,12,15,9,8,5,6,50,21,39,51,13,25,12,10,26,30,227,156,9,81,91,76,2,5,9,19,17,6,7,44,44,29,34,571,51,76,18,16,113,17,20,51,10,12,29,49,24,4,11,39,13,151,15,19,21,15,2,4,3,188,26,27,9,110,37,48,7,20,8,360,26,11,3,51,4,11,22,5,46,81,11,36,7,62,31,8,34,55,21,11,59,2,5,17,5,31,4,8,24,10,52,9,1,99,242,76,29,60,87,7,1,6,7,3,1,19,10,18,66,29,60,18,5,7,10,4,63,55,7,7,105,15,28,17,6,134,5,31,9,7,44,55,15,68,31,8,7,16,1,6,19,2,38,24,15,16,146,38,4,4,18,243,6,21,75,49,14,16,41,1,28,46,52,62,104,1,7,10,3,4,6,16,11,12,30,54,2,5,18,50,28,4,37,19,49,96,11,40,5,12,5,5,9,12,2,9,24,10,26,42,142,25,42,4,22,20,13,13,44,39,7,48,15,2,24,89,47,14,9,33,9,5,29,56,14,16,18,31,4,13,21,9,1,1,16,7,42,20,9,10,38,10,28,28,11,161,4,25,4,4,4,30,11,13,2,76,20,3,30,13,4,9,12,26,2,9,12,0,10,4,14,59,7,12,34,46,23,0,2,33,7,53,15,22,11,7,40,35,7,28,11,11,58,32,12,83,8,40,24,177,13,19,37,7,40,18,19,18,4,17,18,47,14,6,22,25,20,17,36,3,13,86,89,27,22,20,21,15,35,44,8,28,10,14,40,40,9,20,33,2,3,57,16,15,21,4,30,7,29,13,12,5,7,41,10,96,6,45,23,5,45,25,33,26,3,59,6,12,25,46,17,71,6,57,3,44,6,6,10,7,21,7,5,26,15,6,12,4,24,47,13,7,14,9,4,13,25,39,36,8,13,5,25,19,35,3,10,0,11,9,12,5,19,17,9,32,22,6,44,1,2,16,6,84,12,21,16,4,12,74,30,3,42,18,31,23,19,48,44,7,3,32,14,25,4,28,7,2,6,9,51,19,28,38,16,16,16,7,30,17,9,6,13,6,4,149,39,6,19,12,10,5,10,13,19,13,4,7,9,13,17,5,17,10,5,6,8,10,6,15,21,10,6,9,21,8,28,8,46,13,8,42,29,16,55,26,16,3,19,7,12,8,7,57,30,7,12,8,18,17,8,14,23,17,11,53,7,14,81,7,16,54,3,14,10,32,4,16,5,8,18,18,19,51,30,13,20,6,17,6,17,5,11,10,32,2,24,16,34,16,21,6,5,4,13,45,76,8,5,71,15,18,8,87,40,34,5,10,11,18,28,7,38,7,2,82,16,13,11,55,16,17,1,19,3,12,3,7,25,3,12,18,9,23,49,15,15,51,39,14,6,15,15,3,13,16,7,19,32,14,19,9,4,14,354,44,8,7,8,11,15,53,1,32,17,9,4,37,38,17,13,4,16,17,8,20,6,170,70,74,20,8,6,6,7,12,12,16,12,12,9,36,5,3,16,28,24,25,14,13,5,9,9,32,15,6,16,5,13,2,11,29,7,3,5,9,6,9,31,28,21,3,19,18,11,22,11,25,30,6,26,10,10,4,28,4,15,10,7,6,0,25,3,59,13,14,10,11,11,22,9,5,15,17,17,17,2,0,5,2,14,17,14,4,9,11,21,8,4,31,27,21,13,14,6,14,7,3,22,5,26,4,2,8,17,2,2,27,4,19,7,12,112,12,8,10,14,9,6,19,13,5,7,1,8,7,15,32,12,11,5,13,7,22,15,4,11,25,5,15,12,11,25,8,24,6,6,9,26,1,2,8,8,2,5,14,5,10,14,20,14,14,30,43,9,5,9,13,18,6,8,4,17,7,33,76,36,21,5,2,2,12,4,11,3,4,12,4,6,10,10,6,4,23,5,7,5,6,16,7,6,5,23,20,7,5,8,4,6,7,10,16,1,20,5,6,12,2,5,14,5,10,6,12,5,7,2,2,20,34,4,12,13,3,39,6,5,8,8,19,9,2,13,4,3,4,11,5,10,9,7,12,28,5,3,8,14,6,9,1,2,3,2,7,5,2,26,3,0,4,13,13,3,11,2,1,17,7,6,5,3,2,11,12,12,1,3,3,5,0,43,0,1,12,13,7,10,18,7,7,7,2,9,1,18,1,5,5,12,14,22,18,3,89,15,2,4,2,3,0,6,4,15,5,4
refuse,11,35,14,109,4,1,1,44,3,1,28,4,3,62,0,4,8,5,1,2,3,23,10,17,14,13,6,12,5,12,9,111,87,2,29,45,25,2,2,0,2,4,2,2,16,16,16,5,258,6,49,8,3,16,10,6,24,3,1,11,4,10,0,3,14,16,62,6,6,17,7,3,5,3,50,7,14,4,56,27,9,1,12,4,158,8,5,0,21,1,9,6,0,15,32,4,8,3,20,11,4,12,20,12,4,15,1,2,7,5,11,3,2,6,4,20,17,2,51,123,28,12,4,48,7,5,1,10,1,0,3,2,4,31,15,23,13,2,2,3,5,33,15,2,11,50,12,12,8,7,61,2,16,2,1,17,18,2,23,17,4,3,12,3,1,5,3,9,9,14,8,66,20,0,0,9,110,1,7,22,19,3,1,14,1,11,17,21,41,48,6,8,2,1,3,1,7,0,3,11,17,0,2,15,25,7,2,13,15,16,64,7,30,4,2,3,1,0,6,2,2,14,4,5,34,70,15,19,1,4,7,12,5,9,23,8,31,5,1,9,41,12,4,8,19,1,4,11,21,6,5,6,14,1,2,7,5,1,0,8,3,28,10,2,1,19,3,6,11,3,79,1,5,0,2,1,12,3,5,4,30,4,0,10,8,0,1,0,16,1,6,5,16,1,2,6,39,6,2,9,22,13,0,4,11,1,17,4,5,3,2,5,15,4,40,0,9,23,10,3,32,6,33,6,53,7,10,17,3,26,25,4,5,2,9,15,7,9,3,9,6,11,6,18,1,7,26,48,10,10,5,1,8,17,20,4,10,5,8,16,7,2,9,14,0,1,22,7,3,17,1,14,0,6,13,7,8,1,8,1,37,4,29,5,2,16,5,33,19,1,27,3,10,16,15,5,24,1,45,0,16,1,4,2,6,3,7,1,8,6,1,8,0,14,9,6,7,6,2,2,6,17,13,16,8,5,0,18,7,11,12,12,8,14,7,5,0,9,8,1,4,7,3,5,0,2,4,7,30,5,10,3,1,2,20,5,0,17,12,29,5,7,17,18,5,8,9,8,6,1,8,6,3,2,1,19,7,14,12,2,10,15,2,5,9,11,4,4,7,4,75,17,5,5,5,3,0,14,2,5,4,4,3,1,9,18,1,11,1,1,2,9,3,3,7,9,2,10,3,10,2,16,1,21,8,3,15,6,13,21,9,4,15,9,8,2,10,12,36,10,5,1,3,2,2,8,30,12,11,2,47,6,5,24,10,4,14,1,3,7,7,3,14,1,9,9,7,6,24,23,4,5,4,2,4,8,2,3,5,5,3,8,13,14,5,10,3,4,2,8,13,29,8,4,35,6,1,4,44,20,16,4,5,14,4,11,6,16,1,7,21,10,9,2,32,7,6,1,3,2,9,4,1,21,0,1,2,2,6,24,6,7,34,27,13,4,4,2,0,8,4,2,5,29,2,8,2,16,6,148,21,5,4,9,9,10,32,32,1,13,3,5,23,6,7,4,1,5,16,12,10,4,94,24,17,7,1,3,11,3,4,19,16,2,8,2,12,3,1,7,19,9,3,4,10,4,18,6,5,7,6,1,2,6,1,8,9,0,5,6,2,9,11,10,9,33,4,10,13,6,8,3,9,16,1,9,10,2,3,8,3,11,3,6,5,6,25,5,37,4,8,3,3,7,2,9,3,3,4,4,9,2,0,8,0,5,3,6,1,4,2,4,6,0,18,6,8,2,4,5,2,2,0,14,0,8,5,1,3,14,2,1,14,4,9,2,8,70,1,5,6,13,3,3,5,12,1,6,0,2,1,2,8,1,3,3,4,7,8,4,0,1,11,10,1,3,2,6,12,7,6,4,0,1,0,4,4,6,7,6,2,6,4,12,5,1,6,22,10,1,3,8,4,6,3,4,6,9,1,13,15,31,11,6,2,1,5,1,8,1,5,9,2,5,6,2,8,0,2,2,0,3,3,7,11,3,1,11,9,0,5,3,0,5,3,1,8,2,6,1,2,6,0,1,9,19,2,6,4,6,4,2,2,7,18,9,3,5,1,11,3,2,4,3,13,6,0,2,0,2,5,6,3,2,1,5,5,36,3,4,1,1,2,3,6,4,1,7,3,0,1,10,0,0,2,16,8,1,12,6,0,2,0,2,2,2,0,4,8,3,0,0,0,0,0,12,3,0,11,0,15,6,1,3,5,3,0,6,7,7,6,5,4,6,2,3,2,0,12,2,2,2,1,0,0,2,3,2,1,2
enter,4,41,13,164,14,4,12,49,7,5,47,12,13,68,11,11,12,20,4,10,5,51,7,40,28,13,9,12,12,31,11,231,149,10,71,85,53,35,25,3,6,12,7,8,40,23,41,20,422,44,53,7,30,71,11,11,103,32,2,22,26,14,3,18,23,8,111,7,9,26,10,8,3,7,70,14,34,5,104,20,54,2,28,13,290,21,19,0,45,2,16,2,6,38,74,14,26,14,32,12,25,56,44,12,15,32,7,2,21,3,23,5,9,17,10,40,9,2,110,171,42,38,4,89,11,6,2,4,10,2,7,1,8,70,29,47,16,4,6,16,7,38,39,5,5,79,13,15,23,19,70,2,18,6,3,15,41,4,14,7,17,2,19,6,2,10,6,27,29,11,32,133,31,2,6,15,325,4,15,44,15,15,5,11,6,35,38,33,50,97,5,7,20,1,0,7,9,6,16,19,31,1,3,9,25,10,10,41,16,36,86,7,44,15,3,7,0,0,21,3,6,32,4,17,61,141,17,45,9,3,21,32,25,30,34,46,47,11,17,4,93,41,8,12,23,9,5,25,70,8,17,50,23,16,12,23,16,4,3,36,2,27,30,10,12,52,8,5,32,4,152,12,51,6,5,1,31,12,22,1,66,4,3,26,19,2,10,10,19,1,12,6,27,8,6,13,53,5,6,15,30,46,2,18,17,1,29,5,7,5,3,16,28,7,55,26,30,60,23,7,56,15,27,11,82,13,7,34,5,37,4,10,7,6,8,16,25,7,3,29,10,14,13,6,7,11,72,79,17,4,11,24,8,34,33,5,8,5,12,24,31,5,6,22,8,1,59,8,3,15,13,19,5,5,9,41,9,9,19,11,88,5,47,18,8,67,11,23,36,9,24,1,16,28,33,13,80,9,49,7,27,2,3,0,8,8,10,6,38,16,5,18,10,16,8,19,9,8,4,5,9,17,14,14,5,1,5,21,16,23,9,17,14,23,7,7,2,48,9,6,30,37,15,24,6,2,10,5,36,12,11,9,4,4,80,10,3,15,12,31,13,36,23,32,12,10,42,20,15,1,25,3,3,0,3,11,12,16,26,4,14,15,6,4,13,20,13,10,6,5,81,41,6,3,12,14,8,36,7,7,16,3,11,1,16,7,11,16,7,5,9,7,17,10,11,15,6,12,6,11,3,31,3,28,11,4,30,3,14,42,15,7,10,14,16,7,12,9,41,24,7,6,6,8,24,14,27,18,19,11,30,10,7,60,3,7,36,3,8,15,28,13,35,7,14,22,22,10,63,55,13,9,29,6,7,16,37,8,7,21,35,28,16,15,14,3,7,9,14,14,31,43,17,13,34,7,5,10,118,38,28,4,7,12,16,27,8,20,5,13,34,33,21,12,43,9,24,14,12,10,19,6,7,18,5,8,15,19,13,30,16,23,30,38,15,6,13,8,6,9,15,1,10,33,13,39,10,8,6,288,27,7,12,7,10,21,56,17,13,1,9,13,66,43,23,11,22,13,11,17,20,10,78,21,67,12,5,9,32,11,11,35,18,15,16,19,23,9,3,22,25,13,15,23,10,18,22,23,16,21,13,7,2,11,9,9,18,6,8,3,4,33,11,30,27,39,23,10,6,10,16,7,14,27,2,6,3,5,4,19,6,21,20,12,11,7,31,5,73,14,9,6,10,7,15,6,14,11,11,17,7,9,8,20,2,19,8,16,7,26,21,5,9,4,28,22,16,13,4,22,4,9,4,25,5,17,8,7,16,13,10,6,12,5,14,9,11,18,7,21,10,9,11,11,18,27,4,10,5,7,4,10,19,11,2,6,9,5,24,9,15,15,49,7,12,7,4,18,7,17,12,2,15,27,15,7,5,15,8,7,16,10,12,7,10,5,8,37,13,10,11,10,5,10,7,33,14,28,5,18,22,39,10,16,3,5,10,13,13,3,30,8,5,5,11,10,2,9,8,8,8,10,19,12,4,8,14,28,13,6,9,9,8,11,23,4,13,5,19,2,12,20,1,13,10,34,9,2,12,7,12,2,3,8,6,10,29,24,13,15,4,6,7,27,21,7,7,8,6,4,12,12,14,44,9,15,11,32,8,5,7,7,8,14,7,5,6,12,10,11,8,14,10,9,15,43,14,12,47,6,7,4,4,4,5,13,10,11,30,8,25,7,9,9,5,58,14,7,10,14,11,13,8,7,5,4,3,5,16,7,10,8,9,12,6,5,7,2,26,3,4,2,6,1,0,1,4,7,5,0
adoption,1,14,10,105,6,1,1,28,1,2,16,5,4,17,4,3,4,7,3,2,3,27,6,16,10,7,5,5,2,4,4,66,68,4,24,37,14,4,5,5,5,2,0,2,27,12,30,11,139,7,14,4,8,6,14,3,56,25,3,5,9,3,1,1,10,5,49,8,8,4,3,7,8,1,33,12,4,2,57,10,24,0,5,4,109,10,9,0,11,5,2,2,4,17,49,9,8,1,12,2,6,14,14,2,9,14,1,1,4,3,1,5,11,14,0,10,4,1,37,124,10,4,5,30,0,1,5,2,2,6,7,0,0,28,13,18,0,2,2,3,2,11,15,0,1,29,3,3,10,9,25,1,7,1,2,19,15,2,8,4,6,1,8,3,2,0,0,5,13,4,14,42,1,0,4,6,107,4,4,21,4,3,1,7,2,11,24,14,22,24,4,1,2,0,1,0,27,0,5,6,9,0,1,9,15,7,4,51,7,22,34,0,21,4,1,0,0,1,11,0,0,8,1,12,29,38,13,11,3,5,9,2,9,6,15,18,11,5,2,9,37,11,8,1,7,4,3,3,24,4,16,9,5,8,6,10,8,1,2,5,9,10,13,1,5,24,4,4,2,3,87,7,11,6,0,1,7,12,10,8,31,3,3,17,7,0,6,10,8,2,0,3,25,1,1,6,24,3,5,10,13,48,1,2,10,0,13,4,8,1,4,11,13,7,13,13,20,19,6,2,20,7,9,1,34,1,1,12,3,5,8,4,3,3,7,5,21,4,0,9,10,3,8,6,6,2,28,28,11,10,8,10,0,7,18,2,5,2,8,14,23,8,4,9,1,0,29,5,10,3,4,14,1,6,5,18,7,4,12,5,39,0,33,7,1,13,3,8,9,2,8,3,21,10,24,4,43,3,15,0,11,3,3,0,3,1,6,1,22,13,2,9,2,8,11,2,1,4,1,0,4,4,9,2,0,4,2,3,7,9,7,5,0,3,4,2,0,3,11,0,8,19,0,6,2,3,0,2,12,7,15,6,2,3,17,6,0,4,4,10,7,18,14,17,1,0,8,6,7,0,17,1,3,1,2,3,4,21,11,5,3,10,2,5,3,2,9,3,5,3,37,35,1,3,3,3,1,11,5,3,9,5,2,0,1,9,2,14,4,7,7,1,2,5,17,16,1,10,3,6,0,9,4,16,5,5,14,2,8,15,8,4,2,3,4,5,5,6,13,11,4,3,0,5,8,7,7,11,12,6,64,2,1,18,4,5,19,3,1,12,18,5,12,0,15,17,11,4,19,22,10,13,11,1,3,4,9,4,9,7,5,8,4,8,13,2,4,3,0,6,13,25,3,2,11,1,1,1,15,10,21,2,1,3,5,18,2,14,7,7,18,5,4,3,16,6,18,2,9,3,12,8,4,17,1,5,3,11,13,17,5,11,9,13,2,1,1,1,3,6,7,1,2,10,5,22,0,2,2,62,8,4,6,13,5,5,29,9,3,9,1,4,9,6,5,2,0,4,11,7,11,5,13,13,5,5,1,4,1,4,0,17,6,5,7,3,6,4,2,3,6,10,13,6,2,3,4,3,8,13,6,3,4,3,6,2,6,6,6,2,10,4,3,38,9,14,3,8,4,5,3,1,1,17,5,14,2,1,5,6,11,6,1,1,7,2,5,2,22,5,3,2,4,5,3,7,10,7,1,4,10,3,0,1,2,10,6,7,2,5,6,2,6,1,17,2,6,5,3,4,2,2,1,3,4,12,2,3,4,10,3,2,2,2,7,4,6,18,5,6,9,12,4,7,12,7,3,7,2,5,7,3,12,7,2,0,5,2,15,1,4,2,9,1,3,1,2,5,1,4,2,2,7,3,0,7,5,4,3,4,2,2,14,2,6,6,5,17,7,5,1,10,4,1,6,1,6,1,11,0,14,6,2,7,0,3,5,5,3,1,1,2,2,2,4,9,2,3,9,22,0,3,5,8,3,8,1,4,3,1,1,3,0,2,6,3,3,6,4,1,0,9,0,1,6,3,3,1,1,1,5,1,1,4,4,0,3,8,2,11,4,3,8,2,6,3,6,9,3,3,5,5,4,8,3,2,3,6,7,3,3,6,2,4,4,0,2,1,2,8,7,3,0,7,3,8,8,5,24,3,0,2,2,2,3,4,2,2,6,0,0,4,6,1,0,6,2,6,9,8,1,3,6,2,2,4,0,5,3,5,0,2,2,5,4,7,4,0,8,7,1,0,1,0,0,1,0,2,2,0
north,12,8,5,83,6,9,4,54,4,10,12,13,11,48,6,6,5,4,5,4,2,31,13,17,10,9,15,14,5,21,9,128,78,3,28,41,31,9,2,2,0,14,2,5,17,8,20,9,286,57,30,7,17,47,2,0,27,9,3,18,17,5,0,8,9,4,77,4,8,25,5,10,3,3,47,9,12,0,48,11,30,0,21,11,101,1,10,0,27,3,4,1,2,21,31,0,11,3,25,9,6,17,20,1,6,19,2,3,7,6,20,4,3,6,6,26,0,4,39,69,26,12,1,42,15,4,0,7,7,2,11,1,10,34,23,31,1,4,7,14,4,23,17,0,8,45,16,11,4,2,53,3,12,3,2,6,20,9,8,19,2,1,7,4,1,2,2,12,15,7,25,65,16,3,2,5,86,0,6,18,18,12,3,12,4,13,10,13,39,48,3,7,6,0,1,5,11,4,5,6,7,0,4,6,27,0,2,11,10,20,53,5,22,4,6,3,2,2,7,4,5,11,4,12,14,40,14,18,4,0,12,12,5,8,11,5,24,5,8,4,38,25,4,7,6,2,8,9,23,2,4,12,16,1,10,10,5,0,4,14,0,22,14,6,0,6,1,7,23,1,64,4,11,5,2,4,14,9,11,0,16,1,4,17,4,9,1,3,4,2,4,3,1,5,2,4,21,2,1,10,15,16,0,4,5,1,11,4,3,2,2,6,17,7,11,8,7,15,4,3,30,5,10,4,35,5,2,27,1,14,7,4,4,7,4,6,19,5,1,9,3,11,7,5,7,11,43,57,4,4,14,3,6,18,28,1,6,3,7,14,8,4,11,13,4,2,26,14,2,9,0,6,9,8,5,9,4,5,12,2,50,3,15,10,4,21,7,14,19,1,9,0,4,13,18,11,27,3,10,6,14,9,4,2,8,8,6,3,22,9,6,123,1,16,7,11,9,11,0,6,8,4,10,12,0,2,3,5,14,15,6,4,2,6,8,6,1,21,6,5,8,19,4,29,12,30,13,8,15,3,16,5,4,4,73,6,2,5,2,17,2,16,21,16,4,1,6,17,17,2,10,5,2,2,2,4,4,6,10,3,3,9,12,7,10,9,9,2,3,7,41,19,5,7,4,4,7,9,7,8,16,1,3,0,4,1,2,12,5,1,2,4,8,7,0,6,2,6,0,9,1,21,5,14,0,6,21,1,8,9,7,2,4,5,11,4,11,3,30,3,3,1,1,6,4,2,6,12,8,2,27,2,10,34,5,0,19,3,3,4,19,1,15,2,10,7,6,1,13,14,6,6,8,1,3,22,3,3,2,23,0,3,5,8,5,5,9,5,6,12,30,16,2,3,6,4,3,4,61,12,14,0,5,4,5,11,2,6,5,6,13,13,5,8,7,4,22,1,3,3,8,0,1,7,1,5,4,4,11,39,2,10,14,15,5,1,8,6,3,5,5,6,2,10,3,10,2,3,4,175,19,8,5,2,14,10,25,4,5,13,4,1,16,43,9,3,11,16,9,10,11,4,37,13,20,7,1,5,3,9,10,14,9,8,10,2,10,3,8,30,11,3,12,41,1,9,8,6,5,11,12,7,4,3,4,6,7,5,10,3,0,10,9,13,14,10,9,3,7,0,6,1,2,16,10,31,6,0,1,17,2,8,1,10,4,4,15,2,63,11,6,10,4,16,29,2,7,4,1,3,11,1,1,8,4,5,6,9,9,3,2,6,5,2,27,5,0,5,3,20,6,14,3,10,2,9,0,0,8,8,10,2,7,2,7,4,4,7,4,6,6,8,13,8,7,8,2,3,0,6,4,9,2,1,7,1,8,4,7,5,3,7,23,7,5,4,3,9,1,6,3,3,0,3,15,7,3,8,1,7,4,3,6,1,10,5,6,23,7,6,6,1,6,3,0,0,5,13,3,5,19,20,7,6,3,1,1,0,5,1,12,4,2,2,1,7,11,2,5,8,2,7,5,0,5,2,8,8,5,10,4,5,0,4,6,9,2,3,8,2,13,38,3,5,3,8,5,7,1,9,5,6,3,4,11,3,2,6,2,7,1,1,7,3,5,5,4,4,2,1,9,8,2,7,16,7,17,10,1,0,7,3,3,9,2,2,3,0,2,4,3,4,1,1,0,2,0,1,2,2,5,5,1,0,1,0,6,33,7,5,0,16,2,7,0,25,2,1,1,29,1,5,4,7,1,7,1,5,12,3,3,7,4,1,3,0,12,11,4,0,1,4,1,3,0,0,3,4,1,1
convention,8,35,16,245,9,0,21,67,7,5,110,31,8,61,4,7,24,6,1,3,4,37,9,44,19,9,11,19,0,28,10,251,140,6,43,41,24,7,2,2,5,5,1,4,30,28,74,5,761,71,42,5,10,15,1,2,101,22,0,19,44,3,5,20,11,8,115,4,20,14,23,7,0,7,24,11,25,8,107,7,19,0,41,9,356,1,4,0,100,2,38,16,0,57,80,1,22,0,52,1,23,36,65,0,10,50,6,1,20,2,27,6,1,13,0,75,29,3,148,144,34,37,1,114,6,7,1,10,16,0,5,4,0,71,17,23,13,4,4,9,3,26,64,7,3,102,2,7,3,7,79,1,17,2,0,13,16,1,12,2,3,1,2,7,0,1,1,15,10,12,23,81,19,3,0,5,249,0,9,11,21,6,0,12,0,15,17,26,74,182,4,7,0,0,0,5,1,2,17,3,8,0,0,30,19,6,7,2,32,13,101,1,34,12,2,2,0,0,12,2,9,23,10,11,49,69,12,24,8,2,13,36,18,13,22,15,55,1,3,7,71,45,5,1,21,2,5,5,126,4,20,19,23,6,9,35,12,6,3,13,0,51,107,31,7,21,3,1,19,3,172,11,81,10,7,0,20,4,30,2,23,0,3,42,7,0,2,9,12,1,39,72,8,7,16,25,98,10,15,15,36,37,0,17,22,0,42,5,1,0,3,3,44,3,76,21,10,59,10,13,136,6,15,0,91,11,2,23,4,50,36,4,13,4,16,24,23,18,7,22,14,14,9,25,2,7,53,117,4,5,16,27,10,16,45,2,17,3,15,27,19,3,3,10,3,1,47,6,0,6,7,6,12,0,3,14,5,1,35,7,136,3,44,30,5,21,0,23,40,0,37,0,8,120,57,11,136,4,41,2,33,3,6,1,1,2,4,13,42,13,3,15,13,11,22,17,23,13,2,0,2,14,17,14,0,4,3,12,21,39,7,33,31,46,4,13,0,94,8,1,26,38,10,22,2,7,0,2,17,6,15,17,3,7,136,19,0,41,10,98,10,24,21,3,3,0,12,21,17,0,10,0,6,0,2,2,11,26,14,0,6,15,8,3,6,57,5,3,5,5,34,34,2,6,6,12,0,68,7,4,13,1,5,2,6,6,0,46,18,1,0,5,17,9,17,8,1,8,1,5,3,23,23,32,9,17,14,2,23,26,21,1,2,6,20,12,41,9,48,4,8,45,2,1,3,29,16,24,33,6,176,6,8,56,7,4,60,5,7,25,46,12,90,3,23,10,19,8,69,40,9,12,13,4,6,38,8,12,0,27,3,15,16,9,6,5,3,15,15,6,50,38,22,1,23,3,1,0,187,20,55,1,2,75,30,17,5,27,3,5,24,80,47,19,47,12,23,0,17,8,19,0,0,24,1,5,6,7,24,46,0,33,26,43,34,15,7,5,4,5,1,1,5,32,31,17,0,20,7,550,25,9,2,19,18,20,54,37,23,66,9,16,1,121,97,95,27,23,17,26,18,9,150,54,212,4,9,23,17,5,21,59,18,17,26,8,24,3,3,27,85,11,17,20,19,30,9,31,14,36,17,20,13,2,4,8,16,4,7,25,8,47,16,30,36,15,3,10,26,3,1,5,8,15,1,13,3,0,5,11,5,14,1,3,8,7,1,6,74,4,17,11,2,7,27,2,15,0,3,19,7,16,2,36,0,17,6,29,13,1,1,9,30,6,45,2,25,5,0,50,2,2,0,21,13,13,2,0,6,16,4,5,11,5,24,6,3,95,4,17,15,9,5,10,4,11,4,21,4,6,6,7,47,26,1,1,2,13,23,6,17,49,64,16,11,18,5,40,6,26,12,6,68,42,5,6,0,22,6,6,6,33,8,8,6,3,14,36,9,10,26,32,4,34,2,9,3,25,3,12,101,39,11,3,0,7,11,0,12,5,32,12,6,1,1,10,4,22,11,3,3,5,4,5,6,10,28,50,33,24,66,29,4,39,61,17,9,11,7,9,7,22,0,7,10,76,12,25,12,3,11,19,6,4,46,33,38,62,26,40,2,1,11,45,24,34,0,44,6,5,9,29,8,39,16,18,22,70,41,4,18,5,21,12,3,0,3,1,12,1,1,10,2,2,7,61,18,2,20,19,0,6,6,1,6,23,4,4,39,13,0,6,6,10,1,45,1,0,28,4,0,18,4,5,12,12,0,7,19,10,2,2,9,2,9,2,9,1,55,0,0,1,3,0,0,3,0,10,1,0
britain,28,14,9,124,21,1,18,18,9,5,36,32,8,135,8,6,12,17,7,1,6,53,3,25,42,7,20,22,3,22,14,287,235,9,54,55,73,7,2,6,11,5,13,2,50,26,65,20,831,79,81,2,3,39,0,10,73,22,2,24,60,29,5,38,21,12,63,7,39,65,9,18,1,15,59,22,12,5,102,29,62,1,42,5,432,6,21,0,79,0,17,12,0,52,82,17,31,7,41,7,29,46,75,13,20,42,6,2,23,6,24,13,0,6,1,56,14,6,122,194,47,36,26,74,5,0,4,19,13,4,12,2,1,82,25,14,14,1,9,11,2,61,82,5,10,86,5,26,12,10,106,1,21,4,2,13,34,6,16,2,11,1,0,6,0,1,2,26,25,12,29,146,29,0,1,16,308,2,18,9,30,24,0,24,0,11,31,34,174,244,1,9,15,0,1,5,6,8,9,21,20,0,0,26,53,5,6,35,47,60,105,4,40,13,1,0,0,0,12,3,5,26,8,36,45,80,26,18,6,8,23,31,23,39,18,23,59,4,23,10,95,49,7,9,12,7,9,11,55,3,11,23,41,5,16,25,15,0,14,14,2,29,77,16,6,25,1,8,32,9,174,2,40,6,2,0,22,17,27,0,60,5,11,35,21,5,0,6,17,3,23,22,3,9,19,31,91,8,8,13,50,32,0,6,13,4,33,8,1,0,0,9,42,4,20,30,22,81,12,8,89,11,33,0,161,22,1,41,19,48,0,12,25,9,6,20,48,17,6,20,6,17,10,21,4,15,79,149,9,5,14,15,15,19,71,4,4,11,11,42,24,8,7,25,10,0,66,8,2,11,4,15,10,4,5,20,6,2,24,16,82,5,44,48,0,35,2,43,44,5,37,3,3,60,60,19,153,3,54,9,61,2,14,0,4,8,3,15,91,9,4,34,21,28,18,25,34,23,5,2,9,6,14,22,2,3,5,23,17,30,14,19,6,21,5,17,5,107,4,6,42,37,11,64,0,9,8,13,57,11,21,12,0,3,797,27,0,24,9,71,13,32,30,14,8,1,11,56,18,2,13,3,3,2,0,14,16,30,14,4,2,18,27,7,11,9,24,8,7,7,154,49,6,8,8,17,4,12,24,8,15,4,7,6,30,30,2,19,8,3,6,0,15,18,16,22,6,7,1,17,8,18,13,30,12,10,32,0,28,45,7,8,2,10,29,16,25,10,57,19,24,15,2,0,18,20,10,32,65,18,14,5,8,65,2,15,72,0,14,8,66,3,72,12,29,21,22,15,50,70,14,15,9,7,19,82,4,19,7,27,11,19,26,19,14,15,7,7,22,3,73,59,12,5,22,3,5,0,284,41,48,0,12,24,31,37,4,32,6,3,27,42,34,20,52,12,18,10,12,8,16,11,2,24,2,11,25,10,11,60,11,39,28,20,9,5,3,12,3,19,9,2,5,12,30,21,4,13,3,678,89,15,15,9,28,41,77,38,6,43,6,43,121,1,53,29,64,49,26,22,27,14,36,53,110,13,4,25,2,10,23,55,23,26,20,11,19,8,6,78,49,12,32,45,10,8,13,33,27,37,29,22,17,7,9,12,34,13,8,10,13,31,11,36,38,5,5,23,26,3,11,1,12,13,2,33,8,2,1,21,4,11,5,8,5,1,13,6,101,19,17,29,5,17,56,6,18,6,8,15,8,7,7,29,10,28,7,35,12,9,8,19,8,8,33,16,8,11,0,68,6,16,1,17,5,34,10,4,18,33,6,17,21,2,16,17,7,8,16,17,26,0,31,10,1,20,5,15,2,18,17,7,25,8,1,2,11,13,28,17,17,50,60,30,11,17,11,43,14,26,17,21,37,12,13,14,2,11,7,21,7,15,11,1,1,9,17,48,15,2,24,4,7,28,15,10,6,42,3,17,80,42,16,11,2,15,8,2,17,2,57,25,10,3,13,21,14,10,12,15,0,1,8,10,10,11,51,96,30,28,35,22,5,18,42,18,13,8,22,12,8,56,0,8,15,31,14,4,5,8,9,21,4,12,2,17,43,30,8,24,5,13,13,16,30,13,8,44,1,10,22,57,8,44,31,13,57,66,19,11,14,19,12,23,10,5,10,4,14,4,7,15,0,0,2,9,10,6,16,11,0,14,5,8,6,11,14,15,17,11,0,5,4,4,3,81,0,0,4,27,14,21,13,11,19,19,0,13,24,13,12,6,13,5,13,6,25,3,32,4,3,0,4,0,0,6,0,16,3,0
conclude,17,21,6,127,7,0,7,10,3,0,61,14,4,59,0,3,13,4,1,5,2,25,2,14,8,7,3,5,5,10,11,129,97,1,15,26,50,4,5,2,3,1,0,2,23,14,24,5,316,19,37,5,9,19,1,6,37,20,1,10,19,4,2,21,6,2,34,0,12,9,8,3,1,3,17,7,9,2,46,9,19,0,16,5,197,6,7,0,49,1,10,3,0,29,39,5,11,1,27,2,11,14,29,9,2,18,3,0,5,0,21,6,4,9,0,22,11,6,54,71,19,17,0,38,5,1,0,3,8,3,7,1,0,38,10,19,9,1,3,4,0,19,50,3,2,42,1,5,4,6,35,1,11,1,6,6,8,6,18,2,4,0,1,4,0,1,2,15,8,3,16,47,15,0,1,5,87,1,3,13,6,7,2,6,0,7,13,15,20,98,2,2,3,0,1,3,4,3,6,2,3,1,0,13,18,3,3,13,15,12,42,2,13,4,3,5,0,5,5,3,4,12,10,14,25,27,1,7,1,2,9,14,11,7,10,8,35,3,8,6,49,21,1,0,10,1,3,3,43,4,8,13,9,1,8,16,6,1,3,7,1,21,36,24,2,16,4,2,10,2,94,4,24,2,2,0,8,6,16,7,11,0,4,8,3,3,4,2,6,0,12,23,6,9,3,8,49,9,5,10,22,17,0,6,10,0,22,1,3,3,5,2,16,6,29,8,8,37,10,1,57,5,11,0,37,3,1,17,7,13,4,2,7,2,6,8,5,13,3,14,8,12,9,9,3,4,25,56,5,2,11,10,4,17,15,0,1,4,11,11,11,5,7,13,4,0,40,2,5,6,2,3,5,3,2,5,6,0,8,2,54,3,35,11,0,19,0,15,24,1,15,1,8,69,25,5,66,1,23,4,22,1,3,1,0,4,1,5,23,14,2,6,6,9,14,11,12,2,7,1,1,6,10,8,2,3,0,16,13,12,5,15,10,25,4,11,1,55,2,6,15,18,2,22,2,4,1,2,13,2,8,8,2,2,68,11,0,21,4,27,8,21,14,9,5,2,2,13,9,0,9,2,3,0,1,1,5,17,5,2,10,13,8,2,9,18,9,3,2,2,55,17,4,0,2,4,12,18,4,5,7,3,2,0,8,9,1,14,6,2,1,4,15,3,2,12,2,7,5,3,2,17,10,13,8,6,12,3,26,11,8,3,3,8,7,7,15,0,34,6,7,8,2,1,2,16,1,15,15,7,11,5,8,24,5,2,60,2,5,3,27,3,25,2,10,4,12,2,39,40,2,4,18,3,2,7,10,3,0,16,0,12,10,6,7,1,2,6,4,4,22,24,4,2,15,1,2,0,242,25,22,2,5,45,15,6,2,15,4,5,15,24,24,3,18,8,23,6,3,5,5,3,3,10,1,5,8,2,7,25,3,17,12,12,11,1,2,7,1,4,0,1,2,24,19,18,1,15,1,246,27,5,4,7,6,18,26,17,7,23,5,9,97,53,1,48,15,11,16,12,9,2,103,7,51,3,3,8,10,5,5,25,12,2,8,3,8,3,0,17,30,10,12,17,10,9,7,17,4,12,15,6,9,1,5,8,18,4,1,14,1,16,2,15,18,22,1,12,13,1,8,11,5,5,1,13,8,2,1,10,0,20,2,1,8,1,6,1,28,6,11,4,2,5,12,1,9,2,6,5,3,0,0,20,2,7,8,13,1,3,3,7,13,3,19,4,15,2,2,24,0,2,1,10,3,6,2,1,14,6,1,7,8,1,10,6,3,27,1,9,6,3,1,6,1,3,4,8,6,8,8,5,16,10,0,3,4,5,15,10,12,13,11,13,11,13,1,8,1,5,3,1,14,10,4,5,0,10,5,4,12,5,2,6,5,5,12,18,13,6,9,7,1,13,1,4,2,24,4,13,43,17,9,6,0,1,5,1,9,3,31,9,6,0,4,5,4,6,3,11,0,5,6,1,6,3,21,29,15,12,14,8,2,14,34,13,7,6,3,5,6,10,1,4,11,27,7,0,2,0,4,18,3,8,2,7,21,37,3,17,0,10,2,16,3,8,3,36,1,6,6,18,3,16,13,8,15,55,6,3,7,3,10,13,3,3,3,4,8,3,5,6,2,6,2,18,6,4,12,7,0,0,0,3,8,9,1,9,30,5,5,6,6,4,1,25,0,1,3,4,2,4,3,2,13,12,0,6,3,4,2,11,7,2,3,2,7,4,34,0,1,1,3,1,0,0,0,8,1,0
ratification,7,14,8,113,3,1,10,19,1,0,47,14,1,19,1,2,5,4,2,1,5,27,1,20,10,12,0,5,0,15,7,87,49,4,22,26,25,1,0,5,0,0,2,2,10,15,22,1,311,15,37,2,3,7,2,1,32,6,0,11,13,4,1,20,3,0,37,1,12,3,0,1,0,1,8,8,9,1,47,6,9,0,14,0,141,1,2,0,45,1,5,5,0,22,22,0,16,1,16,4,7,15,16,1,5,8,8,1,1,1,9,1,0,1,0,16,8,6,54,61,23,7,2,34,0,4,0,2,7,0,3,1,0,38,10,8,4,1,2,4,0,18,32,1,0,32,4,3,5,5,28,0,10,6,0,13,3,0,9,4,1,0,2,6,0,2,1,16,2,4,10,39,4,0,0,8,88,0,3,9,10,7,1,3,0,6,13,8,25,62,0,2,9,0,0,4,2,2,1,2,0,0,0,7,14,2,4,2,6,5,37,2,14,3,0,0,0,0,0,2,1,5,7,15,27,19,2,7,0,1,5,18,6,14,8,6,30,1,1,0,36,7,0,0,7,0,6,3,26,1,9,5,9,5,0,11,9,4,5,3,0,5,53,16,4,12,4,0,9,1,53,1,12,1,1,0,7,1,10,1,15,0,0,7,3,0,3,1,8,0,9,37,3,2,5,4,61,6,7,7,9,13,0,6,8,0,11,3,0,0,3,0,16,4,23,8,7,19,3,2,19,3,7,3,32,1,1,15,5,9,9,2,3,0,6,7,3,9,2,11,3,7,7,6,4,2,10,55,6,2,6,6,2,12,8,2,0,0,11,6,2,1,2,9,2,0,16,5,3,6,2,11,0,0,0,8,4,1,9,3,47,1,24,9,0,15,0,7,14,0,6,2,9,97,21,3,42,1,20,0,16,1,4,1,2,0,0,7,9,3,2,3,2,4,1,6,30,4,3,1,0,1,16,9,0,1,0,14,10,19,2,8,5,23,1,3,1,28,0,5,7,9,6,6,0,3,2,6,9,3,4,11,0,4,37,7,0,10,1,34,8,12,10,2,3,2,1,19,2,0,5,0,2,1,2,1,0,10,8,1,1,13,4,5,2,7,3,4,1,1,33,29,1,3,1,4,2,4,3,0,3,1,0,1,3,0,1,6,7,0,2,2,14,3,1,7,2,2,0,1,1,3,2,7,2,6,8,0,30,14,3,0,0,5,6,6,12,5,16,4,4,7,0,0,1,32,1,6,11,3,22,4,0,29,2,1,36,0,7,3,14,3,17,2,9,5,2,2,22,28,8,8,10,1,1,9,7,2,6,7,0,8,5,5,1,11,8,5,1,2,13,13,8,1,2,0,0,0,230,15,11,2,2,60,11,6,7,40,5,2,9,23,22,4,21,2,8,2,6,3,1,0,1,5,1,2,1,2,4,16,0,5,14,26,0,2,3,3,1,4,0,0,3,5,8,9,0,4,4,221,9,4,3,29,2,13,32,13,4,11,2,3,95,29,48,1,5,11,5,11,8,0,62,12,40,1,2,12,16,1,13,15,14,2,5,4,4,2,4,9,18,4,13,6,5,8,11,23,6,14,7,5,7,2,3,5,4,6,0,9,2,10,4,11,15,5,5,5,19,0,1,9,3,4,1,2,4,0,1,2,1,5,0,1,1,2,2,1,24,7,9,3,1,1,3,0,9,3,3,9,3,0,0,8,0,6,3,10,8,0,6,5,11,3,20,2,9,2,1,18,0,5,0,3,1,7,0,0,13,1,3,3,4,0,8,3,3,30,13,9,7,2,0,4,1,4,3,10,2,6,3,4,8,12,0,0,1,12,17,5,5,11,6,11,4,10,1,12,4,3,3,0,10,2,0,2,0,12,2,7,2,1,1,1,2,9,10,19,8,7,15,8,2,17,0,3,1,21,3,7,18,13,2,1,1,5,1,2,0,1,9,1,0,1,0,4,1,5,1,5,1,2,4,0,6,4,20,31,14,5,5,12,4,5,21,8,4,8,2,3,2,4,0,1,3,14,2,3,6,0,2,13,2,3,3,7,13,121,2,13,0,1,4,9,10,8,1,20,0,1,7,8,4,17,3,8,8,47,4,3,5,3,11,3,1,1,0,4,5,2,0,7,0,0,0,8,2,1,4,5,0,0,0,0,4,3,2,1,16,7,4,1,1,6,1,9,3,0,3,1,0,7,0,2,13,5,3,1,1,6,0,5,5,0,7,1,4,0,37,0,1,0,2,0,0,0,0,2,0,0
arbitration,4,14,8,34,6,0,4,5,1,0,24,15,2,48,0,3,5,1,1,0,0,5,0,7,10,2,2,10,0,3,4,65,38,3,15,8,23,0,0,2,0,0,0,1,8,7,15,1,156,12,6,1,1,11,0,0,5,7,0,11,8,6,1,11,2,2,8,0,20,7,0,0,0,0,9,3,7,0,21,6,1,0,9,2,146,1,1,0,27,1,2,3,0,13,14,1,19,3,5,4,2,14,11,1,5,19,0,0,13,1,1,0,0,12,0,13,3,0,15,27,9,11,0,12,3,0,0,8,7,3,1,0,0,10,0,5,4,0,0,0,1,15,6,0,2,17,1,9,2,5,23,0,2,1,0,3,7,0,1,1,1,0,2,1,0,0,0,8,6,1,3,34,12,0,0,4,72,1,1,3,10,4,0,2,0,4,8,5,28,68,0,0,0,1,0,0,4,3,1,1,0,0,0,5,3,1,0,1,10,11,18,1,11,1,0,0,0,0,0,0,0,6,0,6,6,3,3,12,1,0,8,7,0,0,6,4,14,2,0,0,12,6,0,2,10,0,0,2,32,1,5,0,6,1,1,9,2,2,6,11,2,8,41,8,0,5,0,2,1,2,34,0,10,1,0,0,6,0,21,0,14,0,0,9,1,1,0,1,6,0,12,11,0,1,2,3,23,0,4,2,16,11,0,8,4,0,15,0,4,0,0,1,17,1,12,1,6,31,4,4,26,2,3,0,22,1,1,8,3,5,0,4,0,3,1,1,5,1,0,8,3,4,0,3,0,1,13,22,1,1,5,5,0,6,19,2,5,1,4,11,1,0,2,6,1,0,12,9,0,3,1,3,0,2,1,1,0,0,4,4,16,0,7,12,0,1,0,3,5,0,20,2,2,31,17,3,30,0,12,2,6,0,2,1,1,0,0,1,0,1,0,8,0,1,3,1,13,3,1,0,2,6,5,3,0,2,1,4,5,6,6,4,0,3,4,1,0,25,0,2,0,4,11,2,0,0,0,4,1,0,0,2,1,1,71,5,0,1,1,9,8,3,16,3,4,2,0,2,4,0,2,1,1,0,0,1,2,5,16,2,1,5,2,1,1,3,2,2,1,0,28,10,0,0,0,0,2,5,1,1,1,0,0,0,3,0,0,15,0,1,1,2,9,7,3,7,2,1,0,1,4,3,3,4,0,2,7,0,1,4,4,0,0,0,10,2,3,5,7,2,0,14,2,0,0,2,0,3,18,5,6,0,14,8,2,3,5,0,1,7,8,0,15,5,2,8,2,2,24,7,1,5,9,1,5,7,0,1,4,9,0,1,2,1,4,3,5,1,1,0,16,9,1,4,8,0,0,0,69,4,13,0,1,6,15,6,3,2,14,0,5,12,7,0,34,2,3,0,2,0,3,0,0,1,1,3,1,6,2,15,3,10,1,5,2,3,4,1,0,2,2,0,9,5,6,1,0,4,1,131,10,3,2,3,0,4,13,4,1,22,0,11,27,64,15,5,1,25,3,5,9,5,1,36,73,0,2,11,7,1,0,7,3,5,8,1,3,3,0,5,23,2,7,16,2,2,3,9,0,2,5,15,3,1,0,15,6,1,0,2,0,12,1,5,4,0,0,3,6,0,7,2,7,0,0,0,5,0,3,4,0,1,0,2,4,2,4,0,2,1,0,3,0,4,30,1,3,2,1,4,0,0,0,4,1,4,2,7,5,1,1,4,1,1,8,0,2,0,0,34,1,1,1,4,1,5,0,0,0,3,0,1,1,0,11,6,0,0,0,1,4,0,0,8,2,3,2,1,3,3,8,1,6,0,2,1,6,2,10,4,0,1,1,7,0,4,2,31,1,2,5,1,22,3,0,0,0,6,0,0,0,0,0,1,1,4,2,13,3,1,5,0,0,13,4,5,4,44,1,3,30,11,2,1,0,1,3,0,0,1,12,0,2,3,1,3,3,14,1,2,2,0,1,0,1,2,15,6,18,3,38,3,5,3,10,7,8,5,3,4,1,0,0,0,1,20,1,0,1,0,0,1,0,1,1,2,5,12,1,5,0,0,2,10,1,2,0,1,1,2,0,26,4,10,2,3,4,4,3,2,2,3,3,0,0,0,0,1,1,0,4,0,0,1,0,10,5,0,1,0,0,0,1,1,0,0,1,3,2,2,0,0,0,2,0,15,0,0,0,4,0,5,1,0,2,1,0,9,0,0,0,2,3,0,0,0,2,0,10,0,1,3,0,0,0,0,0,0,0,0
settle,13,12,9,94,8,2,3,27,5,1,26,15,4,54,3,3,17,12,2,3,6,32,10,14,24,9,4,11,2,15,9,175,105,4,35,46,40,17,9,4,4,4,2,2,20,13,23,16,278,20,53,6,12,23,10,2,21,16,1,18,19,3,1,7,12,2,52,1,30,15,7,4,5,0,42,12,16,4,60,11,20,2,19,7,188,8,15,1,46,0,7,8,0,34,25,5,11,2,23,10,6,32,32,7,12,21,5,1,9,6,17,5,5,8,3,25,3,1,45,170,29,11,1,31,6,2,4,6,1,2,6,0,5,30,13,17,11,9,2,4,3,40,25,3,0,54,7,20,10,7,42,2,8,4,5,4,20,5,9,5,2,8,5,0,9,9,1,18,20,11,7,70,20,0,2,11,151,4,6,13,16,11,0,9,4,5,30,22,74,74,3,8,6,2,0,7,8,1,1,6,13,0,0,14,24,4,4,14,22,43,44,8,16,4,1,1,0,1,14,2,9,13,7,18,25,57,9,15,4,9,13,15,9,12,32,8,33,6,2,1,70,48,10,6,12,2,5,8,34,8,15,18,27,4,7,6,15,0,7,22,1,23,30,5,3,23,10,3,11,2,112,8,32,4,2,0,11,5,31,0,36,5,1,8,18,6,1,6,9,1,6,4,4,4,2,11,34,1,5,22,27,28,5,4,12,2,11,3,4,1,0,1,16,2,30,13,8,30,12,6,54,3,14,4,64,4,2,17,6,27,9,8,11,8,5,7,20,10,1,9,7,8,12,15,3,7,32,53,8,16,9,11,5,32,31,0,3,4,16,28,19,6,3,18,5,1,41,5,4,11,3,12,7,4,6,11,4,2,14,3,47,1,28,15,2,85,3,10,40,1,21,3,6,13,26,8,60,3,23,4,15,0,5,0,4,3,9,4,14,7,3,14,10,14,22,8,6,8,5,5,6,6,13,14,3,3,7,4,18,18,7,3,6,18,3,4,2,40,4,3,13,16,11,14,0,6,6,11,25,5,4,6,0,2,62,7,1,11,3,19,14,15,31,21,4,1,22,13,2,0,9,2,3,0,2,4,5,11,19,5,6,18,4,3,8,8,12,5,3,4,64,33,3,3,4,15,2,12,6,4,7,5,1,0,6,14,7,11,11,7,3,4,14,2,13,12,6,8,9,9,8,17,3,8,5,4,29,5,16,31,7,2,4,6,10,9,13,6,29,27,3,4,7,1,11,8,3,16,21,8,22,5,1,35,7,6,19,3,9,11,24,4,19,3,9,11,8,8,39,30,4,8,11,1,6,23,4,6,8,16,5,4,8,9,7,8,5,10,5,7,20,21,9,2,34,10,2,3,54,14,19,2,6,9,18,21,3,19,9,1,24,18,13,7,32,11,25,6,3,5,11,4,2,18,5,16,3,8,8,30,11,16,17,15,11,5,5,5,2,10,5,0,6,22,7,17,7,3,11,169,33,6,3,3,9,11,36,16,5,13,4,16,23,49,11,11,25,1,24,11,17,9,54,18,70,4,2,6,4,6,4,22,12,8,16,1,7,3,9,6,18,6,14,16,7,8,11,10,8,14,2,8,5,7,9,17,14,6,1,6,8,12,2,15,17,18,8,7,9,5,14,4,8,13,2,22,13,0,3,4,10,21,10,5,12,3,13,5,71,13,8,9,1,5,5,2,9,7,9,10,5,6,5,6,2,12,6,13,2,3,3,13,10,4,9,11,9,2,7,49,1,6,2,10,4,15,3,2,35,12,17,9,9,3,11,12,5,26,2,15,12,10,11,5,4,9,0,4,5,5,4,7,9,7,1,3,2,4,11,4,5,5,13,12,2,11,5,19,9,11,7,6,15,7,8,5,2,7,4,7,14,6,7,4,3,4,3,22,7,2,10,7,3,11,2,12,5,23,4,13,28,19,12,1,0,5,5,9,5,4,11,2,3,3,4,10,7,12,5,7,6,2,1,5,11,6,6,12,13,1,7,5,5,8,17,7,12,9,6,6,1,31,0,1,10,12,11,11,2,3,5,9,1,5,7,2,1,4,1,14,1,2,3,11,8,14,0,3,2,2,9,24,8,7,1,7,6,22,9,0,3,6,10,16,2,3,3,4,1,11,1,7,7,4,5,22,4,8,20,5,3,7,1,3,7,1,2,2,17,8,14,10,6,4,1,3,10,3,7,7,8,4,2,0,6,2,2,17,6,5,3,5,10,9,10,2,5,0,28,0,1,5,5,5,0,0,8,3,0,1
difficulty,0,24,6,111,10,9,11,23,7,1,43,7,4,47,5,4,6,7,6,4,12,40,6,23,19,7,6,8,6,7,6,144,116,7,57,65,44,10,11,4,6,3,2,0,33,12,21,15,238,8,46,6,13,31,6,8,35,19,1,18,24,10,3,15,15,18,71,2,18,15,18,4,6,9,83,11,13,6,81,39,52,0,23,4,210,27,10,0,28,2,8,8,2,38,53,14,19,4,28,7,14,20,50,9,13,31,8,2,21,7,12,10,7,13,1,32,13,10,46,161,35,15,10,33,1,5,3,3,1,2,7,2,1,34,10,33,14,7,5,9,3,46,37,1,3,53,6,19,21,12,60,0,16,8,6,22,18,8,5,9,11,1,3,7,1,3,1,25,27,10,25,89,32,0,6,5,147,3,11,31,26,15,5,11,9,16,26,24,49,72,3,16,2,0,2,2,18,4,5,8,23,2,1,36,18,13,2,33,9,20,49,11,18,5,1,0,0,1,4,3,7,15,8,13,27,75,8,29,0,4,14,7,10,21,25,10,34,6,12,22,67,49,1,1,16,9,4,12,30,13,14,18,26,13,10,20,20,2,10,18,0,29,17,6,4,29,3,1,11,7,126,5,36,8,7,1,11,9,18,1,49,5,2,20,13,1,3,6,13,0,6,6,10,10,6,9,31,13,10,15,22,22,0,3,9,2,15,5,7,2,1,8,37,2,28,14,13,32,18,2,53,7,35,3,54,4,16,33,6,17,2,8,5,6,10,11,20,9,2,15,19,8,11,6,11,9,65,57,12,2,11,14,8,29,23,21,2,1,34,20,22,4,12,12,8,1,39,9,3,20,3,9,8,6,15,20,8,2,10,9,60,2,38,8,4,33,5,19,34,5,38,5,7,18,29,8,70,7,16,6,20,1,5,0,9,2,11,4,15,8,1,11,3,14,19,4,7,5,2,0,3,7,15,23,7,7,2,10,17,6,21,10,8,17,2,5,4,19,9,3,8,20,4,17,3,4,5,13,32,8,12,8,0,9,73,8,1,6,16,27,10,20,25,32,11,0,8,21,8,2,9,6,1,2,2,14,4,11,29,6,5,19,11,5,10,5,15,10,9,7,68,55,1,8,12,13,5,22,15,13,14,3,2,1,11,30,5,8,9,7,6,5,11,11,21,21,2,11,2,10,5,14,10,18,11,3,19,7,34,29,7,3,4,6,12,8,12,20,25,34,2,3,1,7,3,25,13,16,48,13,20,3,2,47,3,5,24,5,7,8,29,5,24,2,24,20,14,8,32,49,7,9,14,8,5,9,8,10,10,15,2,9,16,12,7,9,10,6,3,17,9,40,6,1,19,1,1,7,74,24,20,8,9,13,9,20,3,22,10,9,36,21,16,3,39,13,25,4,13,7,13,9,5,30,6,5,6,8,8,28,16,38,26,18,7,1,17,7,2,17,6,4,7,24,30,24,4,5,4,148,24,11,11,4,5,8,37,17,16,11,11,9,17,26,16,5,3,24,1,17,28,15,69,28,35,8,3,4,4,12,5,21,18,15,10,10,12,5,5,7,12,6,18,16,18,10,11,5,13,16,7,6,7,7,9,4,18,4,2,7,3,5,6,22,17,25,11,9,5,9,8,5,8,23,2,9,18,5,2,15,9,17,4,6,5,5,14,7,45,11,11,5,2,2,3,7,13,4,7,5,12,7,1,4,2,18,8,13,2,8,8,9,6,5,14,15,12,7,4,16,2,10,2,13,11,15,8,4,27,22,9,8,11,5,4,5,7,18,10,13,7,11,3,10,19,8,7,8,1,10,7,2,9,4,4,15,6,8,19,6,3,2,4,10,4,3,2,5,8,12,6,6,7,7,10,5,5,5,11,7,10,9,4,2,4,4,10,36,12,7,9,7,4,8,9,6,12,5,7,13,23,29,7,6,0,3,5,8,3,2,11,3,5,9,7,13,2,2,9,7,1,2,13,7,10,9,8,15,9,7,0,11,7,12,14,6,2,7,6,8,3,21,0,3,14,6,7,4,0,0,9,4,3,15,0,3,6,12,3,26,2,8,4,11,18,6,4,9,4,3,13,31,2,9,3,10,11,31,20,5,7,2,16,11,5,1,4,6,3,7,3,17,1,2,6,14,10,14,38,6,0,4,2,7,5,5,2,2,15,7,4,4,8,6,3,7,9,2,2,5,4,2,9,2,7,7,6,26,7,7,6,9,6,10,5,5,8,1,19,1,3,6,5,0,0,0,1,7,1,1
although,13,27,5,134,10,2,10,28,7,4,34,10,10,61,2,10,5,19,5,6,10,33,3,20,16,14,8,8,4,25,8,173,120,5,47,41,47,6,11,9,2,7,7,6,36,23,29,10,260,7,43,1,15,29,3,5,67,20,0,18,22,4,0,13,21,4,43,8,7,10,12,7,4,2,51,15,13,5,68,18,44,2,16,7,215,17,15,0,41,3,15,6,2,44,50,11,19,9,45,15,15,20,36,10,17,32,4,4,19,4,14,5,4,17,2,53,9,3,68,127,31,11,11,75,7,1,2,8,1,1,13,0,2,33,16,24,9,2,5,5,3,26,26,6,4,56,6,17,11,6,66,2,16,10,3,26,12,2,5,5,6,2,4,5,6,3,11,22,20,16,28,79,10,3,6,9,148,1,8,23,18,9,4,6,7,15,36,20,42,63,2,3,8,1,0,4,13,5,11,15,23,2,2,15,38,4,2,30,14,27,69,4,27,5,1,0,2,4,11,3,8,14,8,9,36,82,26,30,5,13,9,13,19,12,24,27,104,7,6,4,67,29,7,4,15,12,15,14,42,5,13,24,10,13,12,15,11,5,9,12,0,23,23,6,4,36,4,6,11,3,142,10,50,5,3,3,21,19,19,2,38,8,1,18,17,2,7,4,14,0,7,7,15,6,5,9,62,10,7,18,29,27,10,1,16,1,18,8,5,1,5,11,29,4,29,13,12,41,11,13,57,7,34,1,49,11,2,26,10,28,3,11,12,6,5,13,19,11,6,18,12,7,19,10,4,11,28,49,17,3,16,10,8,22,19,7,3,7,13,15,15,11,14,10,5,1,49,7,6,13,2,20,7,7,10,14,9,3,8,16,40,5,29,5,0,21,7,32,23,8,30,2,12,17,33,7,64,5,24,4,30,2,5,0,3,3,10,0,18,11,2,9,1,15,7,12,2,7,3,5,3,5,19,21,3,4,2,14,10,22,26,13,10,11,3,6,1,15,8,7,13,21,9,19,1,4,3,7,23,15,22,5,1,6,51,9,3,8,10,35,13,23,28,21,8,0,9,9,2,2,20,3,5,0,0,7,4,15,24,3,13,14,6,6,17,10,17,3,3,5,68,46,2,8,9,5,1,24,10,14,12,5,10,1,2,46,11,18,3,4,5,7,7,6,12,19,3,8,0,11,7,26,8,25,7,5,22,7,31,30,4,3,2,12,5,6,16,12,37,20,2,4,1,6,7,11,6,24,15,8,20,6,7,44,3,7,38,9,6,10,31,7,28,5,17,11,24,8,38,33,6,14,25,6,7,10,13,8,10,9,11,16,11,17,6,5,11,18,5,3,24,30,13,3,13,3,4,3,60,19,23,2,11,9,9,24,4,28,5,6,26,11,16,11,40,12,18,8,9,7,12,14,10,19,3,14,11,7,12,27,8,32,13,33,8,1,6,2,6,18,9,4,9,25,17,30,1,18,4,170,12,4,12,9,11,19,48,8,12,17,7,10,26,22,12,11,5,11,17,1,22,11,73,22,44,5,3,11,5,3,6,35,20,8,9,11,11,2,4,15,9,9,21,13,9,13,10,5,18,18,8,12,4,14,10,5,21,3,7,6,5,13,8,25,18,12,9,5,12,4,8,6,7,19,3,13,5,3,3,16,11,17,7,5,3,7,18,4,32,10,14,6,3,18,20,5,12,5,11,8,11,9,8,6,7,18,6,9,4,11,9,14,4,4,17,10,16,10,13,9,4,4,3,23,8,19,13,2,11,18,3,8,9,9,13,7,10,10,13,12,7,11,7,5,8,28,2,9,6,4,3,2,15,8,4,2,11,11,22,7,5,5,16,15,7,6,3,10,11,13,12,7,13,18,1,7,3,9,8,7,13,8,11,1,9,10,4,38,8,8,13,5,6,8,10,5,7,9,4,10,16,15,7,11,3,8,7,5,9,1,11,5,10,6,6,6,5,9,5,9,1,4,6,10,12,6,4,21,11,3,11,10,3,5,8,10,10,9,6,9,2,10,2,7,9,14,4,4,8,2,5,13,4,12,9,6,9,7,4,16,3,12,5,17,10,8,1,12,1,7,9,8,4,8,6,8,13,40,3,15,7,5,9,9,3,2,5,9,5,9,10,1,11,9,7,37,10,12,48,4,1,4,5,2,5,11,5,10,18,4,0,8,7,1,1,25,6,7,7,8,9,7,7,5,6,6,0,8,11,8,3,6,8,7,4,4,7,0,11,2,7,6,4,2,0,4,2,6,3,1
render,12,32,16,199,19,3,9,44,6,5,28,12,20,111,13,8,9,19,2,3,8,50,4,31,39,16,17,13,6,21,24,280,193,24,84,68,88,16,12,4,10,7,10,5,44,34,32,21,422,20,64,2,10,43,12,9,120,40,0,28,25,18,5,17,35,6,117,10,12,10,21,22,15,1,100,19,27,5,143,24,72,3,20,7,303,20,33,0,47,3,12,8,0,39,78,23,25,16,32,21,29,58,55,8,19,61,8,6,16,9,20,7,13,22,0,60,10,4,89,239,62,16,11,84,12,5,5,6,4,2,15,7,16,80,31,80,21,11,7,10,4,51,46,4,9,90,17,22,32,23,115,1,23,16,11,33,30,10,13,5,20,9,12,6,1,9,16,36,38,15,33,124,29,1,10,9,281,13,11,40,48,28,1,34,7,20,56,38,47,66,3,11,5,0,0,6,19,7,20,37,34,6,2,18,44,10,13,74,15,46,92,4,40,14,2,0,1,0,23,2,5,29,15,28,75,187,40,43,11,13,20,13,28,30,64,33,61,23,16,16,114,44,15,9,18,4,5,23,77,10,15,38,25,9,24,16,24,2,8,44,8,50,38,7,10,84,13,11,16,10,216,13,54,13,8,0,39,20,23,2,96,12,6,31,16,2,8,13,22,3,14,8,17,8,4,16,52,4,15,30,44,61,1,3,14,5,25,9,10,4,8,35,42,11,48,32,30,63,19,10,64,9,52,10,96,5,13,40,8,31,4,21,10,13,20,26,27,12,7,22,15,15,24,10,10,11,71,90,38,14,17,8,16,49,46,10,7,12,34,38,30,24,12,33,5,1,50,6,6,15,5,30,5,23,15,110,26,7,23,17,105,2,131,9,7,66,12,32,37,5,55,10,23,17,50,19,93,14,53,7,30,5,6,2,11,10,13,6,27,22,1,12,4,31,8,12,8,7,2,1,10,23,25,17,2,9,5,25,17,25,23,10,6,8,4,5,0,19,21,12,28,44,6,16,2,2,4,12,64,20,34,11,4,6,75,17,4,14,17,55,20,34,44,41,12,13,30,19,23,0,38,0,8,3,3,41,12,20,47,17,15,36,5,5,10,12,23,4,7,11,163,62,5,4,17,17,14,23,13,21,13,5,6,0,8,62,12,21,12,14,14,10,11,11,28,24,1,9,10,17,9,39,14,44,19,10,27,16,34,52,15,12,11,23,26,12,29,11,62,34,15,7,6,19,18,10,6,30,34,13,55,14,8,56,24,8,58,3,5,15,37,11,44,19,23,40,18,38,55,55,15,19,35,5,11,3,13,12,7,23,20,20,25,25,18,4,13,15,7,18,36,45,9,16,47,11,5,4,60,30,37,7,13,7,10,34,16,32,13,18,40,31,17,11,71,12,34,11,22,21,26,15,14,37,15,16,10,12,22,43,16,43,29,26,10,8,14,19,6,31,21,0,27,47,13,49,9,9,10,241,29,15,11,9,8,16,62,20,10,20,11,11,18,27,9,8,9,17,28,22,1,21,91,81,50,15,15,13,5,12,9,35,23,16,20,28,16,11,13,21,31,16,28,21,12,22,21,5,18,29,16,6,12,15,32,13,30,14,10,7,10,13,12,33,26,74,16,8,5,19,22,16,9,58,9,17,21,21,13,25,22,27,10,8,8,5,53,10,65,22,27,13,6,20,19,4,25,10,16,13,27,8,10,20,9,16,12,29,10,1,0,22,6,1,40,24,20,9,22,21,12,7,3,20,13,21,21,3,42,16,15,10,32,5,24,21,18,27,22,22,12,23,5,17,23,37,7,8,10,16,5,11,22,10,2,4,17,10,30,16,11,8,16,17,14,9,7,5,7,11,7,6,17,15,17,6,8,13,14,15,21,17,29,11,16,16,22,41,15,4,9,17,16,26,13,15,8,4,12,17,23,42,15,15,4,11,15,16,11,5,7,7,14,8,9,12,18,4,16,22,19,6,5,19,8,9,2,26,20,4,21,10,7,5,20,9,11,8,13,16,6,21,2,4,13,9,9,5,15,12,11,12,5,14,12,5,16,19,7,17,5,10,6,20,13,6,14,14,5,6,14,10,8,21,4,24,3,23,3,21,13,5,19,10,11,5,12,12,8,33,5,23,8,8,12,17,14,30,52,10,15,6,5,6,11,9,10,9,30,8,11,11,15,9,1,23,8,11,9,13,17,10,5,8,9,12,3,20,11,12,10,21,11,9,10,8,23,3,16,1,9,5,5,0,0,1,0,6,9,0
necessarily,5,9,8,118,5,9,4,20,3,7,16,2,9,54,3,5,4,16,3,2,4,28,3,16,13,7,6,10,4,11,4,128,92,10,49,35,20,4,9,5,12,4,0,2,19,14,13,2,143,6,32,0,9,18,6,7,78,26,0,11,15,8,1,16,26,1,61,10,13,16,7,14,6,4,102,6,17,7,43,15,50,0,5,1,143,27,23,0,20,0,8,2,1,22,42,18,12,11,21,13,14,16,44,6,7,26,11,1,11,4,16,6,5,11,0,22,1,1,46,122,33,13,14,46,6,2,5,2,4,1,7,0,4,30,8,39,8,0,5,6,2,16,14,7,3,49,4,4,14,22,44,0,12,2,6,11,15,3,5,2,7,1,3,1,1,2,7,13,21,7,11,51,7,0,3,7,131,0,5,27,21,10,3,14,3,18,35,17,34,19,2,6,8,0,1,3,16,7,4,13,23,2,2,9,20,6,2,34,11,23,65,1,18,15,0,0,2,0,10,1,5,15,3,12,42,54,19,23,12,2,11,16,17,22,20,46,26,6,9,5,51,27,2,4,9,3,2,16,45,1,7,18,7,6,17,14,10,1,4,7,1,18,8,2,10,23,3,3,9,1,108,4,39,6,3,0,13,18,12,1,42,5,3,17,7,0,1,6,14,3,2,3,7,6,1,13,16,3,3,24,21,21,1,2,12,1,10,3,4,0,4,8,22,0,29,16,12,39,13,11,28,4,33,6,37,9,11,13,4,25,3,10,11,6,6,9,12,4,2,15,12,7,11,9,3,9,37,45,15,1,13,10,5,20,16,1,4,6,16,27,11,4,10,9,3,1,33,17,4,10,1,18,5,8,12,15,5,3,17,9,42,2,37,13,2,15,2,15,33,3,8,3,2,5,34,9,46,5,14,5,15,1,5,1,5,6,5,1,27,10,3,5,4,15,2,7,1,6,0,0,4,15,11,16,0,3,2,10,7,18,14,3,2,5,2,4,0,2,6,10,13,17,3,6,2,4,4,3,33,4,12,1,0,5,46,2,0,5,9,34,7,20,20,23,5,1,23,8,6,0,19,5,3,5,3,15,1,13,18,5,8,7,5,1,4,5,9,3,6,1,52,21,3,3,10,6,4,7,11,6,11,3,7,0,13,6,2,12,4,0,9,8,7,9,13,13,3,15,7,6,6,16,5,13,10,2,10,2,9,28,9,10,3,13,10,9,6,7,35,10,3,2,4,3,10,8,2,15,20,6,25,3,5,44,13,7,30,10,6,2,26,2,17,5,16,9,6,6,38,28,8,8,18,0,8,4,18,4,5,18,12,12,14,17,6,8,5,8,5,2,22,22,4,4,27,9,10,7,20,18,24,2,5,2,1,18,5,17,9,9,11,14,13,5,32,10,21,7,9,11,6,12,2,22,3,11,6,6,14,24,8,18,27,14,3,4,4,8,2,8,22,0,8,18,4,24,3,0,5,69,15,10,6,2,3,5,41,6,4,10,5,4,9,14,2,0,5,9,15,11,21,1,37,20,14,6,3,8,3,3,19,31,12,7,10,14,7,0,4,10,9,5,12,11,4,7,11,1,21,6,10,0,4,7,12,4,12,4,11,5,5,3,5,24,22,33,7,4,3,7,5,3,3,21,2,8,5,3,1,18,5,9,2,10,4,3,19,3,18,0,6,9,6,3,3,3,13,7,7,8,10,9,3,17,15,5,13,8,4,16,14,11,1,2,7,13,2,3,4,6,13,3,4,8,12,9,1,4,7,12,4,4,11,3,5,8,5,4,3,15,3,9,2,10,8,11,2,5,2,3,4,4,8,5,6,2,5,7,25,6,11,1,3,6,2,3,4,5,3,5,3,1,8,6,3,9,2,5,11,4,12,7,9,8,6,12,10,17,5,2,5,6,5,5,3,8,6,1,8,6,8,23,3,11,1,3,6,8,3,2,9,0,7,7,2,8,2,0,6,11,6,5,7,11,5,7,2,13,6,3,3,4,2,2,8,3,6,2,6,3,2,7,0,5,4,2,5,3,4,3,6,9,3,4,6,2,5,7,6,16,2,7,5,6,11,2,0,16,6,0,5,9,3,17,2,7,5,9,3,1,6,1,4,10,3,1,6,7,4,12,4,16,5,7,1,4,7,11,26,3,8,3,1,6,6,2,9,9,5,5,3,2,4,5,2,3,2,0,7,10,7,5,4,3,3,6,0,8,9,6,3,7,11,11,6,3,9,1,5,0,2,0,1,0,1,2,0,2,1,0
mexico,43,119,7,483,29,2,39,64,28,16,330,38,15,197,6,37,28,28,9,29,17,136,2,66,61,38,29,38,25,51,62,591,551,13,172,137,325,17,11,42,3,4,22,2,100,86,127,16,1649,65,280,29,30,117,4,31,126,77,6,29,104,23,2,22,41,11,242,4,49,65,27,13,5,20,134,39,30,11,261,93,78,0,72,3,872,48,23,0,188,2,52,29,4,119,154,3,73,22,146,7,18,68,108,36,35,39,10,12,46,11,71,14,2,18,8,168,55,20,233,628,118,102,0,199,3,8,2,14,9,3,31,13,16,126,56,43,100,17,7,23,2,110,181,6,4,235,29,32,38,40,233,2,73,20,4,23,36,39,200,7,9,15,10,3,4,1,20,57,57,59,167,236,47,1,6,86,619,6,43,18,50,69,5,48,9,28,75,105,117,383,2,29,6,1,0,10,25,3,29,17,12,2,4,32,94,5,4,33,57,104,186,10,95,31,3,0,6,0,31,12,13,59,37,48,131,136,33,77,21,18,47,57,60,68,74,26,100,14,4,16,221,63,12,11,50,7,31,21,83,19,14,45,86,28,49,35,81,0,32,33,0,102,68,32,3,61,0,19,50,29,423,8,147,19,9,1,117,33,38,8,128,5,0,57,42,14,0,18,59,2,30,24,7,23,4,32,208,43,11,28,132,98,1,7,20,0,86,14,1,0,12,5,53,7,108,36,18,130,49,5,397,26,109,1,191,33,3,100,20,128,1,24,25,10,18,48,51,59,1,62,46,37,28,63,4,62,196,333,60,25,52,16,17,52,74,4,47,17,51,85,10,9,14,81,28,2,199,44,5,19,10,22,11,9,15,44,31,3,73,35,151,0,116,33,0,79,26,111,139,5,86,8,28,49,130,37,210,11,221,11,40,8,21,6,26,7,17,25,65,27,53,55,11,69,12,42,33,20,25,2,18,81,56,97,4,13,7,56,64,46,37,43,84,75,3,16,0,71,31,2,46,93,32,46,1,18,7,50,139,26,31,16,7,17,83,18,0,124,10,101,71,75,73,25,23,0,20,31,28,0,50,4,4,0,11,16,33,49,45,4,20,85,21,14,34,77,32,30,13,10,630,104,10,27,10,64,3,101,29,15,42,13,5,0,10,1,6,78,7,7,11,24,21,3,11,54,17,9,1,12,3,158,14,33,11,18,77,0,118,123,39,5,19,21,26,10,69,19,183,14,14,9,20,2,10,35,57,96,36,8,67,28,5,122,8,19,150,11,5,19,94,20,69,6,56,21,52,34,110,87,9,35,35,3,13,15,8,25,1,76,1,81,26,29,29,73,6,35,22,32,45,128,21,13,15,18,1,8,471,79,78,2,15,69,52,36,16,183,2,45,155,70,74,5,112,43,87,1,14,28,22,1,4,74,7,5,34,13,30,107,3,36,65,84,58,12,7,43,3,58,8,1,18,140,45,131,12,35,3,1212,31,16,21,7,17,31,163,170,94,78,13,37,150,36,103,62,1,54,69,73,91,37,1,34,193,21,6,14,12,39,10,61,76,24,47,23,47,19,95,105,120,25,42,78,36,19,58,47,46,87,14,11,34,20,14,33,66,40,5,40,20,52,39,61,74,273,67,59,56,7,58,29,143,76,3,48,36,3,4,42,9,43,5,13,45,15,75,44,384,37,28,42,5,16,32,2,40,26,28,18,34,30,15,35,5,35,20,55,9,17,3,23,55,4,84,9,82,15,6,36,12,12,1,88,13,73,7,1,27,65,19,15,60,4,42,11,27,830,20,42,29,12,3,10,8,91,8,44,14,17,4,30,43,17,9,1,23,25,52,53,24,29,70,26,24,38,7,50,37,22,48,8,38,33,43,21,3,13,8,23,43,40,14,49,39,27,17,134,51,25,75,5,1,35,6,10,7,23,22,96,55,140,51,21,1,7,17,6,60,9,10,1,27,15,27,57,3,9,14,14,8,3,5,3,15,14,3,40,55,7,69,33,16,47,90,15,58,48,92,22,34,67,1,41,97,117,61,10,22,9,19,44,39,42,6,25,7,26,9,77,5,32,7,56,40,35,8,67,1,1,52,50,41,8,3,18,7,215,26,1,19,1,34,39,13,5,4,26,9,10,4,55,21,18,3,91,10,79,65,13,6,37,2,12,29,26,82,28,80,16,20,25,5,9,1,62,21,2,6,44,55,41,8,18,58,25,3,30,38,64,11,10,27,5,39,0,40,7,92,12,2,4,29,0,0,0,0,95,4,0
court,12,77,48,376,7,6,9,89,14,6,28,9,11,97,5,31,35,25,2,1,11,88,30,97,82,11,49,18,39,51,12,483,156,28,127,48,26,8,13,3,22,10,6,11,62,61,50,71,1031,16,79,3,5,30,10,11,168,66,1,18,29,19,8,20,64,21,114,20,12,17,5,5,5,25,128,13,64,2,149,41,96,4,18,7,411,20,10,0,58,4,20,30,0,67,85,50,44,22,44,12,27,53,66,24,15,76,1,40,26,3,26,4,6,57,0,69,26,11,240,351,99,31,84,98,26,0,4,17,21,1,10,8,4,133,52,74,43,20,23,2,9,120,71,15,5,165,23,55,29,52,321,2,30,0,0,439,52,4,32,12,36,2,20,9,0,23,9,51,71,12,35,265,52,0,15,15,437,9,23,79,77,24,1,70,6,37,89,80,186,106,12,25,7,0,1,6,39,9,14,22,164,0,1,50,51,18,7,85,26,21,196,3,100,9,9,7,0,3,34,5,2,58,18,28,101,577,63,53,7,9,28,36,38,78,45,18,58,5,7,23,222,59,8,35,22,26,11,15,195,17,44,19,37,14,13,31,24,2,7,39,16,56,82,55,8,78,4,12,9,4,312,1,68,4,14,1,50,11,51,30,85,38,3,59,27,0,20,15,31,4,5,11,45,5,13,26,83,22,20,61,51,89,2,3,27,7,19,11,8,5,5,49,42,19,36,20,19,108,25,14,86,17,55,10,257,124,12,34,14,164,14,36,25,33,24,40,19,25,2,18,18,20,18,36,2,6,103,98,24,6,67,53,34,65,53,18,29,5,46,54,92,11,6,62,6,6,86,27,43,29,10,48,7,23,59,29,34,4,17,5,220,2,86,22,7,64,68,39,78,2,262,2,32,70,96,33,207,9,98,7,71,3,8,2,14,0,17,3,23,9,2,12,0,48,11,17,4,30,9,1,9,9,104,34,6,24,5,32,17,46,6,16,0,23,5,3,0,11,15,51,36,53,17,7,0,4,2,7,92,10,15,10,1,0,113,85,0,67,27,105,36,34,66,56,6,1,12,24,8,2,48,19,0,6,17,45,8,27,63,17,19,20,0,19,6,107,38,6,6,85,59,144,4,8,9,11,3,51,22,44,23,9,10,2,34,8,1,26,32,9,3,50,15,23,14,53,4,24,58,21,2,70,30,107,60,39,60,59,73,103,54,14,10,45,55,21,20,13,62,43,5,63,17,2,2,97,0,22,59,27,163,25,186,132,31,32,37,9,27,25,42,27,83,18,56,39,20,102,68,86,19,9,9,33,17,8,7,35,40,37,7,67,29,32,14,16,34,18,14,12,34,69,33,6,76,4,16,3,77,30,51,6,7,7,50,88,21,92,41,4,94,88,48,9,312,56,28,24,127,5,37,2,4,115,4,32,11,52,34,123,0,94,70,95,43,6,28,28,14,15,43,5,307,43,27,28,2,13,32,568,33,6,11,36,33,12,64,70,24,21,13,13,54,53,7,12,36,18,28,22,81,20,34,1,124,10,28,23,1,9,5,60,14,23,15,35,15,7,12,16,35,32,47,14,11,12,19,23,86,35,6,22,17,24,25,9,40,2,45,9,40,23,4,26,47,7,3,17,23,10,33,17,8,85,3,18,17,2,5,22,18,43,4,22,50,2,2,4,124,8,35,15,4,0,9,6,19,9,7,23,12,0,0,6,4,15,15,48,13,12,11,29,11,12,62,13,16,44,4,37,21,5,5,83,7,60,0,2,19,20,7,4,35,4,23,7,11,44,9,41,24,238,34,6,34,45,22,28,4,37,10,14,36,10,6,1,15,11,41,13,0,1,24,15,5,12,24,26,5,26,5,7,30,32,1,4,5,11,1,13,15,11,14,12,11,6,11,96,49,5,9,40,337,166,10,25,17,18,29,55,79,116,51,8,2,17,16,29,48,5,3,51,21,2,23,30,13,7,27,57,14,25,3,1,7,8,6,25,34,6,27,28,14,2,43,3,13,11,13,3,3,6,0,1,31,8,2,19,14,4,16,1,7,31,40,3,0,6,11,53,8,0,24,27,37,13,10,1,2,14,3,10,18,22,14,38,11,23,7,7,14,21,11,8,26,6,4,9,25,7,8,35,0,0,1,14,9,7,41,21,2,15,3,1,14,16,7,4,19,11,12,10,12,27,1,27,5,2,27,4,5,17,7,7,11,5,0,13,7,12,2,17,12,0,13,17,20,0,28,5,11,9,20,0,0,11,1,5,0,3
claim,23,33,14,374,31,5,15,81,14,6,122,60,8,117,10,18,26,18,10,10,19,75,10,70,46,18,15,26,7,54,26,469,242,9,135,68,64,23,10,10,7,10,23,7,69,37,82,27,1023,53,93,3,21,27,8,9,166,67,2,40,57,22,6,34,34,12,100,10,24,30,26,10,3,9,73,25,18,8,192,38,70,0,47,7,749,30,25,1,101,6,52,8,0,118,103,20,43,17,75,14,27,58,90,15,31,80,7,5,51,6,38,6,13,40,3,87,29,5,220,233,82,51,10,132,10,7,5,10,6,8,26,8,5,105,54,67,50,17,9,18,5,89,100,3,8,145,10,39,18,25,135,3,61,7,4,19,26,3,19,10,18,4,6,1,2,13,12,41,55,22,35,144,31,0,2,24,512,1,21,25,48,27,4,26,9,29,48,43,92,198,7,9,7,0,1,2,14,5,28,23,35,4,5,41,59,9,7,37,46,41,129,6,56,15,2,4,3,7,35,8,23,49,15,18,89,203,40,51,13,19,23,42,25,34,53,40,81,13,9,14,174,74,8,8,27,11,19,15,118,12,38,39,30,6,22,27,20,5,11,54,5,43,106,20,3,84,2,8,26,17,278,23,187,6,5,0,39,16,86,17,87,9,3,67,13,2,5,13,31,4,28,14,13,4,8,27,134,13,18,51,90,107,0,18,25,6,44,8,6,0,3,14,49,6,191,27,31,100,10,9,377,20,47,7,175,30,5,68,4,74,11,20,27,10,33,37,34,32,5,41,25,24,28,21,11,7,94,153,42,9,33,26,25,46,100,6,21,3,28,50,44,13,12,41,10,0,62,17,4,17,4,35,10,18,13,37,24,4,45,16,151,4,64,27,2,93,15,99,75,4,121,6,29,69,101,26,223,4,68,15,64,2,12,0,7,6,20,9,39,18,7,21,27,28,41,25,19,26,8,2,7,10,39,19,3,4,3,29,38,35,25,24,16,43,2,19,0,77,24,7,47,58,21,27,1,10,5,20,48,15,25,18,2,10,155,18,6,27,5,66,22,44,64,25,13,7,14,30,19,0,17,5,9,3,3,9,8,39,31,10,9,30,24,13,14,77,20,11,13,12,151,129,3,3,15,23,10,85,42,11,9,14,2,1,35,18,2,54,26,7,4,17,26,13,22,30,9,9,2,7,6,100,13,39,20,21,65,4,51,64,13,6,6,11,44,19,24,13,88,17,21,5,0,1,8,51,9,44,135,30,62,13,20,150,16,14,53,10,13,17,79,4,105,8,38,28,34,18,109,81,23,31,72,9,13,24,13,14,20,45,7,39,15,38,11,8,7,19,15,20,75,80,48,11,51,21,4,4,284,43,41,3,12,27,76,31,14,77,12,11,78,138,44,16,157,24,50,5,25,18,30,4,5,30,3,14,17,26,29,74,26,85,40,50,59,11,9,9,11,25,18,4,9,43,51,39,11,24,7,749,81,17,22,11,28,44,76,74,17,67,5,20,212,110,51,40,73,70,35,44,50,14,193,124,1,12,9,58,5,7,1,62,44,17,28,29,43,3,5,14,87,25,58,28,18,24,14,31,24,52,29,14,25,21,29,16,58,6,11,18,6,48,12,42,58,37,17,17,36,12,15,18,8,46,3,37,24,5,12,20,10,36,3,6,58,4,19,10,102,18,29,24,6,12,34,3,40,9,15,55,17,16,8,47,8,28,21,29,6,31,29,28,17,12,61,7,19,23,12,118,7,9,4,112,9,30,11,2,43,25,22,18,25,5,22,22,20,88,15,31,32,18,3,10,22,37,11,21,16,15,10,15,44,16,6,5,17,17,69,12,13,20,42,18,14,20,22,57,14,23,29,10,9,53,8,11,2,23,16,17,36,22,9,4,15,16,16,62,20,16,30,15,10,38,49,23,16,53,14,66,78,90,10,11,3,9,11,15,12,1,25,26,29,3,14,26,8,21,16,28,24,10,8,10,24,19,45,74,25,9,121,44,7,24,92,25,30,25,10,9,5,37,2,13,77,76,13,9,6,8,14,25,4,14,20,14,31,43,28,39,2,2,13,93,53,33,4,24,1,5,26,66,10,31,21,27,10,89,87,7,22,9,25,28,16,18,13,16,20,13,5,30,11,4,15,130,17,13,69,47,1,8,3,3,18,11,9,7,49,25,10,7,7,13,5,65,9,55,11,21,5,19,9,10,17,11,10,19,17,13,4,28,33,4,12,6,24,1,155,2,14,4,4,2,1,1,3,14,1,0
existence,2,11,2,70,6,0,0,29,1,0,15,4,4,48,13,11,3,15,4,3,2,29,3,14,14,1,5,8,2,11,7,65,80,7,29,35,28,3,8,3,2,7,3,1,14,15,13,14,230,3,36,4,10,18,8,5,38,9,0,6,22,12,1,8,14,7,78,4,6,8,3,3,1,2,83,5,11,3,45,12,33,0,7,6,172,5,10,0,14,1,1,4,0,19,28,2,18,2,22,12,1,18,12,5,8,19,5,0,2,2,13,5,4,11,0,13,3,2,55,111,23,5,6,28,5,4,1,3,1,0,8,5,11,20,9,22,7,0,0,5,4,18,16,1,4,37,8,10,9,8,61,0,14,3,13,10,9,2,11,3,7,3,6,0,1,3,5,10,11,6,18,56,14,0,3,5,106,5,6,15,11,12,0,11,2,16,20,15,21,12,2,4,5,0,0,3,9,5,5,13,11,0,1,5,14,9,1,19,7,18,42,3,29,6,4,3,0,0,3,1,2,19,4,14,21,71,13,24,2,0,3,6,6,14,27,11,26,3,6,5,54,16,6,1,10,5,3,6,19,3,7,17,12,3,5,5,5,1,4,10,2,23,11,3,4,29,9,4,14,4,94,5,19,3,4,0,10,1,11,0,32,12,3,7,10,0,1,2,7,0,4,1,4,4,1,6,9,4,1,14,14,22,0,1,13,1,13,2,6,0,0,17,18,5,7,16,15,16,18,7,24,4,23,10,57,9,8,27,3,10,11,8,8,1,4,8,17,8,1,4,12,8,9,13,4,11,42,21,13,3,12,4,2,28,24,3,0,6,13,20,5,1,8,10,2,0,35,9,5,11,4,11,2,6,10,16,11,5,12,10,37,3,27,4,5,18,5,13,10,3,14,1,9,7,24,7,30,2,14,2,4,1,2,0,4,5,6,4,10,8,4,6,8,8,36,2,0,6,2,0,2,5,6,12,0,3,2,3,10,10,10,1,3,6,6,2,0,3,8,6,14,13,2,7,2,2,2,9,31,3,3,5,3,3,26,8,0,16,3,20,4,11,17,20,5,0,7,3,5,0,15,1,0,0,5,10,7,12,15,3,11,2,1,9,4,1,4,5,4,5,78,20,3,12,5,4,7,5,1,11,9,2,6,1,0,25,16,8,3,4,4,3,2,4,10,11,2,3,7,5,1,10,5,18,9,6,22,11,12,14,5,0,5,13,1,4,9,2,22,16,2,1,6,24,3,8,4,6,10,5,43,6,2,27,13,5,22,2,6,2,11,2,16,4,4,12,14,9,17,16,10,4,8,5,3,2,7,3,5,15,8,11,14,16,4,3,11,8,1,6,14,17,4,1,27,1,2,3,26,18,18,1,5,3,4,15,3,19,4,2,16,10,4,2,19,10,27,2,4,5,4,13,1,20,3,4,10,5,12,14,1,7,12,16,10,3,15,3,2,5,13,2,8,12,4,14,0,1,2,118,14,4,3,3,5,6,35,20,7,12,5,7,4,13,3,1,0,4,8,5,15,6,21,10,12,1,2,3,4,5,4,18,11,4,5,4,13,8,3,9,9,7,13,8,2,3,8,7,13,7,0,8,6,4,2,4,6,5,4,3,1,5,7,21,3,8,5,7,4,5,4,8,3,4,1,5,6,1,1,10,4,6,2,3,1,8,14,4,15,5,5,2,1,5,8,4,10,3,1,6,14,4,2,10,1,10,18,6,1,9,8,5,2,3,10,8,9,1,20,7,5,6,2,10,4,5,6,1,9,9,2,6,5,2,5,6,4,1,5,2,3,2,4,3,4,5,3,6,0,0,1,3,14,2,8,1,7,4,7,4,6,3,14,3,0,5,4,4,3,9,4,1,1,10,2,3,4,8,5,7,7,2,11,6,4,5,5,13,20,4,2,4,2,2,4,6,5,1,5,3,39,13,6,4,0,2,8,3,1,0,2,9,3,0,6,8,5,1,13,4,0,2,3,5,9,4,0,9,5,0,0,3,2,5,0,1,0,2,4,1,5,5,1,0,5,19,4,0,2,6,6,0,1,12,9,7,0,3,0,22,6,4,5,5,6,2,2,1,2,3,5,3,1,7,4,3,4,4,5,2,5,0,5,2,5,1,2,4,2,4,2,3,3,1,7,4,4,8,24,1,2,4,2,3,3,2,2,5,14,6,2,3,0,1,1,13,3,3,4,7,3,4,9,2,3,8,0,6,5,8,0,5,1,3,7,8,7,6,30,4,6,1,2,2,0,4,0,2,1,2
commend,3,7,6,155,5,1,1,4,1,1,10,9,5,26,4,1,1,6,1,0,2,14,1,8,12,3,2,7,2,3,9,70,47,7,17,9,7,4,6,3,4,0,1,1,14,5,14,4,68,3,8,0,10,10,1,1,21,56,0,4,12,0,4,6,6,2,48,3,1,3,4,2,2,1,24,5,4,2,24,4,19,0,3,1,49,6,4,0,16,1,0,4,0,5,29,7,7,9,12,10,4,11,10,0,5,10,5,1,6,1,1,2,2,10,0,9,1,0,22,64,14,2,28,38,3,0,0,0,0,0,4,1,0,28,6,17,1,3,0,1,2,6,9,3,0,18,3,9,10,5,10,2,4,4,1,16,5,2,3,3,4,1,3,1,1,1,0,10,13,2,5,28,6,0,0,1,58,4,2,13,8,1,3,7,2,1,12,5,21,9,0,3,2,0,0,1,13,2,3,2,9,3,3,3,8,6,1,30,3,10,46,0,7,2,1,0,0,1,12,1,1,6,6,6,21,53,13,5,3,4,10,5,7,3,14,14,5,5,0,3,29,10,1,2,4,3,6,6,18,0,10,7,6,7,6,5,4,2,2,7,1,7,8,1,1,60,10,0,1,7,53,3,13,4,5,0,12,15,10,5,13,3,1,9,3,1,3,11,6,1,1,2,8,2,3,2,14,9,1,4,5,26,0,2,1,0,5,2,3,0,0,7,11,1,14,13,10,11,7,3,9,8,5,2,19,4,3,1,0,5,2,6,1,6,2,9,9,2,2,4,1,2,8,2,5,1,13,15,6,3,9,9,2,11,9,10,4,0,4,7,11,6,3,10,2,1,9,2,5,5,10,5,2,1,2,34,11,0,3,5,21,2,20,9,0,19,1,9,6,0,9,0,5,10,18,3,47,9,11,0,12,1,2,0,0,4,3,1,11,3,0,4,0,25,1,0,0,0,1,0,1,1,6,1,0,3,1,2,5,4,2,2,1,10,1,0,0,2,5,3,5,6,2,1,0,2,2,2,13,1,7,2,1,0,15,6,2,4,1,6,6,8,12,13,5,0,6,4,3,0,11,0,1,3,2,6,1,7,6,2,1,4,2,4,4,5,4,0,1,4,18,24,0,0,2,2,3,6,2,8,5,2,5,2,4,5,6,5,2,2,1,4,2,3,9,7,2,2,0,1,3,4,2,4,2,3,2,3,6,17,2,2,1,7,4,3,5,3,13,6,1,3,0,4,0,4,0,9,6,6,3,0,7,9,8,1,17,0,4,18,35,0,17,1,6,10,2,3,11,11,1,6,10,0,2,7,2,5,2,7,3,4,4,2,6,3,1,3,1,3,14,10,1,3,12,1,0,1,8,6,8,1,1,1,4,8,0,12,4,2,6,17,7,3,7,3,9,0,5,2,3,0,4,4,0,8,7,11,7,20,1,32,6,5,4,0,4,6,4,5,7,1,8,7,4,58,2,5,2,35,9,3,2,5,0,2,9,8,1,5,1,1,9,4,3,2,2,2,3,3,15,3,6,28,9,2,1,8,7,4,6,4,2,10,7,6,2,1,2,2,4,2,3,9,3,5,3,2,6,11,0,1,7,1,7,3,5,2,3,5,2,3,0,12,8,16,4,0,0,12,3,1,1,21,2,3,2,1,5,4,2,8,1,1,4,3,31,0,13,5,4,1,4,6,5,0,2,2,0,9,3,2,2,10,3,5,4,13,9,2,2,5,2,2,5,6,12,4,12,9,1,2,0,2,4,4,5,1,14,4,0,1,3,0,7,3,2,3,2,8,4,29,14,4,3,6,5,16,1,7,1,3,1,0,0,1,2,1,8,1,0,0,1,2,6,4,3,2,2,4,0,3,0,10,4,0,2,10,0,1,3,2,8,1,2,3,7,6,4,7,1,6,6,2,0,3,1,0,30,6,3,9,1,2,2,0,6,3,1,0,2,4,3,2,2,5,2,6,2,26,5,2,2,6,1,0,0,2,15,2,1,3,3,1,14,2,3,4,1,3,3,7,0,3,1,1,2,1,4,0,2,5,1,6,1,0,2,0,0,9,1,0,6,3,4,0,0,1,2,4,1,1,1,1,2,2,0,0,3,2,4,7,2,3,4,1,3,2,2,10,4,9,4,0,1,1,2,5,13,2,4,1,5,0,6,1,1,3,6,1,2,2,1,3,0,4,18,1,3,2,0,0,0,1,1,2,1,0,2,3,9,5,1,1,1,7,5,2,2,0,0,2,6,0,0,9,0,3,2,0
the last session,8,9,4,321,4,0,4,29,8,4,11,8,8,18,8,4,3,5,0,0,8,29,3,10,21,6,4,17,2,11,6,165,67,5,37,17,17,3,1,3,5,3,5,4,24,18,29,8,207,14,19,1,4,8,0,1,44,53,0,17,18,6,1,19,25,1,29,6,10,14,15,11,0,3,17,13,19,2,54,12,35,0,28,1,106,19,4,0,31,0,5,2,0,20,43,8,11,3,22,8,34,15,30,3,4,39,12,0,22,1,10,4,9,9,0,17,6,7,126,71,24,4,6,51,5,2,4,4,3,4,5,3,1,35,6,48,2,1,8,3,0,23,39,2,5,40,1,7,9,19,29,0,15,2,0,14,11,0,2,1,10,1,1,2,2,1,5,8,12,6,22,51,11,1,0,4,145,1,8,21,16,9,4,13,15,12,19,16,33,46,3,7,1,0,0,1,8,2,1,6,11,0,2,14,7,2,6,26,8,19,62,1,35,10,0,0,0,4,6,3,2,12,3,11,36,69,20,16,0,1,14,11,8,5,10,28,24,10,4,0,34,14,6,2,6,6,4,10,45,2,7,15,20,13,11,15,8,6,10,14,8,12,35,9,13,30,0,1,4,1,89,8,43,5,2,0,2,14,19,6,20,2,2,7,8,1,1,3,2,2,6,5,33,9,3,4,48,6,8,9,15,35,5,4,11,0,12,2,3,2,1,2,16,3,34,20,7,29,9,3,25,7,14,4,22,6,5,16,3,11,3,5,5,5,2,31,6,6,5,7,3,6,15,9,1,3,27,34,19,5,9,9,3,13,8,5,1,4,8,17,22,6,0,10,1,0,22,1,0,5,2,9,2,4,4,41,6,1,10,3,45,0,43,6,0,29,3,7,18,1,9,5,37,27,45,1,88,3,20,3,17,0,4,0,4,1,1,6,25,8,0,7,0,4,2,7,11,2,1,0,1,7,19,4,1,0,1,9,7,5,7,7,10,11,3,5,0,14,14,9,14,23,5,9,0,3,3,4,17,5,4,4,0,4,44,1,0,5,2,41,3,6,18,7,6,0,6,19,7,0,5,0,2,0,2,2,2,24,7,9,1,5,2,0,5,5,4,6,1,0,26,47,1,1,6,10,1,8,7,7,6,2,7,1,9,12,3,13,7,9,2,5,13,5,16,15,2,10,5,5,3,9,11,12,6,4,14,0,13,13,6,2,0,7,8,3,19,2,19,13,4,2,0,2,5,9,1,15,10,6,12,8,4,17,5,5,28,3,2,7,22,3,41,3,17,12,12,0,36,11,16,8,58,3,3,10,15,4,5,19,9,12,6,3,4,1,3,5,3,1,24,26,6,5,8,0,2,1,40,12,22,3,0,8,9,23,14,15,4,8,16,26,31,3,12,2,20,0,6,3,17,3,11,11,1,9,12,10,19,26,1,30,12,17,14,0,3,7,1,10,8,0,0,16,13,31,4,11,5,122,8,1,4,7,3,34,11,6,3,9,4,5,23,25,8,12,11,6,4,11,13,8,14,23,58,3,8,1,2,2,14,28,10,12,9,8,5,5,2,9,15,4,18,6,4,30,10,5,13,23,9,6,8,6,12,10,22,2,4,14,2,9,1,34,12,12,8,7,13,7,6,5,0,28,2,7,9,0,2,5,3,17,0,5,4,7,19,1,32,12,14,8,4,8,7,4,15,1,1,15,17,12,1,10,7,9,6,6,3,12,8,5,1,8,12,12,12,10,4,8,7,1,0,7,2,4,3,1,15,9,9,6,8,4,6,6,4,0,7,14,8,12,4,8,8,13,9,10,7,7,7,7,10,14,1,0,5,4,21,6,5,8,17,17,3,4,6,10,7,8,6,7,8,21,23,3,2,11,3,2,5,7,2,3,1,7,15,10,4,5,17,5,3,5,8,7,6,9,20,5,8,25,3,8,2,7,0,2,2,0,9,1,10,5,3,7,1,6,2,18,2,10,2,3,3,3,1,11,11,6,3,4,1,2,15,5,12,5,5,14,5,18,1,9,3,12,5,4,5,0,4,7,1,9,4,3,5,8,3,12,3,8,3,20,9,11,7,9,2,5,15,2,1,9,3,15,6,20,6,9,7,1,9,9,6,12,6,7,1,18,2,8,7,4,6,17,7,18,36,9,4,2,2,0,12,5,8,7,32,6,8,10,6,14,0,16,6,7,3,2,3,9,2,2,11,5,8,2,14,3,2,1,10,1,1,4,7,0,17,0,4,2,4,1,0,1,0,14,0,1
panama,16,20,4,57,1,4,1,0,0,0,73,0,16,27,0,0,4,3,2,0,2,7,1,17,14,7,0,5,6,1,5,103,36,1,30,35,16,4,1,0,3,6,12,2,8,12,19,5,312,27,12,2,1,35,0,2,26,19,1,10,19,3,0,13,4,1,48,2,8,17,20,5,1,2,24,5,11,8,38,13,26,0,3,4,156,11,10,0,42,1,6,0,0,24,58,0,8,2,13,1,39,9,11,4,5,8,2,5,17,12,17,1,3,9,3,6,19,5,34,69,22,18,10,91,10,2,1,3,2,0,4,1,3,12,6,35,1,4,12,2,0,11,13,1,7,48,5,9,3,5,27,5,7,1,0,4,12,1,24,4,12,0,1,10,0,1,1,16,2,4,72,56,9,2,1,1,58,1,0,26,11,14,1,9,0,10,13,10,42,51,5,3,3,0,3,5,6,2,12,3,2,1,1,7,29,2,4,3,9,12,37,2,25,0,0,0,11,0,2,11,8,10,2,8,25,15,25,9,8,21,6,24,7,19,16,10,17,2,0,0,17,6,12,4,6,4,3,20,16,0,4,5,5,5,2,2,11,5,1,12,5,39,9,11,3,20,0,0,5,1,56,0,26,0,2,3,27,19,7,0,11,0,0,4,2,0,3,3,0,3,26,6,2,5,8,3,11,2,4,2,25,7,8,15,4,0,10,1,2,3,3,3,12,2,16,15,4,11,3,1,24,3,11,0,56,4,3,8,0,13,1,5,5,3,5,29,2,6,1,23,3,8,4,12,3,8,17,21,4,2,4,0,9,27,22,5,1,1,5,29,2,4,2,8,1,0,14,2,1,5,3,7,0,1,2,13,2,0,7,1,23,26,25,13,1,29,3,21,6,0,2,1,5,18,14,3,8,1,40,4,13,0,3,0,1,1,4,6,11,4,3,11,1,6,8,2,5,3,1,1,2,10,8,10,0,2,2,3,12,26,7,23,0,35,5,2,0,5,5,0,12,22,7,2,3,2,21,1,18,6,19,2,1,2,13,2,0,1,4,13,3,8,6,10,2,4,6,16,3,1,23,4,0,0,0,5,0,4,18,1,2,4,2,1,2,4,4,3,4,8,44,14,3,1,3,1,2,8,1,1,2,0,2,1,25,0,0,1,1,0,0,1,6,1,6,3,1,5,0,1,4,50,0,23,3,5,12,0,4,14,2,0,1,11,2,2,2,2,19,2,0,1,0,0,3,2,100,2,4,10,1,0,1,21,2,2,12,2,1,7,4,6,22,4,4,2,2,3,24,17,5,0,7,3,5,2,0,3,3,26,0,6,7,5,0,1,5,0,4,0,13,11,0,1,6,0,0,1,138,5,9,1,4,12,5,3,1,3,1,1,9,12,9,9,18,4,4,3,2,0,4,2,0,17,7,1,9,1,2,8,3,4,7,7,0,1,5,10,1,11,2,0,1,10,4,32,2,14,1,269,18,9,1,0,8,5,9,6,11,32,1,3,17,2,10,16,7,4,4,5,5,3,12,1,5,4,7,2,1,3,192,17,2,2,9,1,22,2,3,5,7,4,5,24,9,13,9,5,10,7,5,6,1,2,0,4,4,4,0,3,2,40,8,14,10,15,20,4,2,5,2,6,3,5,0,1,2,1,1,7,1,8,3,2,0,3,24,4,42,1,2,5,16,8,11,1,7,4,0,3,2,11,6,59,22,5,1,1,2,14,10,6,14,11,12,0,32,0,0,2,3,2,3,9,13,8,2,1,0,3,0,3,5,0,13,8,0,0,2,6,2,0,3,5,31,6,24,2,2,1,4,2,6,0,2,4,0,2,12,5,2,13,13,15,1,7,0,2,1,3,2,1,5,3,1,1,0,8,0,4,3,1,0,2,1,4,4,8,16,0,0,0,0,3,0,12,2,10,1,3,6,16,5,0,1,4,7,3,2,2,1,0,1,1,0,2,6,2,5,3,1,0,18,0,2,0,0,1,4,0,1,13,6,1,3,3,6,0,0,3,50,9,0,1,0,62,1,1,4,0,6,0,2,3,1,37,18,10,2,9,0,1,6,9,2,18,6,6,2,2,0,4,5,4,1,8,0,17,2,2,0,3,1,11,3,0,1,2,0,7,1,3,12,4,5,11,1,37,23,1,5,7,0,7,3,6,8,15,14,0,0,2,0,11,1,23,0,0,1,8,0,10,5,0,1,3,0,3,6,4,24,3,0,0,1,10,1,1,2,0,0,1,0,1,0,5,0,2,0,3
acquire,4,13,1,60,6,5,5,31,1,1,10,8,6,48,9,3,4,8,4,1,2,28,0,13,12,5,7,5,10,3,3,103,77,3,28,32,37,20,10,3,1,5,1,0,16,6,11,4,180,9,28,5,9,24,0,2,21,16,0,11,15,4,2,5,8,1,63,4,1,9,13,2,4,2,37,9,11,1,61,8,20,1,13,7,99,13,12,0,13,1,2,0,0,25,26,3,18,4,16,6,13,19,23,6,8,18,2,3,20,8,7,0,1,9,1,16,1,1,23,99,24,8,5,29,3,3,1,2,1,0,14,3,7,24,12,22,3,0,3,3,2,14,19,9,5,32,5,13,16,14,31,0,5,5,5,4,11,1,8,6,4,11,2,1,3,5,6,5,13,4,19,41,14,6,0,2,84,2,1,12,16,12,1,5,0,10,17,20,23,25,2,7,3,0,2,1,14,3,5,4,5,0,0,7,18,4,11,23,5,14,39,2,10,5,0,0,0,0,6,3,2,15,1,13,15,53,12,12,7,2,11,23,1,11,24,8,21,6,6,5,37,23,5,2,9,0,1,5,23,4,4,7,8,3,15,6,6,0,6,9,1,14,5,3,2,15,10,1,10,1,76,2,10,2,2,0,9,4,5,1,48,5,0,13,10,6,2,9,3,0,1,2,1,2,1,3,12,1,6,11,14,20,1,0,4,0,14,1,6,2,0,19,8,2,19,9,7,21,11,0,19,5,19,8,48,6,3,14,1,22,1,5,2,1,4,6,10,7,1,10,5,5,6,7,11,3,24,40,9,1,13,7,3,29,14,1,3,3,12,13,9,4,12,13,6,0,14,5,3,14,0,5,4,3,6,14,4,4,6,7,55,3,25,3,3,60,3,9,17,5,18,3,8,9,19,2,26,3,13,0,14,2,0,0,6,9,3,5,20,10,2,16,3,7,21,12,3,2,3,1,6,8,7,4,1,3,1,6,9,8,1,6,4,4,2,2,0,6,8,3,5,13,2,7,3,4,7,2,19,0,2,8,3,6,36,5,0,4,3,18,2,12,25,11,2,9,14,12,6,0,6,2,3,6,4,12,4,4,14,11,9,3,2,5,4,5,6,1,9,4,36,19,1,5,4,15,1,10,3,6,20,4,3,0,12,1,8,7,6,9,0,3,6,0,15,7,3,8,9,4,3,30,4,12,6,2,14,7,12,21,6,6,1,4,2,3,5,4,31,11,2,0,0,4,6,9,0,7,5,2,10,2,7,31,5,7,10,3,4,4,14,3,11,0,9,12,9,2,25,18,13,4,15,0,8,3,4,3,5,15,5,2,8,9,6,3,6,8,7,3,15,22,8,2,11,5,2,7,47,10,11,2,5,3,3,13,2,8,2,6,22,14,5,6,14,10,18,5,7,5,13,1,1,2,4,3,6,4,4,25,2,8,13,15,9,2,4,10,0,9,4,2,3,16,4,8,2,1,2,111,50,5,10,1,2,5,30,7,3,11,4,9,5,10,5,1,1,6,12,3,12,3,39,9,7,5,4,2,3,1,7,14,9,12,5,4,4,1,15,17,8,4,5,17,7,7,8,3,4,6,2,2,5,7,3,5,7,4,4,2,6,4,1,16,16,10,4,3,5,4,5,2,3,15,1,8,4,2,3,4,1,14,8,4,9,1,2,2,73,15,13,9,4,6,12,2,5,2,4,3,6,1,1,4,0,5,4,6,5,7,7,8,2,2,18,6,8,10,9,7,3,7,1,9,3,7,1,5,7,12,7,3,6,8,1,5,6,27,9,3,2,6,4,4,2,9,0,5,0,5,2,3,8,0,3,0,4,3,12,1,3,6,3,3,1,4,0,2,3,13,1,2,1,5,9,6,1,6,2,4,5,5,11,1,3,8,4,16,11,7,3,4,1,2,3,1,8,1,4,4,18,11,4,5,3,2,2,5,6,0,7,0,5,2,2,6,3,6,11,9,1,2,2,1,3,2,2,9,7,3,0,5,3,3,5,1,2,3,4,7,5,5,1,2,2,5,7,3,5,1,1,3,7,6,6,0,3,2,0,17,2,1,6,9,5,1,0,5,4,2,2,4,2,2,2,4,7,6,1,0,5,1,5,11,2,3,6,3,1,7,5,6,2,1,1,6,2,19,13,3,4,2,2,2,8,4,25,7,8,7,21,12,1,3,0,7,7,1,1,11,7,1,6,1,1,7,3,1,4,2,0,6,3,1,8,2,7,2,27,1,11,2,0,0,0,0,0,3,3,0
canal,5,31,5,145,2,8,7,10,3,0,29,8,21,33,1,1,13,7,4,0,2,14,6,16,18,7,7,28,5,10,2,196,62,5,28,43,12,3,6,1,17,4,8,5,25,8,25,11,250,28,28,3,9,43,0,0,19,49,4,31,14,3,3,30,15,1,34,5,10,22,15,21,3,3,49,2,20,4,49,15,53,0,5,5,170,19,20,0,47,0,6,1,0,26,40,1,17,2,30,2,106,11,7,8,6,11,3,18,15,10,19,3,3,14,4,7,4,11,90,86,27,24,4,100,11,3,1,2,6,0,15,6,4,18,12,106,0,5,18,3,1,18,17,0,3,36,1,12,8,9,40,2,4,9,4,7,17,3,8,13,44,0,1,6,0,8,1,11,2,5,30,55,9,1,8,3,113,3,2,38,27,2,4,17,27,10,21,7,43,77,1,1,2,1,5,4,34,11,8,8,4,2,1,8,31,12,4,7,10,23,57,5,36,0,2,1,11,1,5,14,8,9,4,22,19,13,27,14,10,19,6,24,5,55,20,16,11,3,2,2,44,15,2,2,4,5,3,15,39,2,3,4,10,4,18,25,4,1,1,12,6,15,18,5,4,19,2,8,8,5,99,2,38,1,4,1,12,21,3,1,33,0,1,4,7,2,7,1,2,6,15,14,14,5,15,6,18,1,10,9,12,15,13,4,1,1,9,15,0,14,7,6,23,3,36,20,18,23,5,6,8,3,12,1,60,8,13,19,0,35,3,9,2,7,3,32,9,2,1,13,6,10,3,23,3,18,19,53,17,3,8,4,7,45,24,5,1,2,8,32,16,10,5,5,9,1,19,4,3,8,4,13,5,6,3,11,2,1,8,0,59,15,47,13,3,21,2,14,6,0,7,3,9,20,51,7,36,6,26,3,17,10,12,2,1,3,7,2,30,16,5,16,2,9,7,5,7,15,3,5,0,3,16,9,0,4,3,10,8,17,7,14,15,23,5,4,1,21,6,3,17,16,13,5,1,9,63,2,31,12,14,1,7,8,61,3,3,5,3,21,11,19,6,9,1,3,7,15,41,1,13,1,4,0,1,4,2,3,32,5,0,10,3,2,4,9,9,3,1,3,34,27,2,2,5,5,10,20,1,1,1,1,4,2,35,5,1,1,11,1,1,0,8,8,4,10,1,16,0,9,1,21,5,18,8,5,17,7,5,18,7,1,1,2,8,7,11,5,17,9,1,2,1,0,4,2,22,13,3,11,5,8,1,53,6,16,26,11,2,6,21,13,22,8,18,6,6,2,21,49,7,0,23,3,6,12,0,8,15,38,0,7,10,4,0,1,2,4,3,12,11,24,3,2,20,0,1,1,83,8,16,1,2,6,7,17,4,17,7,1,22,41,21,14,12,10,15,14,1,3,12,2,5,24,4,0,11,5,7,18,4,8,11,6,3,3,10,15,1,14,1,1,4,18,7,30,2,10,5,170,21,11,5,5,10,17,16,12,4,11,0,10,21,23,5,13,0,4,5,6,9,19,10,5,1,4,6,14,192,7,1,19,8,10,12,2,8,6,1,34,19,11,12,36,9,58,6,3,16,13,3,4,5,4,6,7,7,4,0,5,5,24,7,8,14,8,10,3,1,4,10,1,0,20,1,5,1,1,4,4,3,15,5,5,1,5,21,6,39,6,3,3,29,27,18,3,9,15,0,3,2,13,7,41,21,16,3,8,2,18,15,18,5,18,16,8,22,1,1,5,9,7,4,1,19,8,4,7,0,1,0,3,4,6,6,7,0,1,9,12,5,6,9,3,12,29,22,5,5,1,4,6,10,10,8,8,1,3,28,7,3,11,11,7,0,6,6,4,2,5,3,6,1,19,88,11,1,20,1,6,4,3,2,4,7,4,4,7,9,2,4,2,4,1,1,17,4,12,1,1,11,28,0,9,0,5,4,6,1,1,5,0,0,0,2,0,1,5,2,7,0,3,30,0,5,0,0,0,10,0,4,15,16,1,7,7,6,1,6,3,34,83,0,2,0,36,5,2,4,2,13,0,5,2,1,16,57,10,1,14,0,3,9,10,4,13,5,7,2,2,5,8,6,4,0,6,7,3,4,2,1,5,0,13,2,1,7,1,4,33,0,10,14,5,9,19,12,58,33,1,19,3,3,10,11,3,8,29,27,3,4,15,2,7,0,8,0,0,5,13,0,4,2,6,0,7,2,3,38,1,2,3,8,0,4,7,0,4,1,1,0,2,1,2,0,4,0,8,1,3
carry,20,51,16,388,28,16,13,60,7,7,34,29,39,148,12,15,12,44,16,8,15,85,24,51,49,27,26,30,20,43,27,429,311,34,107,146,103,23,31,9,19,20,13,15,77,43,69,48,626,84,102,14,38,92,22,13,115,74,11,50,32,17,7,36,44,11,224,13,21,59,36,23,17,10,173,49,63,22,166,55,131,4,33,19,432,47,57,0,104,8,37,16,2,47,83,46,35,22,69,50,43,68,87,24,37,68,20,7,40,14,43,19,28,39,5,62,8,6,185,336,107,55,21,149,23,18,9,15,14,5,37,8,12,109,36,141,11,6,19,23,9,96,73,19,6,165,19,36,50,37,167,8,40,24,17,67,94,12,17,27,86,14,16,8,10,16,15,59,47,23,64,194,39,12,17,18,355,10,30,81,58,29,31,50,13,62,77,62,92,126,4,12,24,4,5,13,75,22,16,27,77,12,6,23,62,21,14,76,20,85,176,22,73,23,3,5,9,7,30,9,13,31,7,29,109,238,67,57,25,29,35,54,31,58,74,37,76,26,24,18,160,91,21,11,37,12,16,44,118,14,43,58,53,13,26,44,17,6,11,45,11,64,60,15,11,151,23,15,34,9,280,21,93,15,15,4,52,47,28,14,151,36,8,46,33,8,8,19,28,9,18,9,56,18,23,21,103,18,12,36,47,92,9,14,26,3,48,8,10,5,8,56,85,12,105,29,52,99,26,13,108,21,90,10,132,26,23,79,9,50,15,27,23,19,16,37,41,20,13,32,18,22,40,27,17,27,72,131,41,12,24,21,19,81,53,33,11,19,34,66,71,27,29,31,17,6,106,13,22,40,11,46,9,28,22,91,27,15,41,16,141,8,141,22,17,74,28,48,66,14,48,54,40,32,76,23,142,12,94,13,60,6,10,6,11,13,15,17,154,38,3,44,31,42,33,31,18,22,18,14,9,13,41,27,5,16,8,28,26,34,17,26,13,38,15,18,6,32,18,14,50,54,21,34,6,17,58,11,82,20,39,7,13,25,150,15,7,25,27,175,35,50,68,68,8,7,38,32,35,4,50,14,20,8,6,24,12,29,39,14,19,24,17,8,25,36,21,11,17,7,193,84,4,10,26,10,16,32,13,22,27,12,5,3,26,37,24,30,40,21,9,16,31,25,41,44,20,18,14,29,10,51,23,41,19,12,44,29,41,62,20,16,23,27,34,15,32,37,76,51,21,7,11,20,37,42,14,29,32,8,89,22,6,99,18,17,127,16,22,24,53,8,83,18,35,36,45,25,93,74,24,20,67,10,17,14,28,13,12,48,18,45,38,22,30,11,18,19,18,22,63,57,26,20,59,19,13,12,141,41,58,13,16,19,11,59,14,51,34,17,57,61,36,10,70,24,57,8,24,14,28,7,14,36,6,23,23,34,23,81,19,50,43,59,16,9,24,23,10,32,31,5,13,55,34,75,25,24,22,369,79,17,18,10,22,41,101,12,19,35,17,14,59,55,25,15,7,22,21,35,35,31,61,60,62,18,4,28,17,14,19,1,33,31,23,14,22,16,8,59,37,39,29,52,25,38,12,10,31,30,49,18,14,15,29,20,52,17,8,12,3,24,15,70,43,60,28,15,16,21,26,13,15,47,9,42,20,7,10,35,13,36,9,17,16,20,92,21,64,11,29,32,20,67,45,17,34,50,10,26,18,17,26,35,21,36,15,37,21,40,37,23,9,14,42,36,41,11,23,19,17,8,9,21,13,40,20,12,37,34,19,10,31,12,31,23,15,11,17,27,17,26,18,10,46,46,45,19,11,8,17,12,21,16,14,11,25,13,43,10,32,15,53,30,25,13,10,33,9,23,17,8,10,37,16,13,15,28,10,4,19,15,17,10,20,16,18,64,18,12,13,18,13,39,24,46,18,45,12,29,53,60,20,14,11,10,28,19,19,5,19,10,21,16,11,10,12,9,22,44,17,5,8,25,16,4,20,27,31,12,9,25,12,7,25,10,15,19,10,20,13,56,1,15,17,21,13,19,28,14,21,17,13,15,16,13,10,35,12,49,17,25,21,31,26,17,12,45,7,12,19,18,23,24,6,45,12,35,14,8,12,17,16,14,15,13,18,20,10,42,5,24,25,6,23,35,22,45,46,20,24,14,6,13,23,17,20,23,46,13,7,27,17,40,8,127,8,3,21,26,20,22,17,17,18,20,5,12,18,15,107,17,13,9,9,9,24,16,50,2,10,16,14,10,4,3,3,15,7,9
circumstance,14,34,11,136,15,2,10,44,3,0,31,4,5,79,2,4,8,14,9,6,7,51,1,24,27,5,8,9,6,12,19,215,124,3,52,84,83,5,6,10,2,5,7,2,35,31,23,14,368,14,72,9,11,21,10,12,79,33,2,18,34,19,3,14,26,17,74,7,15,11,17,7,5,4,71,11,7,12,91,27,37,0,13,5,238,18,15,0,48,1,13,8,0,36,70,6,20,2,41,15,10,34,48,12,15,47,7,3,14,9,11,6,9,9,1,38,9,6,93,202,59,20,4,64,2,7,5,15,4,2,13,1,4,45,25,36,22,5,3,16,4,47,37,1,5,85,5,14,19,14,79,0,24,10,0,29,37,1,8,6,10,7,15,3,1,2,1,22,9,20,19,98,22,1,1,15,169,4,18,32,27,24,0,12,1,22,38,46,72,68,1,8,2,1,1,3,10,6,7,25,19,1,1,21,33,11,5,28,18,29,73,2,21,4,3,0,1,2,7,1,2,27,11,17,73,103,27,31,7,9,15,6,14,20,37,21,41,8,6,10,89,43,2,6,10,3,11,34,35,5,5,25,26,6,19,25,35,3,12,9,1,40,33,5,6,41,3,2,13,6,173,9,37,12,8,0,22,8,18,5,77,8,3,15,13,0,3,9,26,0,3,3,10,3,5,13,72,4,6,27,29,35,3,5,23,1,38,5,9,3,1,11,23,7,33,19,6,54,12,5,68,10,34,2,90,6,8,27,8,25,3,15,14,3,16,15,22,15,3,19,11,17,23,12,8,3,69,64,16,2,16,13,13,27,33,3,6,7,16,22,6,8,8,25,12,1,62,9,5,20,4,10,4,13,15,28,12,1,19,8,80,3,56,14,2,20,8,21,35,20,31,5,11,14,44,8,87,4,60,8,28,4,3,3,4,3,9,5,34,15,5,12,5,18,20,24,10,13,7,1,3,11,20,16,6,5,4,29,26,14,17,6,2,16,9,12,0,18,12,2,18,27,12,9,1,4,5,13,42,4,15,13,3,6,60,23,0,10,10,35,13,20,43,34,4,4,16,11,17,2,16,5,5,4,4,16,5,22,17,2,7,22,10,8,12,12,15,0,11,8,94,44,4,8,12,10,3,24,18,10,17,6,6,1,13,39,0,17,8,8,3,10,10,8,22,45,3,18,11,9,2,24,10,27,9,6,33,6,27,39,8,6,8,4,9,15,16,15,55,19,11,0,4,2,3,14,6,22,31,9,34,12,4,54,18,16,37,6,10,5,37,11,24,4,26,18,19,17,39,34,15,10,15,6,5,7,7,8,13,14,12,15,19,20,12,9,8,7,4,10,30,62,13,9,34,4,2,0,63,25,26,2,9,22,4,28,8,38,6,8,41,8,11,10,66,8,28,0,12,14,24,12,7,23,2,4,13,11,25,29,12,31,46,43,7,2,8,7,2,17,10,2,10,22,10,25,4,6,3,235,28,10,10,2,7,14,49,16,16,18,6,9,18,23,12,14,3,12,18,20,23,12,76,14,44,11,2,10,2,9,8,33,1,6,7,16,15,7,4,17,12,7,26,10,12,7,10,13,9,28,8,6,9,10,7,10,33,9,2,7,8,11,11,44,19,39,23,14,7,9,20,14,11,43,8,4,5,1,1,13,7,19,4,2,10,5,13,8,60,9,14,5,4,10,13,7,15,4,6,16,14,8,2,6,2,19,12,16,1,17,12,15,3,4,25,12,20,10,7,20,7,8,2,25,4,20,15,5,21,22,7,4,26,9,7,14,3,32,11,24,7,10,5,10,9,19,7,8,7,3,5,11,22,8,7,8,10,14,17,11,11,7,22,8,7,14,4,11,6,15,13,2,5,13,14,5,3,6,8,5,3,9,11,7,4,10,19,36,13,12,22,19,4,11,13,7,10,13,10,19,37,48,6,10,5,11,13,8,12,2,14,9,17,2,8,16,4,3,11,5,1,4,12,12,2,5,9,18,13,0,2,6,3,6,5,3,12,8,9,6,5,10,0,7,11,8,4,8,3,4,6,15,3,26,8,9,5,9,7,40,4,4,7,15,12,8,3,21,5,11,23,16,4,8,4,17,4,32,7,8,6,0,17,17,8,2,3,13,7,3,6,12,5,2,10,22,12,12,25,16,1,10,4,8,6,6,2,4,26,17,3,5,4,5,0,39,7,3,4,8,8,10,6,1,14,10,1,8,17,13,6,11,15,6,9,3,14,1,37,1,6,3,9,2,0,3,1,13,2,1
importance,7,16,4,136,9,1,5,24,9,4,19,11,15,47,9,3,4,11,5,0,17,37,2,16,26,10,10,9,5,15,9,127,98,10,33,42,30,9,8,1,5,3,1,4,23,10,16,15,209,16,16,4,14,26,6,2,53,43,0,14,21,8,2,16,10,4,41,4,6,28,1,8,3,4,61,15,8,5,52,14,71,0,16,3,159,13,11,1,34,0,4,5,0,20,37,19,10,5,19,9,6,33,24,6,11,31,9,2,12,0,16,0,8,3,0,19,4,4,53,78,29,12,3,39,6,0,6,3,2,0,13,6,5,50,10,41,1,2,5,5,1,17,18,5,1,50,8,15,7,11,33,1,12,16,9,15,19,6,6,9,14,3,2,4,1,6,5,12,27,5,26,50,20,6,1,7,145,6,10,31,15,12,2,11,4,12,27,22,43,51,4,6,6,0,0,7,11,10,7,8,11,0,3,10,16,4,4,16,10,28,47,4,8,5,0,0,0,0,14,4,3,9,6,16,33,74,29,17,7,8,11,11,17,15,32,18,15,11,9,4,38,27,11,2,9,4,1,16,38,3,31,9,19,4,7,11,8,1,4,16,3,18,32,6,7,59,7,3,11,8,97,6,11,5,8,1,12,22,14,2,37,3,4,10,9,7,4,2,12,1,5,3,13,3,3,7,28,8,6,14,19,43,1,3,6,1,19,7,8,2,8,24,26,4,16,11,11,30,17,4,28,5,13,3,24,6,10,13,3,12,2,9,7,5,8,1,21,7,2,9,8,9,12,6,8,12,33,43,8,4,9,8,5,29,11,9,0,4,8,20,18,22,21,10,6,0,19,3,4,6,11,15,9,4,12,28,12,3,12,11,52,2,34,10,0,25,0,12,16,2,12,4,13,14,46,8,82,4,21,2,17,2,7,0,11,5,2,7,29,14,5,12,7,23,6,11,4,9,0,4,5,12,20,13,0,4,5,10,9,11,5,6,6,4,3,1,0,21,5,1,13,22,14,7,6,6,10,1,23,9,10,1,1,3,63,5,0,5,9,23,9,15,20,21,8,5,12,19,9,1,15,0,1,0,0,15,1,22,24,5,8,9,4,3,10,8,12,2,9,3,40,35,1,2,8,10,5,8,4,3,18,4,3,1,9,3,8,9,3,0,2,4,5,4,11,13,6,4,2,5,9,12,3,14,3,3,12,3,11,28,14,4,2,6,16,6,13,3,41,13,4,3,0,5,11,10,1,13,14,13,16,1,3,42,10,7,37,2,5,19,34,7,19,1,7,23,15,5,24,38,7,17,30,2,10,3,13,6,4,7,10,10,19,11,7,8,7,8,4,12,17,24,7,3,17,3,9,2,25,12,18,3,4,0,5,25,4,23,8,4,17,26,17,13,19,8,19,5,8,12,16,4,9,10,4,6,16,10,11,29,4,53,14,16,9,2,5,7,5,2,13,1,14,23,9,41,3,1,4,135,24,8,7,3,7,9,14,12,2,15,5,8,17,26,2,2,5,8,15,8,16,7,24,23,17,4,10,12,2,12,10,31,6,1,23,10,7,6,8,17,10,10,10,24,5,9,2,1,9,15,14,6,7,6,14,10,17,4,0,7,3,11,1,18,19,29,2,8,3,14,8,2,2,16,2,9,7,3,10,4,6,13,0,3,6,13,30,7,34,15,8,10,6,11,19,3,12,9,1,5,11,4,4,8,4,9,1,17,9,7,4,6,0,5,16,21,12,10,5,9,5,7,4,10,5,15,4,4,9,10,7,7,11,3,7,6,10,11,5,7,7,8,7,4,10,9,3,6,3,9,3,7,5,7,0,1,3,10,22,2,1,7,7,9,3,8,6,8,0,4,5,3,12,19,10,6,5,5,4,5,11,6,5,1,3,10,14,15,3,10,6,6,6,9,3,8,6,7,6,8,11,16,5,3,12,5,9,3,3,3,11,3,4,3,2,8,1,7,3,24,3,5,5,3,4,2,3,8,7,13,1,5,1,1,8,2,7,4,6,5,3,17,1,1,1,3,3,2,3,3,9,5,8,4,5,2,9,2,8,24,3,1,3,6,8,6,6,10,2,6,3,7,7,5,3,7,9,14,10,2,11,2,3,16,4,2,7,3,4,14,2,6,9,0,1,6,7,21,23,4,11,0,0,3,6,4,9,8,16,6,4,16,4,6,2,19,4,1,0,11,4,2,1,4,6,6,0,10,14,8,15,5,2,5,11,2,4,3,7,0,4,3,7,0,0,7,0,6,1,3
invite,4,19,5,190,9,4,5,24,3,0,23,18,7,66,6,13,8,14,5,5,8,32,9,28,20,6,8,16,4,9,7,163,111,8,45,57,47,7,13,3,4,13,5,4,29,12,27,14,291,14,32,3,12,24,13,7,58,84,5,14,21,10,7,23,14,6,80,3,7,12,8,2,4,1,46,10,12,7,76,12,51,3,14,6,197,20,10,1,48,3,10,5,0,25,47,10,11,4,30,20,11,31,32,7,7,16,9,2,5,5,11,7,6,27,5,23,9,0,57,132,33,13,3,60,5,0,4,10,2,3,11,5,6,49,17,34,9,5,5,15,1,34,25,1,3,65,3,11,6,14,46,8,20,8,4,13,25,1,15,10,11,2,11,2,5,5,4,18,21,10,17,68,18,0,4,8,162,1,6,37,15,12,0,13,2,25,31,9,42,55,1,6,12,0,0,4,18,4,14,13,29,1,3,8,22,8,6,30,19,17,45,5,21,9,3,1,0,2,20,6,2,23,7,16,44,96,34,16,2,6,18,20,25,9,32,24,25,11,16,2,66,27,5,7,11,5,9,17,49,3,14,26,16,2,5,14,11,0,8,16,4,24,32,3,5,71,8,6,13,3,135,9,21,6,6,3,16,24,20,1,53,15,3,15,11,4,6,14,8,0,10,7,7,12,1,10,39,11,11,18,22,33,1,3,10,3,28,7,4,1,2,11,24,9,31,23,20,36,17,1,57,11,23,13,43,5,5,12,3,28,3,13,5,7,6,7,19,11,4,17,12,14,27,6,5,9,49,51,15,6,7,5,8,25,27,5,7,4,15,32,31,9,4,9,5,4,36,8,6,8,5,15,5,14,8,47,8,3,11,7,42,9,46,16,1,44,9,20,19,4,19,2,22,7,48,10,106,13,29,5,20,0,2,4,4,9,7,7,31,18,3,9,9,23,11,12,3,9,3,2,5,7,13,5,1,2,2,11,9,15,10,7,7,11,17,5,1,21,8,3,10,23,6,12,3,6,11,5,28,6,16,2,1,8,54,5,3,7,9,17,10,17,30,23,8,5,20,14,5,1,12,3,2,1,3,15,6,19,11,6,4,14,5,3,11,6,14,4,1,13,79,28,1,2,13,6,10,17,3,6,16,3,2,0,7,13,2,12,7,6,3,7,4,7,11,16,6,11,1,11,8,25,13,18,6,3,13,5,13,27,7,6,1,9,7,5,9,10,51,19,4,6,2,2,11,8,2,22,16,8,30,4,3,46,7,7,42,1,4,23,29,1,26,6,14,39,10,9,38,30,6,10,19,6,4,10,17,7,4,11,13,21,10,9,10,3,8,6,4,10,21,32,10,2,11,7,2,3,50,19,24,3,4,2,6,16,6,28,10,5,22,27,17,9,21,9,17,9,5,10,18,14,4,22,2,6,11,14,14,34,13,158,22,17,7,4,7,5,2,9,14,1,0,25,4,94,4,5,5,180,22,6,10,5,3,7,33,12,8,16,7,10,26,20,8,5,8,16,10,9,20,10,47,15,28,5,7,9,9,5,12,23,7,23,1,7,7,7,4,11,26,9,15,17,4,15,11,5,12,11,20,2,9,3,12,18,14,8,6,8,3,19,7,28,15,29,8,5,21,5,9,3,12,37,6,9,8,2,2,12,11,18,5,7,8,5,43,8,37,8,6,9,17,16,18,6,13,5,6,5,16,5,3,13,9,17,6,28,10,7,6,8,9,7,23,13,17,11,5,19,2,3,1,13,5,15,3,5,15,12,8,2,14,0,12,13,10,31,6,10,13,17,8,4,10,16,1,19,5,11,5,7,9,7,4,3,8,4,14,10,5,2,13,7,5,4,5,15,8,10,11,3,23,30,6,4,4,13,18,1,10,14,18,5,8,10,15,27,8,4,10,8,3,5,4,16,4,4,17,9,20,22,8,5,1,6,11,9,6,3,12,3,8,6,2,7,5,6,8,41,4,3,11,18,1,5,10,14,16,10,3,7,2,10,22,6,9,15,8,5,3,7,1,2,7,11,6,4,4,4,6,6,2,8,8,6,7,9,8,38,4,3,8,6,17,4,4,9,2,5,7,10,11,18,4,8,10,21,4,5,12,9,7,11,1,6,8,7,13,17,3,12,9,1,1,17,13,19,45,3,8,4,3,7,7,7,2,6,15,8,8,4,2,9,3,28,22,1,0,11,6,5,1,10,4,9,0,7,10,8,8,10,6,11,10,5,8,3,17,3,3,6,8,0,1,2,0,10,2,0
discharge,3,27,11,125,16,2,5,25,3,1,15,4,6,52,6,6,4,9,4,2,9,32,3,22,18,5,10,7,7,11,9,126,107,22,45,38,39,5,4,6,13,4,6,0,16,21,14,16,194,4,26,0,10,20,2,5,137,28,0,6,14,6,2,15,12,7,68,8,3,7,44,6,2,2,42,5,13,7,42,10,32,1,14,3,168,11,8,0,30,12,8,6,0,34,68,6,8,4,32,7,7,24,23,9,6,33,8,3,15,5,19,1,12,7,1,17,7,4,65,90,32,8,3,94,2,5,2,1,3,1,8,2,6,41,17,29,5,1,5,2,4,13,19,1,0,27,4,16,8,17,50,1,18,11,3,23,11,6,5,3,3,3,9,4,0,1,1,7,27,5,14,56,7,0,1,10,169,5,11,8,15,14,0,8,0,12,20,26,10,31,0,2,0,0,0,9,8,3,7,7,11,3,0,7,29,14,2,21,6,18,43,1,14,11,0,0,0,0,30,3,9,14,4,14,53,88,19,15,1,3,9,10,18,11,30,36,31,0,3,5,72,30,4,2,10,10,3,13,45,5,6,8,10,21,8,10,12,6,8,14,5,19,18,1,4,59,3,5,12,8,141,9,49,6,3,0,19,25,8,2,39,5,1,13,5,0,5,10,13,0,4,0,13,8,4,7,43,6,6,7,17,35,2,5,10,1,13,4,5,1,5,4,34,5,45,19,12,20,6,1,51,11,9,2,27,1,5,20,5,30,8,11,10,6,3,11,2,7,8,14,17,5,11,5,11,3,44,37,10,6,23,14,9,18,15,2,5,5,14,15,12,6,4,13,5,1,31,7,2,7,3,16,0,3,6,63,10,1,9,14,65,2,46,7,2,8,2,21,23,6,20,0,10,3,30,12,42,4,22,6,14,2,2,2,11,7,4,1,7,10,1,3,2,8,3,9,2,1,2,2,4,12,10,10,0,6,2,14,14,15,8,25,12,15,0,6,0,7,9,7,9,14,10,0,0,0,3,6,19,13,10,4,0,5,35,9,3,6,5,25,3,14,27,34,12,6,6,6,6,0,16,0,0,3,3,5,3,15,13,6,2,7,1,6,9,9,7,1,4,7,66,37,4,3,8,5,8,34,17,4,11,2,2,1,0,13,0,11,6,4,2,6,7,7,16,20,2,8,0,7,1,10,3,22,5,4,14,4,9,23,6,7,4,10,11,4,10,7,44,23,4,7,0,0,1,7,2,13,17,7,49,8,3,43,7,12,17,2,4,4,20,3,29,5,18,17,11,3,24,32,7,13,26,4,3,1,14,10,6,13,2,24,8,5,6,2,4,9,3,5,14,24,4,3,25,0,3,1,26,7,10,0,0,0,3,13,5,34,4,3,27,15,14,1,30,10,26,0,15,8,11,2,4,8,1,7,7,12,13,13,6,28,13,18,10,2,4,2,5,10,5,2,9,12,6,27,6,4,6,93,13,3,8,7,5,9,26,9,2,19,3,2,8,11,3,4,1,1,10,11,28,14,23,35,29,4,6,8,1,4,2,14,16,10,7,1,38,8,0,10,19,7,20,1,13,15,8,3,19,25,1,3,5,1,8,7,9,7,4,9,8,6,7,23,9,31,15,6,11,12,15,4,3,55,3,1,3,3,1,4,6,19,4,3,3,3,17,7,4,6,4,3,4,7,4,1,14,4,12,11,6,19,1,6,3,13,5,11,4,8,7,8,2,0,15,7,6,6,1,9,7,2,1,15,11,16,4,7,6,6,4,6,10,10,2,5,1,4,5,18,7,5,1,10,1,13,0,10,4,11,2,5,7,7,5,3,11,5,10,7,10,2,5,10,1,7,3,4,4,8,6,3,8,24,7,5,4,8,2,6,7,6,12,8,6,12,13,16,7,12,11,11,7,16,4,13,6,5,3,12,16,29,7,6,0,7,6,4,10,1,4,7,11,2,5,10,6,5,2,5,7,0,4,2,3,5,4,7,10,1,5,3,2,4,4,5,6,4,3,12,2,6,0,3,1,18,4,0,4,0,5,5,4,14,11,4,1,4,10,16,8,17,5,32,12,9,4,8,6,2,8,6,5,4,2,13,0,15,2,5,8,2,9,5,6,0,7,9,4,12,0,16,6,32,7,44,47,31,60,5,2,4,5,5,4,18,1,2,23,8,0,1,10,5,3,6,2,8,5,1,2,9,1,4,4,3,2,6,9,2,0,2,9,4,6,7,12,2,6,2,3,3,8,0,1,5,0,3,1,0
obligation,4,29,9,126,19,7,3,33,2,1,43,4,4,120,5,8,7,19,6,6,9,37,10,19,17,15,29,15,7,20,17,196,154,21,76,99,56,5,3,4,16,15,4,4,37,31,22,20,389,31,61,4,24,56,5,10,97,20,5,12,42,16,6,8,18,14,131,8,6,12,13,2,8,5,116,17,13,9,89,35,55,3,21,8,358,29,12,6,34,5,11,9,1,34,93,7,27,8,37,11,7,29,30,17,16,28,10,7,15,6,16,9,8,21,2,37,6,4,65,190,33,27,20,60,4,6,16,8,7,1,18,3,7,49,26,32,14,1,8,7,5,39,28,3,3,76,5,20,12,22,87,2,21,8,0,37,34,5,18,13,5,1,10,5,14,10,0,17,18,14,23,92,32,3,11,15,203,5,21,37,20,14,8,13,2,26,28,20,49,61,1,6,2,3,4,7,12,7,11,19,27,4,5,14,49,27,11,26,9,40,75,12,31,7,3,1,2,6,17,8,4,18,5,16,73,115,29,36,7,22,5,9,16,12,53,23,42,9,5,17,75,24,5,6,21,11,8,35,43,8,9,24,26,8,9,14,12,3,6,16,5,41,23,2,6,27,5,13,27,8,174,24,39,4,6,3,33,18,11,1,95,6,0,27,5,0,14,15,23,1,1,6,22,8,3,19,59,7,9,34,31,34,2,7,18,5,45,0,7,0,2,16,55,7,68,21,21,49,16,9,79,13,37,2,97,11,6,30,3,35,13,15,20,3,9,16,18,10,14,13,14,8,16,37,6,6,58,76,25,9,28,16,4,33,25,5,5,9,9,29,23,7,15,26,4,2,49,5,12,13,6,31,7,23,7,20,13,5,23,9,69,10,51,16,5,17,10,32,26,7,40,3,12,11,43,20,58,3,24,5,25,3,4,8,6,4,12,8,21,14,8,21,3,25,17,14,14,8,3,7,5,16,22,16,0,5,2,11,14,21,29,5,4,19,4,5,2,12,14,5,16,24,14,7,2,2,18,9,38,9,26,24,10,12,48,8,7,15,7,26,16,24,36,19,2,17,21,8,5,0,18,2,5,6,3,11,7,8,22,11,7,21,8,11,10,8,13,7,3,6,94,45,4,15,19,5,4,34,13,12,9,8,0,3,1,47,0,12,5,7,4,10,6,0,10,18,7,6,1,13,6,25,10,34,14,5,30,19,17,35,9,10,4,12,17,10,9,17,49,20,4,5,4,2,4,11,8,27,16,14,63,14,12,39,4,11,26,4,9,12,28,1,23,6,28,27,12,13,43,39,8,7,18,13,5,5,7,8,7,18,3,8,11,14,10,14,7,7,3,9,30,50,7,2,17,7,3,5,95,21,22,6,7,4,6,30,5,22,9,9,27,12,7,10,36,8,19,1,10,8,6,9,1,38,3,4,6,6,19,25,80,19,38,30,8,2,9,8,3,8,10,3,8,6,13,24,7,5,7,228,21,6,7,10,13,13,62,36,12,23,6,10,24,19,8,4,3,7,12,11,16,7,47,15,43,13,2,5,22,4,8,22,15,7,7,38,1,12,1,2,13,19,24,15,8,5,19,8,31,18,15,6,4,6,12,3,21,4,3,3,9,9,13,23,9,10,8,10,7,6,8,3,4,14,5,2,9,1,2,8,10,16,7,9,9,1,10,10,51,3,9,4,0,5,15,12,15,3,7,4,18,13,5,7,6,16,14,5,7,28,20,14,4,6,15,22,7,5,2,12,12,2,1,24,8,25,18,3,11,16,3,3,23,5,9,6,8,8,14,12,9,7,2,7,8,12,1,4,5,6,6,4,24,7,10,4,10,12,26,6,7,5,11,6,6,6,12,9,7,18,7,3,5,2,3,7,6,9,16,8,12,1,13,8,11,13,15,20,17,8,4,5,0,10,9,35,9,11,5,10,32,34,25,5,1,4,5,5,20,6,11,7,1,1,7,11,4,9,12,7,7,2,26,41,12,4,3,11,13,12,9,3,4,5,8,3,7,7,8,6,16,2,0,8,11,11,8,0,5,5,12,6,4,23,9,8,1,14,8,27,8,9,15,15,18,2,2,2,4,5,10,1,8,11,4,8,6,14,6,4,4,5,7,6,9,3,4,3,13,5,3,18,11,9,10,46,54,16,39,5,0,4,4,4,6,5,5,7,17,4,0,2,8,1,3,15,2,3,2,4,3,32,9,13,5,3,7,14,15,7,3,5,9,37,7,19,12,7,34,4,8,4,7,2,2,3,2,4,2,4
assure,8,17,3,75,6,12,3,20,2,5,18,1,6,53,1,6,4,6,6,5,0,21,7,25,6,7,10,7,1,10,5,87,64,12,27,65,44,3,8,8,4,19,5,7,14,6,16,17,166,29,25,8,12,41,12,4,21,8,4,9,12,3,0,4,10,15,52,2,5,2,13,1,1,4,82,4,13,5,30,10,46,0,14,9,144,6,8,4,20,1,6,5,6,13,20,9,10,3,36,16,6,21,21,4,9,15,8,8,6,1,7,11,12,3,6,17,1,2,39,68,16,24,12,49,4,4,3,4,1,1,14,2,7,43,16,32,7,0,2,3,3,21,24,1,0,48,1,10,6,7,47,2,7,7,4,29,15,6,6,19,12,1,6,5,4,5,0,29,13,8,6,34,18,2,2,12,74,6,5,49,12,11,45,12,0,14,14,14,14,26,3,2,4,3,2,3,23,6,3,16,11,3,6,8,31,15,6,14,10,13,47,2,12,4,0,3,11,17,11,5,11,15,1,12,26,38,11,14,2,9,3,7,14,11,18,5,11,3,7,1,27,16,4,7,11,3,7,15,37,4,3,8,20,2,3,12,6,2,1,8,5,19,13,1,3,19,4,15,5,2,69,9,12,9,1,4,21,19,7,2,39,2,5,12,3,7,10,10,10,0,3,3,1,6,1,6,17,9,6,11,8,25,0,3,6,7,23,2,12,5,3,18,27,15,17,8,13,20,6,14,27,8,14,6,31,2,7,18,1,11,1,5,7,2,1,6,15,5,10,11,3,4,7,9,3,8,19,27,12,9,3,11,1,12,12,5,3,3,8,15,19,18,19,15,4,4,19,2,6,7,2,15,6,5,6,18,2,1,9,3,55,2,37,5,5,11,2,21,15,8,16,7,5,7,18,12,13,7,31,9,18,1,2,3,1,1,3,5,30,11,0,6,11,8,13,5,10,11,2,5,1,9,15,5,2,3,1,5,10,2,8,5,0,5,7,9,4,17,15,2,6,17,8,4,2,4,11,4,17,3,25,0,7,2,26,4,3,3,1,20,7,16,10,12,6,4,12,5,2,2,9,2,9,1,2,5,4,9,6,5,2,15,3,3,5,1,4,11,7,2,46,19,3,6,3,2,3,6,12,2,11,2,0,7,2,5,8,5,3,3,4,4,6,4,2,5,6,9,4,8,3,8,0,12,7,3,9,6,7,13,7,9,4,5,10,0,4,3,26,11,2,4,2,4,7,4,3,9,6,1,10,8,2,23,4,1,15,3,2,7,8,1,7,10,4,8,9,6,23,19,6,6,7,2,4,2,3,3,7,13,4,15,6,8,7,5,5,2,3,4,10,14,2,5,21,3,5,8,21,9,9,3,1,0,2,6,4,13,5,0,15,11,9,6,12,6,9,5,8,0,2,1,6,6,3,2,5,4,4,17,5,8,9,6,5,4,6,5,3,4,1,4,9,13,11,11,8,2,4,109,12,2,1,3,4,10,15,5,3,9,4,3,3,8,3,2,3,3,5,2,11,0,19,7,3,8,1,5,2,1,6,16,7,6,7,8,12,1,0,6,9,13,3,5,4,4,3,1,9,5,12,5,1,2,1,1,17,10,1,4,0,8,3,19,6,4,7,4,12,5,2,3,5,5,0,5,5,1,0,7,8,8,1,6,1,5,6,1,18,9,4,6,1,5,8,4,1,14,10,4,8,2,3,3,0,13,3,6,2,5,5,13,2,3,11,6,8,4,8,6,2,1,7,1,10,4,7,2,5,4,2,2,9,2,7,6,1,6,2,8,5,6,2,4,4,6,3,1,2,1,5,3,4,3,3,3,9,5,9,6,0,2,3,6,4,9,8,5,2,9,6,5,12,8,2,0,4,4,2,4,2,4,4,0,6,1,2,17,6,1,3,8,1,1,1,5,7,17,2,5,5,10,2,3,5,1,6,1,2,6,7,2,3,5,0,4,2,2,4,11,3,6,2,1,4,3,7,11,11,5,0,2,2,6,2,3,3,1,6,5,3,2,0,6,2,8,6,5,0,2,5,4,2,1,1,3,1,4,1,12,9,4,6,3,5,5,1,2,2,1,9,7,2,3,3,6,9,12,8,1,0,2,2,2,0,2,2,5,1,5,2,11,2,0,4,2,6,4,10,1,1,1,3,11,4,0,0,2,10,7,2,0,4,1,1,4,1,3,2,1,3,3,5,5,6,5,3,6,0,3,0,1,2,2,2,6,3,8,11,0,1,8,0,9,11,1,7,1,9,3
california,2,10,1,60,1,2,3,26,3,2,5,5,4,18,7,1,2,3,4,0,1,13,2,7,4,5,5,5,1,9,3,92,63,3,19,25,18,4,6,3,4,2,9,2,20,7,11,3,179,16,24,0,1,14,10,2,14,22,4,4,11,5,3,7,7,3,24,1,3,13,5,2,5,0,25,3,7,3,31,12,32,0,11,4,75,3,6,0,33,1,2,1,2,18,13,4,6,2,14,5,17,17,13,1,1,10,4,1,19,11,10,0,1,11,3,12,0,0,30,75,4,7,0,41,9,0,1,4,2,2,0,6,7,23,7,15,0,2,2,4,0,16,13,0,3,17,2,2,15,7,18,2,8,5,1,5,12,7,0,5,5,0,5,1,0,3,3,4,8,4,84,35,8,0,2,2,56,1,1,8,11,23,1,5,12,6,18,6,3,20,1,4,4,0,0,0,2,0,13,2,5,0,2,3,11,6,11,13,3,3,20,4,10,6,1,0,3,1,12,2,0,6,1,10,28,34,20,17,10,15,13,16,5,11,10,10,15,3,1,4,28,17,3,0,3,4,7,13,27,2,2,11,2,8,20,4,2,2,3,14,0,7,5,3,1,15,1,2,1,2,59,0,17,3,1,1,17,2,0,0,23,1,0,2,9,10,1,3,7,4,7,0,1,3,3,4,8,2,1,3,10,35,0,1,1,1,6,1,2,0,0,23,13,3,4,3,7,11,12,0,13,0,6,1,24,1,0,16,0,18,6,2,2,0,5,6,4,11,0,3,5,6,3,11,5,8,13,19,1,2,4,0,1,8,7,2,0,2,4,4,1,1,6,2,2,0,10,5,0,3,0,9,3,3,1,12,7,0,5,4,36,0,15,2,2,40,0,15,17,1,2,2,1,1,10,3,23,3,11,3,10,5,4,0,3,8,7,3,8,4,2,11,2,17,0,4,2,1,4,0,2,3,6,5,2,2,0,6,3,1,15,6,5,5,2,0,0,1,8,5,11,14,6,15,3,10,5,3,16,4,8,2,1,2,38,0,0,3,5,14,5,10,11,14,4,2,9,8,4,0,8,1,1,0,0,1,1,2,11,2,3,5,5,2,4,3,13,2,1,1,49,11,0,2,3,2,4,4,2,3,15,4,10,0,7,34,2,5,5,2,0,0,11,0,6,8,0,0,2,2,3,5,3,6,8,2,5,1,14,16,4,2,1,0,3,2,4,7,21,6,2,0,0,6,7,5,0,7,8,1,21,2,1,28,2,2,18,1,2,5,6,1,17,1,2,10,4,2,15,16,3,5,9,0,2,0,1,3,2,23,6,6,5,5,0,6,1,4,10,4,3,20,7,1,10,2,0,0,17,5,13,0,0,5,1,8,4,5,4,9,9,6,8,1,12,7,3,4,7,5,6,21,1,5,1,4,8,3,2,30,32,11,8,9,17,1,1,14,2,8,0,2,4,3,2,12,3,0,1,94,16,5,0,2,3,6,17,3,1,3,2,8,3,6,0,4,0,9,5,4,13,4,95,12,5,3,2,2,3,15,1,8,4,8,4,0,1,0,1,52,5,2,7,48,4,4,5,1,2,11,6,1,6,0,7,5,5,2,0,5,4,8,6,12,11,16,5,2,8,2,17,0,5,19,1,13,7,1,0,12,6,8,5,0,14,0,21,0,52,7,5,19,1,3,8,4,10,7,2,2,2,0,2,4,0,3,2,21,4,1,4,2,2,0,29,8,7,1,2,8,2,5,0,6,3,3,9,1,15,4,3,1,5,0,2,2,1,26,20,0,0,6,1,2,6,12,2,12,0,5,1,9,8,2,1,1,3,5,9,1,7,6,9,3,3,3,2,5,2,7,2,4,0,5,15,4,1,1,7,2,6,4,5,3,1,1,4,8,13,4,2,4,2,1,4,4,2,0,0,4,11,13,0,6,0,6,2,7,2,0,0,2,4,2,3,7,1,2,5,7,1,1,0,9,4,3,3,2,3,13,0,5,0,0,12,0,6,5,8,0,8,10,2,1,2,2,11,6,5,4,2,1,7,3,8,4,7,3,1,6,1,1,2,3,3,2,13,5,3,1,4,5,1,1,1,0,3,2,2,14,1,0,1,14,0,0,0,2,0,5,1,2,1,1,3,7,2,26,7,1,2,3,1,3,4,4,41,22,19,2,22,7,0,4,0,10,2,2,3,11,11,4,3,0,2,3,3,3,7,16,11,4,2,13,8,0,2,0,1,1,1,1,2,1,0,0,2,5,1,0
coast,5,17,5,110,4,1,7,21,3,9,19,11,12,45,5,9,8,6,5,2,6,53,2,14,26,11,10,20,1,8,22,215,118,3,34,56,49,2,0,5,3,5,11,2,21,13,14,4,392,53,53,4,4,30,4,5,60,52,4,16,34,8,1,21,7,1,36,6,6,47,9,54,4,1,67,12,17,2,83,11,73,0,26,4,163,9,30,0,63,3,9,5,0,41,53,0,16,7,33,4,67,28,37,6,7,19,3,6,44,10,26,7,11,7,3,34,5,6,51,156,33,17,1,67,6,2,3,6,13,6,8,4,1,88,15,68,5,3,6,4,3,49,32,10,4,82,0,15,27,8,38,4,18,12,0,6,22,2,12,13,11,1,5,0,1,8,9,9,25,11,60,115,18,3,2,8,119,9,15,40,23,10,0,18,6,15,38,20,37,98,1,8,14,0,0,3,10,4,31,7,8,0,1,8,34,3,4,16,13,22,72,5,11,7,3,0,0,1,16,5,0,15,4,44,34,58,26,19,18,4,33,42,7,20,32,10,33,4,7,5,61,45,16,6,8,2,13,29,73,0,8,20,17,13,42,13,9,1,8,26,0,40,24,6,3,64,0,8,10,6,122,1,22,13,7,0,26,9,14,1,43,7,4,25,12,13,1,13,8,3,11,9,7,1,10,6,57,8,6,16,11,45,0,3,14,0,14,12,2,0,1,12,32,4,14,13,10,25,6,6,41,4,21,10,42,7,3,25,2,31,1,17,17,8,7,7,21,18,1,8,5,27,23,9,12,56,36,69,17,3,11,4,7,51,20,8,2,3,12,10,5,15,17,16,8,0,41,6,0,12,9,10,11,6,3,47,20,2,9,2,47,0,53,14,1,36,1,25,32,9,14,1,5,12,27,10,56,8,36,8,25,11,13,0,3,7,2,8,76,11,5,42,7,32,19,11,3,16,2,1,3,19,11,15,0,5,1,13,16,20,2,12,2,23,1,6,0,13,51,5,39,57,11,30,6,13,31,6,28,8,12,9,3,3,151,11,0,11,7,22,9,19,19,36,12,12,11,10,18,0,15,9,9,1,2,11,2,6,23,12,6,9,19,3,11,8,16,2,4,0,140,34,2,1,9,9,20,11,5,1,35,14,3,0,8,0,1,9,10,3,4,1,20,7,5,9,3,9,0,13,6,11,3,26,4,9,34,1,14,31,12,1,21,10,13,13,19,5,48,7,7,1,2,1,14,7,1,19,22,19,7,8,6,54,4,11,107,4,6,11,28,2,35,13,11,6,14,4,54,34,12,12,37,11,14,13,0,4,6,46,3,23,16,6,6,2,6,10,29,10,21,29,13,4,9,4,4,1,77,12,17,3,5,10,9,36,6,16,17,16,19,37,23,7,22,16,28,3,10,3,7,4,3,13,1,15,15,7,6,33,5,29,15,19,19,2,5,43,4,48,7,0,8,17,6,62,10,9,5,297,78,12,8,3,17,13,54,16,7,22,3,30,27,78,17,9,5,6,7,15,21,10,105,16,14,9,2,9,5,17,34,59,17,17,11,10,2,6,52,1,11,7,20,160,5,42,5,3,8,18,27,10,7,5,15,19,32,8,0,3,0,10,2,18,27,80,18,6,10,10,38,6,8,66,17,58,8,6,1,12,15,13,2,6,3,18,157,3,57,9,8,26,15,60,59,0,20,11,3,6,6,0,1,7,3,22,9,32,5,1,0,8,7,5,38,17,12,7,2,18,7,17,2,17,5,12,0,5,6,13,7,2,17,8,9,10,5,53,17,17,9,13,11,8,8,11,3,19,3,2,0,14,19,1,4,3,3,4,21,10,13,21,31,16,13,4,7,15,5,13,6,3,4,32,75,10,9,3,1,3,7,18,2,17,7,1,9,25,25,6,11,4,4,1,9,4,1,21,4,23,23,30,11,8,10,6,7,4,8,3,13,4,20,7,1,11,0,6,11,36,7,1,8,0,1,1,13,14,7,16,16,3,7,5,14,8,13,12,24,6,11,42,1,2,14,21,17,2,12,2,4,2,9,7,0,9,17,11,5,19,2,1,6,8,11,12,17,27,5,4,10,14,10,18,1,15,26,22,6,2,12,1,6,8,6,2,8,5,5,18,5,12,4,2,0,6,2,45,16,2,17,6,2,10,9,0,74,103,41,6,18,21,7,7,2,104,19,1,3,54,46,4,3,5,6,14,4,12,23,8,12,3,7,0,7,1,9,5,32,0,1,1,3,0,1,0,0,9,2,0
term,5,57,22,225,14,8,7,77,13,6,47,13,16,85,4,17,7,23,7,7,6,39,2,39,33,15,7,16,11,28,9,230,119,15,56,42,71,13,7,7,12,9,0,6,32,23,49,16,511,18,75,3,11,48,6,7,67,17,1,24,18,13,7,18,11,10,107,12,19,26,13,2,2,10,72,19,19,2,105,24,51,0,16,9,282,17,10,0,50,4,24,3,6,52,55,17,24,8,47,11,16,35,43,10,7,32,2,3,9,2,20,6,5,16,0,30,21,3,169,178,41,19,30,116,12,6,3,9,10,4,20,3,8,71,21,47,12,4,10,9,0,40,35,2,4,83,2,8,13,11,80,1,23,3,4,21,32,4,15,9,12,3,10,5,2,1,2,21,25,14,19,106,21,2,9,10,279,6,15,28,16,16,4,17,0,21,29,21,58,90,2,6,3,0,0,8,15,6,21,9,12,4,3,14,28,8,6,19,32,37,71,8,49,9,2,1,4,5,32,4,5,34,10,23,53,126,20,25,2,5,9,27,8,26,32,18,33,5,14,7,77,42,4,4,28,4,3,9,68,9,15,15,18,9,4,28,11,9,10,20,10,24,59,14,7,32,8,2,18,4,166,9,51,6,4,0,16,11,18,3,49,6,7,20,7,0,5,4,22,1,32,33,10,13,14,11,48,9,12,26,23,34,0,11,15,3,22,6,4,2,1,10,36,4,52,9,15,43,10,6,56,7,20,6,57,5,4,23,10,27,4,9,8,5,6,23,14,5,2,24,11,14,9,14,2,16,57,89,16,9,18,9,10,26,27,4,17,10,10,26,29,14,15,17,0,2,57,16,8,20,5,14,7,6,7,31,10,2,15,6,106,2,42,16,6,54,3,29,33,5,31,7,15,30,39,7,84,10,58,6,26,3,8,0,5,6,4,7,22,14,6,8,3,15,10,7,14,14,8,2,7,22,21,24,2,5,3,18,16,24,15,16,20,33,2,20,4,51,4,2,15,23,17,15,0,7,7,7,42,6,13,14,3,11,77,7,3,33,11,46,13,25,21,21,9,15,14,33,6,0,14,2,3,3,4,16,5,20,13,4,6,29,4,10,7,29,12,5,3,7,95,58,1,7,9,14,2,37,3,8,10,1,9,1,14,13,6,29,11,0,0,9,7,3,11,11,3,13,5,8,3,15,17,21,13,7,17,7,13,36,12,6,3,9,18,8,22,10,51,19,6,6,7,5,7,16,1,20,20,6,66,6,15,61,10,13,26,5,6,10,38,8,30,4,17,10,12,9,47,37,15,15,18,5,7,7,15,14,10,28,4,24,10,13,8,7,8,6,9,13,38,38,18,5,24,4,6,3,113,18,24,0,5,19,11,22,11,45,8,3,36,40,25,6,40,13,27,9,12,8,14,1,9,28,6,7,21,5,8,40,18,17,22,40,23,3,7,12,1,7,8,2,21,30,12,40,5,16,13,302,32,12,10,10,9,31,47,28,19,25,6,11,85,49,30,18,23,18,12,9,31,9,120,35,87,9,4,15,7,8,19,37,12,10,26,19,13,9,5,11,1,13,26,6,12,12,4,13,26,34,6,8,10,6,13,8,13,5,20,13,6,38,16,37,32,34,11,13,45,6,12,13,15,34,4,16,4,4,7,13,3,17,5,11,14,2,13,6,68,10,15,6,5,15,10,4,11,11,5,18,3,13,3,15,7,17,10,8,12,27,29,12,4,12,30,10,11,6,4,29,8,4,5,19,3,19,12,5,16,21,3,3,11,8,26,6,6,138,5,18,15,13,9,6,7,23,8,11,4,12,4,10,31,13,5,0,8,1,21,4,13,0,17,22,3,11,2,20,2,22,3,4,18,27,9,13,2,32,1,6,5,7,8,8,4,16,4,18,10,6,13,11,16,19,3,25,6,35,9,13,43,38,15,4,3,2,9,9,9,2,12,6,12,6,4,11,3,14,7,17,8,24,7,4,2,8,9,17,19,5,37,18,11,14,28,8,12,8,9,14,4,14,2,5,6,33,7,21,13,3,9,13,6,10,34,11,8,16,9,25,4,18,14,27,34,8,2,13,6,7,5,11,11,17,4,17,6,26,16,5,5,4,9,18,6,4,2,8,7,9,3,14,8,2,4,35,8,9,20,8,2,6,5,5,9,8,7,4,33,14,17,5,4,18,12,25,4,2,8,6,7,13,3,3,11,11,0,7,6,13,7,9,7,4,8,10,12,6,30,2,4,7,8,0,2,5,4,12,2,2
opportunity,1,24,15,131,15,27,9,30,6,12,17,10,21,134,2,17,15,29,22,15,4,48,65,49,26,25,42,53,34,47,11,212,134,37,62,183,77,12,18,18,15,42,11,15,66,24,25,22,240,139,42,36,29,130,43,6,61,17,41,39,22,14,6,19,49,17,150,12,10,16,43,1,11,5,198,29,43,5,107,54,42,6,7,17,214,17,17,3,23,0,19,13,4,44,58,19,39,3,61,16,9,27,25,36,26,33,9,6,22,14,35,6,35,38,49,42,2,8,76,158,46,89,45,94,16,16,8,7,1,1,59,15,20,82,53,149,4,7,9,16,14,49,21,6,12,126,20,37,19,4,62,12,19,11,17,36,60,10,11,80,14,4,19,4,7,40,7,38,36,13,22,129,48,6,24,4,150,10,8,93,34,20,43,39,5,45,29,21,39,54,5,11,4,10,2,9,21,23,13,26,41,6,12,14,18,45,6,44,45,40,143,27,30,17,13,36,3,13,23,3,6,19,3,17,44,74,28,24,8,8,17,21,28,24,59,17,33,18,15,12,83,44,17,13,38,6,19,62,66,15,16,17,49,2,1,19,7,6,2,17,6,51,13,4,12,46,40,46,31,8,131,13,10,7,5,9,28,6,10,5,130,10,6,29,10,7,32,25,32,9,2,12,20,7,1,13,49,1,16,28,29,31,0,2,19,7,42,6,22,8,8,20,50,23,31,14,19,36,13,8,61,9,35,29,65,4,10,72,8,44,22,14,10,5,15,9,42,3,2,22,9,27,41,14,2,11,32,53,26,42,8,24,4,44,18,4,6,5,14,47,26,32,29,32,11,22,29,11,31,54,5,76,6,54,10,34,13,3,33,5,85,9,34,16,32,45,8,29,31,10,35,23,28,14,20,11,44,3,50,7,23,23,3,17,7,9,13,16,47,29,4,10,6,22,10,27,12,16,15,29,5,16,24,7,8,6,7,17,10,19,5,5,0,12,15,4,11,24,22,9,18,15,14,23,6,11,54,22,23,13,41,9,30,11,48,10,24,4,13,19,30,36,40,46,18,13,55,38,8,9,59,15,4,8,9,21,5,16,28,9,5,27,3,11,12,6,16,20,2,1,77,33,5,8,23,5,10,10,5,9,8,8,6,8,18,21,7,8,7,4,3,0,10,13,14,14,11,9,3,16,4,20,1,25,4,2,19,5,25,20,24,11,7,16,17,13,8,19,42,13,4,5,9,10,22,11,8,65,14,8,16,2,12,48,5,15,36,2,7,2,25,7,23,5,8,19,9,7,30,44,16,3,10,3,9,1,10,6,5,22,9,15,23,36,13,1,4,3,7,18,26,33,16,5,23,8,9,10,27,28,22,5,6,1,5,35,10,25,7,4,26,20,14,8,24,8,10,8,10,5,14,2,9,28,8,9,6,7,13,26,13,13,30,27,12,11,13,7,13,7,12,7,15,21,6,21,19,6,9,145,23,14,3,5,5,22,31,24,9,13,10,3,11,12,10,4,2,6,6,9,16,5,25,32,25,7,2,4,4,4,11,39,7,10,9,7,19,13,2,7,13,1,14,6,8,15,7,1,19,10,22,6,1,5,14,9,14,17,2,0,11,2,4,33,10,31,21,8,8,9,5,5,3,21,8,12,2,11,12,6,8,13,3,15,7,5,19,5,17,4,14,5,11,9,7,7,10,19,4,4,14,4,0,4,4,5,6,11,5,4,4,20,4,1,24,21,18,8,25,5,17,3,10,16,5,11,7,3,11,9,9,4,8,6,13,8,6,1,8,13,10,3,1,1,8,12,3,9,6,9,3,2,11,6,23,11,14,8,15,5,12,1,6,6,3,6,8,15,5,12,1,0,9,4,5,0,13,13,5,5,12,5,17,6,12,8,10,24,11,21,4,6,3,9,8,6,9,15,3,19,28,20,12,4,8,10,13,13,9,4,4,9,7,8,1,10,5,3,12,9,17,3,5,7,4,7,3,5,15,11,2,7,5,4,6,4,4,6,7,5,15,0,13,7,10,5,5,5,10,13,5,4,13,9,8,1,2,5,10,25,12,16,9,3,9,4,3,4,7,2,1,6,2,3,5,3,4,19,3,5,4,12,7,11,2,2,10,2,9,8,6,18,5,8,3,13,7,4,19,9,3,11,12,7,7,3,1,6,12,6,7,2,6,4,0,7,5,5,2,3,8,1,20,27,4,11,23,2,5,5,1,11,6,1,5,11,4,43,11,9,7,8,2,7,12,5,16,0,9,21
appear,23,30,14,190,8,4,6,38,7,2,26,20,8,60,4,4,5,16,1,6,2,60,4,21,19,9,4,12,7,30,18,233,121,9,47,30,41,19,15,8,6,7,5,2,33,22,33,23,393,13,53,4,17,23,7,7,78,77,1,18,32,4,5,31,28,9,74,6,10,13,4,12,4,5,50,8,17,9,108,16,60,2,27,8,296,32,24,1,60,5,10,5,1,42,46,16,26,9,43,17,21,31,61,16,13,62,11,1,18,8,19,5,7,10,0,38,9,5,91,187,55,12,8,111,5,2,2,9,9,0,11,2,2,59,13,40,6,12,8,6,0,47,40,3,3,78,3,13,13,27,88,0,22,6,0,16,21,7,15,8,14,5,7,5,1,1,3,27,17,13,17,75,18,0,6,7,181,4,14,29,28,13,2,11,2,15,42,26,58,51,2,7,2,0,1,3,21,7,12,22,25,5,1,21,29,12,7,36,14,19,85,4,34,12,1,1,3,5,32,5,14,16,5,19,73,120,32,38,2,16,13,16,31,37,35,41,39,6,14,8,87,40,8,6,15,13,12,22,56,6,10,24,28,20,28,27,22,2,6,29,3,35,43,10,12,79,3,4,10,6,158,10,92,7,7,0,17,31,25,11,60,10,5,21,10,3,6,14,17,0,14,15,17,9,3,13,73,8,9,26,21,41,5,2,17,3,22,20,3,0,2,17,45,4,46,25,14,71,11,9,53,16,26,5,74,7,9,30,10,38,4,13,9,8,11,27,20,10,9,20,11,15,23,12,4,8,61,71,17,7,18,11,10,34,35,12,9,4,26,58,18,12,9,24,13,0,54,11,11,7,4,24,6,14,9,27,8,0,15,14,79,1,59,24,2,53,2,36,39,11,25,6,14,10,48,17,86,12,56,3,34,8,8,3,10,10,11,4,19,12,8,13,3,20,19,9,1,10,8,1,4,6,13,20,1,10,4,15,17,25,41,11,4,13,2,11,0,24,11,6,18,44,11,21,2,8,2,6,42,13,21,20,1,12,65,16,2,13,7,29,17,34,56,16,5,4,14,12,9,0,12,3,8,2,5,7,4,20,16,3,3,7,6,11,8,10,13,2,8,3,87,71,5,7,14,9,5,27,15,18,14,7,7,0,20,55,2,17,8,5,7,5,19,5,16,26,8,7,3,5,4,23,17,27,11,8,29,3,24,36,15,6,6,11,9,16,18,10,49,32,9,3,8,4,8,9,3,28,26,13,39,13,22,75,13,15,40,6,8,13,41,8,27,6,22,25,17,17,48,36,20,11,24,3,9,10,12,9,5,29,13,32,6,18,8,8,14,4,7,13,20,48,10,4,18,6,5,7,74,24,28,3,3,10,15,34,8,35,11,21,33,32,15,11,56,9,35,2,7,3,22,19,10,45,4,9,26,16,17,32,24,46,36,29,14,4,10,8,5,28,16,3,21,48,15,67,3,9,3,233,39,6,10,8,10,14,51,25,3,15,13,12,17,32,12,13,7,14,18,21,28,12,42,47,58,13,3,18,5,5,12,29,26,10,15,20,24,3,7,20,26,14,1,19,7,15,19,5,24,19,7,4,11,16,14,6,25,17,11,13,5,27,7,39,26,28,13,10,11,9,14,9,8,34,4,11,13,1,7,19,13,21,9,6,16,9,35,5,30,13,5,10,2,24,18,6,20,6,4,9,14,16,8,39,32,20,14,21,6,11,11,20,10,8,26,17,16,10,14,9,5,4,1,22,4,11,8,7,19,15,6,12,18,2,17,16,4,6,15,28,8,10,2,8,14,29,3,12,14,6,7,10,17,10,2,8,5,6,23,8,10,3,22,9,6,13,8,9,10,18,8,7,8,20,12,13,4,5,17,9,24,10,20,5,17,15,14,35,14,11,20,17,3,11,17,11,7,8,9,15,54,35,13,14,0,7,6,14,9,1,11,10,23,4,8,16,7,9,12,17,2,4,16,17,4,8,9,39,20,2,7,20,8,12,19,8,9,13,9,7,2,15,2,14,10,16,12,11,11,4,10,8,4,14,10,11,11,19,7,29,13,8,5,24,9,16,7,13,5,5,19,5,8,16,6,15,14,34,8,24,7,5,7,17,10,5,16,16,8,14,1,16,18,15,15,29,11,19,76,7,2,7,2,4,13,18,14,8,34,11,16,6,3,6,2,38,17,3,5,18,4,8,10,4,12,7,2,5,16,11,15,12,12,19,7,6,16,5,50,3,8,5,13,0,1,4,1,7,1,0
pacific,6,16,1,108,9,1,12,61,1,3,37,19,11,85,4,6,6,5,4,3,7,32,2,27,17,19,14,12,3,25,11,205,164,4,44,59,51,10,0,4,3,6,13,3,26,20,28,9,420,60,51,3,8,54,1,7,33,53,1,26,46,26,6,10,11,3,65,3,6,80,18,18,12,0,87,16,16,4,91,12,69,0,17,4,281,6,17,0,61,2,9,2,0,40,103,6,16,10,35,16,72,44,30,5,7,22,2,6,36,10,19,5,7,20,1,31,9,3,64,209,42,26,2,89,14,2,4,5,8,3,14,6,6,77,15,42,3,3,5,14,1,36,40,9,6,74,2,18,27,7,57,5,7,13,3,14,17,9,13,6,15,1,1,4,5,8,3,25,21,4,44,97,27,4,7,11,155,7,9,34,14,22,2,6,37,10,46,17,40,103,2,4,10,1,1,5,11,8,21,7,3,1,2,10,32,9,1,24,15,35,80,6,33,7,0,0,1,0,17,14,2,17,7,24,61,60,25,21,23,22,25,42,9,20,42,13,25,5,4,8,61,39,10,7,15,2,6,29,43,6,11,14,30,18,31,13,9,0,2,16,0,24,23,7,7,32,1,7,11,8,142,11,56,9,6,0,26,6,12,7,42,5,0,25,9,18,1,11,11,3,3,6,5,4,18,10,58,2,8,19,15,48,5,7,8,2,20,3,2,0,3,13,53,10,35,10,20,37,2,4,46,7,31,2,83,6,6,25,0,41,0,9,7,8,3,16,31,17,0,12,12,22,12,11,13,34,56,60,44,1,10,13,7,35,26,8,1,2,10,17,10,20,28,7,21,0,48,8,2,4,2,13,16,4,9,39,21,4,18,6,78,5,44,14,2,47,0,20,24,2,17,2,3,12,28,15,64,3,30,9,22,4,3,1,4,15,6,8,74,17,4,57,1,25,10,15,6,16,3,5,4,8,17,14,2,3,1,16,26,26,1,15,0,17,6,7,0,17,19,4,22,61,12,38,48,22,32,13,36,7,33,7,7,3,115,7,0,12,3,28,15,25,12,22,6,16,8,22,24,1,13,4,6,1,4,4,1,11,20,4,6,17,20,8,21,1,18,4,8,2,110,44,1,4,3,11,8,18,3,5,20,5,4,1,51,0,2,15,6,2,0,5,8,5,8,15,10,4,0,13,9,23,5,15,5,2,15,1,16,36,11,3,0,5,8,5,13,11,66,8,3,8,4,1,4,10,0,29,22,19,14,4,6,60,3,15,98,1,3,22,31,9,19,7,18,9,25,4,41,56,8,7,22,2,14,24,0,11,8,58,0,26,21,13,9,14,13,9,16,16,22,36,0,11,15,1,5,0,61,18,17,3,7,5,20,35,14,17,2,5,26,43,16,11,30,13,18,4,10,14,13,2,3,28,1,11,35,24,14,38,7,26,19,14,9,7,12,40,7,25,3,1,6,22,17,56,7,4,2,293,72,12,5,2,11,17,37,14,4,23,6,41,20,45,17,6,16,16,16,13,21,11,78,14,28,8,9,6,24,17,36,52,10,24,17,1,15,5,48,160,6,6,19,1,11,22,9,4,5,14,54,6,13,4,7,19,34,9,1,6,5,15,1,24,21,21,11,13,10,5,24,2,7,26,8,27,13,5,1,18,6,18,4,5,5,5,74,3,106,18,3,33,9,44,76,6,12,19,6,6,4,7,5,11,10,11,10,27,11,34,18,7,9,20,53,12,11,2,3,27,5,23,4,6,5,20,4,1,22,18,6,4,14,5,10,20,4,26,15,10,6,8,27,13,74,24,39,18,8,2,3,8,15,4,3,7,7,4,27,8,2,47,32,10,7,2,7,9,6,10,11,9,3,3,22,4,8,10,2,14,23,8,9,3,4,14,13,22,29,8,8,4,3,4,5,22,6,22,10,20,32,25,3,8,5,2,6,26,2,2,13,2,5,7,2,8,0,11,20,30,5,3,24,0,8,7,1,14,17,64,1,11,2,6,23,8,6,10,16,5,38,40,0,7,10,7,14,2,7,3,3,3,7,11,6,7,35,11,4,27,2,4,4,18,13,2,10,27,3,11,9,19,9,6,6,5,17,17,9,13,2,1,4,25,5,2,3,3,2,14,4,6,3,1,1,11,12,42,24,2,3,5,4,12,9,8,59,129,25,5,15,28,0,8,0,57,24,5,1,109,19,6,8,9,5,29,2,16,24,10,31,9,5,3,13,0,11,3,30,2,6,6,14,0,0,0,0,3,4,2
promptly,9,17,4,124,11,4,2,15,6,1,21,5,10,38,2,1,2,10,4,0,4,33,4,16,18,14,6,6,4,8,7,115,80,6,20,23,20,9,3,4,7,3,1,0,21,10,17,5,228,13,35,3,11,18,1,5,30,17,0,12,12,2,1,9,12,2,47,3,10,12,6,4,2,3,37,8,5,8,49,5,25,0,12,7,137,7,17,0,39,2,5,4,1,12,31,4,10,5,16,13,11,18,26,7,6,30,4,1,7,0,10,2,5,14,0,14,9,3,62,87,19,17,12,33,4,1,2,5,2,1,4,3,0,25,5,26,5,1,5,3,0,27,24,3,0,51,5,8,18,5,29,1,14,3,1,19,15,5,4,4,8,0,4,2,2,5,8,12,11,6,12,36,17,0,4,4,118,3,9,27,27,6,3,17,1,7,17,14,36,38,2,4,1,1,3,1,10,6,9,1,17,1,1,14,15,6,7,13,7,15,41,5,19,4,0,0,1,0,10,3,3,8,2,5,28,82,15,7,9,5,9,19,2,7,24,15,16,1,6,5,36,26,3,2,13,5,5,13,32,5,28,6,15,8,2,10,12,5,2,5,3,17,26,11,3,38,0,0,4,2,94,13,18,5,3,0,14,4,9,6,26,3,0,11,6,1,5,3,7,3,4,4,9,2,4,18,54,6,3,9,16,26,0,2,6,3,9,0,2,0,7,5,25,3,35,11,6,25,14,7,37,6,16,7,25,5,3,13,7,15,3,1,3,7,2,12,5,6,4,10,10,9,3,9,5,3,24,33,13,10,8,5,6,17,8,4,7,1,9,19,12,10,6,9,4,0,11,0,5,7,3,11,7,5,3,15,8,4,5,5,34,2,32,4,0,46,4,23,14,2,18,1,6,16,15,7,41,2,26,4,21,2,1,0,5,1,5,2,15,5,2,2,2,8,13,4,6,2,2,0,2,3,10,6,0,4,3,9,7,8,23,7,7,10,1,2,1,14,5,6,11,20,8,14,4,2,1,4,17,6,11,1,2,1,27,3,0,13,4,16,4,14,9,20,5,7,6,16,5,0,6,2,3,0,1,3,0,11,19,5,3,7,0,3,5,9,10,3,4,4,57,26,2,3,3,5,3,29,12,6,8,2,1,3,6,26,3,7,8,2,5,5,8,2,8,8,0,4,7,4,2,18,0,19,5,0,10,4,13,15,6,2,6,6,8,5,5,4,18,13,1,4,1,5,2,4,3,13,15,7,9,4,11,19,8,5,19,3,5,8,14,2,20,4,14,8,6,5,28,17,4,6,18,2,13,5,3,2,5,10,1,14,3,4,9,2,1,4,0,6,13,18,4,5,11,2,1,0,32,12,16,1,2,3,13,11,5,18,7,5,19,12,9,2,19,3,6,0,9,5,10,5,3,19,12,4,5,9,5,16,8,14,6,9,8,1,12,7,5,9,1,1,2,27,8,27,5,10,8,152,20,3,4,4,2,15,31,13,10,10,2,1,19,10,10,5,2,7,18,9,12,4,36,11,18,2,3,4,9,7,9,25,12,5,4,13,8,4,4,5,12,8,7,11,1,13,2,5,2,6,12,2,8,3,4,13,17,8,3,0,0,7,3,26,8,23,15,8,8,3,15,2,8,18,1,2,9,1,0,7,6,14,4,3,16,5,14,4,23,7,10,3,2,8,6,1,10,7,5,2,11,3,1,6,2,13,7,8,3,8,4,11,4,3,16,4,7,3,6,9,3,5,2,16,4,12,3,2,10,4,2,2,7,2,4,5,1,10,5,9,5,7,3,1,1,15,9,3,5,3,4,12,2,2,0,3,3,3,11,6,2,5,12,13,2,2,4,2,8,7,4,1,5,9,5,2,6,5,4,2,5,2,5,2,4,4,7,14,6,7,5,6,0,11,5,3,4,4,4,7,15,18,8,0,7,5,1,2,5,0,5,2,10,3,3,6,0,4,5,10,5,3,11,6,4,3,8,6,6,5,9,4,7,2,9,4,11,6,3,3,2,7,0,6,8,14,1,4,4,0,9,6,4,9,6,7,5,7,5,15,5,8,3,11,8,3,4,7,4,3,5,7,4,3,3,6,3,23,5,10,11,5,7,5,3,5,6,4,4,3,2,10,1,1,4,18,4,7,21,10,3,3,0,6,4,3,3,6,13,6,6,4,0,6,3,20,3,3,1,0,9,4,2,4,13,3,1,11,6,3,8,3,5,1,4,1,5,5,14,0,2,2,1,0,0,3,0,8,0,0
complete,10,15,2,194,3,16,15,18,4,5,15,12,34,59,7,5,9,14,7,1,6,40,14,18,14,13,11,23,5,32,6,217,110,16,40,45,24,11,10,8,3,1,4,14,41,16,29,18,200,25,35,7,10,42,8,2,35,65,10,37,8,2,3,39,16,6,54,5,5,22,29,25,4,1,69,13,19,5,86,23,68,1,29,8,145,22,20,1,47,7,16,3,4,49,44,8,17,7,39,9,85,51,35,7,11,30,2,9,39,5,33,6,16,14,9,30,6,8,87,101,37,22,10,132,14,2,6,3,15,4,27,3,3,70,18,175,2,6,8,6,3,15,33,7,3,88,3,13,22,17,46,3,19,15,11,29,26,9,3,13,35,7,2,11,6,11,7,14,16,5,37,93,23,5,6,5,139,9,8,57,38,4,21,20,22,14,33,24,18,84,0,7,9,3,8,9,38,4,22,3,21,2,5,6,20,8,7,31,7,34,76,10,26,6,4,2,1,2,19,18,8,14,6,19,42,55,30,21,14,10,24,41,10,31,29,13,46,11,8,5,44,29,11,3,7,6,8,15,65,3,17,13,24,11,12,11,6,7,4,22,4,27,20,11,7,53,14,10,14,8,117,16,37,5,8,5,15,13,9,11,58,2,5,9,14,3,10,20,7,3,16,10,11,17,14,8,33,9,8,15,25,41,5,13,8,2,15,5,8,4,4,23,26,5,26,21,15,40,9,10,30,8,18,10,31,2,11,29,3,21,6,18,2,5,10,27,17,7,7,16,5,6,10,7,15,8,25,41,19,8,12,9,6,35,18,11,3,5,20,30,30,14,15,16,4,2,21,7,13,18,8,23,6,10,4,46,10,1,9,6,64,4,71,10,7,41,2,11,31,1,17,12,24,23,38,5,61,9,30,8,14,6,5,3,6,3,6,2,22,10,4,8,0,12,10,15,8,5,3,7,3,9,28,7,1,3,2,8,11,8,13,13,9,23,5,14,2,15,27,21,34,19,9,6,1,5,25,5,18,10,26,5,10,3,36,4,4,1,4,28,8,18,26,32,14,10,16,21,25,0,18,8,3,4,6,11,8,19,23,8,7,21,1,2,5,5,12,7,2,2,63,39,2,1,7,11,16,12,3,3,10,5,6,3,15,11,6,7,8,8,2,2,10,9,12,9,5,8,7,9,2,9,5,14,3,6,21,4,4,20,7,4,3,7,22,2,11,6,26,32,6,7,5,2,7,21,3,16,10,5,13,11,5,53,11,4,28,4,2,11,20,8,31,9,21,10,17,6,40,36,20,14,48,4,10,4,8,4,5,26,8,13,14,7,7,5,5,8,4,8,13,29,10,3,28,2,2,2,53,8,25,8,3,9,8,26,12,14,12,2,27,67,34,4,23,8,16,2,4,5,21,3,5,13,6,9,9,6,16,14,8,25,12,17,10,7,7,17,5,21,6,2,5,18,10,45,7,7,8,119,36,2,4,7,6,21,31,5,4,18,3,9,30,8,9,8,2,8,10,13,22,7,19,12,24,3,5,30,13,7,58,38,7,9,15,15,5,4,4,42,12,15,15,22,13,1,6,9,6,14,12,5,7,4,9,19,42,21,3,8,4,26,8,25,17,22,9,6,5,11,5,0,3,33,6,9,11,2,3,5,3,18,3,1,5,6,62,3,24,12,10,11,21,30,16,3,18,13,5,11,6,8,5,21,6,14,7,12,5,23,20,12,9,27,18,10,17,7,7,12,9,4,2,5,5,9,3,1,3,12,16,3,8,2,7,8,7,6,10,11,6,14,14,5,24,13,19,9,15,7,7,9,10,10,8,8,7,11,24,9,1,5,8,14,3,7,14,17,7,17,4,3,18,44,66,5,5,14,2,3,9,11,1,2,11,8,9,18,6,2,6,5,1,4,3,32,12,17,12,10,10,27,3,9,9,3,4,7,2,5,16,3,5,7,2,6,2,5,3,28,16,7,10,2,3,3,4,5,8,3,7,9,4,8,32,9,15,3,6,17,14,56,7,7,3,14,9,6,21,9,4,6,9,3,12,12,20,9,2,17,3,3,3,22,6,2,16,20,6,3,10,4,5,11,3,12,2,7,4,3,3,6,5,3,3,7,6,9,3,31,5,8,16,5,9,14,3,33,31,6,14,4,4,4,14,15,19,13,36,1,12,20,6,6,3,28,12,4,1,10,7,5,4,7,5,4,13,3,22,4,8,4,9,3,6,1,1,9,3,2,9,4,13,2,4,2,0,24,8,5
consequence,2,18,2,103,11,8,6,30,3,1,18,12,3,61,1,9,5,16,4,9,2,42,15,13,13,7,12,12,7,25,9,111,108,9,39,54,38,11,13,4,6,8,4,2,26,15,11,11,260,20,63,4,11,22,6,5,48,16,4,16,23,9,4,14,38,16,74,2,5,6,8,3,5,5,53,4,8,13,45,26,27,0,12,9,177,16,6,0,39,0,8,2,0,21,50,4,11,0,38,9,5,20,38,13,8,20,10,0,9,7,17,2,8,16,1,40,9,2,74,121,27,22,6,68,6,3,3,11,4,0,12,1,5,34,19,33,7,6,2,4,1,51,16,2,2,64,20,21,4,14,48,0,13,4,2,8,29,6,5,11,5,1,6,5,1,3,10,12,25,7,14,71,15,0,8,13,117,8,6,16,21,8,4,15,0,8,26,22,24,44,2,5,6,1,0,5,12,4,10,13,16,1,4,9,20,13,9,33,8,26,42,5,30,4,2,2,1,3,15,0,8,11,7,10,37,92,20,20,6,8,17,9,21,15,32,19,23,4,9,10,56,20,12,4,13,1,8,22,35,3,5,26,10,7,10,13,18,2,8,6,1,33,16,6,5,30,0,13,14,3,97,6,34,2,2,1,20,14,8,0,55,7,0,10,12,3,3,3,9,2,8,3,9,6,1,5,28,4,13,14,21,17,0,3,13,1,17,5,2,7,1,7,24,10,20,14,14,43,14,3,59,2,39,1,54,7,4,17,2,24,11,8,5,2,13,12,19,6,4,15,10,16,17,7,7,6,40,53,14,5,12,10,1,23,26,3,3,1,9,36,13,1,9,20,6,1,37,5,5,18,3,25,1,16,16,18,7,2,12,5,40,1,27,9,5,41,10,24,21,1,16,3,11,8,19,14,58,7,19,2,22,8,2,6,7,6,13,4,13,9,5,9,1,13,9,16,7,12,4,7,2,11,13,15,2,2,2,17,6,11,18,12,3,21,2,5,1,16,14,3,8,11,6,10,1,1,10,14,36,6,13,7,5,3,32,8,4,10,4,21,10,24,15,19,4,3,19,15,8,0,17,6,3,1,4,9,1,12,16,4,11,10,7,7,7,7,13,7,10,7,70,33,4,10,9,6,3,12,5,8,9,3,3,1,11,49,1,3,1,3,5,3,8,3,15,9,8,4,6,15,5,15,8,21,6,2,30,3,13,25,8,2,6,3,6,8,14,11,48,20,4,0,3,0,8,7,24,19,14,9,44,2,6,43,6,7,15,3,5,7,13,5,16,0,12,12,10,14,18,27,10,5,16,1,1,3,8,5,9,12,7,8,9,18,8,6,5,8,4,4,18,36,10,8,20,11,3,6,53,16,16,2,8,4,4,14,5,29,5,11,24,14,12,4,19,4,15,7,4,7,5,14,3,21,1,3,4,2,14,17,12,13,26,26,5,6,8,6,3,15,8,1,4,19,12,15,3,5,2,151,16,4,7,1,7,9,42,9,18,22,4,8,9,13,7,11,3,11,11,10,21,11,58,19,14,8,3,10,9,8,6,12,10,2,11,8,19,3,5,5,4,7,19,9,2,6,1,4,12,11,19,3,5,11,8,10,12,3,3,1,4,10,7,27,12,10,13,5,6,1,7,4,11,14,1,5,5,2,5,14,4,15,8,7,4,7,5,6,33,6,7,6,3,4,7,10,13,2,2,5,5,3,4,27,14,12,7,9,5,5,3,11,2,1,22,5,13,3,2,10,9,6,2,13,0,11,11,6,15,17,3,4,9,1,2,5,7,21,7,12,4,12,4,10,5,16,1,4,3,8,4,5,19,2,9,1,9,5,14,5,2,6,16,9,3,4,2,4,5,6,11,5,4,7,3,4,3,6,10,6,12,5,14,3,4,17,7,20,7,3,5,7,2,4,5,14,6,4,6,16,28,13,13,3,0,7,3,8,7,0,10,1,4,3,9,12,23,1,6,6,2,5,5,10,5,7,7,9,14,3,0,7,0,6,13,1,5,10,6,3,7,11,1,2,8,15,3,4,9,4,7,7,3,10,10,11,2,14,6,23,2,8,1,15,9,5,2,3,4,2,9,6,8,11,0,10,0,16,2,21,3,4,5,7,5,1,4,5,6,6,0,7,10,10,3,23,14,12,32,3,3,3,3,2,7,13,0,2,7,6,9,5,7,5,0,20,2,2,3,7,10,4,9,3,8,8,2,14,8,2,3,6,8,8,5,4,7,6,15,2,4,2,5,1,0,3,0,5,1,3
consent,10,35,10,91,3,1,5,25,0,0,29,4,1,35,1,5,3,4,3,1,0,28,1,12,4,10,3,3,1,7,6,86,62,5,19,12,16,4,0,0,3,2,8,1,15,11,12,2,216,16,36,2,3,10,1,7,24,9,2,4,10,9,0,5,7,6,35,0,6,6,1,2,2,8,21,8,12,4,33,5,5,1,8,1,159,5,1,0,16,1,1,1,0,17,13,1,10,1,13,0,9,9,22,4,6,7,3,0,5,1,12,2,0,10,0,11,8,4,42,84,14,14,1,25,4,3,2,5,2,0,6,2,0,16,18,10,12,0,9,1,4,11,15,1,2,31,1,6,2,8,40,0,9,1,0,11,17,2,8,0,2,1,2,1,0,2,1,9,7,6,8,40,3,0,1,5,81,1,2,7,1,3,1,4,1,3,15,9,24,34,1,3,2,1,0,3,4,2,3,3,5,0,0,7,13,5,2,7,11,10,30,5,15,3,0,1,0,0,15,0,2,7,2,6,12,34,5,8,0,0,8,7,4,10,7,7,18,0,2,4,66,11,0,4,8,1,2,4,23,6,7,1,7,3,3,11,2,1,2,3,1,13,25,2,1,11,2,2,3,1,59,0,8,1,1,0,15,0,5,2,12,4,0,10,4,1,0,1,5,0,1,13,3,2,2,7,29,4,7,11,20,13,0,1,2,0,10,6,0,0,3,10,11,1,4,2,5,23,7,1,51,1,12,2,44,10,1,12,2,10,0,6,6,4,3,9,5,9,1,6,5,2,1,12,0,1,12,43,4,4,8,4,5,5,15,1,2,1,9,7,4,5,2,9,4,0,27,3,5,3,2,3,1,0,2,8,0,1,4,2,53,0,18,6,0,17,0,8,12,1,19,0,17,67,12,6,39,4,13,0,13,0,2,0,1,0,4,5,5,2,1,4,2,10,11,11,11,1,10,1,3,0,9,5,0,1,0,6,3,2,1,6,0,11,0,3,0,21,1,1,24,16,4,15,0,2,2,4,17,2,9,4,4,1,40,7,1,12,2,18,4,11,8,4,0,0,3,5,2,0,9,1,2,0,0,1,5,24,6,0,2,6,4,6,4,3,2,2,2,3,24,17,2,2,4,5,0,2,6,2,3,0,1,1,9,1,0,10,6,0,2,2,10,4,8,7,4,3,0,2,0,12,4,14,3,5,10,0,16,10,11,0,1,4,9,1,7,1,21,4,2,6,2,0,0,6,3,3,16,8,28,5,7,27,1,4,12,0,4,2,6,6,22,0,13,8,2,6,22,16,10,5,9,3,4,8,3,2,0,8,0,11,3,4,4,2,2,3,1,2,17,8,7,1,4,2,0,1,79,7,16,2,2,23,9,8,5,18,2,1,10,15,20,3,15,6,10,0,3,1,2,0,0,3,1,0,2,5,3,27,0,6,15,7,2,4,5,1,0,11,3,0,5,15,4,7,2,8,2,120,13,1,4,10,2,5,16,9,6,23,3,6,31,33,17,23,9,10,5,5,5,1,47,23,31,7,2,5,5,3,3,10,13,1,5,3,8,1,1,3,13,1,5,4,5,9,4,1,5,16,6,4,7,4,4,2,7,3,1,3,7,6,4,4,10,10,6,5,8,1,2,2,2,6,2,10,3,1,0,4,3,6,0,3,5,3,4,3,25,2,11,3,0,2,8,0,3,2,2,12,3,0,0,6,0,2,7,6,4,0,0,4,3,2,21,0,8,2,0,12,0,4,0,10,1,5,0,0,13,7,10,3,8,1,6,1,2,18,4,5,3,9,5,3,9,4,5,8,0,18,5,4,10,2,4,0,2,2,12,3,5,9,6,6,1,7,4,7,3,9,6,1,3,9,2,8,0,7,0,3,5,3,3,1,2,3,4,8,8,4,5,9,1,9,7,3,7,15,6,7,21,17,4,4,1,2,3,2,3,3,7,7,4,1,3,4,0,5,0,3,0,4,2,0,2,0,8,14,9,5,2,2,4,5,9,0,4,0,2,6,3,5,0,1,9,7,2,4,6,2,4,3,3,3,4,1,9,5,2,4,0,0,2,1,10,5,0,8,0,3,2,4,4,7,1,2,6,19,6,5,1,4,9,3,1,0,0,4,3,3,1,6,0,0,3,9,1,1,1,3,2,4,3,0,0,2,0,1,8,4,1,2,1,1,0,9,5,0,0,6,1,7,2,0,6,1,0,2,3,7,2,2,6,1,0,2,5,0,9,1,0,0,0,0,0,0,0,1,0,2
impose,13,20,10,186,6,7,3,53,2,4,14,7,5,52,2,5,6,19,11,3,2,47,14,20,13,16,22,13,16,19,13,217,160,9,42,88,37,8,21,3,59,16,4,5,38,17,30,27,356,21,45,7,10,49,6,4,288,10,5,10,15,7,1,36,30,4,111,29,9,19,20,4,2,8,76,5,22,8,88,36,131,0,10,6,308,48,12,1,30,10,10,6,2,32,59,85,15,5,41,31,5,35,40,13,17,26,20,9,22,9,17,8,12,17,3,57,8,2,120,220,56,28,240,65,8,5,3,4,6,7,15,4,5,63,33,38,7,1,14,4,3,36,29,1,3,67,7,16,24,25,90,1,19,7,7,64,44,9,10,19,21,3,13,2,2,6,14,34,28,8,24,141,30,3,6,7,362,5,14,38,22,29,7,24,1,30,50,26,55,49,4,6,15,1,3,4,10,5,6,24,34,2,12,14,39,12,3,62,19,25,97,7,47,54,10,1,9,11,22,5,12,26,5,31,74,163,25,28,7,26,22,10,48,23,36,132,31,9,17,13,89,38,5,15,23,10,2,27,62,9,7,49,17,28,13,18,11,6,8,14,5,35,28,1,13,36,3,10,26,12,198,11,92,11,4,3,29,24,7,6,60,11,2,18,11,3,5,15,12,1,11,7,19,20,3,7,55,4,11,37,26,40,3,0,24,1,20,10,4,3,5,31,30,7,66,28,23,47,21,7,59,8,33,3,79,8,5,39,7,24,8,28,17,13,11,14,27,10,7,8,17,5,23,18,7,7,61,67,19,5,24,11,12,46,30,5,6,4,12,40,23,8,10,31,4,5,36,8,8,29,8,57,3,19,10,19,18,12,26,14,102,2,57,9,7,36,9,27,34,5,30,5,12,12,39,13,71,6,21,3,34,4,3,5,7,3,11,3,28,18,5,10,13,29,17,15,11,7,3,10,3,8,22,22,2,7,6,8,12,17,14,8,12,12,6,9,11,11,16,9,22,52,17,13,2,3,14,5,45,13,15,10,8,3,68,10,7,31,11,53,13,30,30,31,3,10,38,10,6,1,19,4,2,8,4,35,5,25,28,10,11,15,7,9,8,12,11,5,9,12,60,52,2,8,8,3,2,11,18,11,18,8,15,9,13,20,1,32,8,12,21,5,3,8,17,29,5,15,7,11,2,14,10,31,18,6,24,15,18,35,10,5,9,33,15,11,24,8,34,26,9,1,2,10,15,10,3,32,15,12,60,10,16,65,9,15,39,17,15,6,22,2,41,7,15,34,12,12,46,48,16,15,13,7,7,13,56,16,11,26,41,31,31,12,7,10,6,11,20,10,35,33,14,5,26,2,16,9,52,17,29,2,3,3,7,18,4,52,8,26,45,10,11,15,67,14,28,13,28,9,7,9,6,17,0,24,11,10,14,30,12,26,32,33,5,5,9,34,5,8,27,3,8,22,16,22,7,6,6,200,28,2,11,11,5,11,44,32,5,16,8,5,14,27,4,6,0,8,13,18,18,21,46,86,24,13,6,13,10,4,16,31,9,9,12,19,31,9,2,8,26,19,24,5,2,6,12,5,1,20,2,19,7,10,17,4,18,12,21,4,6,27,17,31,26,9,5,12,7,10,10,4,4,29,0,6,7,0,2,6,7,9,6,10,4,1,13,5,35,7,13,6,1,7,8,6,16,7,11,11,9,9,6,23,14,11,8,11,4,66,70,25,1,21,20,37,10,10,9,13,10,2,3,11,5,9,3,3,1,23,0,10,20,0,5,10,17,15,20,21,6,13,5,6,8,21,5,20,7,9,6,6,18,7,10,0,11,4,24,10,52,1,40,9,5,7,12,8,6,17,5,4,12,14,2,3,9,4,2,13,4,4,11,4,21,9,15,27,15,10,6,11,24,9,7,15,4,4,4,7,26,40,13,26,5,2,7,11,14,1,7,10,5,2,11,5,4,6,7,10,3,9,9,3,1,5,2,27,10,5,8,6,0,6,4,2,7,3,3,6,4,12,0,11,3,5,4,2,11,5,24,5,7,12,3,1,0,6,18,26,3,21,8,19,21,2,3,22,3,2,5,15,1,77,8,8,8,9,0,6,5,13,7,13,8,9,6,13,8,6,1,55,26,8,3,18,12,33,50,5,0,13,4,9,7,4,0,5,11,2,2,0,5,5,5,40,2,3,13,3,14,4,13,10,6,3,2,14,9,5,4,9,7,4,11,66,17,7,27,2,0,7,4,1,0,25,1,5,0,6
deem,9,54,9,278,14,3,4,54,4,5,22,4,5,35,8,10,7,24,3,6,7,54,11,23,28,23,4,13,6,15,12,225,119,8,55,54,45,15,12,3,11,5,7,1,46,17,47,17,438,18,58,1,16,17,5,7,137,36,0,17,28,6,3,21,19,1,99,3,11,15,4,14,10,7,39,10,12,3,81,15,43,0,18,2,254,22,7,0,59,3,14,7,2,29,60,18,16,1,29,4,24,32,50,11,12,38,10,2,12,4,19,5,6,25,0,30,14,5,128,173,44,12,9,65,7,6,1,3,4,1,9,2,4,68,18,36,15,3,12,4,0,32,37,9,5,73,6,10,10,22,105,0,21,3,4,20,25,2,17,6,11,3,4,4,0,1,3,7,15,11,19,78,16,0,1,11,223,3,12,21,24,26,0,14,8,14,33,16,50,65,3,10,2,1,1,3,21,3,4,11,20,1,1,21,32,9,6,31,22,41,85,5,31,17,0,2,1,2,13,8,3,10,10,14,65,116,26,22,2,11,33,15,21,23,24,28,37,7,5,7,75,28,12,5,5,7,6,11,53,8,14,20,22,11,18,17,8,1,9,16,0,29,54,15,3,52,0,11,11,8,251,10,36,7,10,0,28,17,24,10,56,3,2,28,11,1,4,12,9,1,12,6,17,5,3,15,51,13,10,23,17,69,1,3,11,1,24,5,0,1,1,8,26,2,31,21,12,48,13,13,57,12,25,1,72,14,4,24,6,30,6,10,18,10,6,33,15,7,7,19,12,14,15,15,5,2,64,71,29,6,22,17,9,31,33,6,8,6,29,26,19,6,0,14,7,1,89,9,5,6,3,21,6,8,5,31,17,7,17,12,139,3,93,8,0,42,0,29,37,8,34,6,22,27,70,6,123,5,50,1,40,1,6,0,3,12,10,6,43,17,2,11,6,17,4,6,3,9,5,3,5,25,30,28,4,4,2,15,17,12,14,7,9,19,4,5,1,33,10,2,20,20,10,12,0,3,12,7,43,7,17,17,3,10,65,13,1,15,7,37,10,26,21,17,8,0,8,18,14,0,16,2,4,1,6,2,5,28,18,4,3,12,7,3,6,8,14,4,2,4,77,63,4,2,9,22,3,23,13,9,13,5,2,0,18,40,2,8,16,6,6,8,12,4,19,26,9,18,5,6,2,20,15,35,19,8,35,11,24,46,15,10,1,13,19,5,70,17,42,23,7,5,3,4,12,12,3,15,20,13,84,12,12,57,7,11,28,9,5,12,53,6,55,6,38,23,17,8,45,34,15,15,23,1,7,25,18,10,5,22,5,27,8,13,21,2,10,8,6,22,31,40,11,4,17,3,3,1,61,29,30,0,5,9,15,24,11,48,6,1,22,29,26,12,41,9,42,10,20,12,19,14,6,32,3,10,16,13,25,35,18,41,33,22,9,1,4,6,5,25,10,3,9,35,11,46,4,9,11,252,20,3,12,10,13,18,57,15,7,21,13,11,36,37,12,14,2,14,16,18,29,6,87,35,52,7,11,23,7,6,13,30,28,15,11,25,18,5,11,18,34,10,19,14,6,14,11,16,20,1,13,9,18,5,14,10,14,4,8,10,9,17,5,36,26,40,15,9,24,4,15,5,14,38,3,8,5,2,3,18,7,16,7,2,14,8,31,4,64,8,19,9,8,16,16,5,15,13,4,14,11,9,2,18,5,21,10,20,9,9,9,7,10,5,29,21,14,9,1,14,2,7,3,34,11,11,9,2,17,18,0,9,19,5,12,7,9,42,17,14,8,18,7,10,10,29,4,13,6,10,12,15,13,9,4,2,11,7,22,9,15,7,14,13,8,5,5,12,10,19,11,4,11,20,12,10,2,17,7,7,12,12,17,9,6,13,25,28,14,12,25,15,4,16,5,10,10,12,16,10,17,43,10,11,0,9,7,9,8,2,11,13,12,3,4,5,4,11,6,21,5,5,10,9,9,11,4,17,22,2,11,18,5,6,23,8,16,9,3,7,9,18,0,4,15,19,12,4,7,3,13,13,4,8,12,7,6,15,10,24,5,7,12,23,20,6,6,22,2,9,19,8,9,15,7,14,2,29,6,9,17,3,22,11,11,3,5,22,8,19,7,16,4,9,10,18,13,29,57,5,5,5,4,5,16,5,7,7,38,11,4,5,8,10,4,23,5,5,6,3,7,12,6,8,12,13,2,10,16,14,4,13,10,14,12,9,16,0,8,0,6,7,4,0,0,5,0,14,2,0
china,16,15,7,75,4,11,7,11,12,4,17,16,14,59,0,5,1,7,5,2,2,33,13,17,37,24,19,14,4,16,15,123,129,9,27,67,48,4,1,4,2,13,8,5,14,8,11,15,230,39,27,4,8,72,2,3,12,18,3,10,47,8,3,13,31,16,81,7,2,23,9,3,2,0,43,12,23,5,22,15,37,0,23,3,183,5,12,0,50,4,10,0,1,20,44,1,22,7,37,12,12,44,31,4,9,17,1,10,6,4,13,1,13,9,14,32,12,2,40,100,36,54,5,57,24,0,0,4,5,2,15,1,7,42,10,37,6,2,2,6,3,61,15,1,5,52,14,22,9,17,88,10,17,1,2,2,48,9,1,18,4,0,4,1,1,10,10,22,12,15,18,58,17,3,5,10,88,0,9,21,15,2,3,22,16,35,34,19,41,35,8,2,6,3,1,2,3,6,20,8,36,0,0,6,29,1,2,4,7,46,56,11,24,4,2,11,2,0,11,0,5,6,4,5,29,51,49,8,15,1,19,10,8,13,19,4,6,22,0,8,21,29,8,20,18,3,7,9,31,7,12,13,20,1,5,9,7,2,3,6,4,26,4,6,9,15,1,1,4,4,87,21,20,3,2,2,21,11,16,2,18,0,1,22,11,3,4,2,1,1,4,25,5,3,6,3,45,9,14,6,17,28,0,3,3,1,49,1,15,9,13,18,21,19,20,4,6,42,13,5,84,7,36,0,26,13,2,23,0,22,0,10,1,0,6,4,24,21,3,8,0,31,8,1,5,15,39,36,22,4,4,4,6,25,15,3,9,0,9,25,15,7,8,16,9,1,28,0,58,40,1,28,0,4,1,9,4,3,11,1,40,4,24,25,0,9,31,15,17,5,19,2,11,18,37,3,45,0,22,13,14,6,1,7,7,1,4,4,61,23,2,30,8,6,5,20,12,11,3,1,8,5,12,4,3,2,5,8,9,18,3,7,0,13,20,10,11,44,3,2,12,18,8,18,30,22,8,9,29,3,30,6,4,14,50,11,0,2,4,34,12,16,27,35,3,10,14,34,12,0,19,6,2,3,0,9,5,34,16,1,19,20,5,1,9,11,9,1,14,7,51,29,1,4,6,10,5,18,12,3,5,3,0,0,5,4,0,15,11,0,2,3,17,3,4,1,3,2,0,28,4,30,4,17,1,4,24,0,13,5,7,1,7,4,4,0,3,3,35,4,4,11,2,1,19,1,3,8,11,21,0,4,0,15,2,2,46,1,2,12,13,3,22,4,11,7,27,2,46,41,4,7,16,8,6,0,11,2,0,14,11,10,11,10,5,20,5,8,12,1,13,31,11,14,16,10,0,3,125,29,14,1,6,7,6,14,9,2,2,9,11,44,18,2,16,3,5,9,2,3,8,1,1,8,0,6,8,9,4,32,2,5,12,8,12,8,5,5,3,16,13,2,0,3,11,18,4,23,0,193,20,14,12,0,6,5,21,6,6,13,6,12,17,29,15,7,5,2,7,8,16,10,14,6,29,0,0,9,5,2,3,49,8,14,20,1,15,12,6,27,6,22,7,54,12,12,19,6,2,13,1,4,11,9,9,2,41,5,0,4,0,8,2,17,1,5,5,3,12,7,14,0,20,12,3,4,9,3,7,16,4,8,2,2,2,2,7,1,10,1,21,3,5,10,19,18,8,24,8,3,4,2,0,18,2,15,2,15,12,7,5,15,2,0,12,12,11,2,2,16,15,13,5,8,5,8,6,1,1,2,0,1,7,0,12,1,0,0,5,5,5,2,4,2,11,3,19,2,7,0,0,1,20,1,5,1,3,2,12,7,5,6,28,8,16,6,7,25,14,5,2,3,16,4,2,3,5,17,1,0,9,9,0,2,7,8,14,41,4,1,8,0,1,1,10,23,9,34,6,24,16,11,14,3,10,1,13,3,7,1,1,2,8,9,2,4,24,2,1,16,4,1,1,21,1,0,11,27,7,110,9,6,8,3,30,5,11,11,7,4,10,16,0,5,2,4,2,0,13,6,3,5,1,7,2,13,5,21,7,8,2,71,8,20,13,15,1,6,4,5,6,11,1,1,10,9,35,32,7,0,6,5,3,1,2,11,3,3,5,4,1,1,0,0,7,25,13,6,7,13,0,1,1,0,8,6,2,10,6,9,0,1,4,7,2,11,8,0,1,10,4,2,5,14,3,6,0,2,1,2,5,3,7,0,4,0,2,5,1,0,1,4,2,2,3,0,5,5,7,2
accordance,8,15,7,74,3,2,4,15,0,2,13,9,6,33,4,6,7,6,2,0,2,12,0,6,4,8,6,7,1,8,10,87,64,4,17,5,19,1,1,0,5,0,2,1,14,12,11,12,146,1,13,4,4,12,1,4,23,15,0,7,16,7,1,10,7,1,31,0,4,13,3,5,1,2,34,16,4,5,39,7,18,0,5,3,128,3,7,0,24,2,6,4,0,12,24,8,12,1,19,6,6,12,15,1,12,10,8,1,4,0,11,4,6,6,0,11,7,3,49,76,14,6,16,16,5,1,2,5,1,2,6,2,4,19,9,32,3,0,4,1,1,28,9,4,0,33,1,8,7,5,30,0,7,3,4,5,11,2,5,0,3,2,2,2,0,4,6,9,4,2,7,35,9,4,0,9,73,1,6,11,5,1,3,7,1,7,14,11,35,36,0,1,3,0,0,2,16,2,3,13,11,1,1,7,13,7,4,9,1,22,20,3,17,2,0,0,0,2,6,3,2,10,2,10,24,65,9,8,1,5,5,7,8,14,11,5,10,1,2,10,27,13,2,4,4,4,6,9,26,4,6,2,10,4,7,6,4,2,4,9,6,19,20,6,2,21,3,2,10,0,50,4,19,2,3,0,3,9,11,2,12,5,0,12,2,1,0,3,2,0,8,9,9,6,5,2,19,2,4,16,8,17,0,4,10,0,18,6,7,0,3,19,14,2,20,7,7,23,2,4,16,3,8,0,53,4,8,3,1,22,3,2,3,2,3,6,8,8,0,1,7,8,5,8,1,5,22,24,5,1,12,7,7,15,14,3,0,3,6,10,17,4,7,4,0,0,18,0,4,3,1,7,1,10,7,15,8,0,16,0,54,1,19,7,1,7,3,10,11,1,16,2,5,15,20,2,22,2,17,2,6,1,5,0,2,5,3,3,6,5,8,2,2,7,24,4,2,5,1,1,7,5,6,6,0,2,2,10,7,7,5,3,1,5,5,2,1,12,8,0,3,7,9,5,0,3,3,1,12,1,5,6,2,1,38,17,0,7,3,12,4,9,11,25,0,0,2,6,10,0,9,3,0,0,6,23,0,6,11,1,4,3,0,8,9,5,7,0,4,2,57,20,0,3,2,2,1,10,4,7,8,2,0,2,5,15,1,11,1,2,2,1,10,6,6,9,5,4,3,3,3,11,4,16,7,3,9,12,6,5,12,0,2,3,10,6,6,7,20,8,3,6,0,2,1,2,0,11,13,5,21,8,7,17,3,6,16,2,3,4,7,3,25,4,3,10,14,5,17,18,4,3,13,3,4,4,4,1,3,7,4,5,5,7,4,13,8,7,1,5,23,20,4,3,13,1,10,2,37,9,22,0,4,3,9,16,2,7,12,3,9,14,10,4,26,5,6,0,8,1,3,1,1,4,1,3,4,6,7,15,1,5,10,12,3,1,5,6,1,6,12,1,4,8,9,25,2,3,1,97,12,2,3,0,3,5,18,16,1,7,3,7,20,22,6,5,15,8,6,12,6,0,11,22,14,8,1,6,6,2,4,18,6,6,2,3,6,5,1,10,8,6,4,6,2,5,3,4,19,9,4,1,3,3,7,3,7,5,3,4,4,14,1,15,9,5,3,7,2,6,5,2,1,8,0,3,0,1,5,8,6,4,3,5,1,3,18,5,14,7,9,3,3,5,3,1,8,9,4,5,1,3,1,7,2,4,5,7,4,2,4,7,4,5,2,6,6,2,3,13,2,1,2,10,7,8,1,1,2,3,1,1,6,2,6,4,2,0,4,4,2,3,3,6,4,8,2,3,4,4,9,0,15,1,1,0,4,2,4,1,4,3,2,4,4,6,1,9,3,10,0,1,11,9,3,0,1,8,2,0,0,0,3,4,1,7,8,9,13,3,3,3,3,6,3,3,2,23,5,5,35,9,4,2,3,4,7,3,4,0,4,3,2,0,5,3,1,8,9,8,3,4,4,1,0,2,8,5,7,3,15,3,5,2,8,6,1,2,3,0,1,9,1,2,3,4,5,2,0,0,6,1,2,9,3,6,2,3,10,20,5,0,3,7,6,8,0,7,2,2,0,4,3,12,6,2,5,4,4,3,3,3,4,1,3,1,3,1,4,10,2,1,2,1,4,8,5,13,15,2,0,2,2,2,1,3,3,9,8,2,0,14,2,5,3,19,4,1,2,3,5,2,8,1,0,2,0,2,2,4,1,6,2,1,4,6,7,0,22,3,2,1,1,0,1,1,1,1,1,0
annual message,3,26,5,155,6,2,2,8,5,3,18,7,4,21,2,1,3,4,0,0,3,12,2,17,16,5,3,7,3,4,4,114,67,4,25,6,24,1,1,1,0,7,3,2,21,7,10,4,208,8,26,2,9,12,6,4,32,34,0,11,15,2,0,4,19,0,24,3,5,11,2,2,4,1,25,5,9,5,31,7,27,0,6,1,133,6,5,0,162,0,2,2,0,27,27,2,9,2,23,5,17,13,13,3,3,29,1,0,4,0,9,2,4,4,0,23,27,1,34,74,16,4,3,41,8,3,2,1,2,1,5,2,0,20,13,15,4,0,3,3,0,12,40,2,1,30,2,8,6,11,26,0,10,5,2,20,4,2,2,0,9,0,0,4,1,0,3,8,7,5,13,29,3,0,0,7,94,5,4,15,9,6,0,4,7,6,14,8,36,41,0,3,2,0,1,2,3,2,4,4,12,1,0,12,17,2,2,16,11,14,36,0,12,4,0,0,0,0,8,1,2,5,3,7,24,66,12,16,2,4,5,11,5,7,15,15,16,7,4,3,40,18,1,2,4,2,4,4,38,5,10,12,14,3,4,9,8,4,2,8,5,14,17,6,4,23,2,2,2,2,65,7,21,3,2,0,13,7,24,3,14,4,1,6,5,0,1,4,8,2,3,0,9,3,3,7,26,15,2,6,11,50,3,0,3,1,13,2,4,0,0,5,14,3,12,12,6,19,5,1,23,1,4,0,24,7,4,8,6,10,3,7,1,2,6,12,7,1,2,1,2,4,8,6,1,0,36,34,5,3,3,12,4,16,8,3,2,1,15,22,15,6,3,6,8,1,23,3,4,1,4,7,2,1,4,19,4,0,8,2,31,1,24,6,1,15,2,14,16,0,14,1,8,13,26,4,65,9,19,7,11,0,2,0,1,1,2,0,21,7,0,3,6,8,14,5,4,4,3,0,3,8,13,6,0,0,3,8,8,6,13,5,3,9,0,7,0,13,7,1,6,11,4,4,0,0,1,7,17,2,3,6,1,2,30,0,0,8,2,15,7,6,12,4,2,4,8,5,4,0,7,0,1,3,3,1,0,8,6,3,3,9,2,5,5,3,6,0,4,4,23,27,0,1,8,10,0,7,2,15,3,3,2,1,8,6,4,16,3,2,2,6,3,1,15,26,1,6,7,3,1,12,3,9,3,3,14,3,9,19,4,2,1,5,4,2,15,1,19,12,5,2,2,1,4,7,4,14,8,8,8,3,5,20,0,5,23,2,2,5,10,4,12,1,14,14,11,4,29,26,5,1,15,3,7,4,12,4,0,11,5,11,5,3,5,5,0,8,1,8,11,21,3,5,10,6,0,0,53,10,9,0,4,4,8,21,5,21,5,3,10,25,11,3,18,3,15,1,5,4,7,2,5,6,2,2,5,14,14,17,3,36,8,7,5,0,8,2,2,14,3,0,1,15,9,24,2,2,5,125,13,0,8,5,4,5,18,5,2,2,4,4,13,17,9,7,3,5,7,4,12,4,34,17,25,6,7,8,1,5,5,14,9,7,9,5,4,1,6,7,10,1,11,13,8,7,5,7,7,18,11,3,1,5,10,2,8,2,0,8,1,3,1,20,5,13,4,7,2,3,3,3,6,16,2,4,7,0,1,6,4,8,3,0,3,2,12,3,23,6,9,4,1,4,4,1,3,4,2,4,11,4,5,17,13,15,5,12,3,4,6,11,3,2,10,5,6,4,3,8,1,1,0,11,1,8,3,3,19,4,2,2,8,0,1,5,1,14,3,4,19,5,2,9,16,6,7,18,7,9,2,0,5,4,0,3,3,2,25,6,6,7,4,7,2,1,2,3,7,7,9,3,0,6,4,3,0,2,2,5,2,3,5,1,4,2,4,14,5,4,8,2,3,5,5,2,3,5,7,5,7,19,6,4,0,2,3,8,6,1,6,0,6,4,3,12,0,4,4,50,2,5,5,5,1,3,3,4,20,2,5,7,2,0,8,6,7,4,2,5,6,1,0,3,5,3,2,0,3,1,4,6,2,13,10,3,6,8,2,12,0,1,3,11,6,3,3,3,2,4,6,11,3,10,1,1,2,22,3,2,13,1,8,5,6,3,3,2,1,4,3,2,3,3,5,9,2,2,17,6,3,2,0,1,4,2,4,1,14,4,3,2,1,3,1,4,5,2,2,2,0,3,1,0,16,7,0,4,7,2,3,4,4,2,21,2,0,0,17,1,1,1,3,0,0,0,0,9,0,0
instance,6,11,6,60,1,3,5,19,2,4,7,12,4,54,3,6,2,14,2,2,2,19,1,19,25,7,4,5,5,5,9,123,78,4,30,14,27,6,14,2,3,1,8,1,17,12,3,13,185,2,29,4,4,13,5,6,30,8,0,12,10,7,4,8,12,3,45,7,6,11,3,2,2,6,44,7,23,1,60,20,22,0,9,5,141,17,3,0,20,1,4,1,0,23,24,12,17,3,16,10,14,17,27,2,9,15,5,9,10,2,11,5,4,5,0,9,4,1,33,106,40,5,4,33,6,0,3,1,1,0,9,3,8,23,15,34,10,5,1,10,1,20,20,4,3,49,2,8,11,4,42,0,5,4,5,6,23,4,6,7,3,8,8,11,0,5,5,17,13,5,3,74,18,4,0,7,103,1,9,29,23,8,1,23,1,17,24,32,32,31,0,7,6,1,3,1,12,1,5,11,14,0,2,8,13,2,6,15,6,24,59,2,17,3,2,0,0,0,4,1,2,17,2,8,17,108,25,20,4,2,12,10,5,12,17,10,20,6,3,6,40,28,4,7,8,2,1,6,38,1,8,20,7,3,5,11,16,4,2,25,8,12,11,1,2,32,10,4,12,4,76,3,13,2,1,1,23,6,6,3,60,9,4,12,8,1,3,10,12,3,6,2,13,4,2,2,19,5,6,13,16,19,3,4,5,2,16,2,4,2,0,17,9,4,12,12,9,25,5,2,42,10,24,10,55,5,1,16,0,17,3,16,4,0,9,14,14,7,5,4,7,3,8,3,3,3,28,29,9,4,7,5,3,33,20,0,6,9,14,16,20,6,10,21,4,1,18,11,5,16,3,7,2,8,16,17,5,5,8,3,25,2,25,10,2,35,11,22,19,0,18,6,7,4,16,8,34,1,17,6,28,4,1,0,4,0,5,5,7,6,4,4,2,8,2,7,4,5,5,0,6,8,11,14,1,7,4,7,8,9,7,2,0,4,1,1,0,7,3,6,13,17,2,8,4,1,7,6,26,3,9,8,4,2,26,10,0,7,6,33,6,9,28,19,7,5,6,17,6,2,7,7,2,4,6,20,4,12,12,7,8,5,2,7,7,4,6,5,6,2,51,24,0,2,13,7,2,10,5,7,15,2,3,0,9,5,8,6,4,8,7,1,6,6,7,13,0,9,16,5,3,12,4,25,3,2,32,8,18,14,12,3,6,11,3,4,6,5,24,23,2,1,1,4,3,6,1,7,15,16,16,5,14,28,0,5,18,2,4,10,16,11,24,3,3,10,12,7,21,35,8,2,11,4,9,1,19,5,4,12,11,6,8,6,7,5,4,9,3,12,11,30,13,8,25,3,4,1,24,9,7,3,4,1,3,16,6,26,3,3,23,16,3,7,39,4,13,3,12,3,7,0,3,10,3,3,3,6,10,13,0,20,14,25,5,5,9,8,0,7,11,3,4,7,7,11,1,3,5,101,13,2,6,1,5,5,22,13,6,11,3,3,2,7,1,2,1,7,7,14,15,7,20,24,21,4,1,6,2,7,4,15,10,6,3,1,6,2,0,5,6,5,16,4,3,4,11,4,10,5,9,3,5,1,12,2,11,3,4,1,1,1,8,9,17,18,7,4,6,6,5,4,6,21,5,5,6,2,7,8,7,5,3,6,4,2,22,3,9,3,16,2,2,13,13,1,14,4,6,9,6,5,1,2,4,8,9,3,1,16,14,12,2,3,5,7,10,7,8,8,9,7,0,18,1,13,10,1,7,8,6,1,12,6,10,3,7,11,7,8,3,13,6,5,23,13,13,3,2,2,0,3,8,1,3,1,6,4,13,4,6,2,8,5,4,5,2,9,4,9,8,3,10,18,3,2,1,4,1,3,7,2,4,5,4,6,7,15,7,7,3,2,3,5,7,7,8,10,0,4,11,11,7,1,2,1,8,7,4,0,2,10,1,4,6,8,14,4,5,7,6,15,5,1,6,3,2,7,7,0,0,3,1,2,4,1,3,4,4,0,4,10,0,2,6,2,6,0,6,5,2,1,3,4,1,1,0,3,3,12,1,4,4,5,10,1,1,4,3,4,2,3,3,11,4,3,0,5,5,2,0,1,10,3,3,2,2,1,9,8,7,5,5,0,2,4,3,5,8,4,1,3,5,3,2,1,1,3,4,6,4,8,4,3,0,11,3,6,0,5,4,1,2,1,1,0,1,5,5,8,1,1,2,0,6,5,2,0,5,1,2,1,0,0,0,1,0,1,2,0
branch,4,30,24,171,9,8,6,26,3,2,10,10,7,46,8,4,7,16,8,3,5,30,4,19,14,18,10,14,0,13,14,144,83,10,48,33,12,8,8,4,4,6,3,11,26,19,18,15,208,22,47,2,10,18,2,3,57,51,3,11,19,2,1,7,21,6,88,10,1,23,11,1,6,5,66,16,13,3,71,19,53,0,5,3,225,17,12,2,32,1,0,4,0,18,49,12,17,10,19,22,18,26,17,3,16,22,5,6,5,1,17,6,12,6,3,19,6,2,65,151,38,7,13,67,9,1,2,3,2,0,5,1,0,48,19,49,3,3,3,5,3,21,20,4,2,53,2,10,21,26,37,0,9,6,5,21,24,10,6,11,10,4,7,1,4,10,3,15,24,4,20,69,12,5,3,6,131,6,11,24,28,7,2,15,10,17,36,22,29,38,0,4,6,1,0,4,18,2,6,12,27,3,1,8,17,11,6,55,6,28,66,3,23,6,2,1,2,2,29,2,10,14,8,9,65,92,28,28,6,12,23,9,21,21,29,34,19,10,4,6,64,28,5,0,15,1,4,20,45,8,11,20,10,10,15,18,8,0,6,17,17,27,17,6,10,92,7,1,4,11,98,9,50,5,6,4,15,26,15,7,79,8,4,21,9,3,3,7,9,1,0,2,11,5,3,14,28,4,10,17,14,35,1,2,14,0,15,13,0,3,3,15,27,7,31,30,21,27,8,7,20,8,21,5,33,3,8,22,1,31,6,19,2,1,2,22,19,3,7,6,6,1,18,14,8,5,45,33,16,3,16,12,9,38,16,25,1,8,14,35,20,18,11,13,7,4,29,9,4,6,7,8,3,7,7,136,17,5,10,6,52,2,29,12,1,35,16,15,22,1,16,6,24,16,27,4,53,18,36,7,18,4,4,2,10,6,4,1,17,15,1,7,0,19,3,3,6,2,3,0,1,5,15,9,1,5,4,17,6,13,11,5,4,6,1,6,0,6,6,6,9,16,5,3,2,1,3,2,31,3,11,14,4,3,44,13,1,9,8,35,5,13,29,28,9,4,13,8,4,0,7,4,5,1,2,13,1,25,16,4,5,5,1,3,5,10,15,2,2,8,50,44,0,0,15,6,8,21,9,7,8,8,5,0,8,50,2,19,5,14,13,2,4,22,16,14,3,6,4,12,3,6,10,20,5,4,34,4,7,23,6,4,4,11,8,12,8,9,26,19,0,1,2,1,7,4,0,18,8,14,44,12,4,23,18,28,27,12,4,8,15,7,19,8,13,12,13,4,32,31,12,7,20,6,7,5,4,10,4,22,13,17,15,11,6,0,7,7,4,12,28,31,5,5,23,1,3,6,15,9,19,3,6,2,6,18,11,114,3,8,13,22,12,4,20,9,22,4,10,6,13,8,7,11,3,12,6,10,17,36,13,29,15,13,13,5,9,9,5,18,3,2,11,26,6,46,2,2,3,105,3,6,12,17,5,5,27,2,1,9,6,4,4,9,5,3,0,9,9,10,32,12,14,25,29,2,7,12,0,3,6,29,7,14,12,8,12,1,7,15,13,14,14,7,4,9,8,4,17,14,9,7,10,12,1,2,16,7,3,5,2,5,1,25,8,29,4,10,9,28,10,1,2,43,8,7,3,4,9,10,8,29,3,2,6,6,57,3,16,6,11,4,7,12,10,7,23,10,13,6,9,7,4,23,16,16,4,26,6,3,2,12,4,1,22,23,11,9,15,11,4,2,0,4,3,13,8,4,6,10,3,5,14,7,5,3,8,17,5,18,3,13,4,10,12,11,8,5,8,8,4,1,9,5,4,7,5,7,17,3,8,6,2,8,6,1,2,4,1,10,3,7,1,7,7,3,2,14,4,8,10,6,19,4,6,10,8,11,10,7,2,14,8,9,18,3,8,5,13,8,10,23,5,16,9,18,10,6,10,3,5,6,15,12,2,9,6,5,4,14,10,12,2,5,5,9,1,5,12,4,3,1,6,2,7,4,6,9,1,10,2,4,1,4,3,2,3,4,2,3,7,10,5,5,4,3,0,5,11,15,2,11,6,10,14,3,8,6,1,4,5,6,9,12,3,13,1,2,6,16,9,8,6,3,4,3,10,4,4,19,9,10,17,6,7,14,12,14,43,2,4,0,4,5,14,6,8,3,18,5,20,6,3,5,2,10,5,3,13,3,5,5,5,4,7,3,0,5,16,4,18,7,8,5,5,9,7,5,5,0,5,4,14,4,0,6,5,6,5,4
prepare,13,17,9,118,11,14,7,21,2,5,6,17,17,65,4,8,6,12,4,6,2,21,10,20,8,9,9,12,9,15,13,146,95,7,37,50,56,12,3,4,2,10,4,2,28,6,18,11,170,42,32,9,11,47,26,3,27,42,12,16,13,5,1,16,20,8,60,7,9,14,13,5,3,4,123,5,20,9,70,15,37,0,18,11,109,11,11,4,27,3,12,3,1,19,34,5,13,3,26,14,8,27,19,12,8,18,4,6,13,5,24,5,18,19,14,25,2,5,38,92,26,16,8,61,13,4,3,6,2,2,15,4,4,36,14,76,4,3,4,10,4,23,9,0,1,61,4,14,11,12,37,6,15,11,8,18,36,9,7,18,7,5,16,3,3,6,10,23,17,2,16,64,33,4,4,7,96,5,6,33,28,12,21,17,3,17,26,14,13,42,5,5,4,3,3,4,30,3,8,9,13,1,3,5,25,8,9,26,7,20,54,7,14,11,5,4,0,31,14,3,4,17,6,12,37,44,15,13,12,10,12,12,15,7,26,9,34,11,6,2,33,34,4,2,16,1,4,20,37,5,10,15,22,10,9,11,6,2,2,13,0,30,25,7,6,52,18,11,6,3,103,10,22,5,3,1,13,13,9,11,46,2,2,20,17,5,4,12,16,4,4,7,17,9,8,6,25,11,7,11,18,33,1,6,4,4,20,4,7,7,3,7,27,7,19,7,9,23,12,4,23,3,14,14,36,6,4,23,4,23,4,4,4,6,3,8,10,6,0,6,9,9,13,6,8,6,22,29,9,9,2,3,2,20,9,2,3,7,7,20,13,4,15,16,5,6,20,7,12,9,4,13,4,11,4,27,10,2,11,5,38,2,32,8,7,27,1,15,14,0,12,5,15,8,15,9,39,4,24,6,11,8,4,4,3,3,8,0,8,11,2,10,10,12,5,11,1,1,5,5,1,3,23,9,5,1,3,14,13,16,15,8,3,9,4,2,1,11,16,2,11,6,8,16,4,8,23,6,27,7,21,2,5,5,40,4,2,1,5,13,11,21,19,35,11,9,13,3,8,2,14,2,3,4,3,15,9,19,14,8,5,19,1,2,14,4,12,7,2,6,96,30,1,1,10,5,9,7,8,2,15,1,3,0,3,16,6,2,4,1,4,2,11,3,11,10,3,6,4,3,4,5,3,7,3,4,17,2,15,14,10,5,7,6,3,2,11,5,19,14,2,2,3,20,10,10,2,12,6,4,16,3,6,33,7,8,21,2,0,4,18,4,16,4,8,11,6,4,32,17,4,5,22,1,12,3,9,1,5,22,8,16,9,17,6,6,4,3,4,14,14,12,2,3,19,10,9,2,30,16,14,7,1,4,7,15,4,26,2,3,18,22,15,6,19,8,12,3,2,5,17,10,4,22,6,6,3,12,8,13,7,19,15,15,10,2,15,13,3,7,9,2,1,15,4,46,1,11,5,108,14,8,4,2,7,8,25,11,8,9,2,6,8,12,8,5,15,17,4,5,13,4,33,9,16,4,3,10,4,5,7,20,10,10,18,7,3,1,5,19,8,9,6,19,13,19,10,2,4,10,2,3,2,2,2,1,18,16,2,4,4,7,2,19,14,28,9,7,1,5,9,6,3,23,11,4,6,1,0,7,11,18,6,6,9,4,27,10,30,10,4,6,12,17,14,8,11,7,6,5,7,5,1,4,3,6,7,12,2,8,7,11,6,3,14,10,12,2,17,7,6,3,5,12,5,3,5,0,6,4,5,2,8,8,7,9,2,21,5,13,8,7,5,6,3,4,1,8,3,2,0,5,5,5,0,5,4,1,8,0,8,4,6,9,4,4,2,5,3,8,3,5,7,25,14,4,8,10,12,4,4,7,12,10,3,4,4,17,10,5,7,3,1,1,1,6,8,10,4,3,10,16,9,3,5,6,4,3,2,1,2,2,7,5,2,5,5,8,6,7,1,4,9,7,7,2,3,2,8,3,2,8,2,1,9,3,12,5,0,9,5,10,8,1,5,6,11,5,17,5,2,6,6,7,2,4,0,4,5,11,2,4,2,11,2,2,2,8,5,3,3,11,1,3,1,7,2,11,1,8,9,9,4,6,0,1,4,4,1,16,3,6,5,1,5,9,7,26,29,2,6,2,5,7,6,4,13,4,15,6,5,5,1,4,2,19,5,1,2,5,10,3,5,4,5,0,2,4,3,4,2,8,3,4,2,0,7,5,1,3,9,3,5,3,1,4,3,7,12,4
expect,16,29,7,173,12,11,5,39,8,7,43,14,22,96,8,15,9,19,21,11,8,66,21,21,35,26,19,27,9,20,19,259,198,10,76,125,49,15,37,9,14,21,8,3,47,26,22,35,387,37,77,12,16,46,13,15,68,57,10,42,29,19,5,16,27,20,121,22,14,41,89,10,5,7,115,22,34,4,114,40,78,4,47,11,322,35,27,3,52,11,31,8,13,50,94,20,36,11,69,16,30,36,56,21,20,30,10,6,39,14,28,12,10,18,5,46,2,8,96,241,54,24,28,125,9,5,7,11,6,4,26,11,9,71,34,68,8,8,14,10,4,52,47,11,5,87,11,21,36,24,85,7,26,10,7,36,44,9,23,14,32,10,11,2,37,12,4,39,30,14,28,120,31,8,9,14,228,5,22,40,33,12,13,35,7,30,68,42,36,95,4,7,6,5,8,5,19,8,9,24,61,13,10,22,36,19,7,54,17,55,106,8,36,10,3,16,3,14,11,3,13,15,13,24,77,99,45,50,5,77,24,28,30,25,38,50,64,15,14,8,88,39,8,11,16,13,9,23,47,4,14,52,39,16,15,28,25,6,14,15,6,26,35,7,14,60,13,7,15,9,260,22,55,3,10,3,16,52,22,3,89,6,3,35,11,7,11,17,22,4,4,2,9,37,12,15,107,10,10,24,41,33,13,10,14,5,34,3,9,8,3,23,42,9,59,23,31,72,18,12,75,18,49,10,87,5,16,45,7,36,3,28,10,6,11,27,26,13,19,24,20,17,32,14,7,11,61,91,29,15,17,11,8,36,36,14,7,10,29,51,18,24,13,26,16,8,51,6,12,23,3,29,7,13,7,44,13,10,35,20,80,3,58,12,5,67,9,36,34,9,51,11,18,18,37,18,96,10,31,2,33,1,12,3,10,2,9,7,39,20,3,19,12,28,17,20,8,13,6,6,10,6,22,20,5,8,7,24,16,26,6,30,7,14,6,7,0,23,10,8,22,18,9,29,3,10,8,9,45,17,26,8,7,7,77,15,1,12,10,44,23,35,45,39,15,5,26,15,17,5,15,4,3,4,5,21,10,28,27,11,9,25,13,10,20,12,13,7,9,6,132,52,4,11,17,12,8,17,21,17,23,8,6,3,18,40,20,21,9,11,9,9,16,9,16,22,13,17,4,17,4,22,12,28,7,8,30,13,33,47,18,10,8,9,13,9,13,19,40,34,16,2,4,13,12,18,8,23,35,7,35,5,6,49,15,10,72,4,8,11,30,5,40,5,29,19,26,8,43,47,19,16,27,8,6,9,8,5,15,26,14,23,27,21,14,11,11,15,7,15,36,56,15,7,32,8,6,5,72,31,28,7,9,5,11,36,13,32,11,12,25,29,32,14,47,15,38,6,7,6,16,13,6,24,7,6,16,10,24,38,11,32,23,41,12,7,12,18,4,18,24,6,7,35,23,30,13,17,10,211,33,5,15,3,9,33,41,29,9,18,6,7,16,34,18,4,6,14,18,21,30,12,66,40,58,6,5,22,4,7,7,52,33,17,14,9,21,17,5,32,13,14,25,34,17,42,12,7,18,14,41,7,8,11,16,18,1,12,8,12,8,12,12,42,23,39,13,14,10,12,8,10,12,39,5,22,27,8,11,19,7,23,13,4,15,12,27,12,41,14,17,12,5,9,17,5,20,13,7,14,17,26,33,11,6,23,14,23,1,8,8,18,14,9,27,19,9,15,11,12,6,10,5,19,6,18,13,3,27,21,10,7,23,7,17,13,12,24,13,25,16,6,3,9,8,30,14,2,11,7,6,9,22,7,10,8,11,7,33,12,10,5,18,20,7,8,9,19,9,16,12,3,15,23,14,12,6,6,11,22,15,17,20,6,6,20,27,39,13,11,19,9,9,16,13,21,11,4,10,19,42,38,13,18,7,3,12,12,7,3,13,7,15,5,4,20,4,9,9,24,7,12,26,17,6,8,11,24,15,11,10,9,4,10,24,13,15,10,15,10,11,31,2,8,14,6,5,10,4,8,14,19,3,17,12,7,11,8,14,37,15,24,11,28,23,14,12,19,9,10,20,13,7,18,8,16,8,40,5,9,7,6,12,11,7,12,8,12,13,15,4,20,22,17,12,32,24,49,58,13,5,5,9,6,4,19,19,12,20,16,8,14,5,16,8,19,8,5,4,21,20,7,18,11,13,14,5,12,9,11,17,12,14,10,5,9,17,7,32,7,8,4,7,2,1,16,2,8,5,5
ready,3,10,8,60,12,10,3,19,2,4,10,2,10,72,5,6,5,17,8,3,3,30,19,29,13,13,41,12,14,23,13,127,91,36,29,72,61,7,6,12,6,11,2,3,32,9,22,6,148,38,46,8,14,40,18,5,25,15,9,15,11,7,1,10,16,8,72,3,4,14,6,6,9,7,76,12,33,3,93,15,27,5,14,12,86,5,14,3,19,2,13,5,8,37,24,7,15,3,25,11,7,23,22,11,8,32,3,4,10,7,20,4,4,4,7,31,1,3,43,98,28,21,2,60,9,4,4,3,6,0,14,8,3,30,30,49,4,2,6,11,5,22,14,1,1,69,10,9,15,6,40,7,6,23,5,7,25,11,4,22,4,5,2,3,3,13,7,15,17,4,14,73,20,3,9,2,91,4,12,30,26,5,9,24,7,12,25,16,13,32,4,9,3,3,1,3,29,6,11,6,9,3,1,3,25,10,5,6,11,19,36,10,11,13,3,7,2,6,10,1,3,11,6,13,30,49,10,16,12,3,10,14,8,22,52,2,26,6,7,11,60,33,9,5,13,1,3,28,22,5,5,5,17,8,10,16,7,6,0,11,2,56,14,1,4,13,9,11,13,4,98,3,11,12,3,4,28,8,4,1,53,6,2,16,5,3,7,16,15,4,2,3,6,4,3,9,26,1,2,18,16,12,0,4,6,3,20,2,2,4,4,8,31,6,10,6,8,18,4,6,27,5,24,10,59,4,8,30,5,16,9,11,8,3,16,10,21,3,2,13,9,18,20,10,6,5,20,31,15,9,5,5,5,29,12,5,5,7,8,21,7,10,11,17,10,11,18,7,5,14,1,18,0,17,7,34,7,2,20,5,67,6,41,8,10,29,1,16,26,1,21,8,8,7,18,10,20,7,24,5,7,6,3,3,6,3,5,2,19,9,2,10,2,10,9,8,4,4,19,9,6,2,11,6,2,4,3,2,12,10,9,3,1,11,5,2,7,12,26,6,10,23,8,20,1,5,9,9,26,8,18,5,11,7,32,8,9,3,1,15,12,44,22,44,6,6,17,4,7,1,15,6,0,4,6,6,6,16,12,1,4,15,6,3,6,6,12,9,1,2,88,21,3,5,8,2,8,7,4,6,5,6,1,4,11,8,4,4,2,5,1,1,11,5,7,9,4,5,1,5,3,6,3,8,2,6,12,3,9,18,9,5,6,5,3,4,8,12,18,11,1,0,5,4,7,10,1,11,9,3,12,5,0,17,10,7,19,2,5,1,10,3,7,6,12,11,11,6,22,29,2,4,14,0,4,5,0,4,2,11,8,14,9,26,6,8,5,4,1,14,17,25,6,2,7,1,1,4,21,18,18,2,5,4,2,16,2,25,5,4,16,12,2,8,13,4,8,5,7,1,8,6,4,14,2,2,13,10,10,23,5,12,16,16,4,6,1,10,3,9,5,2,2,11,3,19,4,4,3,91,16,4,1,0,2,4,29,7,0,6,6,5,4,13,4,6,1,6,4,3,14,4,40,2,6,5,2,2,4,4,4,17,9,4,8,7,4,10,2,8,5,17,17,9,8,21,3,3,12,4,5,5,2,3,7,16,12,1,6,2,1,4,3,22,9,34,9,6,11,9,12,5,5,16,11,2,6,1,3,14,2,4,3,4,3,1,29,5,23,12,4,5,6,14,23,4,12,7,5,4,14,1,2,2,3,20,2,9,0,8,7,19,1,7,9,4,5,3,3,4,7,0,0,4,6,5,3,2,2,4,1,2,12,3,11,6,1,25,6,4,3,3,1,3,6,6,5,7,2,0,3,6,8,3,7,6,6,5,10,4,6,3,6,6,0,4,3,7,1,6,3,2,8,5,3,3,13,0,2,3,4,4,10,15,4,3,9,12,11,5,1,3,0,0,5,9,7,5,9,6,19,19,3,4,2,2,2,4,2,4,3,4,3,0,2,6,2,3,9,3,1,3,2,0,2,2,1,4,5,3,0,3,0,1,3,0,1,2,3,5,8,8,5,3,3,0,7,1,6,15,5,2,12,4,2,1,7,5,0,14,7,0,4,4,1,2,5,7,3,2,7,5,1,4,2,6,0,3,2,7,2,3,3,3,1,2,7,5,2,3,4,11,5,1,3,6,4,5,11,1,5,4,0,10,5,2,6,4,14,1,5,3,1,0,2,19,1,1,4,10,15,6,8,6,6,2,7,4,6,4,3,4,1,2,4,2,9,5,6,3,2,7,6,3,0,1,1,9,4,3
repeal,0,7,9,87,3,1,0,29,0,0,8,2,0,24,3,1,3,6,4,0,0,14,10,17,8,2,8,3,0,14,3,64,38,5,13,6,3,18,5,1,6,0,0,2,10,8,18,6,135,1,21,0,9,9,4,0,51,11,3,3,6,0,2,6,13,1,39,6,0,7,12,0,3,3,27,9,10,0,38,7,17,2,4,0,85,6,3,2,8,3,3,1,0,13,22,11,4,3,17,4,2,16,17,4,1,13,4,2,6,0,9,2,2,4,0,14,3,2,80,94,20,2,35,26,2,4,1,2,0,4,2,0,0,24,10,11,1,1,4,0,1,10,10,3,0,23,5,10,7,8,36,2,9,2,0,10,7,0,1,2,14,2,6,7,10,3,0,7,12,10,4,18,6,0,0,4,82,2,2,5,12,3,6,5,0,5,15,12,14,12,1,3,3,0,1,3,6,0,0,3,14,0,6,2,5,3,4,25,2,8,27,2,28,3,2,6,1,2,10,3,2,12,3,4,20,153,6,13,2,29,2,3,9,10,10,47,10,1,13,1,35,23,4,2,3,0,2,4,15,5,12,17,3,11,4,3,1,2,1,7,2,15,7,6,6,19,0,3,3,1,52,7,19,1,1,0,4,3,3,2,15,7,1,4,7,0,5,5,7,0,0,0,7,1,4,9,28,3,7,12,6,32,0,0,5,0,1,1,0,0,0,7,13,2,17,11,6,17,7,3,6,4,9,0,24,7,0,17,3,9,7,3,3,2,5,7,6,1,0,3,3,2,6,6,4,3,26,14,5,2,6,5,7,14,5,3,4,0,3,12,33,4,3,12,1,1,25,3,3,10,1,12,4,1,3,6,1,6,11,2,44,2,20,1,1,22,1,13,11,2,6,0,5,3,22,4,28,1,13,1,16,1,2,0,1,3,8,1,2,7,0,6,5,14,9,4,0,5,1,0,6,1,6,7,0,2,0,3,3,8,15,2,3,8,4,0,0,0,0,0,7,10,3,6,0,0,0,1,10,4,5,2,0,6,13,5,0,5,4,24,4,2,7,11,10,0,7,22,0,0,7,2,0,0,0,2,0,8,3,2,3,4,1,6,2,1,3,1,1,5,34,12,0,0,1,4,1,3,4,11,1,2,2,2,1,15,0,11,4,2,5,1,3,2,8,13,0,3,1,5,0,2,1,8,5,2,5,5,7,16,12,1,4,2,2,3,6,2,12,9,7,2,3,1,6,3,0,5,10,1,31,8,35,10,3,6,9,2,6,2,6,2,19,2,4,9,6,4,14,11,1,4,8,7,1,4,8,1,0,15,14,2,14,1,6,4,0,2,3,6,14,9,4,4,12,1,2,3,8,12,8,0,4,0,4,11,0,13,3,6,15,6,1,6,16,6,11,7,8,7,5,13,2,21,4,1,6,9,1,17,12,9,12,16,8,4,3,0,0,0,6,0,9,5,4,20,4,1,15,71,1,2,3,8,5,6,21,3,5,8,6,10,7,8,1,0,0,1,2,7,10,11,5,45,11,4,3,4,0,4,0,8,2,0,6,4,3,1,0,0,20,2,11,1,3,3,3,1,21,8,0,3,0,4,3,2,8,6,1,5,1,4,8,16,4,5,1,2,5,0,2,1,2,9,0,0,4,0,5,2,4,4,2,2,1,4,2,1,9,4,5,0,2,4,2,3,15,1,4,5,5,6,4,6,6,3,3,2,4,14,16,1,6,0,10,17,0,2,0,3,1,0,1,11,1,6,3,1,2,12,0,10,3,2,4,2,11,2,6,10,3,10,1,6,4,2,0,6,4,3,5,0,5,0,3,0,6,3,10,3,10,0,0,1,5,0,1,2,3,6,1,3,0,2,0,6,1,5,4,5,4,1,5,1,7,8,7,5,6,0,2,7,8,2,7,8,6,1,2,2,6,12,3,5,0,3,1,4,6,2,2,4,2,1,6,4,2,0,8,14,5,8,4,14,2,3,1,7,5,0,0,13,4,2,1,1,1,6,1,0,0,0,1,2,4,2,3,1,3,0,12,2,2,1,0,0,0,7,2,7,3,2,3,8,11,2,0,0,0,4,2,1,1,2,0,6,1,7,2,7,1,0,3,1,0,4,6,0,2,3,0,5,3,2,1,16,7,3,30,2,1,1,0,7,0,14,0,0,10,2,1,1,2,0,0,3,3,0,4,0,2,6,9,1,0,0,0,2,2,1,1,5,3,17,2,5,3,1,0,0,0,1,0,1,0,2,1,0,0,0
transmit,8,12,7,160,9,1,5,25,5,1,19,8,5,17,3,4,2,4,2,0,4,7,0,8,7,9,3,12,1,12,8,80,44,3,19,21,16,2,0,0,2,3,2,1,10,9,10,9,197,7,30,0,4,9,7,1,18,59,0,6,2,1,2,7,4,2,29,0,4,4,20,0,1,3,19,5,8,2,34,8,10,0,7,1,115,5,3,1,36,0,7,1,0,10,20,4,15,1,16,0,9,7,15,2,3,11,5,0,5,0,7,0,2,3,0,6,9,4,28,50,8,3,2,37,3,1,0,1,1,0,5,0,1,28,5,14,0,0,2,3,1,6,14,5,1,27,1,3,0,2,17,1,12,0,3,9,6,4,3,1,8,1,0,4,4,1,0,8,3,4,20,20,8,3,0,2,69,1,2,11,7,9,8,6,3,6,12,4,20,18,1,3,0,0,0,1,4,1,0,4,8,0,0,8,11,3,2,10,6,14,39,3,7,2,0,0,0,9,8,1,1,6,3,3,15,38,15,4,2,5,2,6,7,16,9,12,13,6,2,3,21,7,4,0,2,2,2,0,25,0,3,6,9,2,4,6,6,0,3,3,0,9,21,8,3,48,1,1,6,1,50,1,25,1,1,0,6,9,13,3,17,5,0,2,3,2,3,7,6,0,5,6,3,8,2,5,49,13,2,3,5,18,1,3,3,0,12,5,2,0,2,0,12,3,11,7,4,14,6,0,21,2,7,2,23,2,3,12,3,11,9,1,1,3,2,15,2,14,1,6,6,11,1,6,3,2,21,32,10,2,3,3,1,9,13,2,4,3,3,13,11,4,6,11,1,1,19,3,2,1,1,4,0,0,1,14,3,0,2,6,32,2,18,5,0,11,2,9,12,5,6,2,9,17,25,2,44,5,24,4,10,1,1,0,0,0,2,1,9,2,0,4,0,5,4,5,5,2,2,2,0,6,10,4,0,1,0,6,9,11,3,8,6,12,1,7,0,8,2,1,4,7,2,3,0,3,5,4,11,1,2,6,1,1,14,4,0,9,1,16,3,1,7,2,2,0,4,3,0,0,2,0,0,1,0,3,2,10,6,1,0,5,3,2,0,4,2,2,0,2,46,18,0,2,3,5,1,7,5,2,4,1,2,1,4,0,4,17,4,5,1,2,4,2,5,13,3,5,1,0,1,9,1,12,2,3,13,8,9,6,2,0,0,2,7,4,5,2,20,7,1,4,0,0,3,3,2,5,7,1,38,3,2,23,2,1,13,0,3,5,15,2,13,1,9,3,8,1,24,4,4,3,17,0,4,4,0,2,0,14,1,14,1,3,1,1,1,1,3,5,9,11,1,3,9,1,0,0,42,10,12,2,3,18,7,7,6,13,7,1,8,28,11,2,10,1,8,1,1,3,8,0,0,10,1,1,13,6,10,14,0,21,9,12,5,1,1,1,2,6,3,0,3,36,5,46,3,5,5,87,8,2,3,3,3,11,15,5,6,3,2,3,25,10,14,9,2,6,7,6,7,5,40,9,18,3,5,14,3,2,5,12,7,7,8,9,3,4,5,3,13,0,13,6,0,8,1,3,4,10,4,4,8,1,5,4,12,2,5,1,1,7,3,10,8,27,5,5,4,4,15,6,4,12,0,4,3,0,1,6,3,9,3,1,3,2,9,1,27,1,4,2,0,5,6,0,5,5,2,10,10,13,3,10,2,11,3,4,4,5,4,4,2,4,6,5,6,4,5,1,2,0,0,5,1,8,2,2,1,6,0,4,1,1,4,1,1,27,3,10,3,6,3,5,4,8,2,13,0,4,1,4,8,8,1,1,1,4,10,1,0,3,1,11,2,2,2,6,2,5,5,4,11,8,5,2,1,6,6,3,4,3,7,3,1,2,5,11,5,16,13,3,2,5,0,6,0,6,8,3,13,23,4,2,2,1,1,3,4,0,6,2,5,4,1,3,0,3,3,21,1,3,1,0,2,0,9,1,12,5,4,11,0,1,30,2,6,11,2,6,0,3,0,3,2,7,1,9,1,0,1,24,3,4,15,5,2,7,0,9,5,2,2,9,7,9,2,5,1,5,7,2,2,11,6,7,1,29,4,0,7,4,9,2,2,3,0,2,2,4,1,3,4,3,1,8,2,12,25,4,2,0,2,1,1,2,10,1,13,2,2,1,0,2,2,9,6,1,7,0,0,4,5,1,6,2,0,2,3,9,14,0,5,0,1,1,1,1,13,1,3,2,6,0,0,1,0,2,1,0
govern,0,20,8,66,8,3,13,11,2,3,11,13,4,34,1,12,4,6,4,5,2,18,8,11,7,5,5,5,1,7,6,69,38,13,41,49,19,1,1,3,4,10,2,1,17,11,8,8,120,9,19,8,8,23,4,0,33,1,4,9,11,4,1,1,13,8,107,3,1,3,1,0,2,3,66,9,9,0,38,9,10,2,9,10,124,4,8,1,11,1,6,8,1,7,20,3,10,1,26,4,4,10,13,8,2,15,1,0,5,3,7,0,0,10,6,17,2,2,25,67,20,8,2,33,9,0,1,0,2,1,6,7,7,14,15,18,7,2,3,9,9,12,12,6,1,16,5,12,2,4,43,1,10,1,3,19,16,2,9,12,3,2,5,1,1,3,2,7,11,5,21,37,14,0,0,4,83,10,7,10,12,3,0,6,1,18,5,9,13,23,6,5,0,3,3,3,2,7,0,11,7,0,0,5,14,11,6,26,3,17,59,2,9,2,0,7,1,1,10,1,0,11,2,7,23,58,25,13,1,1,3,5,5,10,9,4,22,2,2,2,30,11,4,6,5,1,4,6,20,5,6,1,13,1,5,2,4,0,4,9,2,13,10,1,6,12,3,7,7,0,94,2,3,2,0,0,10,2,3,0,18,3,1,8,3,1,0,3,7,0,1,1,2,1,0,1,12,3,3,8,9,5,0,1,7,3,10,3,3,0,2,4,11,0,5,6,4,16,4,1,19,7,20,0,30,3,8,24,0,19,4,2,8,3,7,8,11,2,0,8,6,9,11,7,3,3,25,22,7,7,4,15,4,10,9,0,3,12,6,8,10,2,11,7,1,1,10,5,3,12,3,6,1,2,6,8,4,1,5,0,37,5,17,3,0,9,2,4,12,1,20,4,7,12,9,8,23,0,18,1,5,3,3,3,6,1,3,0,5,2,1,3,1,5,16,10,2,6,1,1,4,1,11,5,3,2,2,10,1,15,2,1,0,2,1,1,0,2,3,7,3,15,1,7,4,1,2,3,9,3,6,8,2,4,23,27,1,5,7,5,11,5,15,8,2,28,9,6,4,0,7,0,1,5,2,6,4,14,7,3,2,8,2,8,8,12,7,0,1,2,18,11,1,4,2,2,2,2,3,4,1,0,4,0,0,7,2,6,5,5,3,5,1,11,5,6,6,16,1,3,1,9,7,20,3,5,3,0,4,15,1,2,0,9,11,4,4,13,31,6,2,5,1,1,5,3,15,12,5,2,39,2,6,15,1,10,4,1,0,2,16,0,13,3,9,12,3,2,7,13,3,7,2,1,6,2,1,2,2,6,1,2,1,19,8,0,4,8,0,8,17,21,4,1,4,3,0,1,11,21,10,1,3,1,3,12,4,20,5,3,16,6,2,4,23,6,9,0,7,7,4,1,1,6,1,1,2,1,23,19,0,8,28,7,3,1,3,1,3,3,5,4,3,13,2,3,2,2,2,62,31,8,6,2,1,4,18,9,2,4,10,0,8,13,1,2,0,8,3,5,10,5,20,40,6,1,2,2,2,6,5,3,8,3,3,8,9,0,4,0,6,11,5,5,0,4,4,7,6,9,0,4,1,1,2,4,8,1,1,1,1,3,6,8,4,7,4,6,3,1,1,7,1,5,1,2,2,6,2,6,6,6,1,2,1,1,4,4,24,4,10,7,0,1,1,1,2,1,4,4,4,1,1,2,2,3,1,8,2,0,0,16,0,0,12,9,13,3,1,3,12,1,2,8,3,9,2,1,9,3,4,2,7,1,2,0,6,6,5,6,0,8,0,2,0,17,0,2,2,12,5,3,9,3,4,3,9,1,13,1,5,0,0,1,0,3,3,5,5,6,2,1,13,3,1,8,0,1,5,4,2,0,10,2,5,6,8,8,7,2,2,3,8,9,1,3,1,1,4,4,10,18,3,3,0,2,4,0,5,3,2,3,4,3,5,3,4,5,2,5,2,3,0,3,4,4,1,6,1,5,0,5,2,1,3,3,0,2,2,1,0,2,0,1,1,4,2,9,5,3,4,4,3,2,10,1,3,1,3,16,1,0,5,1,9,1,2,0,0,1,2,3,4,1,4,2,1,2,0,4,2,1,6,2,0,1,2,1,1,1,1,3,0,0,1,1,5,2,4,3,0,1,1,3,0,0,5,0,5,2,2,0,7,1,0,2,1,0,7,1,2,4,1,1,3,4,0,4,3,7,0,4,1,1,2,3,4,0,6,0,4,1,5,1,2,0,2,1,2,1
july,29,23,3,141,5,1,4,12,14,1,17,24,19,25,5,4,8,21,1,1,3,28,4,19,13,14,3,22,6,80,11,204,78,7,25,21,31,26,9,2,1,0,6,9,15,7,14,13,373,10,23,2,0,13,1,2,62,81,0,14,17,3,1,20,11,2,31,11,5,16,19,6,0,3,29,3,15,3,72,10,84,0,14,2,175,17,10,2,156,16,34,0,2,55,73,21,22,11,27,9,14,28,23,1,7,19,16,4,27,14,27,2,8,14,0,25,48,8,177,75,22,41,17,167,10,2,4,5,17,1,4,1,2,37,9,40,3,4,5,1,3,26,59,4,6,60,1,7,15,31,28,1,6,4,1,15,23,3,15,3,26,1,7,23,17,1,10,11,9,6,26,63,6,4,2,8,152,3,5,7,18,17,1,9,5,6,24,6,32,99,7,1,11,1,1,4,5,6,19,7,7,1,4,11,20,1,11,20,7,18,70,0,21,7,4,0,12,10,19,0,66,23,7,15,30,71,42,27,14,39,7,43,34,11,15,32,33,0,17,7,46,16,10,2,7,9,7,19,54,3,3,15,9,24,9,3,15,18,9,49,5,42,32,22,9,84,0,1,0,5,124,15,125,4,3,0,18,63,14,1,19,3,2,12,2,1,1,7,7,1,71,29,4,28,25,6,56,12,2,11,14,42,15,38,3,2,7,7,1,0,3,7,21,1,65,42,5,51,9,1,29,2,11,5,22,5,2,18,8,32,2,7,7,1,3,13,14,6,8,44,9,18,3,9,6,1,35,37,15,3,15,9,0,19,15,9,0,0,10,87,13,6,2,5,2,0,30,3,6,2,8,7,4,0,2,34,2,0,6,15,27,0,36,15,2,62,0,38,66,0,13,3,7,17,30,0,60,7,36,8,13,4,5,0,7,0,5,4,28,9,1,10,24,5,9,1,11,5,6,1,3,8,9,17,0,2,4,9,13,46,60,47,41,75,7,10,1,31,2,5,16,14,8,9,1,2,5,3,22,15,11,8,0,4,42,15,0,13,6,35,10,16,19,18,3,24,6,24,4,1,19,3,8,0,6,4,0,12,15,1,5,5,4,3,9,4,6,7,0,16,109,69,2,3,8,5,2,33,3,6,7,5,4,1,22,16,3,10,7,6,2,2,12,8,10,9,2,1,3,5,2,15,4,18,9,3,22,6,11,16,4,3,4,7,17,9,4,4,24,8,3,4,4,0,8,7,103,16,10,12,12,5,8,44,4,1,17,2,10,6,18,10,34,2,4,7,9,3,21,24,7,6,34,5,4,0,15,6,6,54,3,16,5,2,3,4,8,5,7,6,10,17,7,6,8,0,1,1,90,7,13,1,0,8,13,14,5,11,6,4,22,32,26,9,28,7,12,3,5,4,8,8,5,48,9,4,16,3,1,31,40,13,14,7,7,1,1,8,7,4,1,0,4,33,6,81,3,20,6,300,47,2,2,2,9,23,31,6,9,33,4,10,47,31,16,10,12,12,5,13,13,3,52,23,48,5,3,9,40,4,24,24,11,11,19,6,9,8,8,10,38,2,27,15,7,26,10,6,27,17,8,14,3,1,5,7,12,4,4,7,3,1,10,22,13,28,33,4,11,3,4,2,9,26,1,8,7,2,3,5,3,16,7,4,4,27,15,5,27,3,8,6,6,15,12,1,7,7,0,4,2,57,56,159,58,7,3,12,8,64,74,6,38,114,23,23,21,3,8,11,3,3,6,15,4,6,9,4,7,6,5,0,16,5,12,4,3,8,2,12,4,19,9,9,12,9,1,15,13,15,8,5,13,11,1,3,5,7,12,7,28,7,42,9,1,13,4,9,9,12,5,9,28,15,4,3,0,20,1,6,27,25,6,1,1,6,13,18,4,5,17,5,3,8,3,12,3,21,2,5,8,34,4,15,1,7,6,18,14,9,17,3,7,1,3,5,3,9,12,11,11,5,22,6,2,3,6,18,10,9,13,37,3,14,24,8,12,5,4,5,7,10,2,9,1,95,0,12,20,5,3,8,3,7,9,58,7,18,17,13,2,41,6,51,9,28,4,7,5,6,5,10,12,8,6,5,4,24,3,11,4,1,2,10,5,11,4,7,1,11,5,9,80,31,25,52,13,89,161,1,11,3,4,3,5,122,27,4,35,0,0,7,6,8,15,56,7,16,1,3,3,6,2,2,6,5,4,5,11,7,24,3,4,41,3,7,3,5,37,0,1,1,9,0,0,8,0,25,2,1
cease,6,12,9,77,2,1,2,31,0,1,11,3,7,38,1,3,4,9,2,3,2,20,6,24,9,0,9,10,3,17,6,91,78,7,23,18,35,8,11,0,5,8,3,1,16,3,8,6,188,4,26,1,5,12,7,6,67,9,0,8,12,5,0,7,19,2,51,6,7,9,4,0,2,4,39,3,16,1,56,21,28,0,14,4,119,20,7,0,23,0,7,5,1,28,30,16,10,0,22,9,3,14,15,2,1,15,9,3,9,5,10,3,0,7,0,25,4,5,32,98,19,11,6,51,8,6,1,2,2,3,5,1,6,31,19,15,4,1,3,4,3,25,28,1,0,26,8,9,4,11,32,1,13,4,0,10,20,5,8,8,10,1,4,0,0,0,12,15,25,6,16,49,6,0,7,9,115,1,5,15,12,10,1,6,0,6,18,12,13,28,1,6,3,0,1,2,3,0,1,12,9,3,0,2,15,3,1,11,7,17,48,3,14,17,1,0,0,0,2,2,2,14,1,19,18,54,11,21,4,4,9,4,10,11,19,44,22,4,7,4,41,24,7,4,9,4,6,9,11,3,3,26,8,9,10,9,6,0,2,4,1,18,8,5,1,9,2,3,8,4,87,4,39,3,3,0,11,5,5,0,25,8,1,11,11,0,1,3,8,1,4,4,4,3,2,8,9,5,3,8,20,10,3,2,5,0,9,1,2,3,0,5,20,1,27,9,5,20,3,5,38,3,12,4,52,2,3,14,5,12,3,7,2,4,3,11,9,5,2,9,5,6,8,7,2,4,46,35,7,3,8,4,5,6,13,4,2,3,9,25,7,2,6,5,1,0,27,7,2,4,1,16,1,5,3,6,4,1,13,8,47,4,21,3,4,17,1,15,19,3,14,3,7,2,17,9,36,1,21,1,13,1,2,1,2,2,6,4,10,2,2,11,4,8,3,9,0,7,2,2,5,4,7,12,0,4,4,9,6,16,6,5,2,5,3,5,0,4,3,2,8,18,2,3,1,2,2,5,25,3,12,1,0,4,22,2,0,14,6,28,7,13,23,13,3,6,11,9,1,0,8,4,0,1,1,8,6,6,11,2,8,7,4,4,5,6,11,8,5,2,63,18,0,3,8,2,3,12,8,2,2,3,2,0,5,29,4,3,5,2,11,2,1,3,13,10,0,10,0,6,4,11,4,15,2,3,13,7,5,17,8,6,3,9,5,5,13,9,38,10,4,2,0,2,7,3,2,10,18,0,25,4,1,33,4,2,17,10,5,1,14,2,16,1,8,17,5,7,21,15,7,9,7,4,1,1,6,3,3,5,5,7,11,3,7,3,4,5,0,4,12,21,3,2,13,8,9,4,31,10,11,0,10,3,3,9,6,16,2,7,22,8,3,6,15,4,21,3,1,2,3,9,3,7,0,5,5,1,5,19,9,10,19,9,3,6,1,7,2,5,3,4,3,12,3,12,3,2,5,102,14,4,6,4,6,18,21,9,11,11,3,9,16,11,2,4,1,2,6,8,12,5,39,4,12,7,0,1,8,1,7,15,11,1,7,7,13,3,6,2,16,4,7,1,3,8,7,4,17,5,2,1,1,8,1,2,12,3,8,3,6,10,1,7,8,7,7,6,1,1,0,1,6,5,1,3,8,0,2,5,3,4,5,3,2,1,1,2,25,5,12,1,0,1,4,1,6,1,5,5,8,3,4,5,6,10,9,3,2,20,16,5,8,8,12,11,4,1,2,8,3,5,1,12,1,10,8,0,19,12,9,0,6,6,5,3,9,12,5,6,5,2,2,6,4,12,3,6,3,0,0,2,4,3,1,1,9,2,7,3,13,1,10,4,2,2,6,8,4,9,3,2,2,3,1,5,1,3,7,4,6,5,9,7,6,3,9,18,4,1,3,2,3,4,3,5,8,2,0,6,14,19,4,11,0,5,5,6,7,0,1,5,4,1,1,5,7,1,6,1,1,9,1,6,6,6,4,9,6,0,3,9,4,13,5,3,3,4,6,2,2,5,0,7,6,6,2,1,0,7,5,5,4,11,7,5,4,3,0,7,3,7,5,6,4,1,1,5,2,4,8,2,6,20,2,1,1,5,4,0,2,0,5,4,1,1,2,3,2,0,2,13,5,7,8,11,22,3,21,0,0,3,4,2,4,9,0,1,3,3,0,4,6,0,0,12,4,1,5,3,10,11,4,0,1,7,0,3,5,11,2,3,6,6,6,1,1,1,8,1,2,0,3,0,0,2,1,2,1,0
measure,7,54,20,393,31,10,10,91,11,4,48,18,14,123,16,25,10,19,16,9,13,92,24,46,28,28,19,34,12,25,40,313,282,14,122,114,102,24,44,7,19,18,8,8,65,53,108,36,623,31,98,13,31,57,15,19,152,54,5,41,55,15,11,42,38,11,220,14,24,14,34,11,10,3,178,33,34,17,185,41,117,12,35,12,413,46,34,4,76,7,18,6,6,81,156,20,54,11,84,41,25,78,70,26,37,63,31,8,28,14,33,18,28,39,9,75,13,9,147,441,101,26,47,122,11,15,13,15,6,8,25,3,13,95,24,84,13,8,10,21,6,84,56,3,6,214,13,25,37,18,152,1,25,28,8,45,42,20,16,26,40,9,33,9,17,6,13,42,50,22,40,153,38,6,9,26,390,7,24,79,56,36,28,26,4,44,71,52,108,110,5,9,18,2,6,4,40,15,16,18,54,5,19,26,67,25,16,81,25,56,172,10,85,28,2,9,9,16,26,4,10,40,18,34,135,191,41,64,10,24,37,28,44,53,82,72,71,23,16,18,163,72,22,7,27,23,16,32,78,15,42,55,44,12,24,40,22,9,8,38,12,66,52,13,12,58,7,8,29,9,331,25,42,16,8,6,45,33,36,8,123,22,8,34,26,4,20,12,35,14,13,2,52,19,10,22,120,21,18,41,52,119,6,10,48,9,75,3,28,5,7,38,64,31,81,35,48,104,27,19,75,22,47,19,160,9,22,53,8,42,15,25,18,10,18,26,44,17,12,34,36,29,35,28,18,12,97,152,48,13,32,28,13,85,44,5,7,6,26,55,55,27,27,38,9,7,92,25,26,19,8,50,9,23,12,61,23,9,49,17,175,9,121,44,4,48,11,38,58,12,48,10,57,30,114,31,177,15,76,9,49,9,8,4,13,18,13,16,42,37,2,16,14,31,51,32,11,18,4,4,9,12,50,31,2,9,19,29,31,31,27,18,5,19,9,9,1,29,32,6,24,63,18,40,2,9,18,15,74,13,44,25,6,21,113,29,1,19,10,90,29,34,62,33,18,23,31,30,26,2,38,10,4,4,24,19,5,49,31,4,11,43,6,20,25,24,29,9,9,7,209,107,1,9,17,12,3,34,31,26,28,13,7,7,9,71,7,38,16,19,11,13,25,12,41,74,26,20,6,23,10,32,14,54,20,12,60,10,39,61,19,13,10,14,23,18,36,15,72,36,10,7,9,7,24,26,18,35,26,20,122,8,9,87,20,23,75,8,10,23,78,14,46,11,40,51,30,12,97,80,40,21,42,9,15,11,24,8,32,40,22,30,24,23,35,11,14,19,7,41,48,100,13,9,35,3,19,23,83,48,114,12,15,9,21,81,13,67,5,14,44,32,21,16,53,30,46,10,36,13,36,11,13,33,12,22,25,34,33,66,25,55,56,55,14,6,17,21,6,28,22,12,23,35,21,70,17,10,29,331,73,16,18,23,14,38,93,31,10,30,38,13,30,36,15,11,5,15,22,25,33,24,61,26,42,21,12,34,14,16,8,70,44,18,28,23,23,19,12,18,37,33,39,24,26,25,27,4,31,36,17,15,20,9,25,19,42,22,16,10,8,22,7,1,42,55,26,39,18,12,14,12,16,42,7,19,20,9,7,22,22,41,10,21,16,10,46,9,75,27,19,15,9,18,21,13,44,12,9,11,20,10,5,19,1,24,24,37,12,30,27,26,6,10,43,40,15,18,26,21,14,3,7,25,19,33,31,5,28,24,19,25,23,14,27,25,10,36,15,37,18,20,11,21,11,29,5,13,9,9,10,10,47,24,12,5,25,19,39,20,18,4,22,29,12,20,16,13,10,30,11,3,35,13,6,16,3,26,11,22,17,19,37,7,7,37,40,37,41,11,19,36,9,20,17,20,29,11,24,15,89,41,19,22,8,11,23,15,8,3,9,12,20,15,21,17,5,19,41,53,5,13,16,37,16,11,10,44,28,6,4,8,5,9,14,10,20,13,10,16,3,17,3,22,20,16,22,13,8,4,18,15,12,22,37,12,8,28,12,85,24,30,15,25,26,7,11,20,8,9,27,11,9,22,4,33,8,37,14,20,8,8,16,18,11,6,14,8,9,26,13,17,16,14,15,37,20,44,80,18,10,10,8,20,11,6,8,13,47,18,1,17,14,13,7,66,6,9,18,23,13,23,24,14,20,8,10,28,18,13,5,18,21,14,19,19,31,16,63,9,8,8,17,4,7,7,8,17,9,1
limit,8,32,10,244,5,3,15,73,5,9,33,13,21,78,10,12,9,22,12,8,8,62,12,33,31,22,18,19,9,14,14,251,166,12,87,69,58,31,48,11,12,8,3,5,37,32,51,14,603,23,69,9,30,39,11,24,74,38,3,18,35,9,5,14,18,16,150,12,14,25,36,12,12,9,112,21,33,5,114,27,75,5,27,7,334,24,24,4,53,5,15,8,9,56,69,27,38,15,48,28,31,45,67,21,21,44,14,9,27,11,21,7,12,18,5,47,8,13,100,238,79,15,20,124,12,2,6,3,12,4,18,13,5,82,29,53,11,5,8,8,3,45,46,10,6,87,10,24,21,32,107,7,20,19,15,69,49,9,12,9,16,7,18,2,6,7,6,34,31,13,31,114,29,3,2,8,224,4,20,42,48,27,14,20,15,30,53,40,56,75,3,6,6,2,6,8,32,4,18,13,48,7,4,30,42,10,11,36,18,61,105,3,36,14,9,10,6,6,17,5,10,16,2,25,64,163,28,40,6,27,25,27,49,61,55,33,48,11,18,16,97,65,16,9,22,10,22,28,68,3,17,23,30,16,22,23,14,2,5,41,11,35,30,7,12,31,6,7,25,2,245,17,63,17,10,5,42,51,18,3,78,14,5,28,18,9,8,14,15,4,5,10,13,15,9,14,55,11,9,31,50,54,4,5,16,10,36,6,11,2,2,34,27,6,52,27,14,35,16,11,72,16,51,11,115,28,7,33,7,32,2,23,12,10,14,38,27,7,8,24,12,22,18,20,6,12,84,90,31,12,20,26,8,58,43,10,12,8,13,43,31,13,20,35,14,3,59,7,8,8,11,26,6,8,8,45,9,10,15,21,109,8,79,16,4,122,7,38,50,6,41,6,11,14,56,20,104,5,56,4,29,6,8,1,11,12,7,6,21,22,6,21,3,21,4,13,11,14,5,5,5,15,28,24,4,10,6,17,11,19,23,8,6,17,5,6,6,12,15,9,30,38,13,11,1,3,14,12,55,23,32,6,3,7,88,8,4,13,13,64,18,31,57,30,7,13,22,17,13,2,27,6,8,3,2,18,5,17,32,13,10,16,13,10,10,16,16,4,9,5,101,63,1,3,14,20,9,21,19,20,24,11,8,11,25,33,7,19,30,4,7,9,18,10,29,25,11,26,3,15,17,32,19,47,6,8,40,9,20,53,28,6,7,11,21,11,24,17,67,30,9,2,2,4,23,12,2,37,23,16,67,10,15,255,12,15,47,8,17,18,49,5,37,3,38,19,22,9,48,50,48,12,38,5,8,7,12,20,12,49,10,23,17,21,9,11,11,12,12,8,26,53,19,12,38,13,10,9,95,34,31,5,11,17,8,45,6,31,8,12,48,33,12,18,49,20,46,11,11,8,20,16,4,29,5,9,11,12,25,59,17,42,68,28,20,3,17,21,4,18,11,6,16,51,12,40,10,8,6,297,42,21,11,9,16,13,58,28,9,27,9,14,36,38,18,15,4,17,17,18,26,22,74,47,58,3,8,12,10,16,14,43,19,19,15,9,9,6,11,27,32,10,26,21,8,17,12,10,26,26,1,9,5,17,8,14,23,9,4,8,4,13,8,42,1,33,19,6,11,11,17,3,13,37,7,24,12,2,4,12,20,24,12,13,17,5,25,8,127,30,23,15,6,14,20,2,27,10,4,10,20,15,9,16,13,24,14,10,20,14,13,16,3,5,60,22,16,15,9,28,7,4,9,36,12,26,12,8,51,22,39,15,20,11,10,18,9,60,6,14,15,30,9,5,31,27,17,12,7,7,4,11,13,12,12,3,6,12,26,14,5,6,19,11,4,14,11,11,6,24,9,10,14,26,13,3,3,9,6,11,8,10,8,9,9,14,6,38,19,3,13,17,10,13,12,23,15,11,9,18,24,49,18,8,0,6,8,27,3,5,12,14,21,3,11,19,10,2,14,28,8,7,9,11,8,7,13,11,15,12,6,10,2,6,25,5,9,8,10,16,4,25,4,7,9,10,13,8,4,7,10,9,10,15,12,1,9,20,8,27,12,16,13,19,26,8,2,10,4,5,15,13,4,7,1,14,2,12,5,13,8,1,6,14,18,10,11,11,6,17,3,10,13,16,12,18,17,27,61,5,5,4,6,10,13,3,16,17,40,13,24,28,14,11,2,52,6,3,3,17,7,15,14,4,8,10,1,8,10,14,14,4,5,20,5,15,12,9,22,1,6,5,2,3,2,6,5,13,5,1
army,11,61,9,277,27,8,18,30,12,1,45,17,24,132,5,11,13,13,5,6,2,70,10,30,25,12,61,46,6,37,69,454,263,78,135,77,185,13,10,35,8,9,8,10,63,27,30,40,418,21,96,21,8,69,4,9,157,149,7,32,25,7,4,11,43,8,120,23,9,96,26,13,12,10,110,26,33,8,217,33,195,0,26,12,249,26,78,0,92,3,29,13,6,53,41,16,61,7,83,14,22,68,48,10,25,82,23,13,36,9,46,6,28,27,1,34,26,2,141,380,78,24,5,223,10,4,17,4,4,5,15,19,10,116,72,102,14,15,7,18,5,76,37,4,1,146,7,11,47,39,77,1,29,4,3,19,61,27,24,22,28,0,20,8,1,28,39,40,21,16,36,193,42,4,11,30,304,22,13,117,41,20,7,47,12,33,43,71,59,100,4,15,2,1,7,14,39,13,38,15,7,2,1,35,74,14,22,59,33,48,204,22,38,20,8,4,5,2,32,2,6,22,16,95,129,155,48,44,39,6,41,58,64,26,61,21,46,20,8,14,170,49,13,12,10,9,5,84,160,10,10,11,31,12,29,25,34,6,10,160,4,158,36,16,4,163,9,15,18,5,206,6,44,5,15,3,68,34,31,5,119,3,2,28,20,2,8,41,32,17,26,6,28,21,5,21,110,17,10,14,53,79,15,5,6,5,46,27,5,3,2,49,65,13,116,63,29,94,17,16,81,8,78,12,70,11,7,58,3,57,6,36,4,18,15,15,26,19,2,38,12,41,35,32,10,18,65,119,33,8,26,5,17,62,43,7,18,19,38,67,21,17,12,42,3,1,87,28,26,39,5,61,2,11,9,258,70,5,15,7,90,8,115,14,9,43,4,28,62,11,33,15,12,6,64,20,66,32,132,16,23,10,10,2,14,6,10,3,11,33,1,6,1,55,19,37,3,9,11,7,10,65,23,20,1,6,20,32,44,25,15,20,22,83,16,2,1,18,69,19,30,33,12,16,1,5,26,20,72,24,40,13,9,6,64,13,4,38,20,63,27,56,66,280,95,34,48,22,10,2,42,15,3,2,20,74,2,19,69,22,6,42,2,4,18,7,35,14,4,17,592,73,17,4,13,38,9,44,16,18,21,39,14,2,36,4,2,15,24,6,24,7,14,3,24,29,9,11,2,23,3,17,10,69,11,20,32,0,19,62,59,12,29,23,23,28,41,12,77,16,9,2,9,8,0,8,7,37,14,15,36,14,4,68,52,31,26,4,6,14,44,8,84,7,22,43,29,6,80,59,34,20,33,1,14,13,2,11,8,44,5,58,25,31,9,21,12,14,15,36,26,57,31,8,12,3,17,17,66,13,39,6,8,15,13,39,9,29,13,23,76,45,34,7,34,13,23,2,17,9,45,2,9,52,11,8,10,25,28,74,5,58,26,45,38,4,11,11,5,51,31,4,5,210,19,222,14,14,3,258,27,7,11,5,16,20,51,21,33,39,14,10,15,5,22,5,0,18,25,12,74,33,273,7,37,8,16,12,15,10,8,60,39,29,29,31,10,4,16,80,34,31,28,21,23,22,10,10,9,40,5,5,13,18,29,28,39,34,5,27,7,28,7,55,33,1,158,16,22,93,99,30,57,309,53,86,31,23,27,31,43,29,0,14,8,62,336,25,113,26,27,18,10,25,30,10,26,8,28,17,28,7,17,59,23,31,9,48,4,11,7,31,10,27,43,10,29,15,4,11,14,8,4,24,17,17,5,17,67,27,11,14,31,3,21,11,14,184,27,28,18,12,4,3,11,18,2,30,12,16,5,13,25,8,10,7,6,12,39,19,8,2,14,23,9,6,6,14,18,22,13,9,11,35,3,17,19,10,9,6,25,16,25,58,11,6,21,41,32,18,12,5,4,10,11,9,8,14,16,28,13,52,12,6,14,16,16,9,8,14,6,5,10,11,15,16,4,8,8,55,22,5,5,6,15,10,2,13,12,1,14,14,27,8,48,11,27,37,21,17,5,19,11,5,13,30,34,13,6,32,14,50,42,17,8,25,1,1,2,35,8,1,7,13,21,33,7,16,7,16,22,7,20,12,6,28,2,53,3,2,6,5,11,18,12,3,3,21,11,33,28,37,18,7,1,27,12,39,33,6,115,11,32,28,17,17,15,10,53,4,1,13,2,7,5,20,24,43,4,3,98,6,8,8,18,2,19,18,18,27,1,14,5,5,10,5,14,10,9,6,7,7,20,1,2,1,0,23,5,5
troop,4,13,7,89,17,12,1,13,4,0,9,9,29,51,1,7,19,8,9,5,3,37,24,40,12,29,44,27,20,35,29,175,98,38,47,78,70,2,4,12,7,11,5,11,39,13,17,8,228,73,51,16,12,53,7,3,46,34,35,25,9,5,5,13,14,13,67,10,6,19,4,1,11,4,68,7,27,12,73,27,33,0,12,7,126,7,18,0,30,5,18,7,6,44,13,0,28,4,55,0,5,35,19,16,10,37,1,1,24,6,21,0,11,7,7,36,14,11,58,110,28,61,0,67,7,8,5,2,3,3,20,9,11,48,31,52,2,2,11,2,7,32,21,2,3,113,12,10,12,8,42,1,17,4,1,11,52,3,11,44,8,0,16,6,2,19,18,33,8,9,20,88,17,8,23,8,113,12,4,43,27,12,14,33,14,21,19,21,21,44,6,8,3,5,4,4,7,6,8,4,2,0,0,20,27,18,2,9,8,18,87,20,8,14,14,10,0,5,12,2,1,20,2,21,44,47,20,19,16,3,12,12,23,11,21,1,24,2,1,15,69,25,8,11,4,1,8,57,31,5,3,5,16,4,3,7,19,3,5,35,1,110,2,4,4,29,1,27,16,3,100,4,7,1,2,6,45,4,13,1,71,0,3,10,1,2,11,17,6,5,22,15,0,10,3,5,36,11,11,3,26,17,1,12,1,1,23,7,1,5,2,8,31,11,21,21,10,20,4,4,34,1,30,7,46,8,3,67,5,36,17,6,4,6,7,10,33,8,0,10,11,57,23,6,5,19,21,43,16,12,2,8,4,29,24,4,0,3,8,50,2,6,4,12,0,4,34,11,14,40,7,68,0,21,1,79,23,0,12,4,40,3,45,1,28,40,1,26,30,8,11,6,2,0,13,7,21,9,72,12,8,16,6,14,2,2,5,2,2,15,2,3,0,15,22,24,13,14,4,27,7,23,6,17,4,2,4,19,15,16,7,13,0,52,16,8,6,18,25,3,25,19,4,10,3,9,39,15,13,11,37,11,23,1,16,4,12,5,7,24,14,17,26,73,30,19,46,11,0,4,40,14,0,2,4,4,2,5,24,4,6,15,3,7,3,3,9,24,1,6,173,23,2,4,14,21,1,11,7,7,4,4,3,4,15,5,1,3,4,3,9,3,7,2,9,10,9,6,0,13,4,31,0,36,4,1,42,0,10,23,18,5,31,2,3,12,7,13,16,3,2,1,4,1,2,11,52,10,2,9,10,12,0,35,9,4,6,2,5,1,7,0,27,2,13,13,18,9,19,20,6,5,10,0,2,2,1,3,6,18,1,22,11,9,1,1,4,9,1,17,14,20,17,5,5,0,2,3,39,7,9,3,4,4,2,20,6,9,1,2,19,3,8,9,16,1,4,0,8,4,17,0,2,26,5,1,3,5,12,21,10,10,11,5,14,2,6,1,8,15,9,6,3,79,7,47,1,10,1,162,39,3,3,3,13,13,26,3,4,23,3,9,3,5,1,5,0,8,11,9,16,7,67,3,17,5,4,8,20,4,10,28,23,2,8,15,8,7,5,18,11,21,13,11,15,9,13,6,5,15,5,3,4,7,4,9,13,9,1,5,4,33,7,26,19,158,1,2,7,19,48,13,22,101,21,21,3,5,3,10,8,9,2,3,4,29,39,8,61,5,6,8,1,13,12,2,5,0,6,3,24,2,3,25,4,18,5,10,1,3,1,16,6,1,8,7,12,9,0,8,13,7,4,8,7,9,4,6,52,16,8,6,7,0,1,6,4,50,6,10,11,1,2,4,7,6,1,9,4,4,0,20,4,6,19,0,1,4,15,11,3,2,8,13,1,4,5,12,17,3,7,2,4,7,1,4,7,2,6,3,5,7,5,15,9,4,13,12,5,8,5,0,1,5,6,1,6,15,2,15,6,18,6,0,4,8,6,1,9,3,3,4,13,6,13,11,0,2,11,9,3,0,1,0,4,3,12,3,10,1,5,10,13,6,12,3,6,17,38,7,24,14,6,3,7,39,28,22,2,28,5,19,24,5,4,23,3,4,3,6,0,1,0,4,8,16,3,1,2,6,7,7,4,5,1,14,1,8,2,0,6,0,2,6,3,2,0,5,0,3,3,9,3,0,0,19,2,8,5,5,14,13,9,4,2,7,10,3,16,0,1,6,6,1,2,14,3,1,0,2,28,1,12,9,4,2,15,5,5,2,1,8,7,0,3,0,2,14,10,4,5,6,8,10,0,0,1,15,0,14
manifest,7,10,7,79,7,0,7,22,4,3,21,5,2,60,1,12,5,12,5,3,11,38,7,16,17,4,8,6,1,3,11,101,93,2,21,47,40,4,4,8,7,7,8,2,21,16,14,10,240,7,37,4,9,21,3,9,45,13,0,9,13,8,2,7,7,3,79,6,6,4,2,1,1,3,42,13,13,7,62,19,28,0,9,2,192,12,10,1,26,2,6,4,0,12,49,1,12,0,22,3,10,12,19,8,11,15,2,4,7,1,10,4,6,12,0,13,7,4,43,119,26,10,2,32,3,0,3,3,1,2,9,4,8,24,12,16,7,1,6,8,2,26,26,3,3,45,5,10,7,4,44,1,10,4,4,14,12,2,17,2,6,3,3,0,0,4,6,18,12,9,5,50,14,0,2,5,132,1,7,19,20,4,0,9,5,15,25,16,37,42,1,5,2,1,3,2,7,5,3,12,11,0,1,11,18,6,2,19,13,22,55,1,18,3,1,0,0,0,4,2,1,11,7,11,36,57,13,15,2,2,10,6,7,17,21,7,15,5,2,9,45,22,1,2,14,3,2,8,17,8,8,16,11,6,6,11,12,1,4,9,2,16,13,3,6,16,0,1,9,2,102,7,17,2,1,0,10,4,8,0,47,11,4,15,4,0,3,2,15,1,4,1,12,3,0,11,31,2,6,14,19,12,0,1,7,0,33,3,5,0,0,8,16,4,17,11,7,31,10,5,39,3,21,1,65,3,5,17,4,16,2,6,11,2,4,18,14,6,2,8,11,9,5,13,5,1,24,42,14,3,10,10,5,12,14,5,1,5,7,13,13,6,2,11,1,1,38,6,3,2,2,7,3,6,2,11,8,1,20,5,43,0,26,7,1,25,4,16,19,6,16,7,6,4,21,9,44,2,30,6,13,0,8,1,1,4,4,10,25,6,9,8,3,7,18,10,3,4,3,0,3,4,13,10,0,5,1,21,11,9,10,3,2,7,2,7,0,9,10,4,10,14,5,14,0,3,3,4,22,4,3,6,0,3,53,7,0,14,7,16,5,12,24,18,1,4,8,7,11,2,9,1,3,0,3,10,4,14,11,3,2,11,3,8,8,8,5,2,5,2,56,23,0,9,1,4,1,14,5,9,6,3,1,0,2,15,0,7,2,3,6,5,6,5,14,15,6,8,1,7,4,11,3,14,9,3,16,4,9,13,7,4,3,5,6,5,15,8,46,11,5,1,2,2,3,3,12,16,18,8,26,8,4,25,3,6,20,3,1,3,13,3,11,4,18,18,9,8,22,23,12,8,7,2,3,2,2,3,4,9,4,7,6,10,9,16,3,5,1,7,18,37,3,2,10,2,8,0,56,21,21,1,1,6,8,15,10,18,3,5,18,8,7,8,16,13,15,0,4,0,13,3,1,11,1,5,7,8,14,20,10,9,9,16,5,5,7,5,4,8,8,0,6,20,5,10,2,5,4,140,16,8,6,8,4,6,40,19,10,10,8,3,10,23,12,5,3,7,9,5,8,4,59,17,17,7,0,7,4,3,3,15,14,8,5,6,10,4,2,6,13,8,10,13,8,6,5,5,12,9,3,7,7,4,10,7,14,6,2,5,6,4,6,39,6,16,2,1,11,4,4,3,10,10,1,7,5,1,5,11,6,7,3,3,5,1,6,5,22,7,4,2,3,4,9,4,8,13,3,10,7,2,0,4,0,12,7,8,0,7,6,6,2,1,15,13,9,5,4,7,2,5,1,5,5,15,10,3,10,9,12,3,10,5,3,8,5,38,6,17,5,3,1,6,3,8,2,3,7,5,5,4,11,2,2,1,7,4,10,4,2,1,9,5,1,5,7,7,5,8,6,1,2,5,0,5,4,3,5,3,5,4,8,2,6,10,9,19,11,1,10,7,6,7,7,4,7,7,9,12,31,17,3,5,1,3,4,6,4,0,4,5,10,2,3,7,2,1,12,8,0,3,1,7,9,5,6,3,11,15,1,5,6,5,7,3,9,3,2,4,1,9,2,6,9,5,1,1,0,3,4,7,4,9,13,3,0,9,3,26,3,4,6,6,9,4,2,15,4,1,10,7,4,2,2,7,2,25,4,4,3,5,7,7,4,3,2,3,3,13,4,3,4,2,5,8,3,3,16,7,0,1,7,2,2,3,3,5,6,16,4,4,4,1,0,19,4,4,1,8,5,6,12,5,5,4,0,7,7,5,0,3,4,3,5,4,11,2,37,3,4,1,6,0,0,2,1,4,1,0
accept,6,28,10,151,6,7,4,38,4,1,40,10,5,79,1,9,11,12,11,4,4,34,10,34,25,16,10,8,9,16,8,148,63,7,45,56,68,5,5,8,12,8,2,1,33,15,39,7,356,19,58,4,9,37,8,6,36,8,5,17,11,10,2,20,12,6,88,3,6,8,1,3,3,7,52,9,13,0,42,22,20,2,14,12,194,12,4,0,34,1,6,7,1,24,39,10,11,0,17,16,5,19,21,9,7,27,2,4,5,4,20,4,3,5,4,22,7,0,74,133,31,15,10,34,9,5,2,12,1,3,10,4,7,45,15,13,6,5,6,10,4,31,16,1,3,55,6,12,9,10,45,0,15,2,5,10,29,4,15,5,6,0,5,3,0,6,2,13,15,8,11,60,8,0,8,10,144,3,8,22,14,8,2,16,4,12,21,15,45,45,1,6,8,0,0,9,20,10,0,1,13,0,0,10,25,16,5,9,43,20,55,6,27,6,6,7,2,5,7,4,4,10,12,23,34,58,15,16,3,0,11,10,10,10,25,17,29,5,6,6,63,11,1,2,22,3,3,9,31,1,7,8,16,3,3,12,3,0,8,11,1,13,27,6,12,18,2,3,10,9,104,1,17,2,0,0,16,9,12,0,39,6,3,9,5,2,2,9,10,2,15,16,8,7,0,5,43,6,11,14,17,17,0,3,8,0,17,6,4,0,2,24,27,2,40,13,9,33,8,2,45,5,21,5,59,7,11,37,4,25,8,10,13,3,11,9,8,4,3,8,10,12,13,14,4,4,25,62,10,4,6,10,5,10,24,2,9,4,14,18,12,2,10,14,1,12,24,7,8,10,0,7,9,7,5,26,4,2,10,5,64,2,18,9,0,26,3,18,18,2,18,3,12,20,37,6,55,3,30,3,22,2,6,0,0,4,3,10,20,7,0,15,5,9,12,7,9,13,17,5,1,16,19,9,2,1,0,13,14,14,10,8,4,18,6,10,2,41,7,4,12,9,7,20,2,3,9,9,23,4,10,12,3,8,46,5,2,13,8,19,10,17,16,13,6,6,8,16,0,4,17,7,1,2,6,8,5,18,16,3,2,14,3,3,2,13,3,3,4,1,77,36,2,4,4,9,2,22,6,2,11,2,0,0,5,1,1,9,5,0,1,0,6,9,5,7,7,3,1,2,4,14,9,22,11,8,7,6,21,16,8,3,1,6,12,0,11,9,37,4,4,7,4,4,2,12,2,11,11,6,31,3,8,19,3,9,21,4,4,6,24,4,24,1,8,5,8,6,26,29,8,7,13,2,5,22,9,10,6,14,1,7,6,11,3,7,7,5,4,5,25,21,7,3,16,4,3,8,52,16,16,6,2,16,10,17,7,17,5,5,18,20,12,3,19,4,8,3,9,5,8,6,3,17,2,8,5,9,7,16,4,11,32,23,11,4,4,5,5,6,9,6,14,21,11,19,2,6,2,226,37,8,7,2,6,11,17,18,13,6,4,7,26,26,13,19,6,9,5,12,5,3,56,23,36,4,0,13,2,5,1,16,7,3,21,11,7,12,8,10,45,8,11,10,8,5,6,8,7,24,12,2,2,6,9,1,10,11,5,4,3,11,1,18,11,22,7,11,1,4,5,7,12,12,0,6,8,1,1,9,3,9,1,5,2,1,7,3,37,9,11,5,3,3,14,1,3,4,2,7,8,5,1,7,5,14,4,4,4,9,3,12,3,2,10,6,9,4,3,15,3,1,1,10,0,3,4,0,11,6,6,6,9,0,9,3,5,68,8,8,5,1,4,3,4,15,2,5,3,7,11,3,11,9,2,3,3,5,16,4,3,7,11,13,1,11,5,19,3,15,5,3,17,2,1,6,1,18,4,7,6,9,2,7,8,8,9,15,9,2,15,7,4,16,3,1,7,16,4,5,37,23,8,4,1,5,4,2,2,4,6,4,5,4,7,7,2,2,7,9,0,6,9,6,7,2,8,16,22,22,4,6,1,6,7,13,6,5,2,7,0,11,2,1,4,9,2,5,2,9,3,7,4,4,11,5,3,15,2,17,1,2,5,12,19,5,4,8,5,4,7,8,7,9,9,8,7,22,3,3,8,12,8,7,1,3,0,4,6,1,3,11,3,4,1,15,6,6,7,6,0,4,2,3,4,4,10,0,24,14,2,4,6,3,11,12,2,2,5,2,7,1,3,6,5,6,0,3,0,5,1,2,8,6,3,3,9,3,35,6,4,0,2,0,1,2,3,2,2,1
efficiency,1,10,7,97,11,1,9,19,2,7,4,5,8,56,5,0,4,8,5,3,3,33,2,18,20,6,16,17,3,12,18,170,90,11,53,34,26,5,13,11,4,2,4,4,35,14,22,22,86,12,26,9,8,24,3,4,49,38,1,16,5,5,3,14,29,5,60,17,3,17,17,5,4,4,80,13,23,3,52,19,128,1,4,8,144,15,8,5,26,1,5,3,6,16,26,8,9,14,24,25,11,33,23,5,15,23,12,5,15,6,15,3,61,13,2,18,3,1,33,131,44,12,31,75,10,0,3,3,6,4,10,7,2,41,22,66,0,4,2,10,3,25,20,4,4,48,5,11,20,19,33,1,8,7,7,22,33,26,3,14,22,8,14,1,11,9,7,17,15,6,6,72,25,4,3,8,114,4,3,43,30,3,11,27,2,5,36,17,14,30,1,4,5,0,9,7,24,1,13,9,24,5,9,6,32,7,9,58,8,15,61,6,16,5,2,1,5,12,24,1,3,10,6,13,34,62,34,34,8,8,21,15,32,12,27,25,22,8,6,10,55,16,3,2,6,2,3,37,48,0,10,22,8,7,7,15,8,3,2,36,13,19,11,2,1,95,17,5,12,3,66,6,23,2,8,0,11,39,7,8,54,3,2,11,10,1,6,12,16,2,2,3,10,10,6,14,21,2,4,10,14,37,4,2,7,1,17,14,3,8,1,25,21,7,33,21,27,43,2,14,11,3,31,14,17,0,9,13,1,10,3,20,4,4,8,3,15,7,2,10,8,17,7,10,5,7,29,40,13,5,12,11,5,28,15,17,4,13,14,16,20,27,20,8,2,5,17,6,18,10,7,17,1,5,9,126,29,2,5,6,37,0,38,8,1,20,7,19,15,1,7,5,8,6,30,7,24,5,27,6,20,2,4,0,5,1,4,4,7,42,0,2,1,22,13,2,0,2,3,0,5,20,10,5,4,7,6,18,7,9,7,6,3,9,0,1,0,2,18,3,7,10,7,4,0,2,17,1,27,4,13,3,3,0,40,13,1,5,13,34,7,25,17,71,18,13,9,11,7,1,12,1,4,1,8,36,0,14,17,7,5,11,1,3,8,4,30,0,3,10,83,31,2,2,6,3,5,15,4,3,25,19,10,3,4,7,7,6,4,2,3,4,3,14,13,7,3,12,2,5,9,5,5,17,2,3,12,1,12,24,11,8,4,7,11,5,5,13,22,15,2,2,5,8,4,3,1,10,3,4,8,4,6,18,26,12,25,2,8,9,24,4,14,4,13,16,11,8,32,35,12,6,20,4,3,1,6,6,5,19,5,14,12,16,5,11,4,5,0,14,20,29,6,7,19,3,9,6,5,10,22,6,6,0,7,10,4,30,21,2,19,24,15,2,14,6,14,5,6,2,11,0,8,5,2,5,2,14,11,13,0,24,18,5,13,1,10,15,8,15,13,0,2,25,6,56,6,5,7,47,27,8,3,9,3,7,19,11,6,10,5,0,3,3,1,0,0,5,9,4,19,7,7,10,12,5,12,7,5,4,4,21,9,14,5,12,6,5,2,10,6,9,9,5,3,11,1,1,10,4,7,6,3,6,28,5,12,9,0,4,1,3,1,12,11,93,19,4,4,1,10,4,7,76,11,6,7,10,22,13,12,17,0,7,0,7,137,17,4,5,5,2,10,40,17,8,23,18,22,5,4,8,5,7,4,8,9,12,6,16,15,20,4,2,11,15,5,13,20,5,14,1,1,8,6,9,9,7,6,7,2,4,16,1,8,4,5,0,8,11,6,2,2,2,12,18,6,5,6,11,7,1,2,1,4,13,6,9,8,11,1,0,4,11,2,2,3,6,0,4,1,9,0,22,5,3,6,4,4,2,13,6,12,3,7,10,13,7,9,3,0,4,6,3,5,5,10,4,10,6,4,18,6,5,5,7,10,2,1,4,3,4,3,5,2,4,1,5,2,22,22,4,0,4,3,3,0,1,7,29,2,3,8,0,7,5,4,2,0,5,0,5,9,1,0,3,4,6,6,13,8,8,5,9,0,2,0,0,8,14,3,1,3,9,4,5,1,3,9,2,2,1,4,3,0,5,0,5,1,0,6,4,2,1,1,4,3,4,1,23,7,11,8,0,2,1,3,12,27,2,22,8,10,7,11,2,2,5,16,1,1,6,2,4,6,14,6,6,1,2,6,1,1,6,1,0,5,2,6,1,10,2,5,0,0,6,9,7,0,1,3,3,5,1,2,6,4,5,4,0
command,5,32,4,89,7,6,4,16,5,2,14,12,8,32,3,3,3,7,4,0,6,41,7,17,13,6,8,15,6,21,26,149,92,11,43,50,48,23,14,5,1,4,9,0,25,18,16,14,255,10,47,5,8,27,1,6,59,27,5,6,16,6,1,10,16,5,56,7,7,22,5,2,4,3,74,9,20,3,76,9,30,0,16,5,156,13,17,0,30,1,8,2,0,26,28,8,32,6,30,4,11,23,17,2,13,37,11,4,10,6,13,5,8,6,2,14,8,1,62,102,24,14,5,41,5,5,4,7,4,0,6,10,7,38,9,14,5,3,7,7,1,34,23,1,3,66,5,7,16,3,49,2,20,10,1,4,20,10,2,1,7,0,6,1,1,6,4,24,19,5,30,55,16,0,5,17,122,4,10,23,19,6,2,30,2,9,29,19,28,45,0,2,8,0,2,9,14,4,6,4,10,0,1,13,22,9,1,19,4,21,65,7,31,5,2,0,2,1,7,1,4,8,5,10,42,76,15,14,6,4,9,17,22,21,31,11,13,5,3,5,70,37,9,6,8,7,5,21,37,6,6,24,18,2,5,14,16,1,4,20,0,52,10,11,10,33,2,5,13,6,97,4,20,5,5,3,18,7,14,0,56,4,2,18,13,0,4,8,9,2,4,3,23,1,1,3,53,2,3,13,20,35,0,0,1,1,16,6,0,0,1,3,17,2,23,18,9,28,11,6,28,1,17,0,37,4,1,29,3,18,2,11,4,7,4,15,16,7,0,6,5,23,7,11,3,8,29,43,14,8,14,5,7,29,11,6,4,12,12,16,7,8,6,11,8,2,22,12,3,7,4,20,3,4,9,54,14,2,8,2,56,1,34,5,0,50,1,10,28,0,14,3,12,7,28,6,33,7,54,5,19,2,4,2,1,4,5,0,30,7,0,11,6,12,13,12,1,10,1,0,5,18,12,9,2,6,3,18,24,12,6,5,5,12,4,3,1,9,13,7,14,20,6,5,5,1,11,6,23,5,13,6,6,2,24,0,2,8,2,32,5,24,24,57,7,6,19,9,7,0,18,2,0,0,2,14,2,6,13,9,10,9,2,0,15,5,11,7,6,5,113,29,5,4,7,8,4,13,13,3,15,5,2,0,6,13,1,11,8,4,0,2,7,2,15,10,3,5,9,9,4,11,2,26,9,2,19,5,14,19,10,3,14,11,2,5,14,2,40,11,8,4,2,7,16,7,2,16,12,4,48,17,4,46,6,4,15,4,7,4,4,9,21,5,12,14,27,7,35,12,8,9,9,1,3,6,2,3,4,9,5,28,15,13,3,2,2,5,4,11,17,25,9,2,15,3,3,1,35,8,11,11,6,11,3,6,7,20,2,7,30,10,17,4,25,4,23,5,9,1,25,2,4,24,2,4,6,7,15,30,14,18,7,8,8,0,4,7,5,23,7,2,4,106,10,58,6,3,5,142,17,11,4,6,4,14,31,22,8,16,3,6,1,11,8,1,7,14,8,8,22,5,58,33,15,4,3,6,2,5,10,26,20,8,9,15,8,2,17,38,12,5,14,24,15,5,7,2,10,15,14,5,3,5,10,9,8,12,2,15,1,4,0,14,17,99,48,4,5,10,1,14,35,121,11,19,5,8,2,17,7,18,5,3,8,14,51,6,63,0,7,9,3,37,31,3,10,2,10,12,10,2,2,13,2,16,5,11,0,4,1,11,1,2,19,8,10,3,6,10,9,3,2,19,8,7,10,2,26,8,10,6,12,3,3,10,5,38,1,10,12,22,1,4,2,20,0,8,2,4,2,17,14,0,5,3,5,2,13,10,7,3,13,10,3,3,3,4,5,7,8,3,2,25,3,5,3,12,2,10,7,9,2,10,2,5,21,30,15,7,10,3,4,7,14,5,8,8,9,11,12,37,7,11,3,4,1,15,8,1,7,4,12,3,7,14,2,10,4,5,0,1,3,5,10,3,2,3,8,7,3,5,9,4,27,2,8,7,23,3,1,12,0,3,4,3,16,19,9,11,3,17,4,6,10,4,1,2,4,10,1,7,4,2,5,7,10,4,9,2,11,6,7,6,3,10,4,30,1,1,4,1,7,8,9,1,4,4,0,8,6,13,7,4,4,11,5,7,21,5,2,13,4,10,6,2,3,10,23,6,7,10,2,3,1,21,3,2,4,11,41,13,3,3,6,2,3,10,0,1,5,5,9,1,7,2,9,3,14,1,4,3,8,0,0,0,0,17,1,0
body,8,24,10,84,6,3,5,22,5,6,31,13,8,27,0,10,1,10,1,2,5,17,5,13,16,6,14,3,3,8,10,100,52,13,33,25,20,3,0,4,2,4,3,3,16,11,10,6,132,5,26,7,6,10,9,4,24,7,3,9,9,3,3,11,10,2,74,5,3,9,1,4,4,5,54,4,8,2,38,7,21,1,10,14,112,6,8,2,18,5,6,2,1,15,34,4,13,2,15,6,6,8,13,5,5,26,0,3,3,1,10,3,2,8,0,14,7,1,43,70,24,13,5,14,4,1,3,1,3,2,3,5,9,18,16,27,6,1,0,6,7,16,10,2,4,38,7,12,8,3,39,0,12,1,2,8,18,0,7,4,3,0,7,3,0,5,6,15,10,6,18,52,13,1,3,7,108,4,5,20,17,10,0,20,3,22,18,11,21,24,3,2,3,1,0,0,8,8,5,9,24,0,1,5,10,5,2,18,6,10,50,3,14,6,4,3,0,0,4,1,0,9,7,11,15,69,17,14,2,0,7,7,2,12,19,2,20,3,0,6,21,19,4,7,16,9,6,21,15,0,5,9,8,1,0,5,6,0,2,14,3,20,9,3,5,17,3,3,10,5,67,4,6,3,3,1,6,2,7,2,29,12,2,16,5,1,5,5,13,3,11,5,6,0,0,7,21,9,3,14,2,16,0,1,10,5,15,5,9,3,1,3,10,2,14,5,5,30,5,3,22,3,26,5,29,3,10,15,6,13,8,3,8,4,8,3,4,4,1,7,7,6,10,3,2,6,29,33,8,4,6,5,5,12,13,3,11,8,9,18,14,5,14,15,3,2,9,6,2,10,4,5,8,11,8,22,3,3,22,6,30,6,19,7,6,16,9,8,17,2,19,4,25,27,11,5,24,1,22,2,10,1,4,2,1,13,7,2,8,4,4,3,0,12,3,4,2,3,9,1,7,9,13,11,2,3,1,15,4,10,2,5,1,8,2,0,0,6,7,4,9,9,4,0,1,1,5,4,20,5,1,4,3,1,13,4,0,7,10,16,12,12,19,47,5,9,13,6,2,4,18,3,0,4,0,48,4,29,17,2,7,10,2,5,14,9,2,1,2,1,35,14,1,2,1,1,1,4,1,10,12,4,4,0,4,2,3,8,4,3,4,7,8,3,2,8,4,7,23,0,1,11,4,18,4,4,19,10,17,21,3,13,3,15,7,4,4,9,29,15,4,2,2,5,3,5,1,12,8,3,22,2,3,14,12,4,6,4,2,8,9,5,14,5,3,6,12,4,22,21,2,1,10,1,4,4,2,1,4,3,2,10,3,13,1,10,2,4,0,4,13,20,5,2,20,3,15,3,32,13,3,1,1,6,5,8,4,18,4,2,26,7,6,3,18,11,14,5,2,2,6,2,0,10,5,6,4,3,11,12,0,12,22,13,8,6,17,3,2,4,13,4,19,21,4,14,1,4,5,71,13,4,8,0,11,8,11,11,3,7,1,1,5,1,11,9,2,4,5,6,16,3,29,17,18,8,1,5,6,2,1,13,14,2,3,4,3,3,0,6,13,5,9,2,2,0,4,2,4,5,0,2,3,4,1,6,10,5,1,6,7,2,1,12,3,30,13,3,7,4,14,1,6,20,7,3,4,5,6,7,10,9,3,8,1,3,12,0,17,10,11,3,1,7,5,3,11,3,1,5,7,1,0,8,2,5,2,8,1,7,5,14,3,2,6,7,16,4,3,6,5,1,9,11,0,9,5,3,4,3,3,3,7,6,14,2,1,29,2,14,3,12,4,5,21,8,9,9,1,2,2,5,7,5,1,2,2,2,8,3,0,3,3,8,4,4,0,11,2,6,1,2,1,11,4,2,3,6,3,1,2,2,4,2,4,7,3,15,8,1,6,12,6,12,1,3,6,4,1,8,10,11,2,0,1,0,10,3,2,1,1,2,3,1,5,5,2,6,2,8,3,1,1,2,5,2,0,2,9,1,2,2,1,1,6,2,2,7,2,4,2,5,1,5,3,6,3,3,2,1,4,3,1,2,6,1,7,2,2,5,2,1,5,3,7,2,10,5,2,2,3,3,1,1,0,4,1,12,1,4,1,2,5,1,1,1,2,5,3,4,3,5,0,0,0,5,4,3,5,2,4,3,2,2,4,2,0,0,9,0,0,0,2,1,1,6,2,0,7,0,12,0,2,1,2,3,0,3,4,4,4,5,1,1,2,3,6,0,3,1,6,3,1,0,2,2,3,4,2,0
hostility,3,19,1,52,8,2,7,18,2,6,24,8,1,50,0,4,8,5,7,3,1,20,2,17,14,7,13,7,4,3,19,100,82,3,42,25,56,5,2,4,5,7,1,0,15,18,16,11,263,10,36,0,4,15,2,16,24,17,1,9,13,3,2,3,12,3,45,4,3,3,1,4,5,2,36,10,5,2,48,16,15,1,13,3,164,3,4,0,26,0,3,3,0,18,42,2,11,1,26,9,1,20,21,8,3,14,0,1,5,3,12,0,1,4,0,16,3,0,56,102,28,20,2,32,6,2,2,2,0,0,3,9,5,18,12,7,3,2,0,6,1,29,33,0,2,42,2,11,4,4,44,0,12,2,2,2,10,5,20,3,1,4,4,1,0,1,6,22,8,8,7,51,11,0,1,13,108,0,8,19,16,9,0,9,0,4,18,20,17,54,0,3,3,1,1,4,4,1,4,10,11,0,0,13,25,1,1,4,7,24,38,1,6,3,2,0,0,0,0,1,1,10,5,6,14,45,19,18,4,1,2,5,13,14,21,5,11,7,0,5,40,22,2,2,14,4,3,5,12,1,4,11,17,2,6,5,9,0,7,17,0,31,7,2,0,8,1,3,6,2,70,5,8,4,1,0,20,2,11,0,35,6,1,8,7,0,1,4,13,2,7,2,1,1,0,3,25,4,6,3,32,14,2,0,4,0,33,4,3,0,0,6,15,5,4,10,4,24,5,2,46,7,20,0,40,3,0,19,4,11,3,5,5,5,5,8,9,9,0,10,2,18,1,10,0,5,55,50,10,2,1,6,7,19,16,1,6,8,11,20,12,3,6,11,1,0,33,10,1,8,2,5,2,8,2,13,3,1,16,5,25,3,28,11,2,11,4,8,23,4,18,2,4,2,19,5,31,3,32,6,13,4,6,1,0,3,2,7,11,3,3,6,3,12,13,8,2,7,3,1,9,13,12,24,2,1,1,22,19,10,5,1,3,5,7,3,0,10,6,2,12,19,2,9,0,3,3,10,25,5,12,5,0,4,27,3,1,26,6,28,10,21,20,20,9,0,12,4,4,0,16,4,3,0,2,12,5,8,5,1,5,15,2,2,6,6,3,7,2,1,138,14,0,3,2,13,0,5,8,5,11,4,0,0,4,12,2,7,1,5,2,2,5,1,5,6,7,3,3,8,7,24,6,12,12,6,21,6,8,22,10,3,12,8,4,3,8,9,31,7,3,2,2,2,1,3,3,8,8,6,23,7,4,19,2,10,22,1,2,4,20,1,10,4,8,7,13,5,14,13,7,7,1,2,4,6,1,3,6,4,0,7,6,12,3,21,0,5,0,3,14,24,1,2,8,2,5,2,53,11,13,4,2,5,4,7,1,23,0,3,20,5,9,1,15,2,17,2,2,5,11,0,1,12,1,2,2,5,10,19,3,11,10,17,4,3,4,6,4,19,2,0,4,58,11,23,0,6,4,171,12,5,7,1,5,17,22,25,9,14,1,2,8,12,5,3,7,8,8,7,9,3,143,8,8,3,1,0,3,3,0,15,11,2,12,3,4,5,5,8,15,3,8,7,8,3,11,2,4,14,20,1,6,6,2,3,12,5,2,4,1,9,6,16,13,57,22,10,12,7,35,6,1,29,2,10,3,2,0,13,0,4,2,1,2,3,14,9,57,6,4,8,1,5,11,3,9,4,4,2,0,1,1,8,1,5,4,9,4,0,0,8,0,0,8,5,5,2,2,6,2,4,3,15,1,12,3,2,36,9,17,10,16,2,12,3,4,75,4,2,8,0,0,4,12,9,1,4,1,0,4,8,5,2,4,3,3,3,12,10,2,2,7,10,1,3,8,8,6,6,9,1,6,1,0,5,3,1,1,0,3,11,18,6,4,4,14,29,7,8,8,1,1,1,4,0,3,5,3,16,10,22,7,2,0,1,3,0,7,0,2,3,9,0,5,15,5,2,2,3,0,2,2,0,4,4,2,13,14,29,2,7,2,5,16,1,7,9,7,0,2,6,4,3,11,8,7,10,2,8,3,7,9,9,1,3,2,1,1,7,2,3,2,1,5,1,0,5,0,2,13,5,6,4,3,6,5,20,2,0,2,0,5,6,1,3,1,3,4,1,2,7,2,0,0,2,0,2,2,4,1,14,2,4,0,4,2,1,10,2,0,9,3,4,1,15,1,2,2,3,17,5,0,1,5,8,1,9,3,3,0,7,6,0,7,1,5,1,28,2,0,0,2,2,0,0,3,21,2,0
officer,14,59,24,312,31,5,14,29,6,13,23,21,16,76,7,6,14,21,6,9,4,109,10,45,35,31,33,23,9,38,64,467,212,55,145,48,82,12,8,17,8,15,20,5,79,36,32,28,539,21,99,9,8,36,7,15,256,146,10,27,38,13,12,20,31,11,81,25,6,65,8,27,13,17,141,12,33,4,177,43,134,0,32,25,341,34,31,0,76,6,26,9,0,62,57,15,34,11,59,8,25,50,69,19,29,94,22,5,21,6,24,9,16,28,3,42,7,6,201,296,113,35,16,155,10,4,10,7,14,2,14,20,10,141,46,100,12,7,5,5,7,72,54,10,1,171,17,21,34,32,98,3,48,4,2,53,54,19,9,16,21,5,19,10,0,27,17,42,46,19,43,168,31,1,13,28,377,12,37,97,71,10,6,49,9,42,72,52,59,114,3,2,3,2,4,8,40,8,40,22,30,2,1,30,52,14,14,88,15,21,211,20,31,13,11,7,0,2,89,2,6,31,20,50,127,316,60,34,17,2,32,52,47,32,60,33,44,14,3,16,144,71,15,20,14,6,8,82,187,7,21,19,30,16,26,40,27,6,12,122,23,97,53,14,11,195,14,15,22,14,246,7,32,12,18,2,43,20,25,14,150,9,1,43,22,0,29,26,29,7,12,10,26,14,9,16,74,6,8,33,49,120,8,10,15,6,25,30,3,3,10,41,42,8,104,36,20,92,11,13,76,8,80,19,75,20,3,59,6,64,13,43,17,28,10,21,24,15,5,24,7,36,32,15,9,13,86,110,38,15,26,17,13,85,57,12,19,32,33,46,40,23,7,36,10,5,69,13,23,34,9,44,4,24,12,264,95,3,15,12,123,6,88,22,6,41,43,43,57,11,54,10,19,23,60,20,143,32,107,14,60,6,5,5,5,5,16,2,35,44,1,18,3,57,26,28,5,9,6,5,21,39,30,20,4,7,10,69,39,21,12,7,13,50,10,4,1,6,30,21,40,62,9,8,1,11,36,13,53,15,32,21,8,1,72,26,4,22,18,63,20,39,83,296,49,26,29,21,15,1,50,16,5,0,26,58,2,25,46,26,20,25,4,9,17,10,38,12,7,25,259,100,4,4,17,17,6,45,27,22,28,15,9,2,28,39,0,19,30,6,11,12,15,14,36,41,7,12,9,17,5,30,9,78,11,20,52,9,28,64,33,7,14,26,27,17,20,8,70,26,12,3,5,3,6,6,3,31,20,27,87,29,24,80,37,42,34,12,11,29,63,10,83,8,27,42,34,17,65,75,31,31,45,20,16,3,11,12,7,44,10,60,19,30,11,14,13,23,17,23,20,76,24,13,22,4,13,5,54,28,40,9,17,4,6,47,16,67,31,29,46,60,64,12,74,14,51,2,16,18,47,0,20,44,9,14,10,18,44,70,13,76,47,35,36,2,6,21,14,51,44,6,22,103,18,141,15,12,14,305,54,15,7,14,13,32,62,30,16,27,17,16,15,13,5,4,0,13,23,19,58,21,76,85,46,4,21,28,5,15,20,47,43,16,37,55,14,5,19,66,34,21,34,26,18,33,14,6,29,38,12,8,16,21,43,23,39,16,9,12,5,26,5,42,37,309,101,10,12,76,121,20,29,1,33,38,10,18,26,24,40,42,2,7,8,27,202,11,91,12,13,14,17,90,46,16,24,8,37,36,16,13,11,27,14,38,22,50,3,8,5,22,9,15,50,10,28,24,6,6,24,3,11,48,17,25,13,17,50,29,13,9,20,14,9,11,15,25,18,71,26,52,13,10,14,32,1,21,16,42,7,18,24,6,16,4,18,12,53,23,9,1,36,17,12,8,14,17,8,18,12,3,3,83,36,16,7,26,20,3,25,19,25,10,8,11,23,48,20,16,14,15,8,13,37,13,21,3,26,37,28,70,26,7,11,19,10,10,22,6,13,3,51,8,15,25,5,17,11,55,11,11,7,7,14,9,9,2,26,1,13,14,27,5,32,9,14,21,18,7,6,26,3,5,10,16,18,48,14,21,12,33,27,15,45,15,13,4,17,40,12,6,13,18,21,15,18,12,11,12,15,6,14,14,3,32,5,18,5,14,18,11,17,8,13,6,12,11,6,29,25,26,16,11,2,36,11,30,82,7,65,18,27,20,13,11,14,17,49,7,1,14,14,32,5,47,14,10,14,21,32,5,4,10,13,9,13,10,24,15,6,16,15,1,12,1,21,7,21,2,16,13,17,1,0,2,1,13,5,3
train,0,6,5,41,4,7,2,7,2,3,7,2,11,27,0,3,2,8,4,2,1,16,2,13,14,7,9,11,2,10,11,79,54,7,27,24,30,0,0,3,1,10,4,1,7,5,10,7,40,23,12,3,1,19,8,1,30,8,7,3,4,4,2,5,3,1,35,7,4,7,8,1,3,1,59,5,18,0,39,5,26,2,5,6,42,9,8,1,9,0,2,4,2,8,12,2,6,4,15,6,3,14,5,0,10,15,0,2,8,2,9,2,6,8,15,12,0,1,17,47,20,16,3,48,4,0,5,4,2,1,7,7,4,29,10,38,0,1,2,5,4,12,6,0,1,36,3,6,9,2,19,4,2,3,1,5,12,1,2,33,7,0,8,2,2,14,9,11,8,6,8,41,8,4,1,5,58,1,5,37,9,0,4,15,7,21,15,17,7,31,1,4,2,2,0,8,7,3,11,4,11,0,0,1,11,4,10,10,6,6,38,2,9,4,4,4,0,3,1,1,1,9,6,13,15,20,14,9,11,3,6,12,10,2,16,2,12,8,1,3,17,12,2,7,4,1,2,17,27,4,1,8,7,1,4,3,8,0,1,13,15,31,0,1,3,19,17,1,6,3,33,1,6,5,2,1,6,2,0,0,50,2,2,6,6,3,3,4,8,4,0,0,4,4,0,2,7,3,0,5,12,4,1,2,0,3,2,5,3,2,0,13,16,3,10,7,6,15,1,5,10,1,14,29,19,2,3,15,2,6,1,11,2,3,3,2,21,1,3,5,0,7,12,1,1,1,12,16,6,1,5,0,2,13,3,1,0,5,4,5,4,6,13,3,2,0,5,13,3,18,0,14,2,16,5,33,9,3,4,0,6,3,13,2,7,9,8,4,10,1,6,1,3,0,6,2,13,2,16,1,6,2,2,1,3,1,8,1,2,3,3,6,0,13,2,6,1,1,1,5,2,6,6,1,6,2,2,4,7,6,0,1,1,12,7,1,0,3,11,3,15,4,2,4,2,1,19,3,11,4,17,8,3,0,17,4,0,2,6,5,8,16,4,62,10,5,10,0,1,1,22,6,1,3,2,26,1,4,13,9,4,11,1,1,3,3,2,6,0,2,60,12,0,2,5,2,2,6,2,2,9,7,1,0,7,0,1,0,1,0,4,0,2,2,6,3,3,1,0,4,1,5,0,16,2,2,10,0,3,9,8,5,3,7,2,3,1,2,14,6,1,0,3,6,3,1,1,3,0,4,1,1,1,4,6,9,5,1,3,6,2,3,7,4,1,1,5,3,4,9,4,2,3,3,6,2,0,1,3,4,2,1,3,7,2,0,7,1,1,7,3,8,8,0,15,2,5,4,4,1,2,3,0,0,2,8,2,7,2,0,9,10,2,2,3,1,3,5,0,3,7,0,1,7,1,1,0,3,4,11,0,3,14,6,7,2,8,10,2,5,9,1,0,7,3,11,6,1,0,23,7,4,3,0,3,3,11,6,1,2,5,10,1,2,1,1,0,2,2,3,9,2,3,3,3,1,2,2,0,1,1,9,8,2,6,3,5,0,1,17,4,8,4,8,1,6,1,2,0,3,3,0,2,5,8,11,5,11,0,0,1,1,1,7,7,53,21,1,0,11,11,7,2,33,1,3,0,7,5,6,8,3,0,3,0,6,45,4,5,4,4,1,1,26,24,3,2,5,1,2,6,1,0,3,1,2,0,3,0,11,11,4,1,2,1,2,4,6,2,3,5,3,0,2,3,7,0,5,6,3,1,1,5,1,3,5,2,1,3,1,2,1,1,2,19,8,5,0,1,2,1,2,3,0,4,1,0,0,7,3,0,1,5,5,3,0,3,2,0,0,0,4,0,2,1,2,6,1,1,3,1,2,1,5,3,3,4,8,5,0,0,2,0,0,5,0,2,1,1,8,2,1,1,1,4,0,2,0,0,7,2,3,1,1,0,0,1,1,3,6,0,1,1,1,0,3,2,1,2,1,1,2,4,2,2,0,1,1,5,1,5,3,10,3,3,2,1,3,5,19,0,4,7,2,1,1,4,1,0,8,3,1,1,0,2,5,1,3,1,2,1,1,2,0,0,6,2,2,0,0,0,0,1,0,1,1,2,1,1,3,2,3,1,1,1,4,0,0,2,1,12,6,3,5,6,1,1,6,3,0,0,0,0,0,0,8,0,0,0,6,6,1,2,4,1,0,1,1,9,1,1,1,2,0,1,0,4,5,3,0,4,1,0,0,0,1,8,2,8,0
west,15,26,3,151,4,3,6,57,8,1,49,9,9,50,7,4,4,13,5,4,2,42,3,23,16,8,9,6,6,15,6,148,153,20,44,52,34,11,3,3,1,9,4,4,21,5,17,19,333,39,26,5,10,24,10,4,38,37,2,14,8,4,1,7,17,19,62,1,8,29,14,16,2,12,62,12,11,5,35,37,36,0,14,11,112,3,39,0,25,9,11,2,0,28,41,9,18,3,20,10,15,26,15,6,11,27,1,6,14,3,19,12,1,14,7,35,29,11,113,107,33,12,2,67,10,1,5,3,2,9,11,6,14,47,17,43,4,0,6,1,1,31,31,10,3,56,7,12,17,7,10,0,7,7,0,8,17,8,10,10,5,7,3,5,0,12,8,17,15,8,45,107,19,3,5,7,115,3,8,40,16,10,2,10,5,19,28,25,24,40,1,3,12,0,2,8,15,1,9,7,26,0,0,19,37,10,10,38,12,18,69,10,51,8,1,1,0,0,17,2,4,18,4,51,16,95,19,21,13,5,12,14,4,12,16,15,19,6,9,26,53,53,12,4,1,4,3,19,36,1,9,16,10,3,8,8,5,0,1,20,2,17,16,4,3,45,8,2,15,5,93,5,19,3,2,3,22,2,11,1,47,5,3,30,7,3,3,8,4,6,4,3,2,0,4,3,21,4,2,9,10,21,0,3,8,4,14,10,9,4,2,18,19,1,16,8,12,28,6,14,15,2,19,5,31,11,1,30,5,22,3,7,21,2,7,6,13,7,0,21,7,14,19,16,5,16,26,70,10,7,10,1,4,49,18,2,11,3,12,15,7,9,11,11,4,0,20,20,4,9,0,19,5,13,5,24,5,3,5,14,37,2,15,9,0,75,8,8,26,3,14,2,14,30,35,5,29,4,34,5,15,5,6,3,3,3,6,2,45,11,3,63,9,26,19,6,3,7,1,5,6,9,3,5,4,3,2,9,5,16,11,3,2,22,5,1,5,8,17,16,24,35,7,20,4,65,15,1,21,7,18,1,6,5,77,2,0,13,10,24,11,25,36,29,13,2,19,17,27,2,11,11,1,4,3,25,2,21,12,3,8,27,24,1,5,6,7,5,3,11,60,33,3,2,2,29,5,13,4,3,9,2,7,0,10,10,9,7,8,4,6,3,6,6,12,13,2,8,3,6,10,11,6,22,3,4,21,4,18,27,8,4,5,4,8,10,7,4,36,10,7,2,1,13,14,7,0,14,6,6,28,11,3,45,4,1,39,0,1,8,16,3,23,2,5,14,9,3,20,34,25,7,9,0,4,1,3,3,2,33,4,18,15,16,6,1,9,8,9,20,29,20,11,6,16,8,2,1,65,8,17,1,7,3,3,23,2,18,5,11,41,8,20,5,22,19,9,3,2,2,13,3,6,16,3,10,9,5,6,69,2,33,16,18,30,0,6,5,2,17,6,2,2,27,11,39,5,3,4,184,72,10,8,2,22,20,24,26,9,6,14,31,13,33,13,2,0,22,9,13,17,8,48,18,37,5,3,7,1,8,5,42,4,9,9,1,2,5,13,58,16,12,11,27,2,9,5,10,6,8,4,3,4,5,7,4,22,2,0,4,2,8,3,19,24,86,21,7,6,6,19,3,10,38,3,1,6,9,7,10,25,15,5,5,2,14,16,4,108,6,2,23,4,11,18,3,14,10,7,4,10,1,1,6,2,9,14,12,11,9,9,9,1,0,75,15,12,9,12,23,4,18,8,6,7,8,0,0,44,6,15,2,9,2,25,4,11,165,3,12,3,18,3,3,5,15,0,6,5,8,3,5,5,0,1,3,1,3,8,13,9,5,38,12,15,9,3,17,4,9,3,11,1,13,13,5,1,2,2,9,3,3,15,10,8,5,7,16,18,5,11,11,2,6,4,6,5,9,2,7,13,20,4,3,9,2,6,6,1,3,8,3,8,0,2,5,5,1,7,10,7,17,0,5,3,2,6,18,4,6,0,8,0,3,9,8,4,6,15,1,10,67,0,2,14,4,8,6,2,7,3,8,14,3,6,5,0,6,2,17,8,0,4,1,20,4,23,13,3,2,4,1,2,7,7,9,13,14,5,2,6,4,5,17,2,0,10,1,2,20,7,2,0,1,3,7,3,1,3,1,8,5,9,3,4,1,11,24,10,2,9,32,10,3,0,20,17,1,0,12,16,0,8,7,4,10,2,3,15,22,1,8,9,0,5,1,5,7,36,0,5,4,5,2,0,2,4,7,1,2
probably,6,9,3,86,3,4,2,16,5,4,13,3,13,44,5,3,4,15,1,2,3,16,11,17,18,3,5,7,7,10,7,137,108,9,38,32,20,20,21,5,7,2,5,3,17,17,25,5,183,6,56,3,10,21,4,0,42,15,1,11,8,5,2,8,12,2,50,7,9,32,26,1,1,8,48,14,17,4,83,27,68,1,20,8,134,36,13,1,32,4,13,8,0,24,38,17,16,6,40,7,9,29,27,6,11,19,11,3,16,8,13,4,11,3,3,24,11,3,30,234,42,6,13,84,9,2,2,2,6,2,12,0,5,29,17,32,7,3,3,3,1,32,22,6,2,48,6,8,23,19,41,0,16,9,6,18,29,6,6,1,10,9,6,1,2,7,5,16,26,4,26,71,19,3,11,10,100,1,11,34,28,5,0,13,6,17,36,17,16,44,2,10,5,1,7,2,12,3,10,7,40,3,2,8,26,3,9,32,12,19,53,6,10,12,3,7,7,1,13,9,4,13,3,16,55,73,32,37,11,14,14,25,21,10,27,43,19,10,11,7,61,26,9,6,4,6,3,8,29,4,8,31,10,16,9,17,7,1,4,20,5,22,14,2,9,29,1,0,6,2,124,6,60,3,4,0,5,19,4,3,32,3,0,7,6,4,0,7,13,3,1,5,12,11,5,5,39,1,2,13,17,22,3,1,6,3,6,2,2,2,4,11,18,2,33,13,12,39,24,6,23,9,25,3,32,2,10,31,3,21,5,12,10,3,4,18,15,6,5,15,7,4,13,8,10,7,29,46,16,17,13,11,3,29,20,6,2,3,11,26,12,5,9,20,6,0,28,12,2,23,1,22,4,4,12,9,8,3,5,6,46,1,42,10,1,51,3,27,28,1,12,1,5,6,31,7,29,2,18,2,16,0,9,0,3,8,8,1,7,7,2,8,6,7,5,8,8,7,7,1,1,6,9,5,3,5,0,3,8,17,14,17,12,5,3,2,1,4,7,3,10,19,3,17,1,1,11,6,24,11,10,3,2,3,31,4,0,3,9,20,13,26,17,26,6,1,14,13,2,3,10,3,1,6,1,13,2,3,14,12,11,10,4,4,7,5,12,2,2,1,81,44,6,2,9,6,7,14,8,14,12,8,5,0,5,34,14,13,3,5,10,3,5,3,11,13,3,11,22,5,2,22,4,8,4,3,23,5,12,25,8,4,11,5,3,3,5,11,25,31,6,1,9,3,10,5,6,13,12,5,7,4,5,31,11,3,31,10,7,5,17,6,13,1,18,7,5,8,30,41,18,10,12,2,2,4,5,4,9,18,11,11,12,11,3,5,6,5,1,15,21,16,5,3,26,5,6,12,28,12,12,5,1,3,6,16,7,11,7,2,31,14,8,3,25,6,14,3,4,7,9,18,3,12,1,6,5,13,7,21,9,17,23,16,8,4,7,9,3,7,9,1,5,15,4,14,6,5,1,106,15,6,6,1,4,10,23,10,10,3,2,6,3,8,8,4,5,13,18,5,21,5,36,17,24,6,2,9,2,4,1,20,5,7,8,3,9,5,7,8,4,2,13,13,9,11,5,3,7,5,9,0,7,6,3,6,27,6,4,3,2,7,8,20,12,31,3,5,8,7,5,4,3,10,0,6,1,4,4,6,6,15,5,4,15,12,20,6,27,18,17,5,4,9,12,4,14,10,7,4,11,15,9,11,12,11,4,11,4,37,30,18,7,5,15,22,6,6,9,7,5,2,3,16,1,13,6,1,7,5,2,2,13,12,7,3,9,6,7,8,4,3,4,2,14,13,12,6,1,3,3,4,3,9,8,6,4,5,12,7,8,5,6,5,1,3,4,5,7,12,5,4,0,11,4,4,5,2,16,6,10,11,3,7,9,3,6,21,8,4,5,4,6,9,8,6,7,4,7,10,9,23,5,9,1,6,7,9,3,4,0,5,6,3,4,6,9,3,6,8,4,5,12,8,5,6,1,2,3,5,2,5,2,6,12,2,9,4,5,4,6,10,2,4,11,3,6,0,7,3,2,5,0,7,7,4,4,4,5,17,1,21,5,21,7,10,8,2,2,2,8,8,1,11,2,1,1,12,3,2,0,5,7,3,5,9,2,10,2,6,4,13,11,9,11,18,8,33,35,6,2,4,3,2,2,12,11,1,8,7,10,7,5,4,0,9,7,2,2,6,19,6,3,3,3,1,1,11,2,8,1,3,13,15,4,6,5,3,1,0,2,3,4,0,0,2,0,4,0,0
reward,0,3,9,28,3,5,4,6,0,0,4,3,7,23,1,2,3,7,1,2,0,13,20,10,10,6,5,11,2,2,0,67,53,11,22,21,15,0,1,1,3,7,1,2,19,7,11,3,35,22,9,7,9,13,23,0,24,4,11,10,1,2,0,3,8,6,38,6,2,7,14,1,2,4,54,8,10,0,24,10,29,3,4,8,48,7,4,1,7,0,0,1,7,8,8,4,7,4,8,16,3,7,7,3,4,13,1,6,4,3,9,0,10,9,22,12,0,1,12,33,13,14,21,37,1,3,3,1,1,3,5,1,7,12,8,68,5,3,0,4,2,8,5,5,2,23,4,11,3,1,12,2,6,8,3,4,19,4,2,22,4,2,6,1,2,13,5,17,11,6,6,33,9,6,4,3,41,6,5,16,7,6,4,9,3,13,6,8,8,10,2,2,3,2,2,3,8,5,2,9,23,4,4,9,7,6,0,22,6,4,33,3,7,7,1,13,1,4,9,0,0,6,3,8,10,21,6,6,1,3,6,2,10,7,14,6,12,16,2,5,15,15,3,2,7,5,2,9,12,8,3,14,6,3,3,6,6,0,1,10,4,4,4,0,5,9,17,4,9,4,26,4,6,1,1,0,4,1,2,0,33,3,0,10,3,1,8,8,9,1,1,1,5,2,1,2,11,1,1,7,9,10,1,0,1,4,6,6,12,2,0,14,4,4,21,7,9,16,0,0,16,2,11,29,20,0,8,13,1,9,1,0,3,4,2,2,9,0,1,1,2,7,10,2,2,4,5,7,6,19,10,4,3,13,4,5,4,8,5,5,2,9,15,9,4,3,1,8,12,9,0,15,1,6,8,23,7,5,3,1,10,3,8,3,12,12,5,4,9,2,5,4,5,2,0,6,14,4,1,1,5,7,3,0,3,6,13,4,8,5,0,1,6,6,1,0,1,1,1,1,5,6,4,4,2,1,0,10,2,7,0,0,0,3,4,2,1,1,1,4,4,4,1,2,0,2,4,2,12,7,6,1,3,1,15,2,2,0,7,12,1,5,8,32,5,0,10,7,2,2,15,7,3,3,3,36,4,4,7,4,5,5,0,2,14,2,8,3,1,1,19,8,2,2,9,3,5,6,3,5,7,0,0,1,9,3,3,3,1,0,3,1,0,4,5,2,2,4,0,8,5,5,3,14,4,1,3,2,3,12,1,2,4,2,6,5,2,6,14,10,6,0,1,3,1,1,2,8,2,4,3,1,1,5,1,3,5,1,2,5,3,0,7,0,5,1,5,4,7,15,3,3,1,0,0,0,0,2,0,5,3,1,7,4,2,6,4,2,0,10,9,8,3,1,26,4,4,7,2,3,2,1,4,0,0,5,1,3,4,0,9,5,4,3,2,2,4,4,2,2,3,0,3,2,0,1,2,2,2,12,1,8,13,7,1,2,6,1,4,1,7,5,2,3,3,8,6,1,1,14,3,4,1,1,2,4,4,10,2,5,1,0,0,2,2,0,0,0,5,3,21,3,3,2,5,1,1,0,1,2,1,7,1,3,2,3,1,1,1,6,4,11,1,5,1,2,2,1,0,2,3,1,0,2,4,1,8,1,0,0,6,2,0,9,2,23,5,1,1,10,8,5,2,18,7,9,4,1,11,6,8,6,0,1,0,1,8,4,1,0,6,0,1,7,3,4,4,5,5,9,0,2,0,0,0,7,2,6,1,0,1,2,0,3,2,10,2,5,8,1,6,1,2,2,0,6,9,3,4,2,6,0,4,1,2,2,3,0,3,2,2,5,2,0,6,5,1,0,1,4,0,0,5,0,3,2,4,2,6,3,1,0,3,0,2,1,1,1,0,2,1,2,0,4,0,3,9,0,2,3,2,0,9,3,1,5,5,7,2,1,0,1,1,1,5,0,3,1,1,6,8,3,2,3,1,1,4,1,0,0,1,3,1,0,1,4,1,0,1,3,0,2,0,5,6,5,0,0,2,0,0,0,1,1,1,2,2,3,2,0,4,2,4,0,0,0,0,0,2,1,6,0,2,4,2,0,0,2,0,7,2,1,4,0,3,0,1,1,1,1,4,1,1,4,0,1,0,1,1,2,2,0,3,0,0,1,1,2,7,5,0,3,1,1,0,1,0,1,4,0,0,4,2,1,1,0,0,2,2,5,0,6,5,2,0,1,0,4,0,1,1,0,3,6,0,2,0,2,4,3,2,6,4,0,1,2,1,13,1,7,2,0,1,2,0,2,4,0,11,1
merit,0,8,10,65,2,0,3,15,3,2,8,2,4,19,1,4,3,11,4,2,1,28,4,3,5,4,8,0,1,6,7,78,30,9,32,19,7,3,2,1,1,3,4,2,15,5,8,11,81,6,22,5,8,5,1,4,23,8,2,9,6,1,2,5,6,1,34,4,0,8,4,1,2,1,35,7,6,3,36,3,22,0,5,1,70,4,10,0,14,0,4,3,1,5,11,5,8,3,12,6,1,14,16,4,10,5,4,2,2,0,6,1,3,3,1,3,1,2,23,47,20,7,1,31,3,1,1,1,1,1,4,4,7,24,12,20,5,5,1,2,0,13,7,3,0,28,1,7,2,6,22,0,1,1,4,5,8,2,1,3,4,1,2,0,0,9,3,9,12,5,7,35,8,0,2,6,61,8,6,14,11,5,2,8,4,11,12,14,21,9,0,0,0,0,0,3,5,7,5,11,5,0,0,4,10,0,0,67,8,4,28,3,8,0,1,2,0,0,14,0,0,12,5,10,15,63,25,8,2,0,7,13,2,5,24,11,14,7,2,7,41,12,0,3,3,6,1,12,34,1,10,9,3,0,1,12,5,1,1,13,4,11,9,0,2,28,6,2,2,2,59,3,6,6,2,0,8,5,7,2,38,6,1,8,6,0,4,4,10,2,1,1,11,1,1,2,20,2,1,12,8,19,0,0,6,2,16,8,10,1,1,6,6,0,6,7,7,21,1,7,14,1,11,5,25,2,4,5,0,10,2,6,5,3,9,4,4,2,1,3,1,2,11,4,1,1,20,7,7,1,17,3,5,5,7,2,5,4,7,13,12,4,2,12,1,1,11,2,4,4,3,6,1,6,3,47,9,1,9,3,52,3,18,5,1,6,2,10,9,4,15,1,8,1,14,3,14,2,19,3,7,1,6,0,2,3,1,3,9,8,8,3,0,8,2,3,1,2,1,0,7,6,6,7,1,1,0,9,1,4,1,4,1,3,5,3,0,1,2,3,3,10,0,0,0,1,3,1,14,5,5,0,1,2,26,10,0,8,8,15,5,10,19,28,9,1,3,12,0,5,12,3,3,1,7,28,1,11,3,4,2,8,1,0,5,6,3,1,4,7,19,16,2,1,3,1,3,2,4,5,3,2,3,0,3,3,1,10,4,2,1,3,4,7,6,8,2,1,3,9,4,8,4,12,2,3,7,7,11,17,8,2,3,1,6,2,3,2,17,11,1,0,4,3,7,7,1,7,5,4,20,2,8,22,6,7,9,0,2,6,24,3,17,2,7,6,10,5,8,22,5,3,7,6,6,0,3,2,3,5,6,5,4,9,8,14,3,5,1,10,23,17,8,6,6,2,13,1,6,9,15,0,2,1,1,4,19,16,13,2,5,16,10,3,28,4,13,1,7,3,8,5,1,7,3,3,5,4,6,14,4,25,16,12,3,2,8,2,5,5,19,4,14,4,4,19,4,1,6,35,4,4,3,4,5,7,15,4,3,4,5,1,5,1,1,1,3,3,2,3,13,1,4,5,12,1,5,2,1,3,4,10,1,10,2,1,2,0,0,1,7,12,7,1,0,3,5,0,2,3,7,5,1,7,9,0,11,3,5,1,2,3,2,7,4,27,3,5,1,22,2,6,0,26,5,7,4,11,1,6,3,7,0,6,1,6,15,4,8,5,3,2,0,7,5,3,4,2,3,10,5,0,0,10,5,9,9,10,6,5,4,8,6,1,8,6,4,3,4,2,2,1,1,8,1,5,1,0,4,4,5,0,8,1,2,3,7,0,2,3,2,12,2,7,5,7,2,2,2,19,6,2,10,0,2,2,2,3,9,3,5,2,3,2,2,1,4,1,0,6,0,2,0,4,0,8,0,6,4,1,5,0,5,1,3,11,5,8,4,4,2,2,5,7,3,2,5,3,4,4,3,8,3,1,4,1,6,0,1,1,3,5,3,0,5,5,0,3,4,11,19,4,0,3,4,2,1,3,1,0,3,2,0,1,1,1,1,6,0,2,0,3,3,4,4,1,2,1,6,2,2,1,1,4,10,1,2,6,0,12,1,1,2,1,7,1,2,1,3,1,1,2,0,3,0,0,0,5,1,1,1,1,2,3,0,3,2,1,4,12,2,4,0,2,1,5,1,1,3,0,3,0,10,0,7,0,6,1,1,1,0,1,4,2,3,5,3,20,3,2,5,0,1,2,1,2,1,5,3,2,8,3,4,6,2,1,2,3,4,2,6,1,7,0,0,0,0,1,2,0
throughout,5,35,19,138,10,8,12,94,5,6,45,14,19,106,6,9,6,19,9,12,4,32,16,24,16,14,20,17,6,29,18,150,206,12,53,80,81,8,18,14,6,39,4,7,36,19,20,22,355,41,39,5,24,124,24,5,54,29,6,28,16,10,5,17,34,9,131,5,10,7,19,2,6,5,73,15,17,1,88,18,75,6,19,8,181,29,32,1,43,5,17,11,16,22,51,6,15,6,64,13,12,24,40,11,18,37,7,4,20,18,24,9,12,13,9,32,12,8,67,173,26,23,12,133,13,11,6,4,5,3,12,10,12,39,23,38,10,6,7,24,4,49,38,7,12,66,14,24,17,5,73,5,19,6,7,32,30,9,12,17,18,3,6,3,1,5,17,31,38,17,24,99,22,3,9,14,154,5,6,37,25,18,15,18,7,22,40,19,39,42,1,11,6,2,3,5,24,12,16,13,31,3,1,12,28,15,2,48,11,28,70,7,34,11,4,6,3,7,18,1,13,21,6,17,47,100,39,33,19,18,14,23,21,29,43,23,33,7,7,14,70,30,6,5,32,6,10,26,50,4,17,45,27,6,13,18,15,2,2,22,8,44,17,1,6,48,20,9,22,6,118,3,37,1,9,6,25,15,16,6,79,9,3,33,30,4,14,19,16,3,9,3,7,12,3,9,20,5,4,31,43,39,1,2,13,3,26,7,14,4,2,15,32,16,23,24,20,58,25,9,50,8,39,9,55,4,10,28,3,35,2,13,11,5,21,11,17,6,3,40,5,12,17,14,10,13,48,62,9,7,15,10,6,25,13,2,7,7,14,26,21,18,9,16,9,7,46,13,12,21,5,22,4,13,21,38,13,7,17,11,71,3,33,15,4,43,4,26,32,11,30,5,12,7,21,10,56,5,34,8,24,5,10,0,4,15,11,5,29,13,7,25,1,13,8,9,1,3,1,7,7,7,16,15,7,3,7,25,14,19,22,4,2,19,10,6,5,12,15,13,9,27,6,21,7,4,13,4,40,8,22,12,7,5,57,15,4,19,11,31,21,41,39,43,14,2,31,16,8,3,21,7,8,5,4,18,10,22,11,3,14,16,7,10,5,4,14,7,9,9,78,46,8,14,15,10,7,15,20,13,28,8,11,2,6,72,3,26,5,5,2,12,12,10,15,15,7,14,3,16,8,26,17,31,7,4,25,4,17,25,4,5,4,9,6,4,12,10,36,20,5,2,4,8,10,6,10,30,19,7,65,4,5,40,19,8,38,8,5,12,15,5,24,5,10,11,29,15,43,46,12,7,17,9,7,6,13,5,10,18,13,13,20,19,10,7,9,8,7,15,21,30,4,6,49,7,7,6,27,15,22,9,18,2,1,20,7,12,4,3,36,15,11,14,30,7,26,7,4,4,26,25,5,28,5,8,11,7,15,47,20,31,25,19,10,6,5,7,9,17,11,5,7,34,13,30,6,4,6,192,18,6,13,10,5,23,30,28,8,19,6,17,11,21,10,2,4,4,15,16,25,18,42,22,20,10,4,5,7,4,4,35,13,4,12,4,8,7,12,12,13,6,19,18,7,5,14,4,6,18,16,8,6,8,10,7,19,14,2,6,6,5,5,22,12,31,10,11,9,13,17,7,13,24,6,10,6,6,6,1,8,14,6,7,6,5,15,14,42,15,12,9,3,8,14,8,20,16,8,7,21,7,6,11,11,12,6,23,8,16,17,16,8,5,41,23,20,13,3,9,13,9,4,17,11,14,17,9,16,26,1,6,20,2,15,7,4,1,21,5,9,11,4,10,14,27,6,4,7,5,8,8,15,1,7,7,12,7,15,4,6,11,5,12,7,3,11,8,5,7,5,8,4,12,5,5,8,11,12,7,8,8,28,5,8,18,18,50,16,7,1,7,10,8,3,6,8,6,8,10,23,21,11,8,1,9,6,4,5,2,3,8,6,10,10,7,8,4,8,19,7,5,6,23,5,16,3,6,10,18,0,6,4,9,6,1,4,4,12,12,5,11,5,6,8,4,5,15,9,9,5,5,7,13,14,11,12,8,10,14,8,8,12,8,7,6,10,8,8,2,13,7,5,5,4,10,6,5,4,24,3,3,8,10,7,4,5,11,4,11,7,12,12,2,12,12,7,13,31,4,4,13,8,11,5,1,9,9,16,5,2,9,2,3,7,8,5,0,11,7,6,11,10,6,6,2,2,9,11,11,10,14,10,17,4,6,13,8,11,3,5,3,6,2,1,5,7,7,6,2
guard,0,9,3,77,5,7,6,17,3,1,13,0,7,61,4,8,1,22,3,0,4,38,6,15,15,9,6,10,2,9,12,130,91,5,42,55,58,2,6,4,4,9,6,1,24,8,24,7,162,10,29,3,15,20,4,4,58,12,3,5,17,7,4,5,15,2,66,9,10,9,9,5,4,4,103,8,14,3,56,14,33,1,6,8,136,20,16,1,16,7,3,5,0,10,43,12,14,3,16,6,10,19,21,8,10,17,0,4,8,7,10,4,5,7,0,17,0,2,23,126,30,11,6,50,4,2,3,0,4,4,12,3,3,40,17,21,8,4,1,4,2,17,14,0,0,38,3,7,14,7,68,1,8,2,2,16,27,5,3,6,4,3,4,5,1,1,11,19,18,3,26,80,9,0,5,6,121,2,6,26,19,14,3,14,4,16,19,17,12,24,6,6,4,0,1,1,26,1,7,14,33,3,4,9,16,11,14,43,12,11,54,7,21,10,4,2,0,3,7,1,1,15,5,17,36,106,7,18,10,12,11,6,11,20,26,14,14,10,5,6,34,23,7,7,11,5,10,35,43,6,11,7,11,9,12,11,5,2,3,15,12,36,10,0,3,40,3,3,7,6,77,3,28,8,4,4,21,6,6,2,41,17,2,13,8,1,4,7,9,1,2,2,16,2,0,16,22,1,4,12,19,25,1,0,5,4,16,5,7,0,1,83,25,7,18,10,7,19,9,8,40,7,21,8,62,6,3,15,4,20,0,7,7,10,9,7,8,1,0,7,13,13,9,5,3,8,30,39,19,1,6,7,4,37,16,2,1,8,12,13,22,4,6,15,4,2,29,6,1,6,3,8,4,3,9,31,6,2,8,11,40,2,40,9,2,30,3,13,20,2,16,2,11,5,22,16,34,7,29,2,15,1,4,0,4,6,8,4,9,9,0,2,2,19,10,5,0,6,1,1,4,8,16,10,3,3,2,7,7,12,22,2,3,4,1,5,0,3,11,1,5,25,3,6,0,7,8,6,18,7,22,3,4,6,35,4,2,4,11,23,10,13,16,45,5,6,4,8,6,0,7,5,4,3,2,23,4,25,27,5,5,20,4,3,4,8,14,3,5,3,66,39,2,1,5,4,7,8,2,13,13,5,2,0,4,43,1,8,7,11,3,10,2,5,16,19,2,12,7,6,2,21,12,37,9,3,37,11,14,28,16,9,11,5,11,10,9,5,27,20,6,1,2,12,8,7,3,15,13,13,33,4,7,32,14,10,25,4,4,9,16,10,20,2,8,17,6,8,27,26,14,11,4,8,4,3,1,2,4,11,1,10,9,15,8,2,5,7,2,17,8,29,8,5,11,2,9,2,6,7,19,1,0,0,5,22,2,14,13,3,17,9,5,3,24,13,14,0,6,0,13,20,2,17,6,5,4,14,8,17,18,11,14,21,12,2,4,14,2,11,10,1,5,15,3,14,3,3,6,82,12,1,5,3,6,5,33,4,3,6,11,2,5,4,0,1,0,10,9,11,22,5,9,18,10,4,2,3,1,1,3,13,7,6,11,6,10,8,6,15,3,8,13,6,6,3,4,3,7,7,4,6,4,7,8,11,7,2,4,3,6,3,3,22,20,43,8,6,3,12,7,10,0,40,8,25,6,8,3,8,1,19,6,7,5,4,11,8,20,9,8,3,4,12,3,10,14,8,4,0,13,3,0,5,1,10,8,10,3,11,10,7,0,1,10,21,10,10,4,7,11,0,0,13,7,11,10,4,8,6,2,7,10,15,5,10,8,6,11,14,5,4,1,6,17,19,6,3,4,1,1,5,6,1,3,1,3,8,14,5,5,3,3,2,4,2,2,7,3,8,5,2,1,5,2,4,0,2,18,4,7,8,15,6,5,7,8,17,5,4,2,5,2,4,5,4,10,4,4,3,8,21,7,5,4,5,13,5,5,2,5,0,8,4,3,6,8,3,13,14,4,1,4,21,1,6,2,3,5,1,0,4,3,1,4,2,1,1,7,3,3,9,6,3,4,0,11,1,8,0,4,4,2,3,1,1,0,9,7,20,3,9,4,3,11,4,18,3,4,1,4,2,9,1,3,4,1,12,5,10,6,1,6,3,4,0,5,9,1,9,4,6,4,3,4,12,5,8,32,1,5,0,1,6,5,2,2,4,12,5,1,5,4,0,1,13,9,2,2,2,10,5,1,5,1,2,1,4,5,1,6,4,0,17,2,3,5,2,5,1,5,5,3,0,0,1,0,0,0,0
enable,3,41,24,222,15,6,4,32,4,3,28,16,7,75,11,11,7,27,3,3,10,49,7,26,30,11,5,16,5,19,11,263,156,10,78,165,45,29,34,10,11,8,7,7,40,17,24,23,334,16,67,9,13,35,12,1,64,56,0,22,13,12,7,36,22,9,99,10,5,13,83,5,9,3,89,10,28,13,110,27,83,1,17,16,261,30,27,0,60,5,7,5,4,30,83,11,24,12,40,20,19,40,43,11,17,46,10,7,31,11,16,9,7,26,6,30,12,10,85,234,51,23,12,123,8,5,4,2,4,3,15,2,14,65,17,84,6,5,5,10,2,63,41,11,4,94,2,14,19,19,62,5,21,13,3,40,39,16,11,22,31,9,18,12,2,16,9,31,24,9,18,91,19,5,8,12,179,6,12,39,35,20,15,25,10,39,55,28,38,66,5,7,24,0,4,2,25,4,11,12,37,10,8,13,29,10,11,54,14,42,105,5,41,16,1,3,1,4,34,1,7,19,7,17,54,140,30,41,13,14,17,24,35,27,60,26,40,18,19,9,96,53,8,7,15,9,9,29,90,11,10,51,26,20,15,18,17,8,7,35,13,34,19,9,9,91,14,3,14,7,192,19,66,9,10,3,37,28,21,4,55,6,14,18,18,4,8,7,14,5,7,7,16,7,9,16,55,7,14,29,26,73,0,14,15,3,29,11,1,5,6,31,51,11,72,18,44,77,14,9,58,5,24,10,48,3,14,35,6,29,7,14,3,2,9,19,12,4,6,13,19,12,27,19,7,11,48,71,25,11,20,13,1,51,26,8,8,9,24,54,34,14,10,12,13,2,53,9,11,10,5,22,9,12,5,62,18,6,23,7,84,3,77,13,5,86,13,24,37,1,30,11,30,15,35,9,74,10,44,7,26,2,4,0,11,11,3,2,33,24,1,11,19,10,6,14,5,11,4,1,8,11,43,13,2,5,5,14,23,23,14,10,10,24,2,8,1,38,17,4,30,30,13,20,1,3,13,9,36,14,21,8,7,7,51,10,1,9,9,40,8,22,43,43,14,7,38,16,19,2,20,3,5,6,3,33,3,22,23,9,6,25,3,2,11,8,20,5,4,6,102,48,2,7,18,14,6,27,13,5,19,12,8,4,12,39,21,14,10,6,9,11,13,11,36,14,2,15,10,14,5,20,16,33,8,3,33,17,29,35,17,10,5,11,11,17,7,14,48,30,6,8,7,18,31,15,23,30,19,8,38,5,13,71,11,32,34,10,6,15,30,14,41,8,22,24,24,8,41,59,19,13,36,5,13,4,19,11,5,22,10,13,31,9,10,7,12,5,8,22,25,36,7,5,31,12,4,7,51,10,18,6,10,7,15,23,10,39,15,11,29,35,31,14,35,8,36,18,9,13,26,7,9,28,8,14,8,15,17,47,7,44,36,17,6,2,15,12,6,28,11,5,14,28,9,67,12,10,11,177,26,6,5,14,1,17,52,15,11,21,6,8,14,11,20,5,1,21,17,17,27,9,43,43,36,6,8,17,8,14,15,36,19,13,18,19,16,8,8,13,17,13,21,18,14,18,15,6,9,16,8,4,8,5,29,18,23,4,4,9,6,16,4,41,24,29,9,7,9,17,18,9,4,42,3,15,15,6,7,14,19,1,14,7,18,12,34,3,66,17,20,13,20,20,16,7,15,13,16,20,18,24,3,16,6,21,5,31,10,32,26,20,13,8,29,22,11,8,30,27,9,3,3,17,6,14,22,2,33,11,14,8,19,15,9,17,15,7,6,26,15,11,8,7,19,19,8,12,7,10,6,14,13,16,5,5,8,13,26,3,16,2,13,12,4,7,10,5,8,9,8,3,5,30,7,7,4,14,12,7,19,12,25,5,10,12,9,27,13,18,17,14,13,8,16,20,11,8,11,16,15,30,16,6,5,8,12,15,11,1,8,2,13,8,8,13,8,6,7,33,13,8,19,10,14,7,6,15,14,0,3,9,5,7,20,8,13,8,6,18,4,16,2,5,12,12,10,9,7,3,12,12,5,12,15,9,6,11,14,32,9,22,11,25,9,21,3,5,6,6,8,12,5,18,1,5,5,20,2,8,4,5,11,9,4,7,10,15,2,28,7,16,8,15,13,25,17,30,76,5,5,5,6,17,21,11,9,10,41,7,6,12,6,10,5,24,14,0,4,7,10,7,6,11,9,4,8,6,9,11,11,5,12,5,7,8,5,5,19,4,5,15,10,2,7,6,6,8,4,0
sell,0,2,1,66,1,5,3,13,0,4,0,1,3,27,1,0,2,19,0,2,4,19,2,5,7,12,4,5,3,14,5,80,57,5,32,27,8,43,65,1,8,0,0,4,18,7,13,4,142,21,29,1,7,31,7,4,51,17,5,9,4,2,3,14,13,9,53,3,3,5,18,0,4,1,50,5,12,4,65,12,56,3,8,5,121,25,28,0,27,9,3,4,4,22,53,19,12,6,23,19,6,19,16,8,12,12,9,4,14,8,10,5,8,21,3,17,2,8,24,118,14,4,6,62,3,1,1,0,4,3,11,2,4,27,13,15,0,5,1,2,0,34,22,0,0,29,5,10,15,20,22,1,13,1,5,8,15,2,1,13,25,6,6,1,2,11,2,2,18,3,13,38,14,1,3,8,84,1,7,18,26,8,0,10,8,17,27,6,5,29,3,0,24,3,3,10,7,1,2,5,29,2,5,4,19,3,24,18,6,33,39,0,13,13,4,12,4,5,17,1,11,5,3,13,21,64,9,31,2,12,6,12,15,14,28,17,12,3,15,3,28,31,3,0,8,7,7,9,22,3,4,34,9,19,9,12,7,7,0,13,0,9,11,3,2,12,1,2,9,1,78,10,56,3,1,5,10,8,1,1,31,3,6,2,4,3,8,5,5,0,0,3,14,3,1,19,39,1,4,16,22,22,5,8,3,0,0,0,1,2,0,4,22,3,71,19,19,18,7,0,22,3,7,1,21,1,4,16,1,14,1,6,3,3,3,32,8,4,8,7,2,5,15,7,9,1,26,14,12,13,11,10,2,32,12,3,0,3,12,16,4,2,6,11,2,1,17,7,2,4,0,12,5,2,6,6,0,12,4,13,24,0,31,3,1,153,2,17,14,2,6,2,6,3,10,11,25,3,14,5,6,2,1,0,9,5,6,0,32,13,1,2,29,5,3,8,2,0,4,1,0,6,6,0,2,0,1,8,1,7,13,6,3,7,1,1,0,1,1,9,4,5,3,12,1,0,8,2,13,10,3,0,1,10,18,5,0,1,2,11,10,9,9,4,5,1,30,8,6,1,10,3,2,2,0,4,4,5,11,1,4,7,1,2,3,0,7,1,1,0,22,21,2,3,22,12,6,13,3,5,10,1,2,0,8,18,11,9,7,4,6,2,3,2,11,8,3,3,11,1,1,17,7,5,6,1,21,4,11,23,3,5,0,2,3,3,3,3,19,33,5,3,1,43,41,0,3,16,9,2,3,1,3,29,3,6,13,7,6,2,15,3,11,0,9,6,4,1,17,27,3,3,1,1,5,2,27,1,2,8,21,8,8,5,7,2,6,1,2,9,6,13,8,5,11,10,5,8,5,2,15,0,6,2,1,19,3,4,5,4,16,2,0,0,10,13,9,11,5,6,8,8,3,24,5,4,1,6,2,11,64,9,10,8,2,5,5,6,2,10,2,1,4,18,6,24,3,2,4,72,5,14,3,1,4,1,37,10,3,20,1,1,1,5,2,0,0,10,4,7,10,2,5,4,3,2,1,0,3,8,5,9,4,0,5,4,7,1,5,2,5,3,9,4,4,3,8,0,6,7,2,3,3,3,3,6,13,3,2,3,1,7,5,10,12,0,2,3,1,0,5,3,2,2,0,5,5,0,0,6,6,14,1,3,27,1,1,3,16,8,9,2,1,5,5,7,14,2,10,6,8,12,6,4,6,3,6,4,0,26,39,9,6,4,8,34,2,7,17,12,7,5,1,4,1,4,10,6,9,13,3,5,3,6,11,7,14,3,15,11,1,18,3,5,18,9,2,6,2,0,0,5,4,0,4,0,2,0,8,1,28,1,5,5,5,3,4,5,8,12,0,9,0,8,21,7,0,8,11,10,3,9,3,0,2,4,1,15,3,4,2,4,0,3,2,4,6,3,3,2,4,20,0,9,3,2,4,50,3,2,2,3,5,0,10,5,2,1,2,5,1,2,63,10,0,5,0,5,2,1,0,4,0,0,11,1,2,2,3,4,2,9,1,0,3,2,1,0,13,2,2,2,0,4,0,0,0,20,3,9,5,6,0,21,4,2,1,4,1,3,4,4,7,19,1,6,2,2,0,10,1,2,4,5,5,3,4,10,4,10,2,15,15,8,17,25,13,3,51,1,0,1,2,3,1,8,2,0,19,9,131,2,4,1,5,13,6,1,0,1,1,1,5,3,1,1,1,8,2,2,0,4,2,17,0,7,3,2,7,0,5,0,1,0,0,4,6,0,1,0
rather,3,11,7,74,1,5,6,25,5,0,14,6,9,46,1,6,4,12,1,1,0,21,17,16,8,5,8,7,5,8,9,97,65,8,31,51,25,5,9,4,9,15,1,1,32,12,15,14,115,11,22,5,8,23,9,4,24,11,2,9,11,3,1,5,20,7,80,4,4,12,6,4,4,3,65,17,19,2,39,20,33,2,8,7,118,15,6,0,11,2,3,6,0,12,30,6,8,3,27,11,13,13,17,4,13,16,8,4,5,3,9,4,6,7,3,16,1,5,46,128,23,3,9,35,5,2,0,5,1,0,8,5,13,18,19,39,9,1,8,7,0,35,6,1,2,33,9,7,10,14,35,3,8,7,5,24,17,9,7,4,11,1,6,1,2,8,4,21,12,6,3,51,30,2,1,8,87,4,2,33,9,6,8,15,6,13,21,15,22,23,2,3,0,1,5,4,12,6,5,15,26,4,2,5,7,14,5,23,10,16,49,5,11,7,2,4,5,3,5,2,4,9,1,17,18,59,9,20,9,2,12,6,12,13,23,12,21,15,9,5,30,19,3,11,19,2,8,18,27,4,8,10,12,1,2,14,2,1,1,21,4,22,11,0,6,15,8,4,10,8,61,4,10,5,1,3,11,9,5,1,30,9,3,10,6,4,0,8,13,3,3,3,5,5,1,5,13,3,4,13,19,17,2,2,6,6,15,1,9,1,6,17,16,4,10,10,14,20,7,7,22,3,20,5,23,4,21,8,2,12,4,11,12,5,6,3,9,3,2,8,8,3,12,11,6,6,24,32,12,5,7,6,4,18,9,0,2,3,17,16,16,4,13,15,4,1,12,5,8,9,2,8,2,16,10,16,7,8,14,5,39,6,23,13,2,21,11,13,19,7,12,6,11,6,12,5,29,0,14,1,6,5,7,2,2,14,4,4,18,11,5,10,2,7,1,3,9,9,1,2,4,8,13,5,1,2,0,9,2,8,0,1,0,2,5,1,2,10,6,6,9,8,13,8,2,2,8,2,14,5,19,2,4,3,25,7,0,3,3,24,10,10,19,32,4,1,7,5,1,2,12,5,3,1,4,16,2,5,14,2,4,13,2,4,12,4,4,7,7,1,30,22,0,1,4,4,3,2,2,15,7,8,0,0,2,9,3,10,6,2,6,9,5,11,9,11,9,6,4,7,4,14,6,24,7,4,19,10,8,16,8,8,4,7,10,1,2,8,18,11,1,1,2,11,3,2,0,12,7,4,17,1,5,21,3,12,16,8,5,6,12,5,10,9,5,11,12,5,11,25,7,4,6,3,4,1,5,3,3,9,1,5,5,13,3,12,5,2,2,12,17,13,9,2,15,2,10,4,12,8,21,6,3,0,5,22,0,15,7,4,15,7,3,3,13,6,12,12,4,3,7,3,1,8,0,8,3,10,13,16,5,13,26,12,7,1,16,6,0,8,17,4,7,10,2,8,4,3,7,47,10,11,2,1,0,6,11,7,6,12,1,10,3,8,1,1,2,5,6,5,8,10,13,22,6,3,1,5,2,4,5,17,2,3,7,3,9,6,0,6,11,15,6,5,3,1,7,3,10,2,2,5,0,6,2,6,4,4,2,1,2,4,3,21,13,14,3,3,5,7,3,8,1,7,3,5,4,1,6,7,7,7,3,1,5,2,15,3,18,6,6,6,4,8,7,8,9,7,7,2,7,0,1,1,0,3,4,3,4,8,7,6,0,2,8,8,3,14,6,2,2,1,7,7,6,12,2,3,13,12,7,2,5,2,8,6,6,5,2,9,0,3,1,2,11,20,3,1,0,3,8,1,9,2,6,8,7,2,8,5,4,1,3,3,4,2,3,4,2,5,1,1,6,8,1,0,11,3,8,7,5,3,8,2,3,5,4,16,5,1,2,8,1,2,5,5,2,6,2,3,8,12,7,4,5,2,10,1,2,1,6,2,2,1,5,3,3,0,6,9,4,2,6,7,7,2,1,5,5,6,0,2,2,2,0,3,2,1,4,0,1,5,0,3,6,1,1,0,4,5,6,3,5,4,4,0,1,5,3,13,2,3,8,1,3,0,1,1,3,3,0,3,2,2,4,4,3,4,1,2,3,4,2,1,7,4,0,3,8,5,1,3,3,2,10,9,12,2,21,3,0,3,3,4,1,0,0,4,6,4,0,2,4,5,1,5,0,0,4,1,8,4,9,3,2,6,1,1,6,3,0,9,1,2,5,7,7,11,4,0,2,2,2,1,0,4,2,1,2,0
dispose,2,7,6,76,5,1,4,12,2,3,14,7,5,26,0,3,13,11,1,2,3,16,1,8,12,8,8,6,1,11,3,108,46,7,27,17,23,21,18,1,4,4,3,3,17,4,10,8,194,1,21,1,9,4,6,1,22,24,0,6,18,1,1,4,4,2,34,1,4,4,3,2,4,1,20,6,3,6,58,12,27,0,8,3,112,12,4,0,27,0,7,4,0,23,27,4,16,6,22,4,11,16,19,3,8,14,4,2,7,2,9,6,3,14,0,20,3,0,30,78,19,15,1,34,2,2,3,5,3,1,7,3,1,32,9,15,4,1,1,3,0,26,21,0,0,41,5,2,5,8,59,1,16,1,1,19,11,0,6,1,6,3,3,1,7,0,4,5,18,6,13,42,16,0,0,6,99,3,10,13,14,10,1,9,9,21,23,9,40,32,6,2,4,1,1,4,4,3,0,4,25,1,0,5,11,1,10,16,12,21,42,0,27,8,1,0,0,0,16,6,5,7,0,5,30,72,18,17,3,10,12,7,13,7,11,15,14,5,5,2,35,24,1,3,4,0,5,13,26,3,4,16,10,5,6,8,3,3,3,11,0,11,12,5,4,15,2,1,5,2,87,7,27,2,4,0,8,2,13,7,24,3,3,10,4,7,0,3,3,2,3,1,7,1,1,14,36,4,2,16,12,23,1,2,3,0,6,2,3,0,1,2,10,1,13,10,10,32,3,1,37,5,13,1,33,3,4,11,2,23,3,6,0,3,5,18,11,4,1,8,6,7,5,7,1,2,18,34,11,7,12,7,4,31,8,4,2,2,10,12,10,5,2,4,3,0,28,0,4,2,0,10,1,5,5,4,0,4,7,11,50,0,24,6,0,126,1,11,25,1,19,1,9,8,28,6,48,3,17,3,14,1,3,0,2,4,5,6,8,12,1,2,6,6,6,4,2,5,3,1,2,4,8,6,0,3,2,8,3,6,8,5,5,4,0,0,0,19,2,1,4,11,4,2,0,2,2,6,17,3,10,4,0,3,24,1,0,8,0,10,7,12,18,7,4,0,12,14,1,0,5,2,3,0,0,3,2,10,17,4,1,12,1,3,5,11,5,2,2,3,41,29,1,3,6,6,4,8,2,4,8,2,2,0,5,6,10,8,10,1,1,3,3,3,10,14,5,9,2,6,2,30,6,15,5,3,14,3,15,20,8,4,2,3,9,2,13,7,30,27,3,0,1,1,16,8,5,13,19,5,10,2,7,37,3,4,8,4,2,4,17,3,20,1,18,6,9,6,29,22,4,5,2,1,4,2,3,4,2,12,6,12,7,6,4,3,3,2,2,12,11,17,5,2,10,8,2,0,36,13,20,0,1,1,29,14,6,5,8,3,17,15,11,5,31,9,23,2,7,1,6,4,1,14,1,6,4,5,9,15,16,14,13,13,8,3,2,4,1,6,3,0,4,24,8,31,0,3,2,131,9,3,3,2,3,6,24,6,5,11,7,4,8,5,8,1,4,12,5,3,8,4,45,50,58,1,4,4,0,9,1,16,10,6,8,3,9,1,14,3,14,7,16,5,16,5,4,5,4,14,2,1,3,4,6,9,15,3,1,3,1,4,2,16,17,8,4,5,2,0,8,1,2,8,0,2,15,0,1,6,5,18,27,5,1,6,4,2,32,5,2,6,3,5,6,2,9,9,2,7,12,14,7,10,3,8,4,9,2,3,2,6,7,3,10,16,6,5,8,15,1,2,0,7,1,6,6,0,21,9,10,1,6,2,8,10,8,6,4,5,9,7,3,3,9,16,1,6,2,6,0,5,3,7,2,0,2,2,11,3,7,1,4,6,3,4,2,6,6,1,1,3,6,13,19,4,0,11,5,4,4,6,3,0,5,3,4,22,5,3,10,3,9,14,2,1,5,2,6,16,10,11,3,2,1,6,3,27,4,0,4,2,6,1,4,3,0,1,4,13,3,2,5,7,0,4,6,5,6,7,12,20,3,4,12,4,7,3,4,2,2,3,1,3,11,10,6,7,3,1,12,4,2,5,1,7,1,1,0,23,2,0,3,6,6,7,1,2,3,6,4,8,5,2,3,4,0,24,2,2,0,5,11,8,6,8,1,4,7,6,3,9,10,3,13,12,4,3,14,6,0,1,1,1,4,7,1,2,13,16,102,3,1,1,0,6,10,2,6,2,0,1,1,1,10,2,2,1,3,2,0,2,9,5,2,1,3,0,10,0,0,2,5,0,0,2,0,1,1,0
post,4,5,4,57,4,4,6,15,1,1,0,5,7,17,1,0,1,3,1,0,0,18,1,5,8,3,4,6,1,1,5,123,56,6,13,9,14,4,1,1,2,2,0,3,15,5,12,11,95,4,22,5,1,8,3,1,16,39,1,7,8,0,0,3,8,5,21,0,1,56,5,5,0,2,19,1,1,1,37,4,58,0,8,1,53,8,13,1,17,2,9,2,1,13,22,8,12,6,24,0,6,19,13,2,7,10,4,5,18,7,19,1,14,4,0,11,0,10,27,128,12,4,3,61,1,0,0,2,2,0,5,3,4,30,8,13,0,2,0,2,2,19,13,1,0,34,3,12,8,25,24,0,5,2,0,9,5,4,0,1,25,0,3,3,2,3,1,1,19,5,7,39,11,0,2,8,58,4,4,10,8,2,1,9,19,9,16,16,8,14,1,3,3,0,1,3,11,6,5,4,6,2,0,3,6,3,0,32,3,12,36,5,8,5,0,1,9,0,99,0,6,5,4,19,30,36,13,13,0,8,8,7,6,5,5,30,4,4,0,0,34,7,5,4,2,1,3,14,37,2,8,1,3,23,4,6,3,1,3,30,2,19,18,0,4,133,1,1,1,2,59,4,23,3,6,0,14,24,5,3,14,2,0,11,1,0,0,11,7,2,3,1,4,2,1,1,18,3,0,11,3,23,1,5,3,0,6,5,0,0,3,2,9,1,24,14,6,22,7,5,7,4,10,4,7,0,0,12,2,27,1,9,1,4,4,5,6,5,1,3,5,6,3,12,4,11,6,29,7,0,7,8,2,6,8,22,0,4,4,16,6,7,0,14,0,0,10,2,3,8,0,7,2,0,5,38,5,2,1,2,30,0,32,4,6,1,1,5,11,0,3,0,3,7,12,3,12,9,27,4,16,1,7,0,1,0,1,0,4,5,1,3,6,10,12,17,1,6,1,0,0,10,6,0,2,0,5,5,3,1,0,7,4,9,1,1,0,9,6,2,3,8,2,3,0,3,4,6,15,4,11,5,2,0,8,0,0,5,3,12,1,4,9,19,14,3,1,10,4,0,7,4,3,0,3,0,2,4,9,0,0,3,1,0,1,6,5,5,0,2,68,18,11,1,5,8,1,13,1,1,1,7,4,3,9,3,0,9,10,1,8,2,7,2,6,1,5,2,1,2,1,1,2,17,0,1,6,0,9,10,10,0,25,3,13,6,11,7,7,7,5,0,1,3,1,4,0,12,4,5,11,2,0,28,3,8,15,4,2,2,12,2,20,0,7,6,9,0,17,14,4,11,12,1,0,3,1,1,1,17,2,15,17,3,2,1,2,3,9,0,5,4,7,10,3,0,3,0,9,3,5,0,0,0,4,11,3,11,10,3,5,8,20,3,8,2,9,2,0,3,8,3,2,10,1,4,4,5,4,40,1,8,5,8,7,4,0,3,5,7,4,1,3,50,4,24,2,6,5,53,6,1,2,2,1,10,7,0,6,7,2,4,7,1,1,2,2,3,5,7,5,3,15,2,4,8,3,7,3,1,5,20,5,13,5,3,1,5,0,18,2,5,9,5,5,6,7,3,1,8,2,3,2,2,6,4,12,1,4,2,1,27,1,10,5,62,29,1,1,7,14,3,3,27,6,14,12,1,6,5,4,12,1,2,6,1,12,9,20,8,14,8,6,3,3,2,3,1,1,7,6,18,2,6,3,11,2,25,9,9,9,3,0,3,17,3,7,1,4,5,2,0,4,16,11,5,1,1,7,2,2,4,5,0,4,7,3,6,10,17,2,6,7,0,4,3,18,6,1,16,7,8,4,5,7,0,0,1,8,4,0,2,2,5,2,2,3,1,16,5,5,5,0,7,13,0,1,4,2,4,13,6,0,17,3,0,3,5,3,4,8,0,0,0,7,17,3,4,6,9,3,10,1,3,1,3,6,2,2,0,2,1,3,3,3,2,1,0,2,16,2,0,2,1,2,1,9,2,3,0,0,8,3,7,8,3,4,9,8,3,3,12,3,1,1,6,8,2,10,1,4,7,2,5,1,2,0,4,2,7,2,0,4,13,1,7,5,1,2,1,6,0,6,1,2,3,1,10,3,10,0,2,7,4,2,5,10,1,1,9,2,2,3,0,14,9,7,13,12,1,4,1,5,1,5,20,17,4,15,3,0,6,1,22,1,3,15,2,0,2,41,0,2,0,3,5,6,2,6,6,60,0,7,1,6,2,2,0,16,2,5,0,18,0,0,5,1,5,2,0
navy,4,36,11,297,29,7,3,21,1,20,16,7,29,148,22,8,10,14,8,3,8,60,5,28,25,37,25,47,4,23,44,394,207,33,121,93,112,20,8,34,6,6,7,9,57,26,44,37,300,14,57,6,5,110,1,6,124,167,2,38,36,24,2,36,32,3,65,28,6,48,42,40,3,7,173,27,49,10,196,22,220,0,30,17,183,32,60,0,96,5,14,3,2,34,75,7,34,16,66,9,125,64,63,10,17,48,16,3,23,19,35,11,29,29,0,38,5,1,126,316,111,25,3,271,19,4,16,1,24,6,19,15,3,100,48,107,6,9,8,19,11,64,50,4,3,120,2,18,33,42,96,3,22,18,1,7,64,18,7,3,19,15,32,7,9,25,5,26,15,10,57,177,39,0,1,13,295,24,20,177,67,11,15,69,6,30,45,73,30,104,0,6,5,6,18,8,50,12,48,14,16,4,4,13,91,19,31,56,21,77,140,23,21,20,8,2,7,4,26,11,18,23,22,41,123,125,70,53,21,28,49,79,50,21,77,23,51,12,12,8,110,52,8,4,8,7,11,85,158,4,20,12,25,17,24,29,16,6,3,122,0,116,37,17,2,290,3,25,6,10,221,19,70,18,28,0,57,74,26,11,120,8,2,21,28,2,4,25,32,9,8,1,13,20,16,16,59,10,15,37,45,121,24,13,11,2,42,14,2,2,2,16,66,12,77,48,20,73,5,14,56,9,60,3,56,11,10,16,5,36,5,43,14,19,18,20,24,11,4,21,20,34,20,21,18,14,78,75,39,11,30,8,10,73,47,20,3,39,31,47,19,29,19,30,9,1,38,22,7,27,12,40,6,3,11,210,47,5,17,6,80,10,120,30,6,53,9,48,44,6,14,18,12,4,56,11,67,27,86,19,50,11,6,1,17,12,19,2,19,36,0,12,2,75,34,10,0,1,6,2,9,32,34,17,9,10,13,39,27,17,5,16,8,42,4,6,1,3,74,12,29,58,20,14,5,8,111,9,105,6,43,14,2,3,76,9,1,17,31,37,16,50,61,235,16,9,17,13,22,0,26,9,7,2,13,58,10,12,66,19,15,36,8,7,16,16,41,6,4,10,457,118,3,2,16,8,22,43,16,7,29,25,19,6,10,1,0,15,7,1,7,6,19,3,19,18,13,18,0,29,9,34,8,53,12,12,28,1,17,32,42,11,28,40,22,7,22,4,55,8,13,7,8,2,7,12,3,32,19,11,18,12,15,70,23,21,110,7,10,36,37,6,36,30,24,46,20,11,71,55,24,24,75,2,41,6,0,13,8,65,16,28,25,47,8,12,12,10,16,33,30,58,8,9,8,2,13,6,32,21,45,8,9,1,9,48,19,18,10,16,41,55,26,5,34,20,38,7,9,7,32,2,19,15,12,17,13,22,31,33,4,83,31,19,17,4,15,60,20,60,30,1,3,44,5,344,16,6,9,213,31,17,11,4,9,25,48,25,25,31,5,15,1,13,6,2,4,13,14,18,53,19,75,2,19,14,31,19,24,2,21,92,13,30,43,17,10,6,21,157,13,19,35,74,14,62,5,4,13,31,7,18,12,22,57,27,27,29,2,9,4,15,1,46,25,336,39,6,7,137,51,12,14,202,45,16,20,8,15,15,11,34,1,15,4,12,1,36,31,21,15,11,63,282,132,26,76,15,10,12,16,10,30,36,22,23,10,49,5,14,11,28,8,36,36,20,15,18,10,5,16,2,0,26,25,26,7,3,10,12,0,2,43,3,9,11,6,17,28,29,15,13,3,12,3,28,4,23,17,12,0,7,14,6,1,3,12,12,22,17,9,4,34,24,31,5,7,6,3,17,5,15,8,76,28,6,27,18,6,2,12,8,13,28,15,15,24,32,21,9,11,5,5,4,7,28,14,9,41,17,12,46,11,8,13,19,10,8,4,12,16,5,5,12,6,11,8,11,20,62,26,7,5,7,10,7,2,4,21,4,10,8,13,3,4,17,15,27,5,6,8,20,11,5,11,11,17,3,40,41,6,4,31,20,3,4,7,0,1,33,0,9,3,18,10,13,19,21,7,16,3,6,33,4,5,28,2,10,1,3,11,4,10,9,6,2,4,29,12,36,25,22,27,9,5,27,8,98,48,9,56,17,17,24,27,5,13,49,76,3,0,6,3,2,7,207,26,27,1,39,44,3,4,10,2,8,6,15,17,6,19,8,2,4,13,2,26,13,22,4,1,7,28,0,0,0,0,14,17,0
constantly,2,11,3,46,4,4,2,10,1,1,14,3,6,54,1,6,1,5,1,5,1,14,3,11,10,18,9,12,1,11,4,87,98,4,32,33,23,5,7,3,6,8,2,0,14,7,7,4,94,9,14,4,14,18,3,7,46,16,0,18,11,5,3,2,14,4,49,3,5,17,19,6,2,4,74,8,10,4,38,14,61,0,6,2,121,14,12,0,17,1,9,3,0,8,34,7,6,6,18,3,6,17,27,6,8,14,7,1,8,5,9,1,13,10,0,18,0,0,35,102,33,7,9,32,5,1,5,3,4,0,11,3,2,35,12,41,5,1,3,8,1,19,18,3,0,33,4,19,14,11,15,1,11,4,11,16,17,6,8,2,6,4,11,1,1,5,5,15,21,2,11,56,22,2,1,10,80,3,4,33,9,5,2,14,5,16,19,13,12,30,3,2,7,2,3,3,4,0,6,8,20,1,4,7,26,5,8,11,2,20,31,3,7,2,0,0,1,3,11,2,0,14,2,9,31,32,17,13,3,12,10,6,18,9,22,15,18,10,3,4,38,25,6,6,12,3,1,20,24,2,2,9,21,8,7,3,11,1,6,18,5,17,4,0,6,28,5,2,6,2,98,10,31,6,1,0,12,20,3,1,34,3,3,13,9,1,2,8,7,2,1,1,6,8,1,7,19,2,3,7,19,17,4,0,3,1,12,7,8,0,2,14,18,3,28,10,8,29,8,1,42,13,28,6,13,2,3,15,2,24,0,11,5,2,7,12,14,6,1,7,8,10,9,6,13,3,19,23,10,1,1,2,4,22,19,5,4,7,9,12,8,12,11,9,7,3,18,10,1,10,1,4,4,6,9,23,15,2,10,8,34,0,24,8,0,12,5,18,12,5,10,4,3,1,15,4,23,2,18,6,9,2,4,1,7,4,6,6,5,9,1,4,4,10,6,7,3,9,4,0,4,7,8,9,3,3,2,9,9,5,4,2,6,1,4,1,1,4,3,1,12,15,4,7,1,4,9,5,17,8,13,0,4,1,24,7,1,3,9,14,7,19,14,14,8,7,7,6,9,2,15,1,5,0,3,14,2,4,14,9,4,10,3,1,11,3,11,6,4,1,40,17,4,3,6,3,0,8,7,4,11,6,3,0,2,19,13,11,5,4,2,1,4,2,8,7,0,10,1,8,7,23,3,8,2,0,13,2,8,10,5,8,9,4,5,5,3,9,23,13,1,1,2,16,10,3,2,18,8,2,21,1,3,22,7,6,12,3,6,9,12,2,8,4,10,11,10,7,16,15,3,3,8,1,5,2,3,4,8,8,5,5,14,9,4,4,3,5,1,7,20,19,8,2,8,7,5,3,11,16,7,3,4,1,3,9,2,7,4,1,24,3,4,7,17,6,12,2,1,2,8,6,0,10,5,5,4,5,7,17,19,13,9,12,3,3,14,5,4,13,7,2,1,26,3,12,2,4,6,59,9,6,2,2,2,6,23,3,5,5,2,2,6,6,1,1,0,5,7,4,10,3,44,4,10,4,0,1,4,2,6,21,8,7,8,7,10,1,0,3,6,5,5,3,4,3,6,3,5,4,1,5,3,3,3,10,12,5,1,1,4,5,2,9,8,25,8,5,3,17,6,0,9,11,4,4,6,4,4,14,8,3,3,3,2,9,36,1,14,5,7,5,6,17,13,3,7,15,4,1,8,2,5,7,3,8,8,6,5,6,8,4,0,2,9,11,8,3,10,2,7,2,3,10,5,8,5,8,15,9,1,8,12,1,2,2,1,6,2,9,1,5,5,2,6,11,1,2,2,2,1,3,5,6,6,2,6,5,6,6,6,0,13,5,2,1,1,3,4,5,2,1,4,8,11,5,4,3,5,2,4,6,9,4,0,10,7,22,3,2,5,4,1,3,6,3,2,1,2,13,11,14,4,3,1,2,8,0,4,1,0,0,9,2,1,8,1,2,5,4,2,2,6,11,1,3,0,6,2,0,0,3,0,2,3,1,3,0,2,2,3,7,1,2,12,5,7,2,1,4,5,2,1,7,1,1,0,1,1,14,1,15,2,7,8,1,0,5,7,2,3,0,4,7,1,4,3,4,0,3,4,0,2,3,1,3,4,6,6,8,1,10,7,0,2,9,7,13,18,3,3,7,0,3,6,3,6,6,7,4,0,2,3,1,2,11,5,0,2,0,16,0,8,2,1,0,0,9,7,4,10,4,4,9,6,4,2,6,5,0,3,3,3,0,0,5,1,1,3,0
territory,58,83,28,493,25,4,12,202,22,11,94,50,22,139,14,15,23,28,8,8,11,96,9,95,48,24,18,24,13,30,38,541,329,12,151,114,152,39,6,18,16,22,13,7,71,58,79,52,1476,39,137,8,42,60,24,26,116,92,1,59,82,15,10,31,39,14,307,10,15,72,15,14,4,10,139,41,33,7,182,57,93,0,53,18,598,27,39,0,84,2,18,13,1,116,111,6,46,14,85,11,54,74,86,22,16,65,6,5,50,15,38,15,6,21,0,97,35,15,275,483,84,24,8,111,19,11,13,7,4,2,25,5,18,128,58,87,21,9,9,17,1,107,94,4,7,196,20,41,57,27,201,1,21,14,20,82,51,20,51,17,19,7,6,5,1,5,15,59,55,34,108,208,55,3,7,33,442,4,23,65,69,38,4,25,34,13,81,53,179,196,8,15,18,0,1,11,30,10,18,24,33,0,0,51,96,22,14,63,40,83,169,7,99,18,0,0,0,0,49,8,7,32,16,44,129,362,37,47,16,12,48,34,10,66,83,27,82,25,11,31,204,109,10,14,32,10,9,24,128,20,18,41,55,22,59,31,43,2,13,73,0,106,85,23,7,54,15,12,46,12,399,4,37,16,9,0,93,12,56,8,126,15,4,41,37,19,0,17,34,4,12,9,14,8,6,32,103,11,16,45,75,115,1,3,29,2,62,8,17,0,5,24,51,10,46,30,19,91,18,11,186,20,70,27,257,64,14,78,12,75,26,26,25,7,13,50,45,34,2,39,14,50,30,56,25,37,147,215,59,11,43,25,29,62,85,7,30,26,40,62,66,23,38,43,23,2,129,28,1,19,4,34,21,8,18,48,20,5,29,19,238,17,124,33,10,209,32,50,105,4,74,7,39,48,100,22,212,10,105,12,58,6,9,7,13,14,24,11,35,47,18,69,4,44,25,23,16,27,5,4,13,42,48,50,7,6,7,40,39,41,27,16,10,55,12,16,2,72,32,17,35,102,22,38,5,24,25,18,134,24,40,24,6,8,178,27,5,47,8,84,50,60,96,30,15,6,40,41,37,3,32,6,6,6,3,11,19,49,34,9,26,45,24,18,19,39,26,21,23,20,197,86,8,13,7,61,14,46,30,24,57,13,7,0,34,4,12,30,20,19,7,8,33,13,35,45,9,25,4,14,28,106,31,88,16,23,92,2,49,94,18,11,10,17,35,14,57,23,122,29,12,3,8,2,24,32,13,46,51,14,196,30,19,246,23,35,52,8,9,15,72,15,104,16,46,41,43,19,106,84,53,25,46,19,20,37,3,22,18,65,5,39,21,31,15,33,13,16,27,29,64,102,13,12,41,30,3,7,270,57,79,8,22,19,26,51,31,86,11,23,110,32,66,28,93,48,65,6,22,14,55,1,8,63,11,9,24,27,56,161,13,60,67,113,63,4,12,39,4,37,12,7,27,122,36,83,17,9,25,827,92,27,12,11,28,37,116,59,37,73,22,63,74,101,28,24,2,71,45,32,65,18,384,124,102,15,13,32,42,73,39,64,60,34,37,4,51,18,52,57,68,17,30,106,23,24,33,25,35,64,10,14,23,9,16,30,41,23,9,27,24,27,25,75,127,113,61,22,37,4,63,17,57,91,5,108,27,1,8,42,20,66,16,18,32,20,31,14,1,85,27,50,9,6,32,7,20,20,7,43,36,12,5,17,5,42,29,53,26,8,6,27,12,8,133,30,23,17,15,75,18,37,5,67,12,53,7,5,144,76,74,24,40,4,27,19,18,310,33,36,17,96,52,13,21,54,13,39,8,29,9,20,36,20,10,2,11,15,61,29,5,17,36,28,2,25,21,11,18,50,36,19,5,10,44,23,2,24,3,27,10,30,20,23,21,35,17,58,65,25,25,33,32,28,10,12,15,6,28,32,63,108,18,13,4,15,15,21,36,2,32,22,14,12,18,29,18,11,34,32,10,13,13,3,12,14,19,29,40,4,6,22,6,21,56,22,23,31,59,21,32,120,2,6,17,26,43,74,22,5,12,43,15,36,29,5,29,10,10,78,2,2,31,24,80,17,10,23,7,3,30,26,20,17,5,35,18,46,17,3,19,5,31,40,21,6,10,28,11,23,3,20,6,6,2,22,11,60,24,8,12,13,17,11,29,5,73,32,74,16,45,65,7,11,2,28,36,6,34,37,23,46,15,8,23,26,0,23,36,58,13,16,15,2,29,5,39,6,84,4,9,3,15,0,0,0,0,33,5,1
population,6,15,8,94,1,29,6,75,1,8,9,18,9,94,8,9,1,12,2,2,6,31,20,24,10,4,12,15,10,8,12,117,169,7,51,81,48,18,17,12,8,9,3,1,27,21,20,10,273,12,31,1,29,64,16,1,26,21,1,41,10,7,4,3,9,8,126,9,5,7,31,3,3,3,69,20,15,4,92,22,177,1,16,8,146,17,12,0,22,4,1,11,5,19,37,10,25,7,48,25,18,29,17,12,17,26,8,2,34,9,20,2,8,7,3,21,2,9,30,129,42,13,5,85,7,0,10,3,1,5,24,1,17,41,14,38,0,6,5,13,3,31,40,6,6,41,16,43,32,15,56,2,13,30,22,17,15,9,9,13,19,3,6,4,9,2,11,17,24,9,37,84,10,2,16,6,132,2,12,36,22,9,13,8,8,17,30,12,23,41,5,6,8,7,1,4,11,2,16,18,17,1,4,7,32,8,6,27,16,30,66,7,9,16,0,1,0,2,13,5,9,12,11,18,46,72,25,31,12,11,15,25,18,16,43,20,26,14,15,7,39,38,8,8,20,2,8,31,36,6,9,27,9,18,13,8,8,3,3,53,1,18,7,0,5,24,13,3,18,7,117,6,24,7,3,1,25,30,7,1,54,2,9,12,15,6,13,12,10,6,3,2,2,10,4,11,26,6,2,22,17,19,8,5,18,1,13,2,5,3,2,11,21,5,49,8,28,33,14,5,27,7,29,19,39,6,14,24,0,11,5,15,8,6,3,12,18,4,8,16,5,9,10,5,23,3,47,41,19,10,6,7,4,14,20,17,1,7,10,33,13,18,13,21,13,1,24,4,3,9,4,18,7,19,3,23,12,4,23,7,67,4,34,9,9,52,5,15,21,4,23,5,18,17,40,13,32,2,12,6,21,4,4,3,5,47,12,2,17,15,7,11,8,22,5,7,1,4,0,0,2,2,14,11,3,2,7,12,8,10,2,5,1,6,1,8,0,8,10,8,13,18,4,33,5,3,8,6,45,8,10,4,4,4,55,9,1,11,8,26,10,35,38,20,13,5,26,21,18,0,15,0,5,10,1,20,11,16,12,9,3,35,10,3,6,2,19,3,5,2,97,48,1,6,9,17,10,1,18,11,22,8,14,2,2,6,16,11,4,7,11,1,6,0,14,15,3,7,1,15,13,20,5,25,7,3,19,0,7,27,10,12,2,7,8,7,9,1,44,10,10,5,3,20,13,3,8,21,8,11,36,4,1,63,8,10,31,4,6,6,19,3,12,3,15,4,4,3,14,22,24,11,9,1,11,4,6,3,13,12,7,7,14,11,7,8,12,10,5,12,21,29,9,2,30,17,14,3,27,10,13,7,5,5,2,16,8,22,2,10,14,3,15,8,14,19,20,3,2,4,13,7,4,10,1,9,5,4,12,31,7,21,18,22,9,2,8,5,0,10,8,15,11,14,5,15,5,0,1,115,12,4,3,2,8,19,36,13,4,14,5,11,4,19,6,7,1,13,11,10,22,0,37,8,18,5,5,12,1,15,6,11,9,15,8,6,3,9,7,9,10,4,13,18,7,12,6,2,7,8,1,7,6,3,6,10,14,12,4,1,4,3,5,27,30,26,5,7,9,5,0,10,6,12,4,6,18,0,5,15,9,17,8,6,5,8,21,5,85,1,8,11,6,8,10,5,10,13,5,8,9,9,5,7,9,9,3,25,14,54,31,16,3,4,20,17,41,12,22,10,12,11,8,22,4,12,8,1,7,10,3,3,5,0,11,11,5,21,24,12,4,25,9,7,7,13,5,7,2,7,4,5,5,3,0,2,7,10,12,13,6,1,0,6,6,1,8,2,2,7,1,2,6,3,4,3,3,8,3,8,8,10,15,2,11,13,4,25,15,4,3,5,7,1,2,3,8,1,9,8,8,9,2,10,2,2,6,4,1,7,5,6,1,6,15,16,7,2,5,12,8,8,6,5,6,12,2,0,4,3,0,1,3,0,2,2,5,5,14,11,3,15,0,8,1,6,8,4,9,2,8,3,2,13,8,5,1,6,3,21,1,2,7,17,18,0,18,14,5,5,5,4,6,0,2,6,1,2,2,0,6,1,7,16,3,4,7,10,4,26,3,12,6,4,4,6,12,27,14,1,5,2,13,1,3,8,22,8,4,0,10,11,8,2,2,7,12,1,6,11,4,9,11,7,8,5,3,4,3,16,15,10,6,6,4,5,9,15,8,3,5,10,10,0,4,7,5,4,5,2
certain,13,22,6,147,9,10,4,19,5,7,29,14,25,73,13,14,7,14,5,6,3,35,10,19,37,21,8,14,13,19,11,230,126,7,61,45,40,7,19,4,8,9,6,4,30,10,18,21,254,16,46,5,11,34,17,10,45,32,1,19,15,8,2,14,35,5,67,8,7,33,6,3,3,6,100,19,25,6,81,22,55,2,21,11,205,31,15,1,21,2,5,5,4,35,57,27,21,4,33,24,20,53,48,6,18,27,5,10,13,1,14,4,13,14,2,46,4,4,53,211,44,27,23,50,16,3,3,3,2,1,28,5,9,46,24,74,6,5,5,5,9,37,24,11,3,79,8,27,26,16,56,2,17,6,5,31,39,6,6,7,19,15,13,3,3,17,4,25,28,7,8,102,23,12,6,14,169,2,13,44,26,8,7,23,5,29,34,26,41,54,4,13,7,4,4,0,21,11,4,19,46,1,3,8,17,12,22,37,10,28,94,12,30,11,3,0,4,8,9,3,4,26,5,18,31,101,44,26,3,11,19,29,28,26,41,23,50,13,11,7,55,33,10,6,20,8,4,20,54,1,10,13,13,5,9,13,15,3,3,19,11,28,13,7,9,44,2,7,13,5,109,6,36,4,5,1,28,14,10,9,38,12,10,18,9,4,5,20,17,3,7,10,24,7,3,10,24,8,7,17,26,32,0,2,11,3,20,7,7,2,6,51,21,8,33,11,13,47,14,10,31,20,33,1,44,7,17,35,3,38,3,8,16,12,8,14,12,8,6,5,18,13,13,13,13,7,34,52,22,13,13,13,3,62,24,6,5,5,15,30,35,8,15,33,7,1,33,12,18,21,3,12,5,11,18,24,7,10,15,6,58,2,50,15,14,51,3,38,38,2,25,4,18,17,29,9,52,7,39,3,14,5,5,0,3,6,10,1,21,11,2,11,11,26,3,13,4,9,9,5,7,10,28,19,1,6,7,15,11,24,5,10,5,19,5,5,0,16,10,9,18,20,6,11,2,7,11,7,53,11,14,5,8,1,49,10,1,5,15,31,15,13,35,37,9,0,18,26,7,0,16,8,2,11,4,33,3,26,30,11,14,5,7,5,9,10,14,8,15,2,95,54,6,1,10,8,2,21,6,10,18,10,4,5,11,28,12,16,11,14,6,5,10,13,14,22,5,9,8,9,3,13,7,34,6,4,38,14,29,34,12,9,14,16,16,3,11,20,53,28,5,2,5,12,15,11,5,20,16,11,18,3,14,38,7,15,26,4,8,13,21,6,29,7,22,16,12,8,36,38,9,14,18,5,2,4,15,11,7,26,9,12,11,10,4,10,8,13,4,10,17,31,12,5,36,11,20,15,44,24,22,8,11,10,6,26,6,16,9,6,35,37,16,5,31,7,15,12,16,6,21,1,7,18,6,6,5,12,15,30,13,21,37,20,7,5,9,6,2,12,11,5,12,26,9,25,11,4,8,144,13,3,13,4,7,9,27,14,8,9,3,6,17,17,11,9,0,8,11,14,27,6,28,35,29,5,4,14,2,13,3,29,14,8,6,4,9,4,5,8,15,14,5,3,10,10,7,11,13,19,21,9,9,16,11,4,17,4,5,4,10,8,12,19,23,27,6,4,11,5,7,11,4,13,4,2,17,6,3,12,8,20,9,6,2,14,15,7,27,8,1,6,4,17,4,4,6,5,9,13,13,3,5,9,2,6,6,7,6,12,11,18,5,4,19,22,13,10,17,24,11,15,9,27,3,12,4,6,16,8,5,2,16,11,6,6,9,17,8,19,2,11,7,4,27,17,16,9,3,9,10,4,6,8,8,3,3,6,19,5,9,4,9,15,5,7,8,7,10,15,4,0,5,15,7,1,3,10,4,6,10,2,6,15,4,5,12,33,5,6,5,3,7,6,16,7,10,13,7,6,14,29,4,4,7,7,17,5,8,1,5,8,5,7,6,2,20,1,9,20,9,4,9,15,6,5,9,4,9,2,0,3,5,11,10,6,10,11,3,7,2,13,0,3,5,4,4,7,0,5,8,4,3,7,4,4,4,8,16,19,3,15,4,5,10,4,3,4,6,4,8,14,4,6,7,7,2,22,6,4,8,3,5,6,4,8,3,8,9,6,2,11,10,6,5,13,8,8,21,3,0,2,4,5,13,6,2,1,14,3,6,5,14,7,1,7,11,2,5,7,22,4,11,4,7,3,3,3,6,9,8,8,4,7,9,4,11,3,3,0,2,3,3,4,1,5,7,6,0,1
possession,5,10,1,51,5,2,5,14,7,3,15,6,5,36,5,2,3,7,2,2,3,29,2,12,8,1,6,6,1,7,12,86,62,7,30,36,34,4,2,3,2,3,0,2,13,9,15,5,236,21,29,3,2,31,1,4,19,21,0,9,14,6,3,9,7,2,65,4,1,24,1,7,5,1,41,11,12,3,60,7,19,0,26,6,140,10,6,0,17,1,4,2,0,12,27,3,9,1,21,6,16,23,22,6,3,13,0,4,12,3,8,6,1,3,0,15,0,3,35,152,26,12,0,25,4,0,4,5,1,2,7,6,3,28,4,25,4,0,2,5,4,19,23,2,3,50,0,4,12,7,39,3,12,4,3,7,13,3,7,5,2,2,4,2,0,4,1,15,6,5,19,42,17,0,2,6,94,2,9,14,16,7,0,11,7,16,24,13,29,26,6,2,8,0,1,3,6,4,1,6,3,0,0,4,15,6,2,12,8,19,59,8,19,6,0,0,0,0,12,0,2,7,2,12,24,46,17,11,5,4,14,6,7,9,21,4,13,9,4,1,34,23,7,9,11,0,6,17,21,1,4,21,12,3,11,11,3,0,1,13,0,19,9,9,7,14,2,5,9,2,83,2,12,5,1,0,18,2,7,4,34,1,1,10,13,4,0,7,5,1,6,2,6,0,4,5,24,1,2,8,12,12,0,1,2,1,12,2,3,0,0,0,10,1,15,9,11,18,10,1,36,2,8,7,42,2,7,18,2,41,3,6,8,2,5,14,10,10,1,9,3,6,11,12,2,15,19,42,7,3,5,4,5,16,18,4,1,5,3,6,15,9,8,8,5,2,33,5,1,9,1,5,3,3,4,10,6,3,15,1,36,2,25,6,0,48,3,18,22,1,10,4,7,6,18,9,34,5,16,3,13,1,3,2,1,3,5,3,18,4,0,10,5,9,14,11,2,7,1,0,4,9,7,10,1,2,1,7,6,9,6,2,0,5,1,2,0,14,8,8,9,21,11,11,5,7,11,6,21,5,12,3,1,2,43,3,2,8,3,17,9,16,21,6,4,16,13,11,5,1,1,3,3,1,1,8,3,8,4,7,2,8,12,3,3,4,6,7,4,1,67,30,2,3,3,14,5,12,1,5,7,2,3,0,15,9,1,15,3,7,1,4,11,0,3,7,7,5,2,6,3,23,2,10,2,6,17,1,17,16,3,4,9,4,5,2,12,6,37,4,5,0,2,0,8,6,1,8,8,2,10,2,5,31,1,3,21,1,3,4,8,3,11,3,14,11,9,3,26,20,9,11,5,1,9,3,4,5,7,12,6,12,8,12,3,1,3,10,5,5,11,10,6,1,8,6,1,2,45,8,12,1,4,4,7,13,4,13,3,5,21,2,7,3,16,3,3,5,2,3,10,3,1,7,1,7,14,7,11,28,5,12,9,12,7,3,3,7,0,16,4,1,15,20,3,16,6,2,3,150,66,6,2,1,4,14,18,10,3,6,2,10,11,29,4,3,3,9,5,6,13,9,42,15,24,2,1,8,5,9,3,32,5,10,9,3,4,6,19,26,6,5,10,33,3,11,6,3,6,9,3,3,4,2,4,6,12,5,0,2,7,6,1,15,15,18,8,2,5,2,9,3,8,14,1,23,5,0,2,9,3,13,2,6,6,8,11,5,50,11,6,1,8,3,7,3,4,6,3,4,8,2,0,2,0,7,3,5,4,2,1,10,5,1,17,4,8,4,3,14,7,3,1,13,5,4,0,1,22,13,6,4,13,0,3,10,3,13,4,9,5,6,2,2,13,11,3,7,2,5,2,10,12,4,7,0,1,8,13,6,4,18,12,4,2,4,6,5,12,7,5,1,0,7,5,4,1,2,4,4,3,4,2,6,7,11,4,13,12,5,8,11,2,6,2,10,5,0,3,11,14,24,3,1,4,6,8,4,3,0,7,3,4,4,4,6,0,0,8,5,1,8,0,0,2,2,6,12,6,4,2,9,0,5,14,2,6,6,12,5,10,19,0,4,5,4,7,8,1,1,2,4,7,10,4,0,16,3,2,12,1,2,8,3,6,2,0,4,3,2,10,6,3,6,1,2,5,8,7,4,7,3,5,7,1,3,5,2,1,4,2,1,2,1,6,4,6,9,9,3,1,2,0,3,3,0,17,17,3,4,7,11,0,5,3,18,7,0,0,11,19,3,1,4,3,9,0,4,10,11,4,2,1,4,4,1,4,0,24,0,5,3,2,0,0,0,0,9,0,0
building,2,9,4,91,5,3,2,7,2,9,4,11,12,50,7,2,4,10,5,1,2,13,11,7,13,15,7,12,0,4,2,101,42,4,26,35,16,18,9,1,1,3,6,5,7,1,13,13,90,25,13,2,5,25,7,2,11,23,2,14,4,4,3,17,15,0,35,5,4,16,7,5,1,1,33,16,16,2,46,12,37,4,14,3,86,9,15,2,11,4,11,2,2,12,15,7,5,3,26,13,41,22,15,6,5,19,2,5,3,6,4,8,11,7,13,9,1,2,21,83,23,19,6,45,6,3,2,1,9,4,6,2,3,36,6,50,1,7,7,4,0,13,12,2,1,37,0,10,14,6,13,5,6,9,4,14,14,6,4,13,11,6,10,0,12,7,6,10,16,2,14,47,21,3,3,0,52,4,6,51,21,10,19,16,15,8,14,17,11,20,1,4,3,2,4,1,22,4,13,5,18,2,5,6,11,4,7,12,9,10,49,15,14,5,5,3,1,2,7,3,2,10,4,9,28,45,7,8,4,5,11,13,4,9,31,3,21,11,12,4,22,13,2,0,9,0,4,22,62,2,8,4,9,3,7,8,2,2,0,21,2,9,7,1,1,75,6,3,2,4,50,10,5,7,4,0,11,10,5,3,24,0,8,5,5,2,2,9,2,3,0,3,7,11,3,3,13,0,6,12,5,31,4,4,2,2,10,4,1,4,4,6,15,2,12,7,4,15,9,6,16,0,16,23,11,1,0,13,3,9,0,4,4,5,3,11,8,3,5,3,7,6,11,7,11,13,10,25,15,8,2,0,2,38,8,3,2,12,7,14,9,8,13,8,0,0,9,3,1,7,0,20,8,9,4,12,2,2,4,0,22,7,27,3,3,28,1,9,9,1,5,8,13,9,18,3,12,0,9,6,9,6,3,3,2,4,3,2,17,11,4,10,1,19,1,2,0,5,1,2,0,4,9,3,1,1,2,10,2,9,0,0,0,4,4,4,1,5,7,2,6,9,12,8,2,1,40,0,21,3,7,1,2,1,21,1,0,1,7,12,7,6,6,19,4,5,20,7,9,1,10,5,7,2,8,7,2,6,14,8,4,4,4,1,4,5,10,1,1,0,45,14,1,1,3,13,9,7,5,4,6,6,2,4,11,10,5,6,3,1,1,1,6,5,5,4,6,2,0,5,2,14,2,8,1,8,6,2,3,11,1,1,2,7,3,3,3,3,20,17,2,3,0,5,5,5,3,6,2,2,5,1,3,23,3,10,12,1,0,8,6,2,16,2,7,10,4,3,30,19,4,6,22,0,5,0,0,2,3,12,3,11,13,2,2,2,6,1,2,9,5,7,6,4,8,0,3,0,21,6,6,2,3,3,0,8,1,5,2,0,9,9,9,2,10,4,2,5,1,3,16,0,5,1,7,1,5,8,7,13,1,15,5,8,3,1,3,3,0,5,3,1,1,5,4,21,8,6,6,48,7,6,1,0,7,4,8,11,3,10,4,4,2,5,2,1,0,1,2,3,6,6,5,4,6,1,4,4,16,4,29,20,4,6,17,4,0,1,1,15,5,11,2,9,2,21,3,0,1,8,5,3,1,2,7,12,5,6,2,0,0,6,0,9,6,10,1,3,3,10,3,1,1,17,1,4,4,1,0,3,4,20,1,4,3,6,63,6,9,6,4,8,1,41,11,4,5,10,0,3,3,0,1,4,3,3,3,11,3,5,1,6,3,3,8,4,29,3,12,6,2,1,2,5,9,6,8,4,10,7,1,3,5,2,10,2,3,0,6,9,3,11,5,1,6,8,12,10,2,1,2,2,4,3,3,8,4,4,8,4,1,3,3,9,1,0,1,1,2,5,2,1,4,20,9,0,1,14,7,1,0,12,3,0,1,3,5,8,6,3,1,5,1,0,5,10,3,2,3,1,2,13,2,0,8,6,2,6,0,1,4,1,1,1,6,3,11,7,2,9,2,2,0,1,3,0,2,2,5,8,0,4,2,0,9,2,4,2,1,6,10,5,4,3,2,1,2,6,7,3,9,3,5,2,0,4,5,3,0,9,2,12,0,2,3,2,0,12,3,2,1,1,3,1,1,4,0,3,0,5,6,4,1,1,2,0,5,4,0,7,3,2,4,0,0,1,1,15,8,2,3,5,0,6,11,2,3,7,26,2,0,0,1,1,3,23,4,0,0,3,1,0,3,3,2,7,1,2,6,0,4,3,0,0,1,2,4,6,2,0,4,5,7,0,14,0,3,3,2,0
ship,10,4,5,97,7,6,4,6,1,11,5,8,20,63,6,0,10,11,2,2,7,35,10,24,25,25,10,22,10,13,20,195,93,9,89,61,41,11,8,6,1,9,10,0,26,14,35,8,231,45,44,3,6,66,1,8,68,42,2,14,12,22,2,29,15,1,25,20,6,39,10,34,1,3,121,14,44,9,113,14,93,0,16,19,89,19,40,0,49,5,17,3,0,16,51,9,13,8,28,11,83,37,25,6,6,26,1,5,20,8,19,8,3,14,11,29,4,2,50,177,47,41,8,112,12,0,4,7,20,2,7,15,0,74,18,59,1,0,8,3,6,30,21,1,2,75,7,11,19,5,63,4,21,8,4,4,30,3,13,3,23,9,17,9,5,21,7,21,31,7,41,255,30,0,3,13,150,12,11,90,28,3,5,36,5,58,52,41,25,229,4,7,16,7,0,7,25,4,48,8,22,0,3,14,36,6,18,22,10,26,79,15,19,9,4,5,1,3,1,4,6,22,14,19,35,59,36,39,16,8,31,59,13,16,43,8,43,14,8,5,67,51,13,2,13,7,6,68,89,5,3,30,20,6,9,24,11,8,3,48,5,40,18,5,9,31,2,6,10,6,125,2,19,13,11,0,35,26,12,2,81,3,0,22,21,2,3,13,15,3,7,4,5,6,10,9,39,7,3,24,30,35,8,12,9,0,11,4,5,1,0,11,31,1,46,22,18,38,15,2,23,6,52,3,35,9,5,11,2,16,3,20,16,10,14,4,8,5,1,15,7,36,12,6,10,9,39,46,15,5,9,1,16,49,19,14,0,16,13,22,24,34,22,13,5,0,25,20,3,10,6,7,8,1,13,71,19,5,10,3,49,5,44,19,1,43,4,38,18,0,8,11,8,10,33,9,31,10,40,4,28,8,5,2,5,9,10,3,59,10,2,22,12,26,14,7,1,13,1,2,9,10,11,9,5,4,5,24,18,18,4,9,0,22,3,2,0,6,20,3,17,20,6,22,3,8,89,16,51,12,21,7,10,2,72,8,0,11,24,25,17,17,34,128,8,9,17,20,22,0,25,9,7,2,9,44,2,7,49,25,20,20,8,2,7,10,18,4,2,1,205,44,2,0,24,1,20,12,10,2,26,11,4,2,16,2,3,13,6,3,1,3,5,5,13,6,7,11,2,8,3,25,5,39,2,12,24,4,13,20,19,4,15,24,12,11,11,10,29,11,10,3,14,3,12,10,17,23,8,9,9,4,9,51,10,34,81,4,1,11,23,10,10,6,11,13,14,7,28,34,12,6,30,2,11,5,4,11,11,27,22,19,18,21,4,2,8,2,3,18,15,41,10,6,13,4,13,7,33,14,9,6,10,0,2,17,8,18,7,10,26,27,8,10,27,8,22,9,3,3,18,1,4,11,4,15,11,5,21,36,14,17,21,11,11,1,8,25,14,16,13,0,5,22,6,76,8,3,7,160,28,16,13,0,11,10,27,11,7,7,5,16,7,17,5,1,4,5,2,18,20,3,16,0,12,5,6,8,8,6,27,67,10,11,16,7,5,5,3,60,15,9,24,44,8,30,4,2,7,16,10,5,4,13,12,17,9,14,4,5,1,15,1,18,14,25,13,4,3,40,37,7,5,90,26,11,9,7,7,8,12,20,5,8,5,3,282,17,6,8,17,3,41,1,129,15,34,9,12,12,6,2,6,20,10,12,7,18,3,18,13,16,2,15,14,20,17,8,3,2,10,2,10,12,6,18,4,3,1,7,5,3,20,5,3,10,6,3,31,21,5,7,6,12,22,17,10,6,7,1,1,6,8,2,6,9,11,5,15,9,10,4,48,14,51,8,2,8,10,10,4,8,2,30,9,8,3,11,0,3,7,4,1,10,9,5,11,16,2,3,5,4,0,2,12,13,6,7,9,9,14,28,5,9,1,6,3,8,2,3,12,6,5,2,3,4,3,6,6,18,3,3,2,1,8,3,3,9,13,7,4,9,6,1,5,3,8,4,6,19,15,22,4,5,7,14,4,1,54,37,2,6,8,3,1,10,4,3,2,18,1,1,4,8,9,7,11,27,7,7,6,3,12,14,3,1,2,19,3,0,5,4,0,4,2,1,3,7,5,6,12,11,4,0,7,10,1,22,13,8,6,13,3,18,5,3,11,28,32,5,0,8,3,1,5,105,2,0,2,29,25,2,2,3,4,5,0,9,4,3,8,3,1,0,3,0,13,5,21,3,3,1,3,0,0,0,3,1,5,1
sea,16,6,5,81,10,5,9,19,4,8,9,13,20,129,17,5,2,4,4,6,10,49,4,17,20,5,19,10,8,12,19,183,109,6,70,87,56,2,1,8,5,13,12,1,24,16,27,11,313,20,44,3,4,63,0,16,57,31,0,15,20,30,2,20,8,6,41,6,8,26,9,21,1,8,75,15,37,6,90,18,55,0,13,15,157,7,22,0,45,1,19,6,1,27,44,3,22,9,32,16,23,28,32,10,11,30,4,7,18,4,18,7,4,9,0,37,4,5,45,141,39,33,1,78,15,10,8,5,11,0,10,10,7,56,21,33,7,2,8,12,4,29,32,10,3,69,3,15,16,10,69,3,16,12,2,3,33,4,17,3,11,8,11,7,3,8,5,15,23,9,30,80,17,2,2,14,167,4,14,50,22,12,4,21,1,18,44,27,28,69,6,6,11,1,0,6,12,7,6,11,7,2,0,16,52,10,10,21,14,38,74,12,20,14,4,2,1,3,4,2,3,34,5,24,48,70,26,47,5,5,17,21,15,20,48,12,36,8,6,9,71,56,11,4,12,3,5,37,61,5,8,18,25,4,18,24,6,6,6,40,0,51,24,10,4,34,0,8,19,10,185,0,16,16,10,0,40,12,13,1,70,6,0,18,18,6,1,6,8,1,10,3,3,7,9,16,38,10,4,23,28,28,4,8,12,1,27,2,3,10,2,7,34,2,18,18,12,53,8,5,55,6,44,0,82,14,0,23,1,23,0,13,9,8,10,8,15,9,5,5,4,28,12,10,8,11,38,64,16,2,15,10,13,38,24,12,0,13,15,13,10,14,2,20,12,1,32,24,2,11,5,19,9,1,8,57,15,2,14,7,69,5,61,10,1,78,3,22,33,4,23,3,6,9,39,11,54,3,36,6,29,13,10,1,2,10,7,6,53,9,2,26,3,16,10,8,2,9,0,5,3,10,12,13,7,4,5,14,13,16,6,4,1,11,6,5,1,17,24,1,32,42,2,21,6,6,45,13,42,5,25,7,7,1,90,7,1,20,10,18,15,25,31,93,5,8,29,29,42,0,26,3,8,4,6,25,9,8,21,13,8,18,9,9,9,14,9,3,4,3,157,34,2,2,17,5,6,15,16,2,20,16,3,0,3,2,1,7,8,3,4,0,10,23,15,9,5,6,0,7,3,34,1,26,4,4,21,0,12,33,13,5,7,7,15,6,13,6,26,0,9,1,8,3,8,7,2,28,15,1,6,5,12,43,6,23,116,6,8,15,32,6,21,10,17,13,7,4,37,34,13,6,17,8,15,11,2,9,4,22,9,17,12,22,8,4,16,7,14,24,33,29,10,6,11,5,4,1,62,20,12,5,5,3,9,34,5,22,6,6,16,16,5,18,40,5,34,2,7,9,11,2,8,10,3,10,14,22,17,37,5,21,40,17,6,5,10,16,8,30,10,4,2,17,13,35,9,6,2,222,42,9,16,9,13,16,33,22,2,15,3,29,27,56,12,3,30,5,3,20,19,3,32,9,34,8,5,7,11,12,18,45,13,19,18,4,15,8,8,59,10,7,18,76,6,16,7,8,8,16,19,3,4,13,10,14,17,23,2,6,1,12,4,21,20,30,12,9,14,17,31,5,11,46,24,18,12,3,5,14,3,16,5,7,6,3,132,13,32,10,4,7,11,129,1,15,24,10,5,11,12,1,2,9,4,7,9,11,10,5,3,14,4,12,36,9,20,5,8,16,14,8,2,12,15,24,1,0,2,10,2,5,16,0,12,12,7,16,14,7,8,1,9,8,3,12,10,7,2,1,4,8,15,2,6,3,7,5,15,7,13,10,39,11,34,8,2,17,8,15,4,8,23,21,6,9,9,9,2,3,8,7,2,7,5,6,17,18,20,1,14,5,1,7,8,14,13,20,5,7,26,16,8,9,5,4,2,1,3,3,8,11,3,3,2,4,15,4,11,12,2,0,6,6,4,4,7,13,13,14,4,8,2,2,11,8,5,6,15,6,10,35,1,2,14,3,9,2,11,23,3,7,6,10,0,6,7,8,0,39,0,1,5,4,9,9,12,41,2,8,5,10,4,7,5,15,14,15,2,0,7,8,10,7,7,2,4,7,6,6,8,7,6,1,1,11,6,15,7,4,6,8,2,6,5,5,33,31,23,6,3,11,2,2,2,106,3,0,0,49,17,4,7,2,5,10,0,11,7,7,9,8,3,5,2,3,5,4,22,2,3,1,4,0,0,0,0,3,10,0
insure,0,10,2,55,2,4,2,20,1,3,20,4,7,36,6,5,2,11,4,3,1,19,3,6,16,4,4,7,4,3,6,103,55,4,34,42,34,4,5,2,5,3,3,1,19,7,21,14,100,14,10,3,6,21,0,5,40,10,2,10,5,4,4,5,5,8,45,7,1,6,8,3,2,9,45,11,10,4,49,15,15,2,2,4,76,7,12,0,17,3,3,1,2,5,37,6,9,2,13,2,7,11,14,5,8,11,1,0,3,2,8,4,3,12,1,9,1,5,24,96,23,6,1,29,2,1,3,5,2,0,9,0,0,23,12,25,1,2,3,4,0,19,9,2,2,37,1,8,6,7,40,0,10,4,3,18,24,4,2,4,12,0,7,2,4,3,4,11,9,3,12,45,18,2,1,5,59,3,8,37,10,7,5,8,1,26,19,9,12,24,3,4,2,0,2,2,18,8,4,9,15,2,0,5,19,6,10,26,5,10,37,1,8,2,3,0,0,0,12,0,0,6,3,4,20,49,13,12,3,9,5,8,5,14,14,10,11,7,7,5,20,10,3,2,7,6,4,22,33,4,7,8,11,8,9,9,3,2,2,12,2,15,11,0,1,21,4,2,8,2,65,3,13,8,3,1,13,4,5,2,28,8,2,5,6,5,0,3,4,1,1,0,10,2,1,6,14,2,6,2,17,25,1,0,2,3,13,2,2,3,0,8,13,6,25,4,16,15,5,5,23,1,22,0,22,3,4,7,2,16,1,10,5,2,5,7,9,0,2,4,3,5,11,7,5,7,19,18,3,2,3,9,2,21,14,6,3,1,4,18,8,4,4,13,2,0,19,6,9,5,4,8,3,7,3,19,1,4,3,7,28,6,32,7,0,8,1,8,11,4,12,3,6,2,10,8,18,3,31,1,9,1,1,2,2,6,4,2,12,6,1,7,1,5,8,1,1,2,2,5,3,11,8,6,2,1,1,11,4,9,20,6,0,2,3,2,0,3,2,0,8,10,8,6,3,0,5,3,14,3,10,3,4,5,24,2,1,3,5,11,8,9,17,24,7,2,7,5,10,1,7,5,1,1,4,15,2,5,14,8,5,10,5,2,7,5,8,3,3,1,37,17,1,1,5,6,4,3,4,7,12,6,2,3,12,27,3,7,9,6,2,2,4,4,8,6,4,2,10,11,5,10,7,17,2,2,16,9,11,14,4,3,1,6,5,6,3,14,12,18,2,1,0,0,3,2,2,7,7,2,17,4,0,14,4,7,9,2,2,7,12,1,10,1,7,10,5,3,18,33,7,1,3,0,6,3,4,1,4,6,6,2,8,15,6,0,7,2,3,7,4,13,11,1,9,1,4,1,6,10,13,5,2,1,3,14,1,9,8,6,8,10,4,3,14,5,15,2,3,3,13,14,3,18,2,6,0,5,6,15,34,5,15,9,7,1,7,7,2,6,5,1,2,8,7,13,3,2,4,55,7,3,5,2,1,3,17,9,9,6,7,2,2,6,1,0,1,2,7,5,4,3,2,6,3,4,0,4,1,2,3,17,7,3,6,1,12,4,4,0,4,7,6,6,1,3,10,0,6,5,18,1,1,1,7,8,5,4,3,0,1,1,1,13,2,10,2,4,1,8,3,3,3,16,3,3,4,4,3,8,10,7,7,8,2,2,26,3,7,5,4,3,4,15,15,1,5,2,2,2,5,1,0,2,2,4,3,10,3,4,2,7,0,0,4,15,2,2,6,3,3,1,0,7,3,3,10,3,2,0,1,6,5,2,7,2,8,0,14,11,5,3,1,2,6,6,8,2,0,3,4,2,4,0,5,3,7,3,4,2,1,1,8,1,2,1,2,3,4,3,3,2,1,11,0,3,3,5,11,1,3,2,1,1,3,4,4,14,6,3,2,1,3,5,5,4,4,4,2,5,9,13,17,1,2,3,2,3,0,0,9,0,7,3,7,4,1,2,5,10,5,2,5,20,3,1,1,2,0,9,1,7,1,0,7,1,2,0,1,2,1,2,1,1,1,3,3,1,2,4,7,0,5,3,0,0,3,16,5,10,3,8,3,4,8,2,3,4,2,1,4,1,3,4,5,4,3,1,2,10,5,1,1,0,2,2,3,4,5,6,4,1,0,1,0,13,13,2,24,0,0,3,4,4,1,4,0,3,12,4,0,1,5,5,4,12,1,0,0,0,3,1,2,2,3,4,0,4,1,1,8,3,0,15,1,3,1,4,3,0,0,1,0,0,6,1,1,1,3,5
add,5,20,6,175,4,7,6,25,5,9,16,10,15,86,9,7,7,19,6,6,7,50,22,27,15,26,7,24,6,31,5,191,152,13,64,67,39,21,23,24,18,6,5,10,38,22,40,21,261,23,50,8,24,42,13,4,101,40,7,11,14,13,5,19,25,5,114,12,12,27,69,10,11,5,103,17,28,11,93,36,139,2,12,11,259,39,24,4,55,6,17,9,9,54,56,15,30,12,48,25,34,55,38,19,17,40,7,8,39,7,23,10,25,31,19,36,7,6,83,240,48,25,31,185,15,5,6,5,10,9,10,6,14,53,18,57,13,5,9,8,2,47,46,9,1,78,10,21,26,34,69,8,26,17,7,35,31,8,8,17,28,4,13,4,21,16,10,23,35,6,46,99,30,1,3,10,197,4,7,46,31,16,6,20,5,29,42,27,29,88,6,4,11,3,7,6,22,4,25,14,28,4,2,11,54,22,22,42,3,27,82,12,31,23,2,13,24,16,30,9,19,27,7,23,57,137,50,40,22,13,17,30,36,17,55,67,44,13,13,13,81,39,8,7,19,10,5,39,68,12,24,53,18,22,17,18,21,15,5,72,6,38,25,11,13,61,9,9,14,8,168,20,100,9,8,3,20,49,16,7,71,6,3,27,22,9,8,15,20,3,4,2,25,29,8,14,50,7,10,23,19,41,20,18,18,5,22,6,8,8,1,23,31,11,77,42,25,60,19,8,51,7,32,12,43,6,8,44,4,19,13,18,5,10,12,15,22,10,6,17,14,12,26,15,8,4,63,67,28,12,14,15,9,46,24,9,3,9,14,55,27,11,8,19,14,1,34,11,8,22,6,34,9,12,12,46,11,15,13,12,64,3,68,19,8,45,14,20,32,2,26,7,12,16,33,12,62,3,37,6,22,6,4,5,12,17,16,4,27,12,1,11,9,16,6,7,7,10,4,2,3,3,14,9,3,12,7,16,15,14,24,11,14,12,3,4,1,9,12,7,21,26,11,12,0,6,23,8,42,18,27,8,0,5,62,11,0,5,7,28,11,20,34,32,13,2,29,14,10,2,26,3,11,4,7,28,5,16,21,11,5,13,3,4,9,8,35,5,4,5,95,53,2,4,15,3,10,23,15,15,17,13,8,1,8,23,4,9,8,2,14,4,7,5,23,20,5,10,22,17,6,13,10,22,5,19,24,2,25,43,9,9,3,11,4,6,19,6,44,25,5,2,4,19,10,11,5,34,14,11,35,5,12,59,9,9,48,7,10,13,26,4,29,5,16,30,15,14,33,32,19,12,42,6,11,6,19,10,13,47,16,21,13,26,15,10,9,9,4,9,24,37,18,14,26,6,14,4,30,20,20,4,6,6,9,27,8,43,7,15,34,24,9,5,25,17,32,4,6,7,16,18,5,31,5,2,5,22,19,33,37,27,15,20,10,9,14,24,6,20,18,2,9,19,5,62,10,4,9,134,15,6,10,7,8,18,71,5,3,14,10,7,15,18,9,9,3,9,13,12,25,13,40,19,40,10,2,15,7,5,9,34,15,12,13,14,15,1,10,20,11,10,20,12,10,18,13,3,16,15,8,8,3,14,23,11,20,12,15,5,2,7,6,44,27,26,5,8,3,23,10,11,9,24,2,14,14,4,4,20,14,15,14,9,9,3,76,7,20,10,6,4,5,34,24,5,1,15,6,5,11,29,15,47,41,14,8,13,6,20,26,15,10,11,17,26,25,10,12,20,8,4,7,17,5,17,17,4,16,11,12,5,16,15,13,10,16,15,14,19,5,2,2,5,14,18,12,11,12,5,6,8,12,9,2,7,19,10,19,2,15,2,5,16,4,12,7,7,5,16,9,15,11,11,19,3,3,14,15,8,14,4,12,5,7,15,8,35,13,13,6,8,11,5,15,33,11,5,6,14,26,30,9,6,5,7,13,18,1,6,3,10,16,6,6,10,5,9,8,17,4,7,11,23,8,9,5,9,15,7,1,17,3,2,7,8,5,2,9,6,5,21,2,6,12,7,6,2,14,9,8,9,10,10,12,3,0,22,5,23,14,9,3,49,10,10,10,13,6,6,11,4,5,29,2,13,5,10,5,8,13,7,12,8,3,6,16,12,3,21,6,17,33,14,13,36,25,47,103,7,8,6,2,10,8,17,19,7,39,7,31,7,10,3,12,29,5,32,1,14,8,7,12,8,9,4,3,9,13,3,23,5,9,21,7,20,11,8,19,2,7,3,11,3,2,8,2,5,6,4
development,4,5,8,129,5,11,7,24,4,4,15,16,16,122,3,3,2,23,1,7,9,28,12,24,21,21,16,14,7,10,6,185,121,11,39,71,40,9,7,4,10,20,3,3,25,5,35,38,161,53,26,18,21,63,21,3,30,28,3,33,13,12,9,12,8,4,104,11,13,15,41,12,6,3,140,22,30,1,67,12,96,5,7,8,191,17,16,3,17,3,8,10,9,16,47,16,21,10,62,38,26,38,16,11,22,19,5,9,11,3,21,11,22,73,12,23,3,1,59,86,37,32,17,76,15,5,3,3,1,4,33,5,10,71,6,100,9,12,10,11,8,46,20,11,4,77,7,15,12,13,92,12,13,57,18,68,35,51,7,53,15,9,5,2,22,14,10,30,23,3,40,73,42,9,3,1,108,6,10,87,20,14,66,18,12,23,48,24,14,31,2,4,12,5,9,12,48,12,21,10,50,4,20,12,15,6,8,39,12,47,83,12,18,8,5,9,0,21,12,37,7,20,13,9,39,63,30,16,8,26,39,18,20,34,35,16,21,39,40,10,45,23,3,5,16,6,5,29,90,14,16,31,22,7,2,9,6,6,6,20,1,17,11,0,7,37,21,12,12,10,88,25,4,4,1,5,15,25,3,6,56,2,4,22,12,14,14,8,9,8,0,5,16,8,7,13,21,7,2,17,22,34,6,3,9,5,30,6,13,12,11,30,40,23,21,15,29,40,36,8,27,6,14,13,42,10,22,22,3,15,2,10,3,5,4,41,21,7,3,8,3,11,12,13,7,16,26,41,36,15,10,3,3,67,20,19,5,6,18,21,33,40,68,38,20,5,14,7,13,15,8,30,11,48,5,30,7,6,8,3,39,5,48,27,5,56,6,13,12,4,12,22,7,4,15,12,23,2,23,6,13,5,3,3,5,9,9,6,54,31,10,15,8,26,4,12,9,1,11,7,3,10,24,9,8,4,4,6,4,13,4,2,0,4,12,7,6,10,30,11,8,33,20,10,3,11,42,11,29,7,28,1,14,4,58,0,1,3,8,14,8,16,28,12,15,19,27,23,70,1,21,7,7,13,2,14,2,11,25,7,3,23,3,7,21,3,14,3,9,4,54,24,4,2,8,2,17,6,0,3,13,10,6,1,1,41,24,13,4,7,6,1,6,12,8,22,9,7,2,12,10,10,3,16,2,2,18,12,6,21,10,10,3,7,5,4,3,14,26,21,6,32,6,13,19,5,1,11,3,9,8,6,1,33,15,5,43,5,10,15,8,1,18,4,7,6,9,6,31,36,14,5,8,1,12,1,10,5,4,34,7,15,6,8,9,10,7,4,2,7,13,14,19,4,27,8,7,9,19,16,20,10,7,1,10,23,7,5,23,3,21,21,7,8,17,7,4,7,6,1,7,0,6,5,17,11,5,8,8,43,5,14,12,14,8,5,19,14,10,9,4,8,3,15,4,17,8,4,10,76,45,17,2,3,4,5,45,15,3,11,7,4,0,6,2,3,2,7,4,5,10,7,26,9,9,3,2,1,4,2,15,50,4,9,5,4,3,14,7,11,11,19,6,19,7,13,2,2,7,13,24,9,4,4,10,7,13,7,1,5,1,7,1,12,10,8,0,13,4,18,2,3,4,8,5,10,10,5,2,16,8,13,2,7,9,1,15,15,20,13,5,6,10,9,10,2,15,1,12,5,4,1,10,2,4,20,8,12,12,14,6,4,2,5,18,22,30,4,23,12,10,13,5,6,6,15,17,5,10,2,3,2,8,3,12,20,7,1,6,4,4,9,9,6,16,15,21,8,3,2,5,2,5,4,1,1,5,2,4,2,5,15,6,3,5,2,13,7,1,7,3,5,9,4,4,2,6,8,0,5,0,4,13,3,5,6,2,10,4,5,2,7,3,7,1,3,8,16,2,8,2,18,4,1,10,6,8,5,1,12,1,3,1,19,1,5,4,9,0,14,10,6,3,5,1,5,0,2,8,18,1,2,7,2,3,1,6,4,6,2,8,37,4,3,0,4,1,7,6,7,12,3,7,2,13,5,0,5,1,20,10,16,14,3,2,3,4,58,9,6,0,7,6,4,1,1,1,0,4,4,1,15,1,3,4,4,18,3,2,35,3,4,9,0,10,6,6,7,9,2,4,2,4,3,7,1,7,11,11,6,11,24,3,2,2,1,7,0,2,9,4,2,6,11,0,0,2,2,7,2,4,5,1,2,3,1,8,22,4,2,1,27,4,9,12,2,4,1,20,12
ability,6,18,7,62,1,5,5,23,1,2,8,3,6,43,1,3,2,9,8,5,2,15,9,19,11,5,10,14,4,12,9,103,70,14,39,43,13,11,12,13,8,11,7,5,24,13,5,12,87,28,31,11,5,37,8,3,49,13,5,17,7,5,3,2,16,10,56,9,5,12,12,0,1,1,67,7,15,8,53,10,42,1,10,11,104,21,15,1,9,2,4,6,2,11,29,13,5,2,28,26,5,22,11,4,14,7,5,4,5,2,12,1,10,13,13,14,1,1,19,71,33,16,15,47,4,5,3,1,3,1,13,3,9,37,13,49,5,2,2,11,1,24,8,3,5,32,0,13,12,5,35,2,7,8,3,15,26,10,10,14,7,2,2,3,3,13,4,23,22,3,8,55,12,2,4,7,94,3,4,25,19,7,16,15,0,13,25,15,15,25,3,2,9,1,0,2,14,4,7,4,18,2,7,10,29,7,8,32,4,19,52,10,18,9,2,7,0,2,9,2,8,10,6,17,31,62,8,28,2,6,9,18,7,12,25,18,24,7,3,4,53,29,8,4,11,2,5,8,45,6,5,19,14,3,11,11,6,3,3,11,5,17,2,4,7,24,7,10,10,2,70,6,13,4,1,5,20,8,3,1,43,4,5,6,7,4,4,10,6,4,1,1,3,3,5,7,16,4,5,15,10,15,1,3,11,3,9,5,1,2,4,13,32,10,38,13,21,31,8,5,26,1,22,5,22,1,7,16,1,10,2,5,5,6,2,6,10,9,4,6,8,5,7,8,10,0,27,25,9,9,6,7,2,16,11,4,1,3,7,6,19,17,12,3,3,5,16,3,4,9,2,11,3,6,2,39,11,2,5,5,33,2,24,13,7,13,0,17,11,4,15,4,1,2,14,13,19,3,12,5,13,2,2,3,1,4,1,0,27,5,1,9,8,10,3,8,4,5,2,4,3,7,9,1,2,3,16,15,9,8,2,2,1,2,1,4,6,12,9,3,7,15,6,13,3,3,10,5,16,8,27,2,9,0,29,9,0,5,8,9,6,12,19,35,12,6,29,14,6,2,16,2,3,3,2,24,2,8,10,4,2,13,1,1,15,2,13,3,2,0,29,14,3,4,12,3,4,7,12,3,8,1,1,0,6,23,7,5,3,4,6,1,3,14,13,6,2,5,7,11,4,3,8,14,4,2,13,4,5,14,5,4,1,4,9,5,1,2,19,16,6,0,7,4,17,2,4,8,9,1,12,8,2,10,5,5,15,5,5,4,6,2,11,1,13,12,6,4,16,20,9,4,4,8,1,1,6,5,2,7,6,12,9,8,11,4,2,5,0,10,12,14,3,0,13,2,5,4,12,4,3,2,4,1,2,9,1,8,3,3,11,8,12,5,11,3,7,3,2,3,6,3,0,6,2,5,1,7,11,15,27,6,7,7,2,4,9,2,1,9,9,2,4,8,2,10,5,2,2,59,13,3,9,4,5,4,23,17,4,11,1,1,3,8,6,3,1,9,7,11,16,7,28,7,15,1,0,1,0,4,0,10,6,1,6,12,7,10,2,3,5,4,4,6,5,5,2,2,11,4,8,4,2,6,13,6,7,5,4,2,4,0,5,9,4,28,6,3,2,22,10,1,4,37,1,7,7,5,3,8,4,16,10,7,2,1,10,4,7,5,9,3,0,12,5,2,6,12,1,6,7,5,0,2,0,13,8,10,3,10,9,16,0,3,9,18,3,3,11,4,11,2,3,8,2,9,17,6,3,3,1,4,6,6,14,4,7,9,9,10,4,2,0,3,7,8,3,0,4,6,3,1,7,1,4,3,11,3,3,4,5,3,0,4,2,3,5,3,4,4,2,2,1,11,1,3,7,1,3,1,2,3,10,11,8,7,2,21,6,2,2,0,3,7,7,4,3,1,1,4,0,11,5,6,1,2,7,1,3,6,0,0,6,4,7,4,2,2,1,7,4,1,14,8,6,4,7,1,3,0,1,1,2,1,3,2,4,3,3,1,2,1,4,2,5,1,0,4,3,12,3,6,4,1,7,1,0,3,7,6,5,6,4,1,1,2,1,3,2,2,2,7,1,5,1,3,3,8,4,2,4,3,5,4,0,2,2,4,2,11,4,11,0,3,4,21,8,3,18,5,0,2,4,7,1,3,4,2,6,3,1,0,4,8,2,1,3,7,2,3,6,3,5,6,1,1,1,5,5,2,0,2,1,3,1,5,5,7,5,1,5,10,2,2,6,1,3,5,3,1
entitle,6,14,13,110,8,2,3,29,3,0,15,4,2,36,1,7,3,9,2,5,4,32,9,25,18,7,9,3,7,9,6,139,81,10,40,47,21,11,6,2,14,2,11,3,15,10,18,11,218,2,36,2,10,9,4,10,64,26,2,9,5,10,4,5,8,4,56,4,3,9,3,4,3,4,40,8,7,3,51,8,42,0,10,1,174,18,7,0,30,2,9,2,0,23,35,10,15,8,17,10,12,17,24,5,6,19,10,0,10,1,8,1,4,6,0,12,3,3,90,69,26,20,14,28,4,1,0,3,3,3,6,0,5,38,9,20,10,6,2,5,6,22,15,1,4,46,2,8,9,15,49,0,10,3,4,13,28,1,4,2,16,2,6,3,0,4,3,14,21,4,9,58,18,3,2,8,116,2,8,19,16,5,0,11,4,16,22,13,35,25,0,4,8,0,1,2,5,4,1,8,20,4,3,7,17,3,1,21,7,12,54,2,11,6,0,0,2,1,13,2,5,12,4,6,38,100,14,16,5,4,4,11,8,13,17,18,21,3,7,8,65,19,4,6,8,11,1,10,39,2,10,13,13,8,7,10,13,2,3,14,4,20,15,6,6,49,5,4,11,1,121,3,32,1,5,1,14,6,7,1,53,7,1,21,1,0,1,15,13,2,6,2,15,5,2,8,42,5,9,28,17,24,1,3,6,4,12,2,10,1,1,7,14,4,50,9,19,26,11,7,59,4,16,6,71,5,6,19,0,15,8,8,7,1,6,23,11,9,3,4,7,3,12,4,7,2,22,29,12,11,22,7,8,14,9,9,4,6,10,13,19,6,0,11,7,0,23,6,8,12,1,10,5,2,7,30,16,3,7,4,66,0,33,12,1,29,2,15,14,3,23,4,12,12,20,3,53,4,21,1,21,2,7,1,3,6,3,3,9,14,7,4,5,17,10,5,0,3,2,0,3,2,10,5,2,1,2,18,8,7,2,5,4,14,4,1,0,5,9,2,23,44,5,11,2,3,3,3,21,5,7,4,0,4,31,11,0,6,3,14,6,14,34,34,14,3,10,8,6,2,19,1,3,4,1,27,6,17,8,3,3,5,1,7,9,3,9,1,9,1,42,13,3,2,5,1,5,17,2,6,12,7,2,2,11,4,4,18,7,4,5,3,12,7,11,10,6,4,1,4,0,8,4,15,6,8,16,2,22,15,5,2,2,9,9,8,5,6,44,12,3,3,1,7,11,5,2,14,17,1,21,7,1,42,3,7,20,5,2,8,24,4,16,2,6,11,11,6,32,35,6,12,15,8,5,5,13,3,3,13,8,19,11,5,8,14,5,4,5,4,25,32,17,5,33,6,8,4,38,15,15,0,5,3,7,14,14,13,9,4,13,10,7,12,30,10,19,4,5,4,8,1,6,12,3,2,3,2,13,32,5,17,25,13,7,6,6,3,2,12,22,2,5,12,7,16,6,2,7,139,11,5,6,4,7,10,30,17,4,17,4,3,19,15,5,9,4,10,5,8,13,8,18,23,55,6,9,15,3,3,3,26,16,5,5,11,4,4,2,6,18,4,9,6,2,11,5,12,11,14,3,5,4,9,6,5,14,4,5,10,4,4,5,11,10,17,3,10,7,5,12,5,2,36,2,4,4,9,10,7,0,20,6,2,7,7,12,1,43,8,13,4,3,12,11,2,5,5,6,1,10,4,1,6,3,13,8,15,2,9,11,8,4,3,17,3,7,7,11,7,2,5,3,25,4,8,3,0,12,8,11,2,6,3,5,8,8,4,10,11,3,14,6,6,11,15,9,12,3,11,6,4,18,5,1,0,9,1,15,6,6,0,15,2,4,4,9,10,4,9,7,1,2,10,7,3,3,19,2,5,16,9,9,1,6,8,5,14,6,3,6,1,2,3,10,8,11,10,12,8,25,21,13,4,0,5,2,12,3,0,11,6,7,3,4,6,2,5,2,8,8,7,7,1,2,3,3,9,9,4,9,10,4,2,14,1,6,3,4,3,3,11,2,1,6,4,5,2,2,5,9,3,4,6,5,3,0,8,7,16,1,0,11,23,13,3,2,9,2,2,5,2,3,12,5,3,4,10,5,0,0,5,11,11,9,3,2,5,10,17,0,14,7,1,6,19,10,5,12,9,4,1,3,4,4,3,6,1,17,3,11,2,4,19,0,23,2,20,4,5,8,6,5,8,3,6,3,3,2,12,14,2,8,9,2,11,15,0,9,7,3,3,4,0,0,4,2,4,1,0
danger,4,22,5,107,13,10,7,54,5,4,13,6,17,71,16,10,7,28,17,8,4,30,18,26,14,10,31,25,10,17,16,139,144,14,41,122,56,11,11,11,11,26,4,5,31,19,28,9,245,39,49,11,30,52,12,0,55,15,7,20,8,9,4,5,19,24,107,5,6,26,6,9,8,0,115,16,23,15,82,22,41,4,14,8,186,20,12,0,29,2,4,3,0,24,47,5,20,6,45,18,16,30,38,10,10,35,2,3,18,6,14,8,10,13,2,35,5,8,45,178,39,31,12,49,5,4,3,2,2,2,20,1,11,46,36,56,9,1,14,12,6,32,24,4,7,74,12,19,11,10,83,0,14,5,4,15,37,6,15,25,8,4,20,3,1,6,5,22,22,14,16,104,23,4,6,11,169,4,10,35,21,12,5,22,9,30,29,28,35,30,3,10,6,3,4,4,17,5,7,13,24,1,4,16,29,8,14,37,12,38,75,12,23,8,10,4,3,4,12,3,4,22,5,23,50,70,29,29,4,2,11,10,15,21,41,18,36,16,9,11,78,30,12,18,22,4,8,27,42,4,9,22,29,3,15,15,13,1,4,17,5,36,16,5,15,22,11,15,20,7,139,11,13,15,3,1,36,14,15,1,72,12,5,16,7,3,9,7,18,1,6,2,8,4,2,11,34,5,10,21,31,18,0,3,6,4,14,4,4,2,0,13,39,17,23,16,24,35,9,7,49,11,30,9,72,6,7,43,5,30,7,16,10,5,9,17,22,10,7,15,25,18,15,9,6,7,47,49,29,6,10,11,7,32,17,2,4,4,6,24,18,6,5,22,11,10,59,2,6,19,5,28,5,18,13,24,8,3,24,15,72,2,29,10,6,44,3,26,23,3,18,8,11,6,26,14,62,9,32,5,20,12,9,4,8,11,9,4,17,12,3,14,4,7,12,14,6,16,4,11,7,7,18,12,6,3,2,9,11,21,15,3,3,9,7,1,2,11,24,6,17,41,7,9,2,10,15,25,26,17,29,6,12,4,41,5,6,2,11,22,18,39,30,40,7,1,26,5,9,4,22,13,4,4,5,21,3,15,11,8,9,10,7,7,15,3,11,13,8,4,65,39,12,14,18,6,6,17,14,19,10,6,2,1,4,21,1,13,7,9,4,8,7,2,15,18,4,18,10,6,1,29,4,27,9,3,35,11,12,34,18,11,14,15,5,6,17,7,36,17,6,1,6,3,11,8,16,22,14,7,43,8,4,41,5,9,23,2,4,9,15,3,15,4,19,15,14,9,21,43,10,17,14,9,9,5,6,5,8,10,9,21,20,23,13,3,7,5,6,16,24,35,7,6,13,7,1,0,11,6,26,3,9,2,10,25,11,5,9,7,15,7,13,14,33,9,17,4,10,11,15,2,8,19,5,5,10,8,22,29,28,29,35,27,9,4,14,6,5,10,9,4,2,32,9,25,2,6,1,111,19,11,9,4,8,13,37,17,9,7,10,11,7,8,3,3,0,5,12,11,27,10,34,12,17,14,3,17,2,6,2,18,14,11,16,6,18,8,2,6,3,14,14,4,11,6,5,3,9,11,4,1,11,6,9,7,17,14,5,10,4,2,8,20,20,28,24,7,8,4,10,7,0,16,6,10,11,0,5,21,13,18,8,7,12,6,16,8,36,9,13,8,3,6,12,5,11,4,7,10,1,5,0,5,6,9,13,6,1,5,4,10,2,0,27,23,7,7,7,9,9,1,1,14,7,22,7,3,6,9,5,7,13,6,9,10,6,16,12,11,8,6,1,9,6,28,5,4,5,7,6,5,10,7,21,0,8,7,19,5,5,2,13,13,3,2,7,7,13,7,8,4,3,11,8,6,3,3,3,9,8,8,24,7,13,14,11,26,6,3,5,12,4,5,3,7,6,7,11,9,20,25,1,10,10,4,8,5,6,3,6,3,10,4,5,10,10,1,14,6,6,11,10,17,5,6,5,6,9,1,0,3,2,13,6,1,4,5,17,8,9,4,1,3,8,6,11,8,6,14,12,8,8,4,10,4,1,9,5,17,5,1,8,3,5,9,3,7,4,4,16,5,5,2,6,6,1,21,1,1,6,3,4,6,6,6,2,9,7,12,5,16,1,0,5,12,12,3,17,5,4,4,7,8,6,3,7,4,11,5,9,6,8,2,1,13,11,0,5,3,27,5,9,10,7,2,3,6,8,6,2,7,4,12,6,11,7,8,7,5,4,5,5,2,0,1,2,8,1,7
receipt,5,5,0,97,4,0,2,13,5,0,8,4,6,10,3,0,2,14,2,1,1,19,1,6,10,5,5,12,2,25,5,176,62,4,20,35,11,14,14,2,7,0,0,8,22,3,8,14,127,1,15,2,7,3,0,0,40,78,0,3,5,0,0,12,19,1,34,2,3,2,153,2,2,2,30,5,9,4,49,7,173,2,10,1,203,31,9,0,140,5,18,2,1,55,58,17,13,7,28,7,7,30,25,2,8,22,43,3,28,10,35,4,15,6,0,27,10,4,67,75,32,0,32,338,7,4,4,2,10,3,7,2,0,43,10,8,1,1,4,2,3,9,20,14,4,29,2,5,16,42,16,0,18,3,3,11,6,4,0,0,17,0,2,13,33,3,2,4,3,6,6,30,3,0,2,6,113,0,2,15,15,2,5,3,5,12,26,7,18,27,2,0,1,0,3,1,5,9,14,5,39,7,0,4,15,2,3,17,8,16,38,2,21,4,0,0,21,20,30,1,101,1,10,6,42,58,77,52,5,50,4,42,36,10,19,182,37,5,1,2,36,16,5,0,3,4,1,14,39,1,4,13,3,89,9,7,10,6,15,7,1,9,21,1,17,107,3,0,6,6,82,48,305,3,0,0,3,311,12,0,15,3,0,6,6,2,0,4,7,1,6,5,5,34,14,14,63,10,1,1,7,29,16,12,18,1,7,1,0,2,0,2,40,1,77,43,4,28,5,7,14,4,13,0,2,0,2,12,1,10,0,13,2,2,8,14,4,2,25,26,4,0,5,7,1,2,30,25,15,0,27,5,3,17,12,9,1,0,7,205,11,4,2,8,1,0,10,2,0,5,1,9,5,5,4,40,2,3,0,78,46,0,34,3,0,30,0,19,111,0,2,0,1,2,20,4,31,9,12,4,9,1,5,0,9,8,5,0,3,4,0,0,8,13,4,1,2,11,2,1,0,4,3,3,0,3,3,3,3,22,54,73,79,15,0,2,0,4,2,2,3,4,5,0,0,0,4,0,31,23,8,11,0,7,23,2,0,3,4,31,9,7,11,3,3,1,2,3,0,1,4,0,2,0,3,3,0,3,13,4,0,9,1,1,5,2,8,6,1,0,33,76,0,2,2,2,0,26,4,5,13,4,20,1,0,32,3,18,4,2,16,2,2,2,11,14,2,1,0,9,0,10,9,7,4,4,10,8,9,27,6,0,0,8,5,2,9,0,9,27,1,1,0,2,10,0,4,14,6,6,6,2,4,37,0,6,5,4,6,5,13,5,15,3,7,10,8,1,33,10,15,11,34,1,4,3,11,2,4,107,5,13,2,8,3,1,2,8,8,4,4,16,3,8,7,0,1,0,11,6,11,1,2,2,2,18,10,8,5,29,20,0,9,3,14,6,8,1,2,3,10,7,8,31,7,1,2,2,0,12,42,23,14,27,5,2,1,7,2,8,4,0,3,23,0,95,3,2,2,52,5,1,3,1,1,15,34,2,2,9,3,1,16,7,0,0,0,6,7,9,8,9,30,0,16,4,2,12,11,1,13,17,8,4,5,19,13,2,0,0,13,4,16,7,3,8,3,0,9,9,2,3,4,5,7,5,26,1,6,13,1,57,3,10,15,7,2,2,5,8,2,1,1,13,1,1,15,2,0,7,3,24,12,0,14,18,10,2,12,9,3,2,0,2,1,1,29,1,5,4,5,1,143,189,145,21,7,7,12,34,30,17,16,23,6,12,2,2,4,4,3,0,1,1,5,4,18,1,3,11,0,1,7,8,3,2,4,18,25,14,2,1,1,5,11,11,0,7,10,1,8,19,7,2,1,0,5,4,7,1,17,2,4,13,1,0,7,5,5,14,2,48,0,2,11,5,1,8,5,13,48,35,8,0,1,4,1,14,1,3,9,5,0,1,5,19,4,3,6,1,5,12,1,24,0,4,2,33,0,1,1,2,9,0,2,6,0,1,2,11,4,4,27,9,7,5,0,5,7,0,3,14,0,1,2,6,1,4,0,4,0,1,0,1,3,3,4,5,11,1,4,5,3,4,2,12,0,10,80,11,5,53,3,113,7,53,0,1,3,10,8,3,3,7,2,5,0,11,4,19,2,2,2,8,4,57,6,19,2,11,5,3,140,63,94,81,39,237,369,4,0,0,0,1,9,80,6,1,27,4,44,1,0,4,7,3,4,13,0,1,0,1,3,0,4,1,4,4,5,1,31,0,16,22,2,9,7,1,3,0,0,0,15,1,0,26,0,15,0,0
the fiscal year,0,0,0,73,1,0,6,6,0,1,1,0,8,18,1,0,1,6,0,0,3,9,1,7,1,10,1,11,1,25,5,106,34,1,11,5,7,11,12,8,1,0,0,6,12,4,16,41,72,1,8,1,2,3,2,0,20,66,1,4,2,0,1,4,12,0,8,1,4,4,198,9,0,1,23,0,7,6,29,3,131,1,1,1,106,15,7,8,83,11,23,0,6,33,38,18,27,7,44,0,11,22,20,0,7,12,30,7,22,11,11,1,17,3,0,23,16,2,42,45,10,4,25,182,10,1,1,2,5,3,1,0,0,46,1,22,0,1,1,9,2,10,29,5,3,24,1,1,13,22,16,0,8,12,3,29,11,0,0,2,24,1,1,9,75,0,7,0,4,1,10,15,0,0,0,3,44,0,1,19,9,1,29,5,2,5,20,3,3,31,0,0,3,0,7,7,6,6,9,5,19,6,1,1,12,5,10,15,0,4,15,0,20,2,0,0,17,31,11,6,53,0,0,5,58,42,76,36,20,260,3,24,53,13,4,82,20,0,5,2,13,9,5,1,0,11,1,5,33,0,0,12,6,27,8,2,5,4,15,38,4,5,19,2,6,104,2,0,6,1,50,46,222,3,1,0,2,240,1,1,6,0,5,0,11,4,6,6,3,0,9,0,12,23,9,2,35,5,1,3,0,26,59,2,5,0,2,0,0,1,2,4,15,1,41,38,4,14,8,7,4,0,5,2,1,0,1,7,2,7,1,6,0,0,4,17,1,2,20,27,1,4,1,7,10,1,27,12,7,0,20,4,0,13,3,5,0,0,4,241,20,5,2,4,0,0,0,0,0,4,2,16,1,0,1,54,0,2,1,38,18,4,20,2,2,18,0,11,78,0,1,2,4,0,11,0,14,3,7,5,4,0,2,0,4,3,0,0,5,2,0,1,38,2,0,0,11,2,1,0,0,1,4,0,0,2,2,1,3,13,24,9,52,10,1,0,0,0,2,2,8,2,3,6,0,1,1,2,20,24,8,2,2,0,23,1,0,0,4,12,9,3,8,12,1,0,7,4,3,0,1,2,0,0,0,1,0,2,9,0,0,12,0,0,2,0,3,2,0,4,85,64,0,0,7,0,4,12,3,1,6,4,34,3,3,47,9,10,3,1,6,0,5,0,1,12,4,0,0,4,0,6,6,3,1,11,3,14,5,5,4,0,0,2,4,8,1,0,12,14,0,10,0,0,5,1,0,5,4,8,1,0,3,22,5,1,5,0,5,1,4,3,15,3,3,6,1,1,21,5,6,3,65,0,1,2,2,8,4,83,17,0,0,2,0,1,0,5,8,4,1,4,14,22,3,0,0,0,4,4,6,7,0,0,3,7,1,2,2,16,18,12,1,1,10,2,2,0,1,1,3,1,5,17,9,3,1,3,0,9,26,8,5,12,3,0,0,20,2,3,3,0,1,12,3,76,1,10,3,46,3,0,1,0,0,31,16,0,0,8,0,1,2,7,0,0,0,5,1,8,10,3,15,0,8,2,2,1,6,1,7,26,2,4,3,1,5,3,2,1,3,0,8,5,1,5,4,0,6,2,0,1,5,1,4,1,33,2,4,3,1,56,4,5,9,17,3,0,1,5,2,0,1,11,0,1,9,0,0,6,0,3,6,1,7,2,30,5,5,5,5,0,1,6,2,0,15,10,0,1,0,143,1,265,211,9,0,3,2,53,46,11,19,43,7,27,0,2,15,4,2,0,1,4,3,12,19,0,3,5,0,0,7,3,5,1,0,1,3,4,4,1,1,1,11,2,1,7,4,0,2,1,2,2,0,0,0,7,5,3,24,1,3,5,2,0,3,3,2,6,0,33,2,1,5,0,0,4,0,5,38,17,3,0,0,1,1,9,0,2,2,0,0,0,3,15,1,3,1,8,0,19,1,11,1,1,0,22,0,0,0,0,0,0,2,3,0,0,0,10,13,0,12,3,6,0,0,1,3,4,0,6,0,6,8,1,5,1,0,9,0,15,1,1,0,4,1,0,3,0,4,1,3,2,0,12,0,5,32,2,6,58,0,64,1,10,1,2,6,15,2,1,4,11,2,1,1,0,2,4,2,0,2,12,3,33,11,13,1,11,5,2,125,38,64,48,21,216,183,0,6,0,2,9,20,37,1,0,17,0,36,3,2,5,10,16,4,37,0,0,1,0,1,3,0,0,17,2,0,0,16,1,3,10,1,2,4,7,1,0,0,5,3,3,0,14,0,18,0,0
june,19,31,11,212,3,2,6,8,3,1,21,18,14,24,2,1,3,18,1,2,5,35,3,19,10,22,7,14,8,41,8,270,91,11,32,22,15,11,23,4,2,1,0,4,28,11,17,22,312,12,37,1,6,14,7,0,61,139,2,14,23,2,0,13,16,3,36,6,10,21,46,13,1,2,62,1,25,3,78,19,214,1,21,3,244,19,25,1,210,12,52,2,3,83,111,28,40,23,49,7,13,37,62,2,12,35,59,6,46,21,48,7,8,14,0,31,42,9,183,109,27,19,24,581,15,2,3,2,21,6,4,1,3,49,7,51,1,9,4,5,2,25,57,17,9,84,4,7,23,91,27,3,11,4,2,20,27,8,13,3,45,1,7,21,50,1,12,11,16,5,33,52,10,2,2,4,162,0,3,19,28,8,4,17,6,8,34,11,35,80,6,1,13,0,4,4,1,7,44,3,31,2,5,11,25,4,13,31,5,14,45,1,30,5,0,0,24,14,30,3,88,16,4,4,105,100,124,50,35,59,10,103,94,16,23,142,31,1,8,2,44,18,10,1,7,13,9,16,57,0,10,33,7,64,20,14,17,16,11,74,9,54,33,27,10,178,1,0,4,2,156,37,383,4,2,0,20,297,20,5,23,1,9,8,6,4,4,5,8,0,47,8,20,64,25,14,75,12,4,12,17,33,37,29,9,0,15,16,2,1,3,5,36,3,96,72,7,60,9,3,34,1,9,3,19,4,5,18,6,19,3,12,2,2,4,17,6,4,15,55,3,15,4,7,16,4,51,48,22,5,59,3,5,32,15,23,5,1,16,575,18,15,4,9,3,0,18,4,5,5,9,19,4,2,3,99,9,2,4,49,55,1,65,7,1,59,0,28,129,0,15,4,13,14,31,1,58,10,49,11,14,3,2,0,5,3,9,2,27,6,1,6,60,7,4,3,8,4,3,2,1,8,9,15,0,4,6,5,20,41,57,43,138,86,3,6,0,12,2,4,27,8,3,13,1,4,6,6,46,16,6,10,1,2,52,6,0,6,4,47,10,18,21,23,4,2,7,17,7,2,15,3,1,0,2,1,1,9,17,1,3,21,1,0,7,4,21,6,3,16,153,129,1,0,12,1,9,33,5,6,7,7,31,0,5,11,7,15,4,1,14,3,7,5,14,25,1,12,2,5,3,14,7,15,11,23,21,2,21,35,9,0,7,5,16,12,12,3,24,16,2,6,2,4,10,6,103,4,14,12,9,3,9,58,13,6,24,2,8,6,19,8,39,3,8,6,13,2,48,21,14,3,71,8,7,3,14,5,6,116,10,15,7,8,6,2,7,3,12,8,14,12,31,23,21,0,0,1,74,9,19,3,0,9,15,13,4,22,4,25,38,45,19,6,30,6,11,2,6,8,9,2,3,46,9,4,4,2,3,23,24,28,13,12,7,4,4,15,5,20,10,0,4,27,9,132,2,25,4,246,21,5,2,4,8,35,28,5,8,20,1,8,36,29,20,8,4,6,4,6,20,17,35,6,47,10,10,10,59,4,41,35,6,8,13,6,7,3,4,7,15,4,39,11,6,21,27,6,23,18,18,7,17,2,23,4,11,2,6,10,2,159,5,19,16,59,25,4,7,7,13,8,8,27,3,6,11,0,10,11,5,16,4,1,10,6,36,7,17,7,9,2,4,20,9,2,47,2,2,6,5,189,265,1,545,16,4,12,9,95,91,38,30,64,30,30,18,3,10,5,2,0,2,15,2,10,15,3,4,8,7,5,4,3,15,4,0,6,9,13,5,15,12,6,35,10,1,10,16,8,10,5,28,18,2,11,3,8,16,8,26,4,30,14,3,5,6,11,6,9,1,58,10,23,8,4,1,24,0,4,58,52,7,1,1,4,5,21,2,6,9,0,1,4,2,20,3,7,10,2,22,28,5,16,2,2,3,26,3,4,8,3,4,9,4,7,1,3,8,15,9,11,32,3,10,3,12,20,16,9,10,27,3,19,44,10,7,3,2,3,14,22,0,4,4,81,1,9,14,3,9,13,5,7,7,70,13,13,32,14,3,58,5,159,4,35,2,9,9,16,1,9,8,12,10,2,2,21,6,13,3,2,7,22,7,51,6,20,4,16,7,10,244,86,82,70,31,329,279,6,8,2,2,7,32,65,50,1,52,2,17,3,8,10,10,57,12,85,2,4,2,1,11,1,13,5,1,5,9,3,62,2,18,8,6,4,3,1,18,1,0,0,14,1,0,9,0,36,1,0
30,2,12,10,131,0,3,3,10,1,2,3,5,10,17,1,1,1,15,4,0,4,12,9,18,9,6,7,9,2,19,3,171,65,4,22,10,8,8,27,5,0,0,1,3,19,5,9,9,117,12,26,5,3,19,3,0,65,101,7,7,12,0,0,4,14,5,27,25,3,9,52,12,2,5,47,1,19,2,49,3,195,4,9,3,144,25,14,4,79,9,29,3,33,54,70,34,24,17,28,5,9,15,35,1,11,27,37,12,32,10,31,8,10,12,12,20,10,3,83,58,11,9,22,539,7,0,1,4,19,10,4,1,1,26,7,47,1,5,4,17,1,17,27,14,3,32,4,7,27,77,8,1,11,2,3,23,23,6,1,6,43,0,7,9,60,5,11,9,11,2,19,32,4,1,0,2,87,0,2,25,15,1,11,11,3,6,24,8,7,30,1,0,9,2,6,2,6,7,20,2,28,4,5,6,19,4,7,22,3,8,28,5,12,19,0,9,22,11,25,2,51,8,3,6,46,53,101,46,16,53,7,67,54,10,14,123,15,1,12,0,14,14,5,2,4,6,10,5,40,1,6,37,4,45,12,9,7,11,6,53,15,5,25,13,7,135,1,3,10,1,57,34,291,0,1,0,6,235,7,2,17,1,8,2,12,1,11,9,2,0,13,5,16,41,8,5,36,2,0,7,6,18,32,6,3,2,4,12,3,4,2,1,17,1,88,43,8,44,10,2,7,1,12,0,11,1,6,21,3,10,0,6,3,0,2,8,5,1,9,26,5,7,3,6,9,1,27,15,17,5,39,3,0,28,4,10,1,1,4,461,15,8,4,9,0,1,7,0,4,4,3,22,1,2,3,59,3,9,2,36,24,1,29,3,3,15,6,5,92,0,3,0,4,2,10,1,28,7,15,4,9,0,2,2,4,2,6,1,17,5,0,5,38,10,3,3,2,2,2,0,0,3,5,1,1,2,5,1,5,29,40,10,25,26,2,4,0,2,8,4,6,14,4,3,0,0,9,2,23,17,10,3,0,0,30,6,0,0,4,15,9,18,11,14,2,5,8,4,1,3,6,8,0,0,1,0,2,0,8,1,4,11,2,1,4,1,19,2,0,10,67,65,0,2,11,3,10,21,4,2,2,8,23,0,9,18,10,11,1,1,11,0,2,3,7,15,2,9,1,7,1,5,6,0,2,13,2,7,8,27,8,0,2,6,3,8,3,0,12,3,0,1,0,13,3,0,0,7,4,2,2,1,4,33,2,1,8,1,6,1,9,7,18,3,5,3,5,1,29,11,11,6,46,2,7,0,16,7,1,98,13,9,6,6,1,3,3,2,8,3,5,6,14,12,12,0,6,7,18,6,5,2,0,1,4,8,4,12,3,22,26,14,1,3,11,4,5,0,2,2,4,8,2,37,10,0,4,1,1,11,25,20,8,11,3,0,1,16,2,14,4,0,4,6,3,97,4,4,4,81,11,2,4,0,0,29,15,2,0,2,2,4,0,10,2,0,1,2,2,7,9,15,5,4,8,1,3,7,22,0,21,21,2,4,9,3,6,0,0,3,7,4,32,10,2,6,14,0,14,5,2,2,13,4,16,3,6,3,6,2,2,58,6,1,13,23,4,0,5,4,2,2,1,14,1,2,12,0,5,11,1,6,6,0,3,3,22,3,5,9,2,0,3,10,4,2,41,4,0,3,6,145,211,545,1,10,0,5,6,114,116,34,22,57,18,34,11,6,0,4,2,0,2,12,2,6,17,2,1,5,1,1,2,3,12,0,5,3,7,11,3,7,6,4,22,10,1,5,6,5,5,0,13,5,1,9,2,5,12,3,36,1,11,3,0,0,4,6,2,5,0,49,0,13,4,0,1,9,0,2,43,45,4,0,0,3,3,11,0,3,1,0,0,1,4,14,3,3,5,1,3,8,1,9,1,0,0,23,3,4,5,1,3,10,2,3,0,2,0,10,5,6,29,4,5,2,0,0,6,10,0,18,2,5,14,3,1,1,5,2,2,11,0,2,1,10,0,2,7,4,3,1,1,2,0,13,0,5,25,5,1,12,6,111,7,46,6,1,4,9,0,2,0,19,2,1,2,0,2,17,6,4,2,8,4,38,8,10,2,10,3,9,161,64,64,40,25,251,180,1,4,2,6,3,29,16,24,2,16,0,6,2,8,6,12,13,5,49,0,2,1,0,15,1,11,0,2,2,1,5,37,0,17,4,3,5,0,3,7,1,0,1,5,3,1,9,2,23,0,1
fully,8,27,15,161,7,9,12,22,6,3,17,6,12,56,5,8,11,27,10,8,3,39,15,34,21,21,8,9,3,34,9,215,117,16,64,42,36,9,12,9,12,12,6,1,45,18,26,25,293,31,42,14,18,56,12,6,52,78,11,24,26,13,10,19,22,8,73,5,8,21,18,11,7,7,93,12,18,7,53,24,73,1,13,6,252,17,20,4,58,7,14,6,10,24,44,14,24,10,34,9,17,33,44,10,14,31,15,13,15,7,24,10,11,31,4,26,10,3,78,108,40,23,19,108,10,0,6,5,5,3,11,5,9,64,18,73,10,7,4,17,1,39,33,6,2,76,9,17,18,19,67,2,15,18,4,40,35,6,3,15,16,7,8,8,11,4,5,25,40,20,29,83,27,7,3,9,148,3,14,47,24,11,13,18,11,16,35,17,30,35,3,7,16,2,4,8,26,5,12,10,24,3,2,22,25,8,5,41,10,44,82,3,26,6,0,8,6,15,7,10,9,16,10,12,56,102,35,26,9,16,18,16,23,18,41,30,34,4,6,14,73,49,4,7,10,11,6,21,54,5,19,11,17,15,13,15,10,3,10,20,7,20,34,6,18,75,3,6,14,8,158,22,35,5,5,5,23,23,17,2,56,9,7,17,13,1,10,16,11,0,6,4,8,8,8,14,60,13,5,11,23,43,2,6,13,5,16,6,6,7,3,14,48,13,52,41,25,42,9,6,45,5,27,7,56,6,16,20,8,25,1,14,7,9,1,10,18,11,8,11,11,20,21,11,12,10,43,52,23,13,18,14,9,36,25,15,1,2,23,37,35,16,33,23,10,4,32,10,14,7,4,25,9,9,9,57,24,3,9,13,60,2,45,17,18,33,5,17,22,6,21,12,11,10,47,18,83,14,36,9,23,5,2,2,6,4,9,2,31,15,1,12,8,22,7,5,5,12,9,6,3,12,15,19,2,14,12,25,10,24,11,7,9,20,2,4,1,5,15,6,20,21,6,7,4,2,13,9,43,11,24,4,4,3,70,6,2,11,9,42,22,21,32,29,9,13,12,22,22,2,26,5,6,2,9,18,2,10,19,8,7,7,5,0,9,2,24,8,10,10,70,61,2,5,9,9,6,11,15,11,17,4,5,1,9,17,11,16,6,8,5,7,5,11,24,31,8,8,3,10,6,14,4,19,5,8,20,0,15,31,15,2,4,7,10,8,12,15,42,20,5,4,5,17,10,11,10,10,22,8,35,7,7,71,6,9,33,5,6,9,23,1,22,7,28,18,23,6,42,54,9,10,22,13,7,8,13,3,5,37,3,20,8,15,11,7,4,6,4,13,27,39,10,6,19,8,4,10,38,15,22,3,4,9,6,16,10,30,14,9,26,20,18,6,35,9,28,2,11,6,8,4,19,20,5,6,8,10,15,37,5,36,20,13,9,4,14,3,3,16,9,6,2,26,7,66,7,8,13,159,17,11,10,4,15,18,54,14,5,19,10,5,17,28,7,6,4,12,18,18,16,5,35,15,28,10,5,9,5,5,16,36,19,9,17,13,16,13,3,22,17,5,20,11,13,14,12,2,11,21,15,4,15,8,16,6,23,20,3,11,3,7,10,24,24,31,18,12,14,8,16,5,5,38,2,9,11,7,9,12,10,21,3,3,8,11,23,8,42,9,6,7,3,12,7,4,14,20,13,13,9,21,9,16,10,1,18,15,6,22,26,17,3,5,12,29,12,9,14,10,6,10,4,10,7,25,20,10,42,6,9,9,18,17,11,7,5,25,13,16,10,12,6,6,9,15,3,9,8,3,5,9,10,3,2,9,16,7,33,10,4,11,3,15,5,8,2,13,5,7,3,8,9,19,7,5,8,13,4,7,10,10,12,6,4,13,4,31,9,9,7,7,6,9,6,16,13,10,9,6,14,29,11,6,7,11,8,9,4,3,12,6,14,5,3,15,7,8,4,28,10,6,14,8,5,6,3,11,22,6,4,10,7,3,14,5,12,12,20,7,4,18,0,5,5,10,8,9,5,7,13,10,8,13,11,8,3,18,5,24,15,7,10,11,14,8,7,13,5,7,4,2,8,6,3,12,5,15,9,1,8,5,8,6,9,6,9,3,3,14,8,11,11,12,9,21,15,19,48,3,7,5,3,8,4,8,11,5,23,5,3,7,9,5,3,5,24,6,4,5,10,4,7,9,14,8,5,13,10,5,20,4,8,1,7,3,13,3,11,0,5,4,11,4,3,9,4,9,5,2
justify,7,21,8,89,7,3,2,25,2,3,17,3,9,46,2,3,4,9,5,4,3,31,5,23,10,6,5,10,3,10,7,115,90,4,24,32,24,6,8,1,10,6,5,2,27,15,13,14,193,8,27,3,5,17,7,9,46,20,0,12,21,10,0,11,9,3,84,5,9,14,4,2,6,3,85,8,13,7,49,13,39,0,14,4,174,14,8,1,22,0,5,2,0,17,26,12,18,2,26,17,7,20,33,11,16,24,17,4,9,0,12,6,4,9,0,25,3,0,52,142,30,19,17,40,7,5,3,3,2,0,22,8,6,25,16,25,10,2,6,2,1,25,12,1,2,58,3,11,6,18,66,1,8,6,16,22,14,2,9,1,10,2,2,1,1,1,8,15,17,6,12,62,15,1,4,7,135,4,5,21,19,3,3,15,3,16,24,16,33,34,4,5,10,0,2,2,5,2,6,8,19,2,1,11,18,12,2,21,6,18,72,3,17,4,4,3,1,5,10,2,2,13,4,13,38,89,21,11,2,2,9,7,13,16,23,27,31,11,5,11,49,26,10,5,10,6,5,10,25,4,4,14,20,7,13,10,9,2,3,17,2,18,12,6,4,42,4,3,10,4,92,4,12,5,2,1,16,16,9,4,44,6,4,20,11,0,3,8,6,0,3,0,12,5,2,8,29,4,5,13,15,26,1,2,8,2,11,1,8,2,0,21,22,3,24,6,13,41,8,4,30,7,26,7,60,3,8,14,2,22,6,10,3,2,8,21,12,10,7,11,8,11,14,15,3,3,38,38,16,4,9,8,5,30,27,1,2,3,12,20,12,2,8,21,5,0,35,14,4,6,1,16,3,3,3,11,5,4,12,9,44,3,29,8,1,25,5,26,14,5,23,0,12,11,24,5,37,4,33,1,19,2,2,4,1,4,4,2,8,5,2,14,1,9,23,6,0,9,3,0,5,4,10,19,0,5,1,14,10,10,7,4,0,9,6,4,0,4,7,4,16,15,5,11,0,4,2,3,34,5,5,7,1,5,26,8,0,10,5,26,4,11,18,14,6,5,6,13,9,1,20,4,2,1,5,11,3,13,10,4,7,4,4,13,8,1,9,3,6,1,68,26,4,9,6,5,2,21,6,13,5,5,7,0,3,8,15,8,6,2,0,8,4,6,14,19,5,9,2,4,3,18,6,22,14,2,20,10,13,21,10,3,0,10,3,4,4,2,29,12,4,1,6,32,7,5,12,12,15,12,42,7,5,29,6,5,34,3,6,7,19,3,15,4,10,17,11,10,23,21,14,5,12,1,8,4,18,5,7,11,15,9,8,10,13,3,13,5,1,12,18,25,7,1,19,3,2,5,32,9,23,0,6,4,6,19,8,18,5,2,27,11,9,7,33,10,17,4,11,5,5,2,4,12,3,2,4,8,16,28,12,13,17,18,5,5,22,4,0,7,13,6,6,11,5,19,5,6,0,93,16,2,5,7,13,4,31,17,3,8,6,6,6,7,8,3,2,6,8,6,12,13,20,15,21,18,4,6,1,4,3,15,12,1,6,5,14,3,2,9,10,6,14,10,7,7,7,7,8,10,2,5,5,9,4,7,14,2,3,3,1,3,9,24,14,9,5,7,4,9,5,2,4,22,0,14,4,2,9,6,8,5,6,4,4,2,10,8,29,3,6,3,3,7,9,3,8,8,8,8,13,7,0,4,0,18,1,12,9,11,14,8,1,0,20,15,10,6,20,7,7,7,1,14,7,8,3,2,15,9,2,5,11,2,5,5,0,21,7,11,7,6,0,4,8,9,4,4,4,1,4,7,16,4,7,2,9,1,11,1,5,2,13,6,3,9,5,8,3,16,9,6,2,4,1,4,2,5,3,6,7,5,7,4,5,6,11,17,12,5,3,4,1,2,13,9,3,4,8,10,29,23,5,3,0,4,10,5,12,2,1,6,4,5,4,2,1,2,6,14,6,1,7,8,2,5,4,6,15,0,1,7,2,6,5,5,3,3,9,5,4,11,1,4,12,4,4,5,6,2,8,12,3,7,7,4,0,5,2,19,2,3,7,5,12,2,2,2,4,2,6,5,3,14,4,4,1,16,5,0,6,1,7,9,4,3,3,14,4,6,4,11,2,4,5,5,14,7,19,2,3,4,1,2,2,1,1,8,21,6,3,2,3,4,2,18,3,6,3,9,1,5,11,2,5,6,0,15,3,4,8,4,5,13,8,9,6,1,35,2,5,3,2,0,0,7,1,2,2,1
establishment,5,12,12,169,10,4,8,38,6,5,10,17,11,75,10,6,6,9,9,3,5,37,5,18,22,5,11,16,4,11,11,187,130,8,52,55,55,10,13,8,5,14,6,1,37,13,48,19,264,38,35,2,9,27,4,6,57,60,2,13,29,13,6,12,10,2,71,7,7,31,15,10,5,8,57,12,10,2,70,16,66,2,21,6,223,18,24,0,41,3,3,9,5,15,67,6,11,6,29,18,16,30,37,11,11,27,11,5,14,5,26,10,9,16,1,18,6,4,58,154,41,14,10,69,9,3,2,4,0,2,10,5,6,68,21,28,1,8,2,6,2,41,35,5,6,51,2,20,8,20,60,1,8,10,1,31,18,9,10,6,19,1,5,6,0,2,2,15,23,2,29,74,18,0,2,6,162,2,6,24,17,12,2,8,8,13,39,13,22,35,1,3,10,0,0,4,32,5,9,13,19,5,1,11,29,7,13,43,15,33,80,1,22,8,1,2,0,6,36,4,3,12,11,13,67,84,22,24,0,8,18,8,20,29,28,40,25,19,8,7,84,25,4,3,16,5,6,13,63,4,15,22,15,11,16,18,11,3,5,23,12,28,25,5,9,87,16,2,9,12,151,10,31,10,8,1,22,37,15,8,50,6,6,19,5,2,14,10,9,1,3,6,18,5,3,14,35,3,3,18,17,81,3,2,8,1,18,18,5,1,7,28,24,7,26,29,15,57,14,8,51,9,22,6,45,8,3,17,3,18,5,5,8,8,6,12,23,14,5,13,6,10,21,11,9,12,68,36,21,5,16,7,4,24,24,18,3,3,12,35,22,15,3,19,10,3,34,4,7,7,9,21,4,5,3,64,10,5,14,8,93,3,47,12,2,35,4,16,24,3,29,5,22,20,39,17,90,9,61,7,37,4,4,0,7,6,4,6,23,23,4,21,6,27,11,10,2,14,2,0,5,5,14,5,1,1,4,12,14,18,10,8,5,17,9,5,1,22,23,4,28,36,8,21,1,3,6,9,32,9,16,6,0,5,69,28,1,5,3,47,12,18,39,29,11,17,19,15,7,1,20,3,7,1,2,3,7,14,20,5,3,14,12,1,11,10,19,5,4,14,81,37,1,5,11,9,5,17,8,9,8,10,3,4,12,31,14,18,19,9,8,8,14,17,26,20,7,9,5,4,8,18,12,40,2,12,19,4,21,29,10,13,4,3,17,19,17,8,43,15,5,14,6,8,11,7,15,19,14,12,29,6,1,41,21,7,41,6,7,8,47,7,35,3,21,24,12,6,46,53,4,18,26,5,15,12,14,2,5,27,20,27,17,10,11,8,14,6,5,10,24,25,11,9,22,10,6,9,51,19,19,8,8,11,8,15,14,37,12,9,9,44,12,9,28,16,39,6,15,8,17,13,14,16,6,15,17,16,11,59,15,49,22,24,12,4,2,9,10,19,7,0,9,28,14,41,14,4,4,175,50,4,9,7,2,9,38,14,6,16,7,9,29,35,13,10,7,13,13,9,29,8,55,48,29,6,13,6,1,6,8,37,16,17,28,11,5,6,21,32,8,11,21,27,8,12,9,6,11,20,15,7,12,3,26,12,23,9,2,4,8,12,3,37,10,48,10,8,4,12,11,8,9,50,3,12,11,6,10,23,10,31,4,3,9,25,49,6,53,25,7,5,11,18,11,10,13,12,10,15,6,7,3,12,5,15,12,1,11,14,11,10,4,5,29,19,23,6,21,15,5,8,5,8,15,15,9,3,27,13,12,9,8,7,6,16,7,22,10,21,3,21,12,12,3,16,11,17,4,11,10,8,12,10,3,2,4,3,17,5,6,9,12,11,13,3,11,13,2,7,5,11,11,22,11,7,2,13,7,6,15,11,25,6,12,11,15,32,6,12,9,12,4,12,19,13,8,10,29,7,17,40,7,14,6,9,10,13,2,3,11,2,9,2,6,10,5,12,1,33,23,1,4,10,3,3,5,18,15,10,3,5,8,3,18,8,8,10,5,18,5,15,2,4,8,4,10,22,4,1,7,8,27,11,2,2,3,9,9,13,5,14,8,12,10,7,8,7,2,6,7,15,5,16,10,8,15,18,6,9,6,8,11,7,2,4,15,2,5,28,10,4,4,6,12,21,7,19,29,7,16,5,5,10,3,15,21,11,48,8,0,5,5,10,3,27,7,6,5,15,4,6,1,2,6,12,10,7,18,12,42,9,3,8,19,2,7,4,17,2,10,6,8,1,4,6,1,7,4,1
extension,5,6,6,96,1,6,4,19,2,2,11,9,7,26,2,8,1,4,0,0,3,17,1,10,15,10,6,6,2,7,1,94,61,6,27,21,11,5,8,5,0,1,2,5,13,4,16,10,104,13,13,4,10,15,3,2,18,21,0,8,10,4,1,6,8,4,33,3,2,12,15,5,1,3,27,11,5,3,37,6,62,0,14,3,94,9,5,0,30,3,8,2,1,15,13,11,9,9,25,8,15,29,5,2,11,7,7,1,14,1,11,9,9,6,0,15,1,6,52,51,17,13,2,48,7,2,8,2,6,1,4,4,1,21,4,25,1,0,2,3,1,16,14,10,0,26,5,8,5,11,29,2,6,6,2,28,17,2,2,7,9,3,5,1,0,3,8,5,19,4,10,25,10,4,1,3,80,0,2,23,10,4,10,6,1,11,16,8,12,13,0,1,6,1,1,8,8,4,4,7,22,0,3,2,5,4,8,50,3,15,38,3,12,2,0,0,2,1,18,3,0,8,3,7,25,57,20,9,6,5,4,7,9,16,25,21,14,6,7,4,14,11,2,2,5,5,1,7,33,2,12,6,7,10,5,5,2,1,4,13,4,7,6,2,3,53,8,0,7,4,47,4,18,6,2,1,10,25,4,3,20,8,2,6,7,7,6,4,11,0,1,1,5,3,3,2,21,9,5,1,12,36,1,0,1,0,10,3,2,0,3,22,16,3,13,17,16,22,9,6,14,3,9,3,12,3,8,12,0,10,0,5,2,2,1,9,8,6,1,18,4,5,5,3,3,7,25,24,12,6,7,2,1,11,13,8,2,2,5,14,20,15,9,6,2,0,7,2,7,4,7,13,2,8,1,28,2,0,3,4,23,3,23,8,2,29,2,14,7,0,13,2,7,10,14,1,18,4,15,2,15,1,0,0,1,2,6,1,18,5,1,12,1,21,2,6,4,0,1,1,2,4,9,3,0,1,3,4,3,10,3,0,0,10,1,0,0,6,2,0,10,18,6,7,1,5,8,3,17,5,9,3,2,1,35,5,1,2,4,15,3,5,13,3,7,4,17,8,13,0,5,1,0,0,1,1,1,3,7,2,2,9,2,3,8,2,7,1,4,7,25,19,0,0,6,3,7,6,5,6,3,1,4,11,3,17,5,11,4,5,3,0,5,5,12,5,1,6,1,1,5,7,5,17,1,0,7,1,5,17,6,2,1,2,6,3,4,3,22,13,3,7,1,5,5,4,1,7,4,12,15,3,0,35,4,3,31,3,1,4,10,2,19,3,6,14,4,3,19,6,3,9,6,6,12,1,6,4,0,22,8,4,10,3,4,5,3,4,2,2,12,5,4,6,11,2,1,3,19,11,5,6,3,8,4,9,4,8,3,1,9,24,7,9,9,5,3,3,9,5,6,0,3,11,3,6,5,3,4,25,2,15,4,7,4,5,2,4,1,3,1,1,1,13,5,12,5,3,4,54,9,5,1,6,3,5,12,4,1,7,2,9,13,12,1,8,5,2,2,4,10,4,9,13,6,1,9,3,2,5,2,21,1,9,10,4,7,2,4,5,12,5,6,11,3,5,5,4,4,9,12,4,3,1,6,2,1,0,4,4,2,8,2,12,20,4,1,0,4,6,0,1,4,3,0,11,4,1,6,8,3,10,0,4,2,9,5,5,26,14,6,4,3,3,10,3,6,12,3,2,1,12,2,9,6,6,9,11,1,14,12,3,3,3,24,6,12,3,10,8,4,2,0,4,6,5,11,1,5,8,1,4,3,1,5,5,1,16,2,7,4,14,5,2,16,10,5,7,4,7,4,4,2,2,3,2,2,2,10,7,2,5,7,4,4,4,1,3,3,6,3,6,16,4,3,1,3,14,2,2,2,3,4,0,1,1,7,11,7,1,6,4,1,3,1,5,6,9,7,4,6,17,8,2,8,1,7,5,0,4,1,1,3,2,2,1,1,3,4,12,4,4,1,5,4,1,0,3,3,3,4,3,1,1,4,7,3,4,3,5,2,12,3,0,0,2,4,3,6,0,2,6,0,3,2,6,4,13,5,11,3,8,9,7,8,5,0,6,2,2,3,3,4,3,5,3,2,4,2,2,12,2,4,3,5,6,13,7,1,21,3,0,8,1,3,5,5,7,11,2,1,1,2,2,6,1,6,5,5,5,7,12,4,5,3,5,4,4,4,3,1,1,3,3,2,3,3,2,3,4,21,4,2,2,2,0,3,2,0,0,0,4,4,0,4,3,2,1,0,1
per,5,12,8,136,1,19,8,7,0,14,8,2,17,45,2,1,5,40,1,5,7,38,14,51,31,12,5,14,8,58,4,277,197,19,61,38,17,66,62,1,21,2,2,12,31,11,33,26,343,15,47,3,13,31,15,2,234,78,2,22,10,11,2,20,14,11,115,63,24,22,54,7,8,7,76,5,40,4,148,23,478,4,12,15,396,139,39,2,108,92,84,6,25,40,244,179,48,39,58,33,16,35,50,3,22,53,76,13,68,14,43,2,23,11,5,48,18,35,140,335,31,41,131,349,4,2,5,5,41,37,10,0,9,73,9,58,2,10,10,24,5,65,74,12,0,85,8,24,46,59,38,7,44,6,6,31,68,11,2,16,69,4,18,81,18,11,14,21,64,6,61,100,17,4,12,10,295,6,6,64,34,3,12,34,10,30,77,21,24,62,0,3,41,10,3,6,43,14,44,12,80,28,40,12,27,3,10,72,24,29,106,8,40,57,3,1,9,2,24,0,32,22,6,25,75,160,138,104,39,55,14,75,102,23,40,190,36,7,41,3,75,48,8,6,11,27,2,22,62,7,10,92,5,77,27,14,11,67,10,85,26,13,13,9,8,95,9,2,39,5,176,63,346,7,3,1,14,86,9,2,45,13,4,16,14,3,2,13,5,1,20,2,35,13,92,17,100,3,5,26,22,66,25,107,23,5,11,15,3,14,5,26,32,3,238,56,17,86,43,6,14,6,32,16,26,1,10,33,2,39,7,37,8,4,4,8,32,6,4,52,5,14,14,23,16,1,75,58,27,15,42,6,0,98,26,19,2,2,9,75,24,16,13,48,4,0,23,9,7,23,4,54,9,7,8,46,7,8,8,9,64,1,33,11,4,47,0,23,38,6,17,3,18,6,48,8,54,0,15,26,21,4,6,0,15,13,7,4,46,11,1,15,113,30,8,2,3,5,3,2,0,6,19,3,3,1,1,9,16,47,74,14,8,32,3,2,0,2,1,9,11,30,6,26,4,4,25,4,38,38,57,10,5,9,63,15,0,16,14,48,19,32,55,28,5,9,44,16,1,6,11,12,3,15,5,20,3,1,18,15,18,17,1,2,5,3,43,3,3,3,48,76,0,3,32,2,11,47,2,8,12,10,56,2,43,92,31,37,9,8,36,7,4,7,22,21,11,5,2,15,0,6,8,21,9,6,17,12,28,38,7,8,0,17,15,9,4,5,48,11,0,0,2,23,39,4,1,38,15,24,4,1,17,93,2,10,27,12,17,6,36,8,54,3,7,5,5,3,49,52,17,13,26,2,4,1,43,12,10,65,26,12,26,5,6,6,2,11,15,7,14,25,40,13,18,5,21,23,25,13,14,2,6,4,13,49,4,14,14,44,71,22,8,17,51,12,11,19,8,4,19,88,5,130,17,14,3,27,11,34,71,27,55,14,12,15,4,22,2,13,8,4,5,15,12,113,10,5,13,229,34,6,22,8,3,16,81,9,4,26,5,3,1,9,3,0,1,3,8,11,1,16,17,12,31,9,2,12,14,7,18,40,17,7,7,8,28,5,1,1,27,4,11,34,8,23,5,0,66,9,7,2,4,16,3,8,8,8,14,5,0,64,20,30,14,11,3,7,9,16,4,7,0,8,11,9,37,0,5,16,11,32,26,8,3,9,14,6,8,54,12,2,5,18,5,4,20,14,10,9,5,34,53,95,114,22,11,14,14,1,1239,30,51,111,27,152,16,7,29,18,6,2,13,22,3,4,33,4,8,12,3,3,18,35,33,6,31,6,44,20,7,13,2,4,19,31,13,15,16,4,12,3,7,7,10,4,6,10,15,7,140,6,43,29,15,13,2,28,6,17,4,59,1,9,2,3,1,13,20,25,19,2,13,1,5,7,3,28,4,3,2,5,5,1,20,50,26,16,2,0,7,30,8,27,2,4,13,40,10,2,20,19,5,4,5,4,4,6,4,24,8,8,257,77,16,1,1,6,12,23,8,30,3,2,20,14,7,3,2,7,2,13,3,1,5,12,0,0,24,0,8,2,1,4,0,20,1,16,21,23,4,23,16,74,14,23,38,4,4,8,1,13,13,65,18,3,9,4,0,72,9,8,4,9,6,56,12,10,3,6,10,89,91,37,42,59,40,86,185,5,3,8,22,18,7,35,47,4,48,5,15,11,0,14,75,58,9,38,0,5,2,0,25,12,6,2,4,9,4,5,58,3,11,61,10,49,5,4,21,0,1,0,8,0,1,41,11,2,0,0
cent,3,4,7,129,1,20,4,11,0,13,6,2,13,39,2,3,4,48,2,3,7,31,8,44,37,5,4,9,8,40,4,268,174,14,54,28,13,53,99,0,17,4,2,9,35,17,31,26,314,8,36,2,14,27,6,0,274,73,0,19,9,9,2,20,21,15,112,82,18,12,32,1,10,7,69,5,47,5,121,21,511,1,11,19,361,116,33,1,105,96,84,5,21,32,216,174,35,55,49,30,7,32,45,1,22,47,92,10,75,13,38,1,22,7,2,47,15,37,130,330,30,27,112,348,5,0,5,2,46,43,12,0,7,76,7,50,3,4,7,20,6,64,71,12,0,85,10,25,49,50,32,6,50,5,5,28,67,2,4,6,85,8,13,77,9,5,7,17,57,6,46,92,23,3,9,8,288,2,8,54,35,3,13,27,6,27,74,22,17,62,0,3,63,12,2,3,41,10,42,10,79,30,36,7,28,1,8,81,20,19,102,5,37,58,2,3,12,4,15,0,30,23,6,23,74,164,132,111,36,87,13,74,92,21,30,191,44,7,30,2,76,70,4,7,8,21,3,22,57,5,5,99,3,69,33,24,10,87,10,85,26,12,12,8,6,98,10,1,40,3,175,52,316,6,2,0,13,72,8,6,45,16,11,15,17,3,4,16,4,0,20,2,23,11,86,17,97,2,5,25,17,63,18,109,24,4,8,18,3,12,1,22,28,2,234,68,26,95,41,3,19,5,32,12,20,1,11,30,3,29,7,39,8,3,3,7,40,9,4,46,5,14,9,27,15,0,83,59,23,15,41,4,1,92,22,21,2,2,8,79,23,14,10,44,3,1,26,8,2,22,3,43,5,3,10,40,6,22,8,5,77,0,36,10,8,38,3,20,41,0,11,3,15,6,42,8,48,0,17,22,21,4,6,0,12,10,4,2,63,12,0,10,126,24,6,1,3,7,2,0,1,4,16,7,3,8,1,6,14,46,69,15,8,24,2,0,0,1,1,9,9,33,6,27,4,5,20,6,30,33,58,9,5,8,55,11,0,18,5,47,19,30,48,29,5,8,37,14,0,7,13,7,3,9,6,17,3,0,16,13,18,20,0,0,4,4,39,3,6,2,41,78,0,1,27,4,19,52,5,9,11,10,49,4,38,84,33,45,9,9,40,7,2,8,23,18,9,4,2,18,0,8,6,21,8,4,16,15,28,34,10,9,0,20,10,8,7,4,48,9,0,0,2,54,42,3,0,34,13,17,3,1,14,83,0,6,28,12,20,2,37,10,47,2,6,9,4,5,46,45,16,13,22,2,5,1,71,15,12,60,35,16,25,4,7,2,8,10,17,7,15,21,27,15,20,5,23,32,28,17,9,1,7,4,17,54,1,13,11,44,86,20,7,19,53,15,11,16,7,5,16,71,5,113,7,14,3,25,9,30,65,25,54,14,13,17,4,40,6,13,6,1,2,14,9,98,8,5,12,203,33,8,18,9,2,11,97,11,2,21,6,2,1,8,3,6,1,3,8,9,0,14,3,11,29,8,2,8,10,7,15,37,12,4,6,7,20,5,4,0,29,4,11,18,4,20,3,0,70,9,5,4,6,14,2,7,8,7,16,4,0,74,16,27,13,7,1,6,3,15,1,5,0,5,11,9,30,1,4,17,10,26,39,7,2,9,11,8,6,31,11,1,1,13,3,2,26,6,9,11,4,30,46,91,116,26,14,11,12,1239,1,26,44,134,26,178,15,7,28,15,4,2,21,14,2,4,26,1,5,11,2,5,18,33,43,6,31,6,44,26,6,7,2,4,23,30,10,14,16,4,7,4,6,2,12,2,9,7,19,7,131,2,49,30,11,15,2,24,6,17,2,61,1,8,2,4,1,10,20,26,15,1,14,0,4,3,3,36,2,3,1,5,4,3,23,34,30,10,2,2,7,25,10,27,1,3,11,41,10,0,22,19,3,4,5,2,4,1,3,27,7,6,235,77,12,1,1,22,10,20,7,26,2,3,12,13,5,3,0,7,2,9,0,0,4,10,0,0,24,0,11,2,1,3,0,34,1,19,22,26,4,18,19,75,17,16,33,2,2,7,0,15,13,70,18,1,9,4,0,64,9,15,7,9,4,54,9,15,7,5,9,76,81,33,45,69,48,74,170,4,2,8,22,15,5,26,40,1,36,1,3,4,0,13,82,41,3,16,0,5,0,0,23,12,5,2,2,4,2,4,52,4,11,60,13,44,5,2,26,2,0,0,7,0,0,26,10,2,0,0
able,12,23,13,160,11,19,14,32,8,8,27,13,14,114,5,10,8,13,19,10,6,44,31,57,24,23,15,29,8,19,16,226,134,23,73,90,70,6,14,8,22,12,18,6,36,20,17,22,268,30,46,11,27,59,36,5,53,35,7,24,17,9,3,22,30,10,129,14,10,8,26,3,3,5,167,20,62,11,100,33,79,1,26,19,235,31,29,0,52,2,7,13,5,19,51,19,25,6,49,27,11,36,41,13,19,42,7,11,23,10,32,5,15,24,16,36,4,8,75,162,48,44,51,141,19,6,9,4,7,5,14,20,11,76,35,83,16,6,7,8,9,39,35,13,4,85,10,25,28,23,64,13,25,16,5,28,80,13,15,74,20,8,22,1,9,27,11,34,41,11,23,99,35,7,9,7,162,10,8,65,52,17,12,22,3,41,33,34,41,70,6,16,12,3,6,8,29,19,12,20,37,4,5,10,47,15,5,41,10,50,109,17,28,16,17,26,5,4,12,1,5,26,6,18,50,96,52,69,7,16,15,24,25,11,44,30,49,14,11,10,89,39,12,13,18,15,7,42,66,7,16,35,38,10,7,18,13,6,7,25,9,28,21,4,5,50,18,14,14,8,163,10,52,5,3,9,24,24,13,3,97,4,6,16,18,4,30,23,29,17,2,6,16,13,3,10,54,6,8,25,19,19,2,4,13,4,27,9,10,6,6,31,59,10,73,11,48,78,13,10,34,9,50,19,44,6,22,45,2,27,4,26,11,9,14,7,15,15,4,18,9,17,25,15,15,8,48,46,16,28,18,14,6,45,26,8,12,16,21,67,33,14,20,28,7,4,26,8,9,25,5,22,5,13,10,31,18,10,19,14,65,8,40,17,11,34,7,16,43,14,35,2,11,16,32,18,55,6,42,7,28,9,4,5,7,7,11,3,24,18,6,5,9,20,23,10,12,14,10,4,10,7,15,8,3,10,6,18,6,18,16,6,2,6,7,23,6,24,3,9,22,19,9,20,11,2,18,10,53,8,9,9,15,5,52,6,2,7,13,35,29,48,42,62,7,28,36,15,5,3,22,13,3,16,5,53,13,11,34,14,11,16,3,6,10,15,15,9,7,1,77,47,1,12,15,7,5,17,15,6,22,7,9,16,12,7,8,16,7,8,5,7,16,8,16,14,12,20,3,12,7,20,10,17,3,11,28,12,22,38,9,4,8,13,6,9,13,22,60,35,5,2,16,14,16,18,6,24,24,11,18,10,7,42,16,13,20,5,7,7,19,7,20,8,12,29,16,17,35,52,8,7,21,2,11,3,9,9,10,17,10,7,22,27,9,11,4,15,7,21,26,37,13,4,42,7,9,11,34,23,15,1,9,5,8,22,5,26,12,4,48,24,15,9,51,7,8,10,7,4,17,2,9,18,7,9,4,7,17,35,11,16,34,18,8,3,16,13,9,11,17,3,22,20,14,27,15,7,7,156,45,10,7,4,13,16,29,21,4,5,2,6,9,19,7,5,4,13,9,14,22,11,23,29,28,5,5,5,6,8,18,23,15,6,8,8,14,13,2,8,12,20,20,7,11,12,11,4,25,7,15,7,11,12,12,11,18,19,1,4,16,6,5,26,16,31,16,6,12,20,11,14,8,22,4,9,18,2,8,16,7,20,9,6,6,3,28,4,27,16,18,10,6,16,14,7,15,4,16,8,10,17,11,38,34,17,8,10,3,30,26,1,2,5,21,15,8,9,18,8,22,7,4,13,7,14,10,3,19,23,5,0,19,0,8,8,5,4,10,9,11,7,2,3,15,25,3,6,26,7,9,8,10,6,11,8,14,14,27,8,9,1,2,13,3,8,7,18,0,23,12,6,11,7,2,7,8,8,7,3,14,8,8,7,10,12,6,32,12,11,3,10,9,16,6,14,14,13,7,11,15,26,7,4,5,5,6,6,4,7,3,3,9,14,6,7,18,5,10,14,11,7,7,14,3,3,6,11,10,10,5,6,8,3,16,4,13,6,7,5,5,10,22,5,7,5,5,7,6,10,12,3,4,16,3,3,2,7,5,29,9,9,4,23,6,4,6,5,8,3,7,9,7,11,15,9,7,4,14,7,3,5,7,2,5,7,5,8,5,5,8,27,21,9,22,19,19,24,37,11,4,7,4,4,4,5,6,2,17,5,11,5,8,4,3,4,7,8,0,2,8,4,16,18,11,2,6,8,8,6,3,7,7,10,6,13,8,12,22,1,2,3,3,8,1,6,6,3,1,7
november,3,16,1,61,3,0,2,7,3,1,21,8,5,15,0,3,4,7,0,0,2,11,1,11,4,5,1,8,2,46,2,81,31,1,5,12,10,33,6,0,2,0,1,3,9,5,11,8,165,4,12,5,4,7,5,2,10,28,1,2,11,2,1,3,5,1,27,3,9,6,15,2,2,0,7,2,7,0,40,7,41,0,7,2,123,17,2,0,73,6,28,6,7,24,29,3,9,4,17,0,1,13,22,4,6,30,5,0,17,4,15,3,1,7,0,19,20,3,45,52,12,9,1,68,5,1,1,0,2,4,2,0,2,18,5,13,7,0,5,0,1,15,23,5,3,35,1,3,6,6,16,2,11,6,0,4,4,0,14,3,21,1,2,13,7,0,3,2,6,6,9,28,5,0,0,9,52,0,1,7,6,5,0,5,2,1,5,3,17,39,2,0,2,0,0,5,7,1,14,3,5,1,0,4,14,1,4,9,9,4,27,0,11,0,0,0,1,1,4,1,10,3,0,5,21,32,20,16,4,19,4,18,21,3,7,14,18,0,4,0,23,15,1,0,2,4,1,9,23,1,2,2,7,10,1,6,7,8,4,12,1,17,15,13,1,19,1,0,0,1,33,8,86,2,0,1,5,13,2,2,3,0,1,9,3,0,3,4,1,0,17,8,5,5,10,4,38,0,0,2,11,13,7,19,1,1,8,1,0,0,1,3,13,7,33,12,2,23,8,4,19,1,4,0,11,0,0,13,3,26,8,1,2,0,4,7,2,1,2,16,4,8,4,10,3,2,9,19,2,4,10,3,0,10,1,0,3,2,5,24,4,2,0,4,0,0,9,0,0,2,2,4,0,0,0,20,2,0,2,3,12,0,10,5,4,14,2,9,23,0,3,0,5,8,10,3,19,2,18,2,6,1,2,0,0,0,1,0,8,4,0,4,3,1,7,4,2,2,3,2,0,2,11,7,0,1,0,4,7,20,26,17,6,39,1,2,0,11,1,1,1,4,1,3,0,0,3,1,8,5,5,1,5,1,16,3,1,10,8,16,8,15,8,2,2,4,9,7,1,0,6,0,3,0,1,0,1,11,14,1,0,1,1,3,7,8,4,1,1,10,33,23,0,4,10,2,0,7,0,1,4,2,13,1,2,10,5,9,6,1,1,4,5,2,4,5,6,5,0,2,0,8,1,10,0,3,6,0,5,17,6,0,0,0,5,3,8,1,10,2,2,3,1,1,7,6,41,4,6,9,22,1,5,17,1,0,4,0,0,1,7,5,22,2,6,2,4,2,29,9,1,2,13,1,2,0,2,2,1,29,1,7,1,1,0,3,2,0,0,1,11,9,4,4,5,1,0,0,39,1,12,1,0,9,10,12,6,12,6,1,12,11,14,2,13,3,2,0,0,1,4,15,1,22,5,2,2,1,3,14,27,5,15,9,3,1,1,6,1,2,2,0,1,8,5,32,0,7,2,116,14,0,0,4,1,8,16,8,6,9,6,5,30,8,13,11,1,10,6,4,6,1,55,11,17,2,2,1,14,2,5,9,3,0,9,2,4,2,2,7,4,4,10,9,4,9,2,3,1,10,2,4,3,2,4,6,14,1,6,2,0,38,8,6,3,10,6,2,3,4,1,3,0,9,1,1,7,0,6,8,0,13,6,0,7,0,8,0,12,3,5,5,3,2,4,0,10,2,0,4,2,16,19,30,22,3,1,4,3,51,44,2,1,68,7,8,11,3,0,7,3,2,0,2,1,4,2,0,2,3,0,2,8,0,8,0,0,20,2,5,7,4,0,2,2,4,3,2,3,3,2,4,9,3,0,0,6,2,3,2,4,4,1,7,2,4,0,5,7,4,1,1,8,9,1,0,0,4,2,3,2,4,3,0,1,1,7,10,4,4,10,8,0,4,2,7,1,7,1,8,5,6,7,1,0,6,0,11,0,4,0,0,3,0,3,4,1,5,4,1,0,4,41,9,0,0,0,10,3,2,6,27,1,5,9,1,9,1,2,1,3,6,0,3,7,33,4,6,4,2,0,3,0,5,14,26,6,9,3,7,3,4,1,23,1,20,2,1,2,0,4,8,4,2,1,2,2,29,2,13,4,3,4,1,1,2,1,4,3,4,5,11,23,11,18,20,10,24,80,3,2,1,3,4,2,40,5,1,9,0,0,5,2,1,5,8,0,4,3,2,0,2,1,1,3,0,0,2,1,1,4,0,9,35,2,1,3,2,4,0,4,0,3,2,0,2,0,9,1,0
1,7,14,4,85,2,6,0,12,3,0,5,7,12,22,2,1,3,5,4,3,2,9,10,10,8,10,3,10,3,37,2,108,28,3,15,26,9,9,24,2,2,0,0,12,12,9,25,16,147,22,5,5,1,17,8,0,46,53,6,9,3,2,0,6,10,4,25,22,2,15,75,3,1,3,37,7,24,2,45,10,143,4,6,7,103,27,9,7,42,18,20,0,26,29,40,32,15,6,23,8,19,13,11,0,8,17,18,10,21,11,29,2,6,18,14,20,30,3,56,49,5,10,37,168,7,2,2,1,7,12,8,1,3,32,5,41,0,8,4,7,2,17,44,7,1,46,0,11,13,21,19,13,3,8,1,26,10,2,0,12,35,2,6,47,74,5,9,9,12,2,13,38,6,1,2,7,67,2,1,30,9,6,15,8,1,9,22,5,12,38,0,0,11,2,8,10,12,6,17,3,18,7,8,5,19,1,3,6,1,6,49,0,17,19,0,5,27,25,12,1,16,14,1,10,22,49,38,37,7,47,2,30,53,4,16,59,13,3,8,2,29,19,6,1,4,11,0,10,36,5,4,18,4,21,5,14,2,28,3,37,16,11,13,25,1,50,13,1,4,3,40,30,111,4,4,4,13,47,5,1,20,10,5,7,11,2,5,7,3,1,21,7,10,18,37,1,18,5,4,7,5,25,24,36,2,4,5,8,2,10,0,4,31,8,75,25,2,31,7,4,11,0,11,3,20,1,3,10,4,16,0,8,0,3,2,6,2,1,13,28,3,14,5,4,5,2,21,16,10,11,11,7,0,24,7,4,2,1,2,66,22,8,5,4,3,5,7,9,4,12,4,17,1,6,5,24,3,3,0,3,18,0,19,2,1,17,2,4,36,0,2,3,17,7,19,5,35,6,12,3,6,1,6,4,4,1,5,1,14,6,0,4,6,3,1,1,1,2,0,1,0,2,14,0,1,1,1,2,4,22,41,53,7,48,2,3,2,4,10,4,6,17,2,7,2,1,7,2,14,8,14,1,1,1,20,2,0,1,3,29,11,12,5,11,1,11,25,6,1,1,13,5,4,2,3,3,0,4,7,1,6,6,0,2,4,0,5,0,0,4,37,44,1,1,18,1,1,8,2,2,4,6,19,3,16,25,8,4,5,1,12,1,2,2,7,7,0,2,0,5,0,5,1,1,1,2,4,4,6,15,1,1,0,6,6,5,0,1,13,13,0,7,3,13,10,3,0,10,3,7,2,0,3,26,5,2,3,2,2,4,11,7,19,3,3,3,3,0,18,6,6,1,29,3,3,0,12,0,3,44,3,2,6,1,0,0,4,4,2,2,7,4,11,8,4,2,9,8,21,3,3,4,1,2,8,9,7,9,0,11,18,21,5,5,4,7,3,2,0,1,5,25,2,40,12,1,1,4,0,12,38,7,15,10,2,1,1,22,4,2,4,3,3,6,3,50,5,5,17,98,13,3,1,0,3,10,16,4,0,4,1,2,6,8,3,3,1,4,5,4,1,2,4,12,12,3,2,8,11,2,18,14,4,5,7,0,6,3,0,5,12,1,8,20,3,27,1,2,21,5,0,5,2,3,1,3,9,7,0,4,0,114,8,10,5,27,1,1,2,2,2,2,0,15,2,0,5,3,1,5,1,8,4,2,3,3,36,2,8,4,4,1,3,15,12,0,11,5,3,3,0,23,43,64,57,5,0,5,3,111,134,5,68,1,9,28,7,2,14,6,2,0,7,2,3,4,10,1,1,1,0,0,5,4,6,2,6,4,3,13,5,8,5,3,7,7,6,5,5,1,5,0,7,1,2,2,10,6,3,1,19,6,2,3,0,2,2,5,6,5,0,3,7,7,0,2,2,14,0,1,15,17,4,1,2,0,5,11,0,2,3,0,1,0,13,6,1,4,3,1,6,7,4,7,5,5,0,9,7,6,1,0,2,2,1,3,1,1,3,13,7,2,39,15,7,1,1,2,4,3,1,29,6,2,4,0,1,0,2,4,6,4,3,1,2,22,1,2,13,1,2,0,5,2,0,18,1,5,2,7,5,8,7,35,4,16,5,2,2,10,0,4,10,22,1,0,0,2,1,24,4,3,0,3,1,12,3,4,2,8,2,12,57,15,28,23,11,78,109,0,13,1,1,4,6,19,11,2,18,0,8,1,4,9,23,19,0,9,0,1,0,0,7,1,1,1,5,1,2,2,18,2,6,22,1,7,3,3,2,2,0,4,2,2,6,5,2,18,5,2
extend,13,45,27,290,17,9,9,92,8,7,62,9,20,105,10,22,9,20,10,10,3,57,28,32,29,36,28,21,16,26,13,328,274,28,79,106,74,29,21,12,11,36,7,12,55,15,47,28,613,65,62,11,27,75,23,13,98,50,15,48,32,23,8,14,35,14,162,11,11,53,38,14,5,9,144,16,31,8,134,42,117,3,33,12,317,20,20,4,57,2,25,18,6,56,70,13,36,22,69,28,37,42,51,14,21,50,12,11,28,9,33,11,16,27,15,50,33,4,226,224,73,52,29,165,9,4,12,4,22,10,26,9,16,91,39,90,12,10,6,21,5,61,52,3,9,114,14,26,27,27,128,9,28,13,10,59,40,10,25,47,22,4,22,12,8,27,17,40,39,14,49,129,23,3,13,16,239,8,13,61,40,32,29,21,5,38,46,28,47,96,5,3,12,3,5,10,34,9,12,18,44,10,8,18,59,23,16,97,26,62,136,16,67,14,4,9,6,13,42,3,9,29,7,26,60,257,38,38,14,21,29,47,30,43,44,63,50,18,15,24,107,62,18,5,24,20,18,33,85,5,25,43,27,18,16,25,13,7,6,34,10,52,38,13,9,83,20,20,26,6,233,25,40,13,9,3,46,27,15,3,106,12,9,40,26,20,29,25,13,4,11,13,15,13,14,22,66,5,8,37,30,83,5,6,19,10,34,7,9,6,9,22,40,21,43,39,62,61,19,11,87,13,47,8,109,33,9,39,6,49,6,22,15,13,13,27,27,20,8,47,17,18,31,21,22,30,83,118,27,24,25,21,8,46,41,9,10,8,24,50,41,22,20,21,21,7,55,10,12,24,7,41,11,27,10,73,13,6,22,12,111,9,68,13,9,101,10,23,41,7,40,6,22,40,47,16,90,5,48,16,35,9,5,3,13,22,19,13,53,33,8,33,11,29,13,24,11,29,11,9,10,10,32,18,2,4,6,27,21,27,17,12,11,34,16,6,4,22,21,12,33,76,10,32,5,10,24,9,44,20,38,10,8,13,92,14,7,20,8,48,11,48,45,30,20,3,35,29,20,0,54,6,3,6,5,20,13,34,23,4,7,27,18,7,19,8,24,8,4,31,99,45,11,10,19,23,16,37,14,16,25,12,11,22,13,37,21,30,17,13,5,14,20,14,26,21,9,13,8,12,11,32,21,33,13,6,26,10,22,42,25,6,9,12,10,12,20,17,66,31,13,8,4,22,18,10,11,44,22,9,67,16,16,92,8,14,79,11,11,14,36,10,59,6,21,20,26,9,58,62,54,15,29,4,20,19,14,10,11,58,27,24,29,31,17,4,16,9,11,20,49,47,10,23,41,16,4,7,103,28,45,5,13,3,14,19,15,31,14,24,42,42,40,29,48,23,32,5,13,16,15,7,5,35,15,16,15,14,20,124,6,32,36,31,27,12,13,24,6,21,17,13,14,45,9,35,26,11,13,361,32,7,10,12,20,30,76,31,18,28,17,27,45,33,19,20,8,9,14,17,40,7,84,62,61,10,5,12,12,18,16,42,25,16,23,15,15,11,29,38,30,24,26,53,16,18,22,21,20,29,12,2,10,5,22,14,27,9,10,6,12,23,12,43,60,43,8,15,10,11,19,6,8,50,1,75,15,2,8,41,10,29,8,8,10,17,36,9,133,20,19,17,8,14,36,4,17,18,9,17,27,6,7,30,18,12,20,29,24,27,26,21,7,9,1,34,35,12,28,32,11,13,4,22,10,20,44,7,24,17,12,11,23,7,29,18,9,120,9,17,23,41,14,9,16,40,11,14,6,18,17,11,16,13,10,7,15,9,28,16,8,14,37,18,13,14,10,7,13,22,10,24,9,13,18,11,10,13,9,19,7,16,16,19,11,22,22,51,22,7,6,15,16,7,16,18,10,13,9,15,29,40,28,9,7,6,14,16,4,5,11,13,14,11,9,14,10,5,7,25,15,20,15,11,11,9,5,32,21,7,2,16,6,16,21,9,10,13,17,7,8,54,5,13,12,9,12,15,12,10,10,9,7,18,15,13,15,18,10,37,8,11,21,10,27,8,13,24,11,8,16,16,16,10,22,14,6,17,9,19,19,11,2,27,15,6,22,10,6,28,8,14,7,0,17,15,21,23,38,7,7,9,15,9,11,5,20,27,24,8,10,23,10,24,9,28,12,6,4,20,19,9,15,11,4,31,11,9,15,27,36,13,7,6,8,5,25,12,32,10,9,4,15,3,3,10,9,8,11,5
value,4,8,1,159,8,10,5,37,4,6,4,7,16,103,4,10,6,43,8,13,13,60,28,40,25,17,18,27,12,33,4,276,222,12,62,107,43,39,103,7,25,44,3,11,58,26,31,31,270,88,49,2,34,99,40,5,155,38,17,14,17,7,5,12,37,12,145,25,24,7,27,4,21,5,149,20,37,4,131,34,261,10,17,14,281,77,29,1,83,12,23,9,5,27,106,40,34,19,47,46,27,31,53,23,24,20,11,11,39,6,36,9,24,50,9,49,0,7,62,279,53,49,64,199,7,16,4,12,8,5,24,2,22,90,50,91,8,12,11,51,1,66,44,1,6,108,9,32,37,21,98,12,59,9,8,22,57,2,5,31,36,3,35,8,14,22,12,26,61,19,31,126,30,5,15,16,248,12,21,49,21,16,9,22,8,57,60,29,23,56,6,11,52,5,5,11,20,9,7,34,66,13,12,7,29,20,9,80,12,35,127,17,25,26,7,27,4,7,15,2,12,15,5,14,72,131,70,55,6,80,26,26,30,24,60,45,48,19,37,7,63,70,26,4,39,13,6,32,46,9,21,52,29,59,23,24,19,8,7,62,6,27,14,5,20,34,10,19,56,13,222,7,149,9,6,2,33,9,24,2,97,14,4,26,30,11,6,13,15,3,3,1,19,5,9,17,72,4,0,39,32,40,12,11,27,3,29,12,16,1,7,20,60,7,112,32,36,66,26,8,42,7,36,9,57,5,11,48,12,42,4,37,14,6,8,19,24,14,12,28,6,11,34,9,14,6,71,58,16,44,17,11,6,72,26,4,5,4,21,75,45,15,14,38,10,8,45,24,8,21,9,46,14,37,17,27,7,25,37,15,64,4,78,9,13,80,11,27,43,18,16,13,10,3,45,18,62,7,29,8,25,7,16,2,8,11,15,4,68,28,13,20,152,22,6,9,3,6,4,9,3,9,22,18,6,4,5,11,3,30,45,26,11,10,4,1,2,3,9,11,15,32,4,19,5,4,23,10,50,26,29,13,7,14,81,15,6,12,20,49,7,37,55,23,8,0,54,12,28,7,39,3,9,5,2,34,8,5,19,10,10,20,2,9,14,3,34,6,4,4,39,52,6,8,29,13,11,28,20,37,12,7,36,6,13,77,12,22,23,14,7,7,5,12,41,35,14,19,6,14,4,52,36,20,18,3,27,17,21,37,4,8,2,16,24,11,4,4,62,26,6,2,3,37,86,11,6,28,24,6,36,7,8,55,7,27,66,9,10,12,44,5,28,2,35,22,19,15,47,51,28,16,7,1,5,15,33,16,16,23,45,6,31,15,13,3,8,9,6,17,31,39,32,9,62,23,35,17,14,15,34,2,10,1,7,44,7,6,21,12,55,14,4,15,26,14,27,12,18,19,28,55,2,67,8,20,5,13,15,56,149,18,36,24,6,8,10,16,6,16,40,6,5,22,3,47,8,3,14,150,12,11,12,4,3,17,72,27,6,22,2,5,2,16,4,2,0,11,15,10,24,13,9,13,7,8,6,12,0,6,8,36,12,21,13,7,22,6,8,17,10,21,17,12,4,10,5,0,37,21,12,6,5,7,23,10,19,4,17,5,9,23,11,40,22,10,7,13,6,15,8,7,5,10,2,15,22,10,6,23,21,22,34,8,16,3,20,11,30,17,22,4,4,20,9,15,26,22,18,3,23,12,27,30,34,29,15,19,6,152,178,15,8,28,34,1,7,12,37,14,13,7,21,26,4,28,48,8,1,15,2,11,11,30,28,12,15,5,25,20,10,1,2,12,13,22,5,11,8,0,9,3,24,8,14,8,13,11,21,11,131,7,11,10,10,3,12,10,9,21,5,20,3,13,7,9,10,7,42,10,12,7,33,13,14,22,11,51,13,18,4,4,5,2,16,32,14,5,9,9,13,29,0,26,6,8,24,40,12,4,8,6,10,5,20,13,6,4,13,12,13,6,54,105,13,11,1,5,15,3,0,15,2,5,6,4,13,11,8,17,5,10,11,4,8,5,1,1,9,8,18,3,6,15,6,7,3,48,20,23,2,22,10,10,32,22,8,23,10,5,13,10,20,30,15,1,4,0,2,24,8,5,13,13,6,24,4,7,1,22,1,34,45,12,7,54,49,44,79,3,4,7,3,9,6,13,4,4,33,8,13,7,2,2,10,11,8,5,1,8,2,4,11,13,8,6,3,9,19,5,1,8,10,128,3,16,5,13,5,10,5,7,11,5,6,8,6,15,3,6
city,8,20,9,171,10,14,6,32,5,2,39,131,30,88,5,9,7,23,11,3,7,51,27,23,13,23,14,21,14,17,11,205,172,6,63,51,39,14,3,6,9,4,16,11,29,9,20,12,292,57,40,6,14,32,38,5,41,39,14,18,15,6,2,25,16,6,118,9,10,16,27,13,10,10,121,15,30,2,76,28,54,3,22,11,233,15,23,1,51,5,11,10,7,18,43,20,33,6,40,14,31,24,25,9,18,35,2,6,19,16,19,7,5,20,15,28,18,10,49,143,41,19,6,98,21,5,7,8,1,7,21,8,33,70,22,97,7,11,6,14,6,43,19,6,7,77,13,36,19,21,40,2,14,11,23,36,37,9,10,31,22,2,10,9,11,7,11,14,25,16,97,103,32,1,11,7,139,3,5,64,35,14,31,19,4,32,34,19,33,40,3,3,6,0,0,0,54,3,20,7,36,1,7,10,23,8,6,35,6,15,81,14,33,5,5,8,3,9,15,16,6,21,13,11,36,86,56,32,12,11,18,30,15,27,32,10,26,12,4,3,45,38,16,9,16,5,4,34,69,4,11,15,26,11,4,19,13,3,2,39,4,39,14,14,9,54,9,11,16,14,109,9,26,4,9,6,31,10,7,4,66,6,3,24,29,12,25,16,14,6,9,8,3,15,5,9,40,5,2,17,17,45,4,4,16,4,21,7,11,7,7,37,30,3,37,19,9,41,61,7,67,3,25,25,30,6,28,30,2,35,4,13,6,6,4,24,14,17,8,12,6,11,26,16,7,10,41,48,19,24,12,6,11,48,24,13,3,6,22,20,24,20,11,21,6,2,33,6,4,24,9,18,7,53,10,36,7,2,15,6,46,6,38,21,24,47,40,16,26,9,18,7,13,12,23,10,36,2,54,6,18,14,8,8,5,24,5,4,14,9,3,20,4,44,10,12,1,6,7,0,5,10,14,10,4,10,1,9,17,17,7,11,6,19,10,5,0,12,16,4,12,14,2,9,2,5,22,14,41,11,17,3,8,4,54,7,1,9,12,12,20,22,34,31,9,7,30,18,22,1,37,9,10,18,4,26,8,17,17,4,12,13,9,5,2,13,7,3,7,9,58,21,2,1,12,17,6,16,12,19,10,4,9,0,10,6,27,27,12,5,3,6,10,4,10,12,6,4,1,13,3,24,2,14,1,12,21,3,28,30,2,22,13,12,14,9,13,14,34,20,7,11,6,48,7,17,27,32,11,13,20,1,3,46,9,5,31,4,7,6,25,2,25,6,16,9,5,9,33,42,8,8,19,7,6,1,10,2,4,24,8,10,16,12,7,7,13,7,3,16,4,19,12,9,38,11,6,2,39,11,29,0,5,10,4,15,5,11,3,7,24,24,11,10,44,14,18,2,4,8,14,1,2,10,3,15,7,11,18,39,2,22,23,19,19,4,22,9,4,12,16,26,4,38,2,26,4,16,10,183,16,9,3,6,9,7,21,21,8,16,6,0,25,8,15,9,2,9,12,16,20,2,82,16,19,9,12,12,32,8,22,41,20,12,17,6,7,8,7,12,11,18,16,11,7,17,13,8,10,14,11,6,6,10,11,12,9,5,0,6,13,21,4,15,16,29,12,9,9,5,10,16,5,28,4,12,6,2,4,20,10,11,2,3,6,7,15,8,23,41,13,8,29,17,20,2,25,30,3,7,7,2,0,18,11,12,10,23,12,16,15,8,11,7,35,7,1,10,18,11,12,7,10,9,8,9,6,2,1,11,6,5,8,1,13,9,5,20,3,14,7,104,40,3,11,21,14,11,8,9,3,9,11,9,4,8,9,1,24,13,5,15,11,13,4,7,3,19,7,7,8,1,21,21,11,3,9,11,1,5,13,4,9,7,2,9,16,30,10,8,5,14,1,6,12,24,12,6,10,11,10,20,7,2,4,8,9,4,8,1,3,2,4,1,3,11,9,6,3,16,5,2,1,5,2,5,7,11,13,0,1,8,10,4,22,6,5,4,3,13,12,40,4,1,4,19,4,6,14,9,7,1,12,13,2,19,2,9,1,18,1,4,6,10,3,13,52,13,4,4,5,5,7,9,3,11,2,24,3,5,6,5,6,10,5,1,7,10,4,64,2,21,5,2,7,7,2,16,20,2,2,7,7,4,7,5,12,6,26,5,0,14,7,8,1,12,7,2,1,3,7,3,8,5,8,2,2,2,11,7,8,9,6,2,5,11,6,8,14,4,10,5,7,1,25,2,4,8,5,3
generally,0,21,7,78,4,3,7,20,5,2,14,2,10,31,6,3,1,7,1,4,3,29,4,15,20,2,2,5,8,8,4,108,76,6,47,24,36,8,12,4,12,6,1,2,26,12,19,12,168,8,22,4,14,7,3,3,45,21,0,9,9,5,2,9,13,5,62,5,5,7,12,2,1,4,36,9,12,1,46,12,41,5,9,5,132,23,12,0,14,3,3,2,0,22,48,22,6,5,24,15,7,15,28,3,11,29,8,5,17,5,5,4,10,16,0,26,3,4,35,82,31,4,7,40,3,0,4,4,2,3,10,2,3,35,14,26,10,5,3,2,1,27,10,2,4,37,1,9,17,10,49,3,8,4,3,27,21,5,3,7,8,5,5,3,3,3,3,12,18,5,16,57,18,3,3,6,122,6,3,40,16,9,9,10,7,15,35,15,21,27,1,7,8,0,5,0,11,4,6,7,43,6,5,11,17,5,11,23,8,26,59,1,12,5,1,0,0,0,31,1,2,20,7,5,24,77,22,16,2,13,15,11,14,18,34,17,18,10,9,4,45,21,2,8,14,4,5,8,37,4,5,13,10,4,9,12,12,3,4,12,7,9,10,3,4,41,4,0,10,4,75,1,18,4,2,2,9,14,10,6,38,5,4,13,13,1,8,11,10,0,1,3,9,1,2,5,21,6,4,15,9,15,2,1,5,2,11,3,9,2,3,26,11,7,25,11,13,28,14,7,19,6,21,4,26,3,7,16,3,22,3,5,7,12,4,16,13,5,3,9,9,6,12,6,6,2,23,44,11,3,13,10,6,21,16,7,6,2,16,14,19,5,14,16,3,1,16,7,10,8,2,19,5,11,15,24,9,7,8,7,37,0,24,12,3,29,4,22,17,3,18,4,11,8,20,3,53,2,17,3,25,0,4,1,6,3,8,6,6,11,1,11,9,18,3,4,6,4,4,1,6,8,14,7,1,3,1,20,6,3,7,0,0,5,0,6,2,4,6,1,16,17,6,12,0,3,2,2,18,6,6,10,3,0,33,17,0,2,8,28,9,21,26,27,1,3,3,14,3,1,10,4,2,2,1,9,4,18,16,6,4,8,6,3,4,2,1,3,6,8,55,32,1,3,6,7,7,14,3,17,12,6,3,8,10,17,11,10,5,9,2,4,6,15,15,6,3,10,2,9,1,14,9,15,5,2,37,4,16,17,7,2,2,4,7,4,4,7,23,31,7,2,3,10,6,4,1,13,7,4,17,5,12,27,2,13,14,2,3,2,17,5,13,0,9,11,9,12,18,28,8,8,9,12,4,7,17,6,3,10,5,16,12,14,7,2,12,8,1,4,25,23,13,2,15,7,4,10,8,16,22,2,3,0,2,22,7,22,10,0,25,12,13,6,21,8,8,25,6,4,16,2,3,6,1,7,7,8,11,21,4,29,21,14,8,3,12,5,0,4,6,5,5,18,8,15,1,1,7,74,15,7,8,2,3,7,10,13,2,13,5,5,5,11,2,2,0,2,7,10,9,3,15,44,23,1,4,10,0,10,1,11,10,10,11,6,5,4,1,7,6,8,10,2,3,7,3,2,10,9,2,2,4,7,9,2,15,3,2,4,3,3,1,18,15,15,9,5,4,13,3,4,2,24,6,9,6,5,3,13,10,8,7,14,5,1,18,3,17,12,10,4,3,8,5,2,10,4,3,7,7,2,2,3,6,9,6,6,3,7,7,9,3,2,12,12,10,1,10,4,3,4,5,15,4,8,3,9,19,7,4,6,11,3,3,8,2,9,6,15,7,4,3,6,6,17,8,5,3,14,2,2,9,1,5,3,3,6,14,7,7,1,6,11,6,3,2,9,4,11,3,2,5,19,3,4,3,8,3,4,6,5,1,1,4,6,8,14,1,4,4,5,7,5,5,8,6,5,5,6,14,17,7,3,2,7,14,2,4,1,9,3,9,7,3,6,5,1,6,10,5,7,4,6,1,7,2,8,3,2,1,1,4,5,7,6,3,3,5,3,0,10,0,5,3,2,3,5,1,1,6,3,2,9,8,4,1,5,2,15,2,1,2,3,14,3,8,2,6,4,4,5,4,12,3,6,4,7,4,5,9,4,7,9,6,4,2,3,2,22,0,4,1,0,2,16,5,7,9,9,3,2,4,4,6,0,3,0,7,13,2,5,7,5,0,9,3,4,0,6,5,4,3,7,4,10,1,5,10,2,2,9,5,0,3,4,5,4,2,0,5,5,6,0,1,6,0,4,0,0
agriculture,4,7,8,104,0,7,9,20,1,6,2,10,12,66,6,4,1,7,1,2,5,35,3,15,21,7,8,4,0,3,2,168,146,18,50,26,11,16,61,7,12,5,1,8,17,10,16,10,144,12,19,7,33,26,8,1,33,61,0,25,9,2,4,28,24,4,74,10,9,16,45,0,2,0,120,15,20,3,43,11,123,2,5,7,190,10,37,1,26,1,5,3,3,15,52,25,17,16,39,79,8,36,18,4,34,29,11,5,21,6,12,0,17,12,2,32,1,2,46,85,34,11,27,100,14,2,10,4,2,1,23,13,9,48,13,78,0,7,5,5,2,37,18,7,4,64,4,27,23,14,47,3,9,15,39,45,27,4,9,27,25,14,14,2,7,8,7,21,28,8,14,66,14,4,8,17,108,5,7,59,29,7,20,22,7,38,38,11,17,25,1,1,51,0,2,4,14,5,17,21,54,3,2,8,21,9,17,33,5,17,64,4,13,17,1,1,4,8,12,6,10,21,12,12,25,66,27,26,12,41,13,23,37,13,39,19,47,29,61,3,30,29,12,2,9,20,6,8,69,8,12,48,11,9,12,8,3,1,8,32,0,11,6,3,8,207,21,7,11,18,94,11,25,1,5,1,20,38,11,7,62,5,35,16,13,14,13,10,5,1,3,0,3,2,3,5,26,9,6,16,13,20,7,2,15,2,36,10,20,7,11,32,29,20,19,23,19,60,17,10,18,7,11,26,9,4,45,22,1,20,0,7,2,10,5,6,15,14,17,16,6,11,12,4,11,12,26,28,37,8,14,11,4,49,22,10,1,2,22,22,20,21,12,20,10,0,19,8,2,7,5,45,22,13,14,14,5,11,10,8,31,2,45,21,1,46,7,26,13,1,6,9,9,3,25,7,39,2,25,18,12,4,7,2,6,14,12,4,23,26,3,12,23,29,0,0,1,3,2,2,10,14,17,5,4,5,8,8,0,9,7,10,0,7,5,0,0,1,4,4,26,21,11,13,3,0,8,4,39,12,11,5,12,3,28,3,3,4,11,18,4,11,36,17,26,4,26,16,18,2,26,2,2,3,5,24,4,7,15,3,13,18,0,1,7,1,15,3,0,1,38,18,1,2,23,7,6,17,5,3,20,8,21,3,1,33,105,15,6,3,12,3,4,8,25,20,2,9,1,5,6,7,4,13,4,3,21,12,12,29,3,5,1,9,12,11,3,10,27,20,5,6,0,172,36,2,2,27,8,7,6,4,6,22,36,7,63,9,12,1,16,1,25,2,15,10,14,9,24,34,8,9,9,2,6,0,27,6,2,19,50,14,22,4,8,2,8,6,9,21,7,15,8,9,70,42,7,18,13,6,11,9,5,1,4,9,15,6,19,9,19,26,9,3,17,6,12,3,5,1,16,1,9,5,10,3,4,3,10,38,0,27,26,14,10,2,29,6,2,23,22,3,0,19,6,46,14,4,8,81,17,3,3,5,7,18,11,14,4,4,3,3,0,0,2,1,0,7,4,13,22,4,6,4,12,20,12,4,0,9,1,23,7,5,5,1,2,8,2,2,4,25,14,3,6,7,2,0,9,1,2,3,3,8,15,17,11,3,0,5,1,8,2,26,9,4,0,4,3,20,6,3,2,6,2,12,9,8,4,3,4,30,17,6,8,4,10,10,15,22,17,3,12,3,8,6,12,23,11,11,7,4,15,10,0,14,20,21,10,29,28,18,0,14,28,37,18,10,1,13,9,6,9,4,3,14,29,8,24,4,18,2,13,16,13,13,6,3,4,18,5,8,4,6,5,16,7,10,17,1,6,5,1,8,3,2,11,5,9,5,26,1,1,10,6,2,10,7,3,6,1,6,3,59,10,0,3,6,1,13,13,3,11,2,10,6,3,14,4,10,0,3,0,4,16,0,7,3,6,10,1,4,1,9,14,7,11,3,0,2,3,4,2,7,6,6,9,2,4,17,40,13,6,4,10,3,0,3,7,1,0,3,12,4,33,9,11,5,2,6,1,8,1,4,1,0,3,3,8,0,16,0,1,5,0,0,0,6,2,15,12,19,1,6,3,2,0,22,4,7,3,5,4,7,6,2,0,2,6,2,15,2,2,3,0,0,10,2,1,20,5,4,4,6,28,10,8,28,12,0,4,4,2,7,9,0,1,2,14,1,3,8,4,0,5,1,13,2,2,1,1,0,13,7,1,4,2,6,7,6,5,8,6,0,1,10,12,6,1,0,9,20,5,0,0,17,4,0,10,1
settlement,10,10,9,141,12,3,3,19,5,4,31,12,5,62,3,4,10,12,2,1,7,28,1,14,25,8,4,8,1,17,6,213,111,6,44,32,57,24,17,5,2,6,1,3,29,11,25,17,332,17,42,7,10,29,4,5,48,28,1,26,27,6,5,16,10,0,44,2,34,18,7,6,2,0,46,15,3,4,58,13,41,0,23,6,256,10,15,0,50,5,7,6,0,52,52,10,25,5,38,11,13,27,35,14,9,18,6,3,20,5,6,8,2,8,0,28,6,1,46,114,22,7,2,45,6,3,1,6,2,5,6,3,2,51,14,28,18,4,3,7,2,37,39,4,3,47,4,19,16,7,52,2,7,8,4,6,16,3,9,2,13,6,3,4,9,4,2,18,16,11,22,45,18,0,0,16,165,3,13,15,20,11,2,20,6,15,30,19,69,78,0,3,9,1,2,2,14,5,6,7,13,0,3,27,15,5,4,27,29,35,51,2,17,4,0,0,1,0,24,2,7,18,2,19,24,90,21,15,6,16,10,10,10,19,31,15,40,11,8,4,54,37,3,1,18,3,11,11,45,0,14,10,16,5,5,15,15,3,2,23,4,11,32,15,4,32,3,10,14,6,121,4,52,7,9,0,12,3,22,4,38,4,0,18,6,3,2,3,20,0,5,10,8,5,7,12,42,6,6,16,28,41,3,11,10,0,37,5,5,0,3,2,29,6,42,13,14,46,18,8,55,8,13,1,44,5,4,29,4,30,2,9,11,8,7,33,20,9,5,11,12,8,10,9,8,13,42,53,13,10,7,16,12,36,16,6,1,2,20,30,12,9,5,25,9,0,22,8,0,6,4,9,7,8,6,10,9,4,5,9,53,2,30,14,2,144,0,19,27,0,41,1,6,30,41,15,69,4,25,8,17,0,8,1,5,5,7,9,15,14,3,14,6,27,7,10,24,9,7,1,10,8,14,10,2,2,4,12,10,24,9,7,2,18,3,6,3,56,4,6,19,20,8,4,4,7,7,8,29,8,11,6,5,2,86,6,0,9,4,28,16,8,32,7,4,0,23,42,15,1,10,5,3,1,0,6,3,9,18,5,4,12,6,8,7,10,12,0,6,3,61,34,1,2,5,15,5,36,10,5,12,11,1,2,15,5,5,10,3,7,3,4,5,7,16,24,4,11,8,6,3,14,2,9,4,4,31,4,23,28,9,4,2,9,20,8,15,5,32,27,5,9,2,0,7,18,3,12,32,6,10,6,5,49,11,6,24,2,7,11,27,3,35,6,16,12,9,7,60,50,10,6,10,1,8,19,0,11,3,13,3,18,12,6,6,7,10,9,5,7,22,34,9,6,18,5,0,2,85,27,32,1,7,12,20,20,9,26,11,3,27,38,21,8,39,5,17,7,14,5,8,1,2,17,9,8,2,13,14,40,6,26,20,18,10,6,9,5,3,15,4,1,3,19,20,25,4,5,6,214,17,9,12,3,5,13,21,6,5,22,4,20,50,68,24,18,34,49,16,9,21,6,36,37,118,7,9,8,2,7,5,19,20,9,19,9,12,6,8,18,29,5,9,27,9,12,10,12,13,14,16,13,8,8,11,7,12,4,3,1,3,11,8,21,28,11,8,7,15,5,10,6,6,6,3,23,7,1,2,9,7,27,12,2,15,5,5,2,75,10,24,14,6,2,16,3,20,12,4,7,9,4,4,5,4,10,7,15,8,18,15,8,7,6,32,14,11,4,13,1,4,19,2,10,6,21,10,3,60,13,23,5,17,3,15,9,10,10,10,12,13,9,5,4,8,10,12,9,9,10,12,8,13,7,3,3,7,8,21,12,3,9,15,10,0,8,10,27,12,9,14,7,12,3,21,4,2,12,1,6,15,4,4,3,6,9,6,35,7,3,5,0,5,10,4,17,9,43,5,14,27,27,9,4,5,7,6,20,2,0,13,3,6,3,6,14,6,9,16,26,5,3,8,5,6,3,23,20,15,13,17,3,6,13,16,15,12,7,18,4,2,28,1,3,16,14,11,2,4,6,10,8,3,10,1,6,15,6,7,16,1,12,10,20,12,15,3,6,2,6,11,28,7,8,8,4,10,26,19,2,9,5,11,9,6,2,6,3,5,18,3,8,7,2,3,26,15,7,15,9,0,5,1,1,6,4,8,9,18,7,32,15,8,1,5,4,24,3,2,9,3,4,3,3,4,8,1,6,10,6,9,4,5,1,8,4,10,1,35,0,1,3,2,2,0,2,0,6,0,0
depend,7,8,5,63,7,24,8,31,2,5,4,10,9,83,14,10,8,21,6,4,2,26,22,13,17,6,28,25,10,22,15,141,90,31,62,79,43,8,5,13,9,16,5,7,27,13,9,10,162,50,30,10,23,73,17,3,32,12,14,26,5,9,2,14,17,8,97,7,11,7,18,4,4,3,122,7,20,8,63,28,39,1,7,12,109,8,17,0,13,1,7,6,1,26,27,5,9,10,29,15,4,17,19,16,14,25,3,8,13,4,15,1,21,15,16,25,0,4,33,86,33,37,12,52,7,6,4,2,2,2,21,8,10,32,28,61,5,5,4,6,9,23,7,5,3,59,9,11,11,12,57,1,7,12,7,8,28,8,5,32,10,6,10,3,4,20,3,21,19,3,16,80,19,3,16,6,218,7,13,36,17,13,11,21,1,22,31,22,22,25,5,3,11,6,1,2,14,10,6,14,14,9,7,11,20,11,4,34,9,15,69,9,13,14,10,6,2,5,12,3,9,8,2,16,31,61,26,21,13,6,9,10,12,12,34,14,27,12,16,7,37,26,4,8,9,2,3,38,30,12,7,9,12,2,11,7,2,1,0,17,8,31,3,0,5,23,9,25,16,2,90,5,15,6,4,6,24,8,5,1,66,5,3,15,8,2,11,15,11,3,1,4,8,8,1,7,11,4,2,23,28,14,0,0,9,4,20,4,12,5,2,18,23,13,17,17,14,26,12,7,26,2,30,11,51,1,17,36,1,21,8,7,4,2,8,1,14,3,7,6,9,9,14,2,3,5,24,38,10,14,7,16,3,34,8,7,7,11,12,22,12,11,12,10,9,4,17,12,17,32,3,37,11,24,5,33,5,3,8,3,40,5,34,13,15,21,3,14,18,4,18,9,3,4,15,10,21,3,16,3,13,11,3,7,6,5,12,1,28,16,3,6,3,9,3,14,9,5,4,12,1,12,16,5,4,4,0,9,3,13,6,0,2,8,5,1,3,15,15,5,8,16,5,14,10,3,23,9,27,8,34,4,13,3,34,7,8,2,10,11,11,18,21,27,9,14,31,9,30,0,17,7,2,8,5,11,2,13,13,4,7,7,2,6,19,12,9,7,6,5,52,27,3,4,13,3,2,5,10,5,7,10,8,7,2,10,12,10,6,4,1,4,5,6,4,10,9,14,0,7,3,16,4,16,7,4,17,2,7,14,14,8,5,7,9,11,8,8,23,8,4,1,4,18,17,5,2,20,5,4,19,1,1,25,8,7,28,4,2,5,10,7,10,7,9,9,9,4,18,28,6,5,7,6,11,0,3,1,2,14,4,8,10,18,2,2,8,8,1,11,19,15,16,5,25,0,2,5,14,14,9,1,0,0,1,6,5,10,8,2,23,9,11,2,31,3,11,7,5,0,5,5,4,13,5,11,1,5,8,9,5,9,38,15,8,2,4,10,5,16,12,5,15,5,1,12,9,1,4,76,10,6,4,2,1,12,18,14,2,4,2,6,2,6,0,0,1,1,2,4,12,13,12,21,7,5,1,7,3,3,9,17,7,5,2,7,12,2,2,7,8,17,5,5,3,9,9,0,10,2,15,2,1,9,4,6,6,7,1,2,12,3,3,14,7,14,13,2,3,14,9,5,2,24,5,4,5,6,2,13,11,9,7,2,1,2,16,7,18,12,11,7,2,10,14,3,8,10,11,2,9,3,2,2,2,6,7,5,4,6,4,22,3,2,11,13,12,3,9,4,1,4,5,7,10,10,10,4,5,3,5,2,9,5,5,6,1,4,7,10,3,10,4,5,0,14,3,4,1,11,3,3,4,3,9,2,10,6,14,7,9,0,2,7,4,1,2,6,1,12,0,3,1,7,11,1,3,3,12,1,6,4,11,8,4,10,8,18,3,4,3,6,4,11,5,6,9,3,2,8,8,20,4,5,4,3,5,4,1,2,1,1,5,6,6,10,13,2,9,4,3,3,2,7,3,5,3,1,5,7,0,3,3,2,7,3,8,2,3,2,9,16,2,3,2,3,2,2,4,9,0,1,7,4,5,1,0,5,0,17,1,5,2,3,11,1,8,5,4,0,2,2,5,5,1,6,4,5,0,3,7,2,4,2,0,1,4,3,1,10,5,10,0,2,6,7,7,4,9,1,2,4,4,4,2,1,5,3,8,6,2,5,6,3,1,6,2,2,4,2,5,0,4,10,6,1,9,3,11,3,1,6,6,4,1,1,5,15,4,3,7,7,2,3,4,1,13,3,5,11
region,3,5,1,35,2,9,5,12,0,2,14,1,10,44,5,4,2,11,4,10,3,12,14,10,13,5,6,8,6,9,8,81,64,5,21,32,23,2,5,4,2,13,9,3,12,7,6,10,126,37,22,5,11,27,10,3,15,6,10,10,10,9,1,8,16,6,49,0,3,17,2,2,2,3,46,12,8,0,27,11,20,0,7,7,80,11,7,0,11,1,1,1,1,11,19,4,8,5,20,9,3,17,10,3,13,8,1,10,13,2,8,9,2,13,0,18,2,0,14,52,19,9,2,35,5,1,1,1,1,0,24,0,7,27,7,38,3,4,8,1,0,32,3,6,4,39,16,22,11,5,12,1,2,5,4,8,22,4,4,20,4,10,5,2,0,11,5,18,20,3,18,46,15,11,0,2,46,0,2,16,11,5,2,8,4,12,16,13,20,23,3,5,8,0,2,3,3,5,3,4,14,0,1,13,11,6,7,9,0,20,30,2,17,5,1,4,0,1,5,4,0,12,2,12,6,33,33,5,8,0,11,10,1,12,19,3,29,6,13,3,28,33,3,2,12,2,0,11,13,1,3,12,8,2,6,4,4,1,1,5,0,12,3,1,2,28,0,6,5,4,40,4,4,2,3,1,13,1,2,1,40,4,2,5,9,7,1,14,4,1,1,2,1,0,1,2,23,3,1,7,12,10,0,2,5,5,16,4,7,7,5,16,11,6,14,3,6,17,2,3,17,6,15,1,28,6,6,16,4,16,0,5,3,0,2,2,11,6,0,2,6,11,10,1,7,15,18,39,7,2,9,2,3,39,14,0,2,2,7,19,2,7,20,13,6,2,14,5,4,6,2,19,4,2,5,5,2,2,5,6,20,3,19,7,12,51,2,11,15,1,7,3,4,2,13,8,14,0,6,6,11,4,7,6,2,5,5,1,12,14,8,14,3,12,1,5,3,10,3,6,1,3,9,4,2,2,8,7,3,13,4,0,0,8,4,3,4,1,8,1,10,7,2,12,17,23,6,7,20,0,15,2,5,3,43,8,0,2,2,9,4,4,12,20,5,2,7,17,14,2,10,4,1,6,2,13,1,2,8,7,13,2,3,2,2,2,7,3,4,2,9,14,1,2,5,6,4,5,6,3,9,4,1,0,1,5,12,2,0,5,0,2,10,4,6,3,1,1,0,1,3,9,0,10,0,0,19,0,1,10,1,0,0,5,7,2,6,6,30,13,0,1,3,5,6,4,5,2,10,4,1,1,1,17,2,2,14,0,0,0,2,5,12,2,2,7,5,3,7,13,1,1,1,1,0,0,0,2,5,17,4,3,4,6,0,0,6,4,2,5,5,22,4,6,21,13,1,3,28,4,8,0,3,2,2,4,0,2,3,7,14,9,7,2,2,3,7,0,2,1,5,1,1,6,2,0,4,2,6,16,11,4,12,12,2,3,6,4,1,3,1,5,0,3,4,6,2,3,2,76,10,6,8,1,1,6,15,7,2,9,2,14,2,16,2,5,1,6,10,4,7,3,12,5,9,6,2,1,2,7,7,8,8,7,3,2,2,1,5,17,4,3,4,23,5,4,6,4,2,7,13,1,1,7,2,3,10,0,0,0,1,3,5,3,4,8,7,5,1,1,3,1,4,3,3,18,2,1,1,9,0,3,5,1,2,0,2,2,37,11,15,3,1,2,8,1,4,13,2,5,1,0,0,0,0,10,7,8,2,2,2,7,2,0,13,7,7,4,6,19,4,1,3,8,1,2,0,2,11,9,2,0,3,0,3,3,6,3,1,4,2,2,2,2,3,8,2,5,2,1,1,7,6,0,0,2,3,2,9,2,2,14,2,2,2,1,3,2,0,3,0,0,3,1,9,4,2,3,0,2,3,4,3,1,2,2,2,7,3,6,0,0,0,2,7,2,5,9,1,7,12,4,5,1,5,1,2,2,1,0,4,2,0,2,0,5,20,4,7,8,4,2,0,2,5,5,3,0,3,2,0,0,1,0,2,3,0,2,7,0,12,25,0,4,4,1,4,0,1,5,1,1,0,1,1,1,7,3,2,5,0,1,0,1,1,0,4,3,4,2,4,5,0,5,1,3,15,2,3,1,4,1,1,4,1,2,2,1,2,4,0,4,0,0,7,1,2,0,2,1,1,4,0,2,4,0,3,8,3,1,3,10,3,0,0,2,5,0,3,8,3,1,6,6,1,5,0,1,10,1,2,3,5,2,3,0,2,6,6,0,8,5,1,3,0,2,2,0,3,9
living,0,6,0,26,5,10,2,0,1,6,5,6,10,33,1,3,6,3,6,5,3,9,7,9,15,4,5,7,4,8,2,40,64,4,27,26,17,5,34,2,9,12,0,5,12,4,8,5,34,17,15,3,12,31,21,0,17,4,7,7,1,4,2,3,12,2,63,25,9,3,15,1,0,0,65,8,13,4,17,15,69,16,2,5,50,4,6,1,4,0,6,4,3,4,7,8,11,7,10,11,6,6,11,11,12,16,8,4,3,2,14,2,20,9,15,15,0,4,12,66,27,25,15,40,7,2,2,4,0,3,12,2,18,22,8,30,3,1,2,9,3,24,6,1,1,27,4,9,4,8,15,5,5,6,5,6,29,0,2,11,61,1,5,1,8,3,1,12,18,4,5,49,7,3,3,2,43,2,1,13,6,4,8,9,0,14,23,7,11,6,3,3,11,3,2,1,12,3,6,2,14,8,6,8,8,3,1,17,3,6,28,9,7,21,1,9,5,0,9,1,1,20,2,5,11,31,5,5,2,10,5,4,15,7,29,13,10,5,18,2,12,21,3,5,11,5,4,25,17,1,3,12,8,0,2,7,0,5,0,13,2,10,3,0,6,3,7,7,4,7,30,3,3,0,2,2,13,5,3,1,36,0,13,13,10,4,4,1,1,1,6,1,2,1,4,2,7,3,2,12,11,9,1,2,7,5,10,4,4,4,1,2,12,8,16,2,12,18,8,7,23,3,13,6,8,0,5,17,4,16,0,9,1,1,3,3,10,2,2,6,1,7,15,2,4,0,8,10,3,22,3,1,1,15,9,0,0,0,2,12,20,11,5,11,1,2,5,2,3,8,1,5,6,14,3,10,2,4,2,1,11,1,19,10,10,17,2,7,4,6,2,6,5,1,10,3,14,1,9,4,10,2,2,0,0,1,4,0,13,2,4,3,2,5,1,1,0,1,1,2,4,3,6,4,1,0,2,4,1,9,7,1,0,1,4,2,0,1,2,5,5,12,3,4,2,5,15,2,16,5,9,2,1,3,20,0,1,3,7,5,7,24,17,16,3,0,14,2,1,4,24,7,1,4,2,25,4,1,12,3,5,5,3,3,1,0,3,4,3,0,18,12,1,1,7,1,1,6,0,5,3,4,4,6,2,2,15,2,4,1,0,3,1,0,1,5,1,1,0,3,2,3,1,4,0,2,6,3,5,10,10,5,0,6,6,0,2,4,19,6,3,2,3,15,11,0,2,15,4,3,0,0,3,18,3,1,2,1,4,2,6,0,7,6,2,7,7,3,7,9,6,1,2,3,4,0,20,4,4,7,2,2,4,10,0,1,3,3,2,2,6,9,6,3,31,3,73,24,2,10,3,0,3,0,3,6,3,2,6,1,11,2,3,9,5,4,5,9,4,1,7,1,3,4,3,0,1,4,12,7,6,9,14,5,0,5,13,2,2,0,7,4,3,5,4,2,7,0,5,22,5,3,1,0,5,3,12,3,0,4,1,3,0,1,1,0,1,2,2,3,3,4,1,5,4,2,0,0,3,1,4,9,2,4,1,1,1,7,0,2,5,10,1,4,2,2,2,0,3,3,5,2,0,0,0,5,5,0,1,0,2,6,1,7,9,4,4,1,1,1,2,9,3,11,0,8,3,2,1,4,0,3,1,7,0,4,0,3,5,8,9,1,2,10,2,0,7,5,3,3,1,1,1,2,2,4,1,5,0,13,21,4,0,7,4,21,10,5,9,2,5,3,1,12,6,3,1,8,14,2,0,2,3,7,6,7,4,0,4,5,1,6,0,2,1,2,4,0,0,1,7,4,4,1,8,1,2,2,11,0,4,1,1,4,0,0,1,3,1,0,0,0,0,1,1,1,1,2,0,1,2,0,4,0,3,1,0,9,2,1,0,0,1,1,3,2,2,0,0,2,3,2,2,1,3,0,5,0,1,1,1,1,12,1,2,5,1,0,1,5,0,1,2,0,3,4,2,1,0,2,1,1,2,0,5,2,0,5,0,0,2,2,0,1,0,0,2,5,3,6,0,0,3,1,1,0,0,2,3,9,3,0,1,2,5,0,1,0,5,2,0,3,0,3,1,0,0,4,2,2,0,0,2,2,3,2,3,2,0,10,1,9,2,0,2,0,4,1,10,0,0,1,3,3,2,0,0,2,0,0,2,0,4,6,2,3,0,2,0,2,1,0,24,6,1,1,1,1,3,1,3,0,0,3,1,2,3,11,1,0,3,1,0,1,5,13,8,0,2,2
person,5,31,18,173,10,9,5,27,5,5,35,12,18,75,7,13,12,22,4,10,6,67,12,37,31,20,17,13,19,21,27,238,195,23,67,32,65,13,17,5,6,16,14,3,43,20,32,16,590,17,48,5,7,24,21,7,79,36,4,20,18,6,0,11,25,8,112,7,3,7,13,10,7,11,85,14,25,9,105,29,47,1,21,8,307,31,16,0,48,3,12,10,1,37,42,15,19,9,31,21,9,32,45,12,17,43,6,4,14,2,27,6,10,15,1,38,8,6,136,202,57,28,14,98,10,7,2,7,4,3,26,7,14,85,25,57,19,19,3,11,0,55,35,7,2,114,14,24,18,16,68,1,48,11,3,25,40,4,19,13,12,11,25,4,1,12,11,23,38,12,30,126,20,6,12,22,261,3,18,50,30,10,4,31,4,21,29,31,43,60,7,12,3,1,2,6,15,7,3,16,26,10,0,14,27,6,7,41,25,18,85,9,47,13,1,6,0,2,25,4,5,30,5,16,53,234,43,31,6,7,12,27,15,26,51,16,39,8,6,13,117,40,18,8,21,15,4,27,79,3,17,14,19,9,8,24,13,2,10,73,9,31,21,14,7,57,5,6,22,7,159,7,35,9,16,1,38,6,13,3,106,20,2,35,6,3,4,30,20,4,14,6,15,7,10,9,64,7,9,43,35,50,3,7,21,6,22,3,4,2,9,26,15,7,55,15,19,49,18,9,173,12,54,4,114,31,9,42,8,50,7,14,16,7,9,14,24,10,1,13,14,32,19,15,11,8,69,69,19,19,15,21,9,51,45,8,11,10,9,30,36,9,4,30,17,3,45,8,13,20,1,29,5,14,15,63,9,5,24,6,127,5,54,15,10,61,31,37,37,7,53,5,20,10,33,14,90,9,43,5,33,2,5,1,9,7,13,3,20,19,5,18,1,27,21,14,3,8,11,3,3,24,27,24,4,5,2,17,10,26,4,2,4,21,4,4,0,8,15,7,33,52,7,12,1,3,5,7,37,14,24,6,6,3,47,13,4,41,8,35,24,35,40,30,15,0,16,28,8,3,36,9,2,11,5,30,7,18,19,11,14,9,3,5,6,18,9,5,8,13,105,62,3,4,15,8,2,26,10,16,14,11,2,1,6,15,7,18,11,14,6,10,15,9,13,25,9,14,7,16,3,131,14,36,17,24,51,11,43,42,11,11,11,10,18,8,13,10,74,23,6,6,4,5,7,9,1,29,34,10,73,16,27,86,7,16,37,6,5,15,33,2,46,4,11,11,26,15,43,55,17,18,8,10,11,3,7,14,10,18,3,28,6,19,4,4,8,12,10,8,28,42,19,5,38,8,4,6,67,27,30,3,9,2,14,33,3,36,20,4,49,41,23,10,78,9,24,4,9,7,13,2,2,44,4,7,4,17,42,30,13,34,57,35,21,2,12,7,7,24,28,10,22,31,8,35,9,7,14,390,17,6,13,2,13,21,46,22,14,25,3,10,21,17,10,3,4,10,13,23,20,8,88,83,112,10,2,7,9,9,1,21,25,10,13,15,24,1,6,17,19,16,22,6,16,5,13,10,11,34,8,10,11,18,4,12,19,4,11,5,8,15,12,25,36,24,8,5,10,8,19,11,15,48,2,6,16,2,8,17,13,17,4,7,7,16,26,10,67,22,27,13,5,12,12,7,17,6,8,25,14,1,4,15,12,10,14,8,4,22,14,13,2,2,22,26,9,15,4,10,7,8,12,1,9,30,10,3,19,13,6,11,16,7,19,7,9,23,8,27,14,26,3,7,15,25,6,13,3,34,3,7,16,9,1,3,4,15,23,19,3,2,19,9,10,5,8,6,7,21,7,6,4,36,2,6,2,10,6,3,20,9,7,11,9,11,15,35,13,14,13,7,9,7,11,15,23,4,6,40,30,52,16,4,0,12,17,14,30,2,6,15,18,4,16,19,10,1,17,25,2,6,3,6,7,6,6,13,12,0,8,9,5,3,15,2,7,3,11,4,11,13,0,3,31,19,6,9,7,10,5,5,1,7,33,4,5,5,8,26,3,1,16,16,31,12,9,7,4,6,8,4,9,10,5,10,2,18,8,10,4,4,9,5,2,4,9,9,12,4,3,18,4,2,1,17,12,16,31,4,8,6,10,3,5,7,8,4,29,2,1,9,8,9,5,62,6,28,6,5,7,8,9,8,10,4,3,7,5,13,9,8,13,3,15,8,11,7,16,2,11,8,3,0,0,11,5,7,1,2
maintenance,1,4,6,53,8,3,2,16,2,2,21,3,6,31,9,7,7,4,2,2,1,13,4,10,6,3,10,6,1,2,5,72,51,5,23,30,46,3,4,3,3,12,0,1,9,10,11,6,112,8,15,0,9,10,2,7,26,14,0,10,13,6,3,5,7,2,38,1,6,1,12,8,2,6,49,3,5,3,31,0,19,1,6,4,98,4,13,0,8,2,10,3,0,8,24,10,7,1,22,3,29,12,11,2,14,11,5,3,11,2,8,3,12,5,3,13,0,1,28,40,15,5,6,37,7,5,5,0,3,1,8,3,3,18,11,24,2,1,7,5,0,17,7,2,2,27,3,7,16,19,38,0,6,3,4,11,13,2,6,7,14,1,6,1,8,1,0,7,9,2,11,30,5,2,1,6,90,6,6,18,9,10,5,11,5,4,17,10,15,17,0,3,3,0,0,2,5,4,2,6,9,1,0,4,26,5,6,20,3,17,31,4,9,6,1,0,1,2,9,2,1,6,1,9,28,54,7,7,4,5,3,6,8,10,12,7,11,4,5,1,33,17,3,3,3,3,3,11,27,2,5,3,7,3,10,3,3,1,1,12,4,24,13,1,2,30,8,7,7,4,75,6,10,6,5,0,6,14,2,0,29,3,3,5,6,0,3,8,8,2,3,1,2,6,1,6,12,3,2,9,10,15,2,0,2,2,12,1,3,2,3,5,14,6,12,12,3,19,2,11,20,4,11,5,36,2,3,6,3,11,1,5,4,3,4,10,10,8,1,7,2,1,4,4,4,3,19,20,8,2,4,9,1,18,9,4,2,1,3,12,6,6,3,10,3,0,9,6,2,8,2,14,5,3,4,32,7,1,8,5,45,3,22,7,0,11,4,9,3,3,7,1,5,5,10,2,21,2,22,5,14,2,5,0,3,2,4,4,1,5,2,1,1,8,5,4,0,3,2,0,5,11,12,4,0,2,2,4,6,5,6,2,0,3,2,3,0,3,16,0,8,22,3,2,0,2,8,3,10,4,17,3,2,4,16,4,2,3,6,14,9,15,10,10,5,7,9,1,5,0,9,2,3,1,3,5,1,7,7,2,2,3,2,2,4,4,3,2,4,9,49,14,0,3,6,2,2,11,6,4,1,4,4,1,4,0,0,4,2,3,1,4,3,0,6,6,4,10,3,5,8,7,2,17,2,1,13,1,9,7,4,3,2,2,2,4,12,2,14,8,1,2,1,0,3,2,3,10,8,2,17,1,5,18,6,3,15,2,3,4,7,3,10,6,6,10,6,1,25,22,5,8,13,3,9,0,6,2,2,15,0,9,9,9,6,3,2,2,1,6,15,10,6,3,6,3,2,8,25,5,10,4,4,1,2,7,2,7,5,2,9,18,1,7,24,12,7,2,9,5,6,0,4,8,3,4,2,1,10,15,3,8,8,6,3,0,4,2,4,6,3,2,2,10,8,19,1,3,6,66,15,1,4,2,1,6,23,5,0,5,4,2,13,5,3,1,1,4,11,8,13,12,13,7,9,4,4,2,13,3,19,13,4,5,5,11,8,10,3,5,3,5,4,5,4,5,0,1,5,11,5,7,1,1,3,5,6,6,1,1,3,4,1,19,12,17,7,5,0,6,8,0,1,17,3,7,1,0,1,11,7,6,1,6,1,11,25,5,12,4,3,5,9,6,15,3,5,6,2,4,7,5,3,2,2,7,7,15,6,3,2,7,1,3,10,4,8,4,3,6,10,1,6,9,1,6,0,3,10,6,1,4,8,2,3,4,3,0,2,11,4,4,2,4,3,5,9,2,3,3,5,2,8,3,2,2,3,1,4,1,1,6,3,3,5,5,2,5,3,5,2,2,4,11,2,0,3,6,0,2,2,1,7,3,2,3,5,10,6,5,7,0,5,5,0,6,1,1,3,6,7,15,1,2,4,5,2,0,4,2,2,1,1,2,1,4,0,5,6,5,7,1,2,0,2,2,3,0,7,4,2,5,4,7,3,1,4,2,6,4,0,4,3,3,4,2,7,2,3,0,1,2,10,1,5,0,4,1,3,12,3,1,3,3,1,0,1,4,0,0,1,2,3,2,2,6,0,4,3,0,5,0,5,3,5,0,4,2,2,6,3,4,5,3,3,2,7,20,17,1,2,1,4,7,5,1,8,3,3,5,1,1,5,2,2,5,1,3,3,3,3,0,3,4,1,1,3,2,1,5,1,2,0,0,2,4,1,2,4,0,4,3,5,1,1,1,1,4,3,1
involve,9,22,14,169,14,6,4,25,6,3,24,9,14,71,6,18,11,9,9,9,5,42,11,24,29,8,16,10,7,20,15,189,144,8,55,90,65,6,8,5,9,19,4,2,47,23,35,20,342,26,50,8,23,32,12,16,72,32,3,21,23,9,9,16,20,10,104,16,12,17,31,6,9,1,94,22,10,10,88,19,72,1,18,13,278,33,13,1,39,1,5,13,3,38,76,15,23,7,35,24,25,24,45,15,13,25,6,4,24,4,20,7,13,23,1,31,6,4,60,222,44,23,13,94,7,5,6,2,4,5,12,7,10,51,43,51,12,6,9,8,3,47,40,7,4,71,7,18,15,16,78,4,29,8,3,41,26,6,15,12,38,2,18,4,11,9,8,27,40,11,22,115,26,3,6,23,214,5,22,38,23,14,10,10,8,19,37,36,86,74,3,9,14,0,1,5,27,4,13,24,41,4,8,13,29,14,8,40,9,48,89,3,25,13,1,4,1,3,14,7,3,10,5,12,63,121,29,39,16,34,15,29,20,23,33,13,36,21,14,8,95,43,10,10,17,8,8,22,48,6,23,28,28,11,17,24,14,2,6,22,20,31,39,5,5,56,10,7,25,9,166,2,24,9,6,0,21,27,11,4,52,13,5,24,11,4,11,15,16,3,4,5,13,8,4,13,38,10,7,28,23,49,9,7,25,3,24,8,11,3,2,27,32,7,48,19,18,54,17,13,71,14,27,4,68,21,9,28,5,30,3,16,11,15,11,17,29,10,5,17,16,5,14,16,6,8,48,57,19,17,14,13,5,32,31,16,2,6,20,31,24,11,11,25,5,1,57,9,2,13,7,22,16,13,10,45,11,5,16,7,79,3,60,19,3,35,17,25,19,8,29,4,12,14,44,13,89,10,31,10,25,2,6,5,7,8,9,3,38,8,5,12,6,19,16,15,6,7,1,1,8,10,18,19,3,8,6,20,12,26,3,5,3,17,6,4,1,14,9,3,17,32,14,21,5,3,10,16,42,14,23,5,2,10,90,13,0,18,7,31,16,18,27,21,3,6,20,18,18,3,39,7,9,1,1,18,4,10,22,3,17,16,4,6,8,21,16,9,6,5,109,42,1,11,12,5,6,15,11,12,12,7,3,2,7,33,4,11,9,7,8,9,5,6,14,24,7,15,5,16,5,42,5,24,6,6,28,7,19,40,11,8,3,20,22,8,13,8,66,25,5,6,13,4,11,20,18,24,29,10,45,6,9,51,9,12,34,4,18,7,37,10,25,3,20,30,16,13,41,40,12,15,16,21,8,19,8,12,10,23,7,14,22,16,20,9,8,10,5,6,36,41,8,8,49,16,8,4,48,14,29,3,9,2,7,38,9,37,8,3,37,25,13,13,52,11,20,5,15,3,14,1,7,39,5,8,11,20,12,38,9,28,34,23,4,2,17,4,7,12,15,7,13,27,6,27,9,2,10,207,20,9,20,5,13,8,42,26,8,17,12,9,13,34,6,7,5,15,15,19,21,9,73,60,30,5,4,4,8,7,8,40,20,15,15,16,25,4,3,12,19,11,11,20,12,9,11,5,9,11,8,8,8,13,13,3,18,5,6,8,9,6,10,33,26,17,9,15,3,9,7,9,12,25,7,8,13,6,5,14,11,14,4,12,6,5,26,8,53,12,12,4,6,18,24,3,17,15,9,8,22,4,12,10,6,25,8,15,5,4,4,14,4,4,20,28,9,8,14,21,10,2,3,30,6,1,19,5,18,18,9,0,12,8,12,5,12,22,7,24,11,10,3,5,18,27,4,4,6,3,8,4,13,7,10,8,16,10,17,12,9,7,4,7,11,10,7,9,5,15,8,3,12,25,7,4,7,9,6,4,8,5,21,6,10,10,12,28,17,6,7,9,11,21,22,33,10,9,9,19,23,33,12,6,7,7,12,14,17,1,11,3,12,4,5,12,9,7,18,22,13,3,17,23,10,7,6,13,18,7,3,3,5,9,10,5,8,6,11,13,6,11,0,0,15,10,6,3,6,4,8,7,5,19,12,4,11,14,8,27,8,9,12,8,12,2,7,4,4,8,8,8,8,10,6,12,2,11,8,5,10,5,6,6,5,3,14,8,7,17,8,12,7,1,5,19,30,25,27,3,4,5,2,9,4,6,11,10,18,7,2,8,3,8,6,15,3,4,3,10,3,5,7,8,8,3,3,11,11,7,11,5,4,3,7,4,8,4,16,7,2,6,6,3,2,2,7,12,7,2
credit,0,5,4,90,3,9,4,17,3,3,0,1,9,41,0,4,6,10,8,2,7,53,15,20,15,24,7,6,6,9,0,173,138,15,40,39,7,22,39,3,12,3,5,11,22,16,37,19,177,17,27,4,18,27,26,1,32,16,7,15,6,4,9,0,12,5,72,7,5,7,66,2,10,1,72,15,23,8,67,17,79,0,11,12,193,36,21,4,38,6,9,3,19,15,49,25,15,13,40,35,7,22,30,12,7,21,13,9,17,13,17,5,21,31,15,28,2,5,41,147,16,38,88,105,10,1,1,1,8,4,9,7,5,52,14,41,0,8,1,13,1,24,36,3,3,57,1,10,19,8,48,9,29,15,11,44,17,5,2,33,23,2,17,7,18,14,8,9,40,21,16,88,17,3,8,15,109,5,15,51,8,10,13,17,3,31,23,23,16,48,3,10,13,5,3,2,26,15,15,19,67,18,20,7,10,11,14,84,6,34,68,6,25,14,7,15,9,12,9,1,15,11,3,4,30,59,20,29,8,50,13,14,40,39,44,29,31,22,18,3,50,27,6,1,13,13,6,32,46,10,10,44,22,19,25,20,8,5,8,10,6,14,9,0,11,35,10,10,5,7,99,32,62,3,4,0,23,27,3,4,59,2,8,6,19,9,16,19,16,4,3,2,27,11,12,7,16,1,3,20,16,28,6,5,22,3,30,2,6,5,8,18,52,22,69,24,13,41,22,6,26,4,28,7,18,0,9,15,2,24,2,13,6,0,8,19,8,2,23,22,7,5,17,3,7,1,30,18,32,29,7,8,3,34,17,8,4,4,13,43,25,10,10,9,9,3,26,5,11,8,5,26,13,19,3,21,1,2,11,6,36,4,44,8,4,37,1,18,26,1,2,5,3,2,17,10,51,4,22,4,11,2,4,0,5,7,12,1,54,13,0,1,21,8,0,9,9,3,2,0,10,10,12,3,9,4,3,18,5,11,48,7,3,10,4,2,2,4,1,4,5,8,5,23,0,1,4,8,26,18,44,5,3,8,41,4,1,4,9,33,7,10,19,18,10,0,29,10,5,4,11,11,1,0,1,8,2,5,9,6,7,20,2,4,1,2,27,7,0,0,43,32,0,2,25,2,3,24,9,14,8,12,12,14,11,225,33,5,6,10,5,4,3,3,19,13,12,5,3,9,2,13,12,12,2,1,34,31,14,33,8,3,2,7,3,10,5,2,34,20,2,2,1,23,25,6,5,14,18,5,13,3,4,30,5,4,18,5,7,2,14,7,6,4,17,13,13,5,24,30,18,3,20,1,3,5,7,4,6,30,7,3,8,7,7,6,4,15,1,6,7,24,14,3,19,4,6,2,2,6,13,8,7,0,8,3,6,6,8,8,18,8,4,2,14,4,13,2,4,1,15,37,2,34,14,3,0,5,7,29,43,9,23,7,3,8,11,10,5,8,6,2,2,5,0,24,15,6,4,83,2,3,15,0,2,14,45,4,5,8,2,0,2,10,2,0,0,3,8,13,21,1,7,0,11,6,5,3,2,1,4,20,15,4,3,4,18,7,9,0,12,7,8,4,3,3,11,0,3,9,6,1,3,10,8,5,13,3,3,2,2,9,8,31,12,5,4,10,4,9,10,5,3,13,0,0,6,9,1,17,10,22,10,2,6,1,7,5,7,8,4,0,8,4,1,10,17,17,17,3,7,18,19,15,17,20,3,9,11,33,26,10,2,10,44,48,6,3,29,10,10,0,1,10,0,19,1,7,1,6,4,6,9,31,15,9,10,0,15,13,5,1,0,6,6,13,15,0,5,1,14,3,7,5,5,6,29,7,11,3,5,1,1,7,9,3,6,8,7,6,4,3,1,14,0,3,2,3,33,2,14,3,32,0,4,19,8,22,5,4,0,4,0,3,12,33,18,3,0,3,3,18,6,5,4,7,8,35,3,5,0,4,2,0,11,10,1,1,4,4,3,3,29,83,21,9,0,3,6,13,0,6,1,3,2,4,5,2,2,4,2,3,28,1,2,0,0,3,10,7,12,1,1,6,5,1,0,27,2,8,18,73,6,12,2,4,6,2,8,6,7,6,7,2,2,2,1,0,2,33,1,5,6,6,3,6,17,6,1,7,4,4,12,4,19,30,50,15,61,1,2,3,4,14,1,6,5,2,26,7,3,3,6,2,10,8,3,1,4,4,4,11,11,7,3,0,2,11,12,1,4,7,2,29,2,4,16,28,0,4,0,10,3,1,7,9,7,7,2,2
management,2,10,4,54,3,3,3,5,2,0,3,3,3,20,1,3,1,11,4,4,3,19,2,6,6,7,2,6,3,5,0,54,29,6,25,14,17,4,7,3,2,2,4,5,8,8,13,13,55,5,12,7,5,10,2,1,22,19,0,9,13,0,3,9,12,0,33,1,2,7,8,1,2,3,34,4,4,3,20,11,33,6,10,3,117,12,10,2,11,2,5,1,4,5,17,7,4,2,16,10,7,10,16,3,12,14,2,3,1,2,5,3,21,13,3,17,0,2,30,36,6,4,6,26,1,0,1,2,3,1,5,3,3,30,10,26,4,5,3,3,1,14,12,2,1,11,4,5,9,12,12,2,2,9,1,22,13,2,0,12,11,1,4,2,3,5,1,7,12,0,4,36,5,1,1,2,58,3,4,35,5,6,15,4,1,14,10,8,7,14,1,2,0,0,5,3,11,2,8,5,23,4,3,4,9,15,6,24,2,21,32,3,9,2,0,3,1,3,11,2,2,10,1,6,17,30,8,12,0,2,4,6,9,25,15,8,9,8,14,2,19,13,3,5,3,0,3,16,22,6,7,9,8,5,4,3,3,2,3,5,3,5,6,1,7,29,3,2,7,2,30,4,10,2,1,3,9,5,2,2,17,6,5,5,1,1,3,4,3,1,2,1,13,4,2,4,11,1,2,5,9,12,2,1,3,3,6,4,6,1,4,9,10,5,14,7,5,14,3,5,11,4,9,5,14,2,15,11,1,15,1,2,4,6,1,5,8,0,1,8,9,7,2,3,1,6,19,17,10,2,4,8,0,5,9,1,4,4,6,12,11,15,7,7,3,1,13,1,6,11,1,5,6,5,5,14,6,3,4,3,8,0,15,6,4,29,0,8,8,5,2,1,4,3,7,8,25,6,17,3,6,0,0,0,3,9,4,2,7,6,1,2,3,11,0,3,2,1,0,2,4,4,9,3,1,1,2,14,4,7,8,3,2,4,2,3,0,1,6,7,3,4,3,1,1,0,1,2,15,2,5,2,3,2,17,3,0,0,2,3,5,6,8,15,5,1,7,3,7,0,11,0,3,2,0,6,1,8,8,0,2,4,6,0,4,3,6,4,0,2,28,10,1,1,3,4,3,6,3,2,4,4,0,4,7,20,4,7,1,2,2,1,0,4,10,5,0,4,0,4,2,8,1,12,3,2,7,3,4,13,6,4,0,3,5,1,1,3,14,16,3,0,6,5,2,0,1,4,6,2,7,3,2,12,1,4,6,2,4,2,6,1,11,0,3,8,9,2,10,12,3,4,8,1,4,0,0,4,4,7,1,9,3,3,5,2,3,4,0,1,10,16,4,2,56,0,5,16,2,5,4,0,2,0,1,7,2,13,4,3,10,10,6,1,6,2,6,2,0,1,5,2,2,5,3,4,4,1,1,18,4,12,7,9,6,3,7,9,2,2,4,0,0,15,1,14,4,1,6,28,1,0,1,5,2,2,9,2,1,7,3,0,0,4,1,0,0,2,4,2,3,4,1,2,2,1,1,1,1,5,7,12,5,4,5,7,3,2,1,5,5,3,7,1,2,1,6,0,3,2,1,1,3,1,4,0,3,2,1,2,1,4,0,5,8,17,6,3,0,7,2,3,2,17,5,0,1,3,0,9,4,2,6,3,0,1,3,8,5,1,6,1,4,3,0,3,4,5,6,0,3,1,0,3,2,10,2,3,1,4,1,3,0,1,7,8,2,9,8,3,4,2,8,3,3,5,7,1,24,9,1,2,2,5,4,5,3,0,2,8,2,8,6,4,6,3,4,2,1,2,3,4,3,1,4,2,1,0,8,2,0,0,0,2,2,0,2,2,1,4,0,0,2,13,4,3,2,5,4,2,7,0,5,1,1,4,2,6,2,6,1,5,1,1,2,2,4,4,4,3,8,9,0,1,3,3,2,2,3,1,1,2,11,4,0,6,1,3,1,9,7,1,2,5,2,2,1,4,0,0,1,0,0,1,10,2,1,6,0,2,0,1,1,3,1,0,3,3,1,3,5,1,0,9,3,1,0,5,1,5,13,4,2,4,7,1,0,1,4,0,5,3,5,1,1,2,1,0,0,4,4,1,0,2,2,0,3,2,2,7,2,1,3,0,0,4,13,6,19,2,0,1,2,4,2,2,1,0,5,3,9,0,4,1,1,0,6,2,0,0,1,2,3,4,2,2,0,4,7,0,0,2,1,3,1,1,4,7,3,0,2,2,7,2,1,2,4,3,0,0
indian,7,16,13,145,9,0,5,18,2,6,8,6,3,45,10,1,14,4,0,20,9,65,1,22,14,5,6,5,10,15,2,316,141,1,63,22,50,34,7,0,16,3,13,3,57,13,6,24,390,9,27,2,7,10,52,27,59,87,0,49,54,0,5,11,31,2,49,0,8,11,7,3,6,2,66,10,9,9,91,19,33,0,24,4,304,4,26,0,37,1,7,9,0,40,56,2,18,15,51,20,8,37,49,10,11,59,14,0,20,2,29,6,4,3,0,35,1,2,78,124,60,7,5,67,2,4,21,2,17,2,7,4,22,90,13,74,9,2,3,3,0,59,38,7,0,83,7,19,27,36,47,2,14,4,5,24,11,7,5,12,10,4,6,5,0,1,19,39,29,13,21,73,26,2,1,11,257,13,4,53,36,17,2,17,4,8,36,16,35,43,1,3,0,0,6,2,22,0,6,27,5,0,0,69,27,7,4,35,11,77,121,1,24,13,0,0,0,0,6,3,7,15,9,15,38,105,35,16,5,7,18,19,28,31,31,3,36,10,1,18,62,59,8,20,6,0,10,15,61,11,10,10,25,3,15,14,24,2,5,47,3,38,48,3,3,32,43,9,19,3,186,26,16,7,4,0,61,13,17,4,54,1,6,10,21,8,6,24,4,0,4,3,0,2,8,7,51,9,4,15,43,48,3,4,1,2,47,4,25,7,0,4,17,6,23,15,26,57,3,5,58,14,22,75,60,19,1,43,2,47,2,33,1,17,5,20,42,25,0,15,4,26,26,28,16,22,44,55,33,17,6,24,17,37,20,4,5,9,27,33,24,17,16,9,2,1,28,7,7,10,5,35,3,15,0,35,17,8,3,8,50,9,66,5,5,196,1,14,38,16,36,4,9,15,53,9,118,18,30,6,24,2,3,0,9,10,10,8,7,23,6,12,1,13,0,40,17,5,13,1,6,14,8,23,1,8,13,41,8,21,9,3,0,34,12,1,0,32,12,10,30,44,12,1,1,5,3,3,51,11,8,4,0,4,38,2,0,6,11,43,26,16,92,34,15,0,15,21,1,2,49,5,3,0,0,2,0,3,32,9,17,26,8,1,12,4,8,11,2,3,68,52,3,1,0,43,4,16,7,14,12,2,6,0,9,0,41,1,3,7,7,0,9,7,31,12,9,19,3,9,59,46,3,20,6,6,35,0,10,40,11,11,11,8,19,7,16,6,83,7,16,1,3,0,3,8,4,14,11,8,1,1,4,98,8,10,6,2,4,19,28,13,43,0,16,22,27,23,23,55,17,19,46,3,16,12,1,17,13,11,0,22,7,16,6,9,22,13,2,5,9,24,9,4,14,17,1,3,95,43,27,3,4,17,9,23,7,40,5,5,15,40,28,5,22,7,42,0,10,13,25,0,1,15,4,5,1,5,9,66,2,45,11,32,20,1,13,2,3,23,8,9,4,85,24,117,8,4,5,193,16,5,7,6,4,11,36,8,3,16,4,8,6,18,14,13,0,35,27,11,42,7,27,19,43,9,14,15,0,7,0,37,21,9,15,6,11,5,15,6,16,11,19,22,10,3,15,13,1,17,1,2,19,7,6,6,27,2,2,1,9,7,19,28,51,67,52,10,11,6,26,4,36,50,6,44,7,4,4,16,8,33,9,13,21,7,10,15,144,7,16,22,10,1,2,2,16,10,3,12,6,3,3,4,1,42,15,27,5,8,5,19,2,1,24,1,1,19,24,60,5,11,14,19,10,18,1,24,1,54,163,35,28,11,13,8,3,18,1,40,10,10,1,5,8,25,0,24,15,14,8,22,8,4,5,2,2,18,26,18,0,6,3,10,2,3,10,17,7,9,8,3,3,8,5,5,8,4,3,0,10,12,5,3,6,21,10,35,9,13,5,7,3,7,1,12,7,26,8,19,12,36,9,5,6,13,10,27,0,0,14,4,46,5,13,28,7,5,7,44,10,9,0,0,4,7,6,0,20,0,3,4,10,6,91,12,14,10,29,3,4,18,0,5,1,16,37,8,15,3,19,9,2,54,1,2,30,6,4,29,30,2,7,5,13,3,5,0,4,2,17,9,8,5,0,21,2,9,3,0,11,0,14,17,11,6,7,3,23,17,10,0,2,7,9,11,2,17,20,6,5,18,7,0,1,2,6,6,34,14,26,44,44,12,3,2,89,6,3,11,5,5,3,1,4,13,0,8,15,16,2,7,8,0,21,6,17,0,6,0,2,0,8,0,0,0,0,9,0,0
portion,4,19,8,116,8,3,5,66,3,5,18,6,8,56,4,12,8,7,3,3,5,34,3,14,15,6,11,13,7,16,10,148,109,4,55,34,47,15,7,4,18,5,5,2,34,17,18,7,338,11,49,0,18,15,6,12,64,30,0,13,12,4,3,14,25,1,93,9,10,13,6,4,3,1,48,12,16,5,62,18,46,0,12,5,198,30,16,2,24,0,4,4,2,30,65,7,21,1,30,20,15,19,42,7,10,48,3,1,11,2,13,4,1,8,1,19,7,1,59,166,31,5,37,45,3,3,2,4,0,2,6,2,10,36,32,17,3,5,2,4,2,37,32,1,3,42,7,12,17,23,57,1,15,7,3,21,16,6,16,8,4,3,8,4,3,4,4,20,18,11,17,94,15,1,4,15,163,3,17,14,15,12,2,13,5,14,27,35,41,51,4,5,7,0,3,1,23,4,6,22,22,2,6,13,23,7,3,36,11,39,60,7,24,8,2,0,0,1,11,2,10,29,3,13,49,73,13,15,2,4,13,9,13,22,19,25,29,4,10,6,68,32,6,5,10,6,3,19,36,5,8,31,19,9,16,17,13,2,5,14,4,32,20,3,2,41,13,6,11,8,129,20,39,4,4,1,17,11,17,3,66,6,2,21,13,3,4,8,11,4,6,2,14,11,4,9,38,2,6,21,23,29,0,3,14,3,23,6,5,1,1,8,26,4,42,20,23,37,16,7,50,6,29,10,47,5,1,19,6,19,2,12,7,6,10,11,18,4,1,14,5,11,19,15,5,14,55,54,18,6,15,14,8,18,21,3,8,7,13,25,11,6,7,14,2,0,45,5,0,13,2,11,2,14,7,24,14,7,18,7,53,6,35,12,1,50,5,13,38,11,23,3,7,7,29,17,76,6,20,2,31,0,9,1,13,8,5,2,28,10,6,12,7,24,1,12,7,8,2,3,5,9,14,23,2,3,5,7,11,8,7,11,1,15,2,5,0,19,10,1,15,18,5,14,3,2,7,4,30,11,11,6,2,8,60,6,2,18,7,37,16,30,33,19,9,1,16,11,1,0,14,3,1,3,0,15,12,9,14,2,7,20,9,5,6,7,9,7,6,4,68,34,2,4,8,7,3,21,9,8,18,6,5,1,2,24,2,15,7,3,3,4,7,6,23,19,5,11,4,9,11,19,4,18,4,5,24,8,9,30,11,6,3,8,10,9,13,7,47,15,7,2,2,5,11,9,7,18,14,4,47,2,6,46,7,10,22,7,12,7,38,4,24,3,13,19,18,11,37,27,12,8,21,3,6,14,12,5,4,12,8,11,11,14,11,7,5,8,6,8,24,27,7,1,17,8,3,6,42,22,28,4,11,5,5,23,6,23,6,1,14,19,5,7,22,11,26,6,8,4,14,0,3,18,5,9,5,7,6,25,14,31,21,32,7,1,6,9,5,17,11,6,7,28,13,26,8,7,6,175,12,10,4,4,6,9,43,17,14,13,10,8,16,33,6,1,3,12,22,18,16,12,65,20,25,9,4,9,3,12,1,34,22,10,12,6,16,4,4,13,21,9,15,18,4,12,17,7,23,18,2,3,4,8,10,4,21,4,12,6,3,6,12,24,22,27,16,9,6,7,8,3,9,29,3,6,5,2,4,26,6,11,13,12,9,2,12,9,76,10,8,13,7,7,10,0,11,2,3,8,9,11,5,8,5,6,9,13,8,12,11,23,3,1,17,15,11,7,4,13,3,9,2,13,6,18,6,9,54,1,16,7,13,8,5,11,11,37,6,8,8,18,11,7,11,18,0,5,3,3,5,7,11,3,4,1,4,6,10,5,13,9,7,10,3,4,7,4,9,20,3,7,0,3,8,5,1,8,2,8,8,13,9,3,6,9,8,27,7,7,9,11,9,4,5,6,12,5,4,8,13,19,6,4,3,7,9,11,5,2,9,5,13,2,8,10,2,3,4,5,2,10,2,8,6,19,1,9,12,5,2,6,2,9,11,2,11,7,12,6,3,19,1,3,4,5,10,3,5,2,14,9,3,12,2,5,2,7,3,27,2,9,7,18,15,4,5,5,4,1,7,10,11,14,4,12,3,9,8,9,9,3,10,16,8,4,8,5,2,15,7,17,12,11,5,19,13,20,41,5,0,8,10,7,11,12,2,5,19,5,15,9,4,3,1,11,8,1,4,6,8,7,3,6,5,4,2,10,10,8,5,9,6,4,6,12,13,1,12,2,7,1,1,0,0,4,1,11,3,1
tribe,0,4,4,53,5,0,2,12,0,0,0,3,1,39,3,2,3,2,1,2,3,16,0,18,4,1,1,2,1,3,1,149,47,0,27,23,33,12,4,4,2,0,6,0,20,6,5,2,215,2,19,0,3,1,15,14,20,32,0,17,27,1,0,9,14,0,30,1,0,0,2,0,1,3,16,6,7,1,21,3,14,0,16,4,87,6,5,0,19,0,8,4,0,26,22,2,6,3,12,17,0,14,12,3,8,16,3,0,7,3,3,2,0,0,0,8,1,0,37,46,19,2,1,19,0,1,8,0,4,3,2,1,15,31,4,15,0,0,0,1,0,29,12,3,0,33,2,6,7,7,9,1,2,5,1,1,3,3,5,4,3,2,2,1,0,3,8,16,22,10,14,19,6,0,1,5,85,0,4,6,22,17,0,2,3,2,15,10,12,12,0,3,0,0,0,1,6,0,4,10,4,0,0,26,15,0,1,11,3,24,31,3,1,6,0,3,0,0,0,1,0,9,5,10,15,26,15,9,2,1,9,11,4,9,17,2,16,6,0,4,27,16,2,3,5,0,3,4,15,4,3,15,12,0,5,14,9,0,1,18,0,17,18,0,5,8,12,2,7,0,67,3,5,5,3,0,13,1,9,0,18,0,5,2,6,0,1,2,1,2,2,0,0,1,5,5,19,3,3,15,22,14,1,1,0,2,23,6,1,2,0,2,3,0,6,8,1,12,3,2,35,3,20,26,24,2,1,18,1,9,2,8,5,3,1,0,9,16,0,4,0,4,8,4,7,7,23,28,11,9,3,4,9,8,8,0,0,2,7,8,2,6,5,9,2,0,19,3,1,5,2,8,3,7,1,10,4,3,6,3,23,5,23,0,1,70,0,5,6,2,21,9,6,6,20,2,30,1,7,4,3,6,1,0,5,3,6,9,12,11,6,3,3,6,1,4,9,6,2,0,1,1,5,5,0,3,7,12,9,11,0,1,2,13,2,2,0,17,3,5,13,28,0,1,0,4,3,5,36,6,10,4,0,6,14,1,1,2,0,32,10,4,73,12,1,3,3,5,1,1,13,2,0,2,0,3,3,0,9,2,7,6,4,1,5,0,5,3,7,0,33,21,1,0,0,21,1,7,2,4,7,3,0,0,1,1,8,4,2,4,4,0,2,2,16,1,2,10,1,5,35,16,0,6,8,0,18,0,4,9,2,3,4,1,7,8,3,3,30,3,9,0,0,0,5,6,0,12,11,2,0,5,1,71,2,10,6,4,1,0,21,0,28,0,15,7,2,9,11,18,16,9,19,1,3,1,0,3,4,9,4,6,1,3,2,1,2,2,0,5,3,11,6,2,13,12,0,1,77,12,13,0,6,5,2,7,1,9,0,1,7,20,13,2,16,6,25,0,1,4,4,0,0,3,1,7,0,6,4,30,0,18,13,14,10,0,5,0,1,9,0,7,0,16,12,29,6,2,0,111,3,5,1,1,0,7,11,2,2,10,3,10,4,6,1,3,0,17,9,3,15,4,19,7,22,2,0,9,0,7,0,19,7,7,8,4,3,2,3,7,3,9,6,6,2,16,3,10,0,0,0,1,2,6,3,5,10,1,0,0,4,5,9,19,39,11,8,12,6,2,10,3,17,13,1,15,2,6,5,1,2,14,3,7,10,2,0,1,74,3,5,6,1,5,2,1,12,3,1,11,5,0,0,7,1,9,2,12,1,3,2,5,0,0,12,2,6,4,18,23,5,2,0,6,1,9,4,1,163,16,1,11,5,2,5,17,3,2,0,2,0,3,5,0,1,8,0,10,10,4,5,6,6,4,2,3,3,6,10,6,0,2,1,2,0,0,5,10,0,7,5,1,2,0,1,2,1,6,1,6,0,13,1,1,1,8,5,12,1,4,2,1,0,1,0,1,3,12,3,10,5,1,4,5,1,1,9,10,0,0,14,0,5,1,3,7,5,2,1,7,1,5,0,2,0,2,0,0,1,0,2,0,8,2,25,7,2,3,18,3,0,20,0,2,0,2,18,1,21,2,1,8,0,10,0,0,1,3,4,17,4,0,1,7,3,1,6,2,4,0,5,5,1,1,0,8,0,1,4,0,2,0,1,9,3,3,9,0,1,13,3,3,0,0,6,9,0,5,6,0,3,3,6,0,2,0,2,0,7,2,6,32,19,3,1,0,21,0,4,4,4,4,0,2,5,5,0,8,9,3,0,0,1,0,2,0,4,0,1,0,1,0,2,0,0,0,0,3,0,0
induce,3,16,3,48,5,1,5,15,1,1,8,2,2,20,2,6,1,4,6,2,1,29,2,4,9,7,2,8,1,6,6,96,63,2,28,19,22,10,6,1,6,0,3,0,19,8,16,7,127,5,11,3,5,7,2,2,39,8,0,6,8,2,1,7,10,1,33,4,2,4,2,4,1,3,27,9,5,2,21,7,17,0,11,2,108,4,8,0,10,1,4,2,0,9,25,1,3,5,18,9,1,8,21,7,6,23,1,4,5,0,6,3,3,7,0,16,1,1,17,71,20,3,12,16,1,1,3,0,1,4,4,1,3,17,5,11,0,2,0,5,0,19,10,1,0,23,3,9,6,8,30,1,8,1,0,5,15,4,4,4,0,1,2,2,1,1,1,16,7,3,15,30,11,0,2,3,101,4,5,12,12,5,0,5,1,8,17,13,20,17,3,2,2,0,1,2,4,2,1,5,11,0,3,6,12,2,2,23,12,32,35,0,14,4,0,0,0,0,11,4,1,10,3,5,21,57,11,8,0,1,8,1,5,16,23,18,16,8,6,3,29,16,3,4,11,4,7,5,18,1,4,12,11,4,8,7,4,1,0,13,1,8,13,3,1,12,3,1,12,4,70,5,8,6,2,0,12,5,6,1,31,2,3,4,6,0,1,5,6,1,3,1,12,3,0,8,19,1,3,7,13,18,0,1,6,1,5,3,3,0,0,3,12,3,7,13,3,14,18,0,25,8,8,1,23,8,2,14,3,11,2,5,4,5,5,8,12,6,0,2,6,3,11,10,7,1,20,26,9,1,7,6,4,18,7,4,1,4,8,11,10,3,8,6,5,0,25,3,4,7,2,9,6,6,2,9,8,3,7,5,35,1,16,7,2,20,1,9,14,7,10,1,7,5,14,3,43,1,20,1,10,1,2,0,2,2,3,1,16,6,2,10,2,8,3,8,1,4,0,1,3,3,3,17,1,4,2,14,7,2,4,1,1,2,2,3,0,11,1,2,9,13,2,6,0,0,2,6,8,4,4,2,0,2,25,6,0,3,2,18,5,7,15,11,4,4,3,4,0,0,14,0,1,0,0,0,0,9,10,5,2,5,6,4,6,3,10,4,2,1,23,21,2,0,6,7,1,8,4,6,5,2,1,0,7,18,1,8,4,1,4,0,4,2,8,4,0,6,0,4,4,11,5,11,4,2,10,0,17,15,8,9,2,5,3,7,6,4,25,11,5,1,0,0,2,2,2,7,7,7,21,5,3,22,4,9,13,0,3,5,27,2,20,0,12,9,13,5,13,14,8,6,9,1,6,10,5,4,1,4,2,9,5,4,2,1,3,3,3,8,8,13,9,1,19,4,3,0,17,11,19,2,4,2,4,14,3,5,5,3,8,1,4,8,19,3,12,1,6,7,10,4,2,12,3,4,5,5,8,11,9,10,14,15,3,1,4,3,1,7,3,2,5,17,12,10,3,3,3,66,16,2,5,1,3,7,18,2,1,6,2,2,5,17,7,3,1,9,8,8,10,4,15,4,18,6,1,6,3,3,3,10,4,7,2,6,3,2,1,2,3,4,12,4,2,3,4,3,10,9,1,1,2,1,5,2,7,2,10,4,2,0,0,25,15,14,6,3,6,4,6,3,10,9,1,2,2,0,0,6,7,8,5,2,1,4,2,8,24,3,2,4,3,3,5,6,5,2,4,2,7,1,0,5,1,9,5,9,4,3,5,0,2,0,11,11,5,6,2,5,2,0,2,11,4,0,6,2,35,7,11,1,8,1,2,3,4,11,1,7,9,5,5,6,9,4,0,3,2,1,3,2,2,7,3,2,6,2,17,1,3,1,6,5,3,3,1,0,4,8,2,3,1,3,2,2,1,4,3,8,3,3,15,2,6,11,4,15,4,1,2,1,1,1,2,7,1,0,4,6,7,8,4,3,1,0,5,0,3,0,5,2,6,2,6,6,1,5,5,8,0,4,2,7,3,0,5,9,4,1,0,2,1,3,8,2,1,1,2,0,2,9,0,3,2,4,5,1,2,0,7,3,2,4,3,0,0,8,0,8,2,3,3,3,2,1,2,2,0,2,9,2,3,8,2,8,1,15,2,2,3,1,2,7,1,1,5,2,2,5,0,4,1,0,2,8,0,3,18,1,1,5,1,2,3,3,0,2,8,8,1,2,6,4,0,4,4,0,6,3,5,2,1,0,2,6,0,8,6,2,5,5,2,3,9,2,3,0,8,0,2,2,5,0,1,0,0,2,0,0
though,14,24,9,114,11,9,6,31,3,6,19,4,10,81,3,5,9,14,11,3,6,42,17,43,27,10,10,18,5,28,14,188,135,7,59,38,55,9,11,8,10,9,4,2,36,15,21,15,300,14,57,6,11,25,7,5,68,37,3,24,16,8,3,11,19,6,82,9,10,13,14,6,4,2,88,15,23,12,71,23,52,3,9,5,180,24,19,4,37,2,9,5,6,34,53,7,24,3,34,16,13,24,43,9,8,33,12,10,21,11,19,4,10,10,4,43,8,5,77,166,60,21,21,77,12,2,4,9,6,1,14,4,7,47,31,52,21,6,6,6,7,34,30,6,8,82,4,26,24,14,76,2,12,2,4,44,45,4,12,15,9,4,15,3,7,8,6,24,23,12,15,94,23,2,2,13,161,4,10,41,29,11,1,27,5,27,50,30,43,60,3,7,6,2,12,3,9,9,8,18,40,6,2,12,26,3,11,28,16,28,66,3,20,7,0,6,6,14,16,1,8,31,7,18,44,96,29,56,9,15,15,9,17,19,46,18,67,12,12,13,85,34,9,13,17,11,9,29,32,6,13,26,15,7,15,19,14,5,3,26,3,36,24,4,7,37,10,6,22,3,144,10,41,4,4,3,21,16,7,0,53,10,1,17,11,4,8,9,15,4,3,4,10,8,5,10,44,7,8,20,25,23,7,2,18,3,27,4,12,1,5,12,34,11,33,16,20,44,11,9,53,4,77,16,69,8,13,32,5,24,2,15,9,4,19,7,28,10,2,13,8,9,24,11,7,8,51,65,12,6,16,15,4,29,19,7,5,7,18,15,17,10,11,8,4,4,51,16,10,11,5,21,6,19,17,39,7,8,20,7,51,3,33,12,6,25,14,20,29,2,29,6,13,8,32,15,54,8,42,8,17,2,5,3,6,7,7,3,17,6,6,14,4,13,17,11,1,6,5,3,6,14,22,22,8,5,1,19,13,30,26,12,6,8,8,3,1,14,13,1,11,28,6,19,1,3,19,5,39,21,16,7,4,3,60,12,1,23,16,30,8,30,39,20,4,9,17,20,6,2,22,6,1,3,1,42,5,9,18,13,4,13,6,3,17,4,7,2,4,4,97,49,6,6,7,4,3,17,13,18,23,14,8,2,9,54,2,13,2,9,3,13,5,10,10,17,5,8,4,15,7,22,8,31,6,10,27,10,15,33,14,9,5,13,14,7,19,16,47,20,4,1,9,10,10,12,8,18,16,5,40,5,9,45,12,16,31,4,10,9,18,6,13,10,21,16,14,7,41,33,8,4,23,6,11,22,8,11,13,14,6,9,15,18,7,8,12,5,4,13,28,34,10,8,27,4,5,1,38,20,20,3,4,4,7,25,4,20,7,8,33,18,8,7,42,12,33,4,8,2,18,18,2,20,5,2,6,7,13,22,19,18,33,27,13,3,9,8,2,13,11,2,14,17,7,20,3,10,3,163,26,8,11,2,8,15,50,27,14,12,2,7,11,21,8,4,1,9,11,9,32,11,60,35,25,5,3,8,5,6,4,31,26,11,14,10,23,9,5,17,11,8,18,14,7,8,9,8,20,19,7,6,8,12,14,8,23,12,3,1,7,16,6,23,20,31,7,10,9,16,12,7,16,20,5,9,13,4,8,20,10,19,3,5,6,5,43,12,40,5,16,13,5,20,16,5,16,8,6,6,13,7,7,4,2,18,11,8,3,18,18,19,8,5,23,11,8,11,13,17,9,3,3,16,8,12,9,2,28,13,5,8,1,6,9,7,3,32,13,14,11,5,7,4,7,19,2,8,9,5,5,11,10,2,7,4,6,3,16,5,15,4,16,6,8,4,5,8,11,19,11,3,4,5,4,6,6,4,22,8,9,5,19,15,5,8,13,31,11,6,5,10,12,9,8,9,11,5,5,22,17,31,14,12,2,7,11,3,10,2,5,14,5,2,8,10,3,3,13,6,6,4,8,20,5,9,1,11,8,3,3,6,4,1,12,3,10,7,5,4,5,23,1,6,17,6,10,3,6,9,10,2,6,6,4,2,6,5,7,18,3,4,6,12,13,3,4,18,6,1,13,9,3,11,4,5,6,13,4,12,5,5,8,9,4,4,5,12,7,6,9,17,7,4,9,14,17,12,23,3,1,6,6,4,8,8,3,4,16,4,3,7,4,3,0,20,8,9,3,13,16,15,5,7,2,8,4,14,13,4,8,10,6,14,7,5,14,4,27,0,3,2,7,1,1,7,0,12,4,1
stock,1,11,3,52,2,2,0,5,0,4,0,3,5,16,0,0,1,22,1,0,7,20,5,20,12,5,1,5,1,11,0,102,57,7,22,14,9,17,15,1,6,1,2,0,13,5,13,11,127,2,22,0,6,13,2,0,23,11,1,10,2,0,4,5,11,0,39,5,2,1,60,4,7,1,42,3,9,3,47,24,32,2,6,10,135,33,23,0,28,16,2,2,0,23,47,8,8,6,17,15,4,6,16,3,1,15,4,7,11,3,20,4,7,24,5,22,1,1,38,77,30,11,14,64,2,0,1,3,5,1,0,0,2,22,4,44,0,2,1,6,1,15,14,1,1,35,3,9,17,17,36,3,5,1,1,14,23,5,0,7,4,2,7,5,4,6,2,11,16,10,7,48,9,1,6,2,69,4,5,21,10,4,1,16,6,13,16,12,9,24,0,6,9,3,3,0,18,6,7,11,24,12,13,3,13,2,23,18,13,7,43,1,10,5,1,6,2,2,3,2,5,7,4,7,14,36,11,14,2,12,5,16,11,28,21,6,23,8,8,1,30,19,3,2,4,2,0,23,19,17,8,23,13,15,6,9,7,19,7,16,8,4,5,4,4,29,5,5,4,1,52,35,64,3,3,2,5,6,9,6,35,6,3,10,5,0,7,7,4,0,0,2,23,10,11,5,13,0,3,8,13,12,1,3,15,3,6,4,4,2,1,20,23,2,47,4,7,17,32,4,11,7,4,7,16,2,11,8,4,37,3,9,1,9,1,4,2,6,5,11,7,5,3,2,2,1,20,26,11,0,3,12,4,18,11,1,0,2,7,13,11,1,2,8,2,1,32,1,5,10,1,2,6,9,8,4,3,9,4,4,30,1,21,3,5,18,3,5,16,3,4,5,11,0,8,3,21,7,16,3,4,0,0,0,8,8,4,0,6,6,0,0,3,2,0,2,0,0,4,0,4,1,8,4,4,3,2,3,1,6,31,19,8,12,0,1,0,1,2,0,4,1,1,7,0,0,7,3,21,7,21,0,2,4,19,0,0,2,4,28,12,11,16,17,2,0,11,4,1,2,5,2,12,0,0,18,0,8,19,7,5,7,0,1,1,2,6,0,5,0,10,20,0,1,10,0,1,10,2,5,7,5,3,0,33,93,14,6,11,10,2,0,5,3,8,8,2,9,17,6,1,8,1,18,6,2,24,24,9,18,11,7,0,5,2,9,4,16,22,14,0,0,1,15,40,1,6,11,11,5,6,3,7,15,4,3,6,3,1,1,12,3,15,1,13,5,2,0,13,26,6,3,9,0,2,9,1,4,3,18,2,11,7,2,2,1,4,5,1,5,6,18,6,0,24,8,7,3,5,9,3,4,3,0,2,10,2,13,8,2,12,9,8,3,13,8,14,6,1,5,11,13,4,41,0,0,0,8,7,15,17,9,22,16,4,2,5,8,1,4,4,0,0,8,1,23,5,5,5,67,0,3,7,0,5,8,24,4,4,5,2,2,5,2,1,0,0,3,5,9,5,3,4,4,5,2,0,4,0,8,6,12,9,3,0,10,5,2,0,8,8,6,2,5,2,2,1,1,0,5,0,2,0,6,7,8,7,3,2,1,1,5,6,14,11,3,0,5,0,1,3,6,2,14,1,2,12,1,1,2,15,15,6,2,2,0,3,1,4,0,11,0,2,5,0,2,15,3,6,3,6,8,3,3,3,17,2,7,1,35,33,0,0,4,7,30,1,3,16,3,5,0,7,7,2,8,31,5,11,8,2,1,6,1,18,7,3,20,4,18,2,0,0,1,15,6,7,6,2,0,6,7,2,1,1,0,6,2,8,0,3,0,0,1,5,0,2,1,5,11,2,1,0,14,7,1,5,3,11,0,23,1,13,0,1,7,5,13,2,7,1,5,2,0,7,11,10,4,1,5,9,26,0,4,2,8,3,16,4,0,5,4,9,5,5,6,2,6,4,4,8,2,29,17,4,5,0,1,1,0,1,6,2,2,5,1,3,9,0,3,1,1,2,0,0,1,0,6,14,1,2,0,0,7,1,8,0,14,0,8,5,37,5,21,2,10,0,0,6,2,3,1,2,6,0,1,0,0,2,10,2,0,7,1,1,2,1,4,0,7,4,9,0,23,8,23,22,27,74,2,0,1,1,8,0,17,0,4,37,5,2,7,4,0,1,1,3,2,2,2,1,2,3,2,5,0,0,1,2,0,0,4,6,6,0,5,1,5,0,0,2,2,1,0,3,1,4,0,1,0
represent,12,50,24,174,5,3,12,49,5,3,33,15,3,83,4,5,3,14,7,2,3,31,9,41,29,14,12,14,6,22,5,175,127,13,53,35,43,9,17,6,11,5,10,7,34,11,30,20,312,29,32,5,18,44,10,9,48,29,7,18,11,4,4,16,24,14,119,11,19,8,18,0,9,7,82,6,13,5,61,17,62,1,9,7,201,26,12,1,30,6,10,8,7,29,62,10,12,7,32,26,3,27,19,2,8,23,6,5,15,8,13,3,9,13,8,32,7,10,55,129,52,25,10,81,5,7,5,4,11,4,9,1,3,45,10,39,11,5,2,13,5,33,32,3,4,63,7,17,18,9,73,3,18,3,3,19,41,12,7,21,20,6,8,7,23,10,4,35,44,5,12,133,25,5,9,5,155,5,3,25,28,14,5,16,4,24,44,16,34,44,10,4,4,1,2,5,10,3,21,21,36,13,9,6,24,11,3,29,10,23,68,0,37,4,6,1,8,8,14,7,4,26,7,15,26,84,25,38,8,25,14,14,17,32,31,21,37,8,14,8,43,30,12,7,15,8,12,14,43,12,10,17,24,4,7,13,6,5,3,38,3,15,19,2,9,39,9,7,6,6,98,5,35,6,4,0,23,13,5,6,58,9,9,18,13,5,4,6,13,2,9,7,14,7,12,9,38,5,6,17,19,34,5,5,10,4,11,4,13,6,1,28,37,4,41,12,20,44,17,6,44,9,17,10,53,4,13,21,4,31,25,11,9,7,12,10,20,8,0,15,3,12,12,6,7,4,49,48,12,17,9,6,13,23,19,0,16,6,14,30,18,7,13,22,2,2,36,12,8,17,3,13,10,11,14,28,3,8,18,7,35,2,43,16,3,26,6,15,21,3,26,3,44,36,31,4,44,1,25,3,16,2,10,3,6,20,2,7,23,13,5,13,0,14,2,7,11,9,1,2,4,14,16,10,6,7,3,11,5,11,4,3,1,11,4,4,2,11,7,3,11,16,8,14,4,7,8,5,37,8,26,6,2,4,45,5,1,7,8,21,13,32,38,25,6,2,12,11,4,4,13,5,10,1,0,25,4,45,15,9,10,10,4,11,9,8,9,3,18,3,60,43,5,1,13,9,7,16,3,13,9,5,2,1,5,18,9,20,8,11,3,4,9,6,12,9,2,7,13,14,5,26,8,30,10,5,32,18,13,34,9,6,5,18,10,6,4,22,23,29,5,15,16,31,12,6,3,6,12,7,35,4,4,36,10,4,26,4,11,11,20,5,20,9,15,16,15,14,37,44,8,7,9,5,6,10,21,7,8,25,3,13,11,15,11,7,5,5,3,11,30,24,8,6,40,11,6,9,41,18,21,3,5,7,4,19,5,22,9,2,34,36,21,1,29,15,11,4,7,2,7,9,1,12,5,5,4,8,9,34,5,12,15,30,12,6,16,6,1,8,6,3,13,14,5,11,9,8,6,185,8,6,11,1,11,16,32,19,9,14,7,7,24,16,10,8,11,11,4,13,24,5,42,23,22,5,7,6,13,1,6,31,7,7,12,2,9,7,2,9,26,13,17,10,4,7,2,6,5,12,12,6,1,10,5,7,17,11,4,4,2,12,5,27,10,21,1,3,9,8,3,14,12,9,3,25,7,2,2,15,5,9,11,8,8,4,9,2,27,11,6,3,10,3,12,7,13,12,14,5,9,3,5,15,12,11,5,6,5,33,43,8,8,6,29,28,13,3,13,15,5,3,6,19,3,12,15,4,13,5,5,2,9,18,1,4,9,60,1,21,5,20,3,3,21,22,4,14,6,10,3,4,11,6,2,2,4,1,20,13,18,5,5,7,3,6,4,12,8,9,4,6,58,14,0,2,4,7,2,6,13,4,7,5,9,5,11,18,3,9,5,15,5,12,5,7,10,12,3,12,29,26,7,1,3,3,9,7,5,2,5,8,2,7,8,12,6,11,6,5,3,4,32,10,9,3,3,8,24,5,3,6,8,2,11,1,11,8,4,5,4,15,2,2,4,5,5,8,4,4,2,2,4,4,5,1,7,10,4,18,4,11,12,13,11,5,6,11,3,12,6,4,3,8,5,2,8,34,6,9,5,12,4,10,3,5,2,9,7,9,4,13,5,3,4,6,12,12,21,3,2,2,5,3,2,2,7,4,16,0,4,6,2,7,9,14,4,9,38,8,7,5,9,9,2,5,2,7,3,11,4,7,1,8,3,8,6,3,7,2,4,5,6,4,0,10,4,2,3,4
particularly,4,4,5,77,5,2,2,15,2,1,11,2,10,39,1,3,3,13,0,1,7,20,1,12,16,7,7,6,7,2,2,104,79,7,30,33,21,4,15,4,4,6,2,6,14,9,18,16,182,13,20,5,7,35,8,3,39,21,2,15,21,10,2,16,12,9,37,2,15,10,13,1,3,2,50,12,9,4,54,9,42,5,11,6,111,11,17,1,15,3,9,6,1,17,42,10,12,4,27,16,10,20,23,6,13,18,9,1,6,3,6,5,12,7,3,21,2,2,37,104,17,10,16,35,5,0,3,3,5,0,5,1,9,41,5,27,5,3,4,5,1,28,20,0,2,36,1,7,13,5,26,4,7,15,5,15,13,5,13,9,17,4,6,2,5,3,3,17,24,6,9,37,13,2,2,4,89,4,6,24,12,8,21,6,4,11,27,13,18,29,1,4,7,3,2,5,9,7,8,4,19,10,6,9,13,7,5,29,6,11,56,6,10,8,0,0,0,5,7,2,0,14,5,8,25,43,18,2,5,6,16,11,12,21,39,12,23,13,12,5,26,26,5,5,8,3,6,9,26,5,15,24,12,3,8,11,7,4,5,18,5,20,10,1,5,31,9,6,4,7,79,7,12,4,7,0,6,4,17,4,35,6,7,11,10,10,5,7,5,1,2,0,3,5,3,8,21,8,1,17,17,24,2,2,15,3,15,3,3,3,5,5,10,10,18,9,11,35,8,6,23,1,11,3,37,4,6,11,1,19,3,3,0,5,2,8,5,3,5,8,6,3,12,8,2,2,26,47,9,7,10,5,3,22,18,8,2,1,7,12,14,8,20,8,9,0,29,7,5,5,3,9,4,6,7,30,4,4,12,6,19,1,25,10,3,44,0,18,21,3,15,3,4,5,18,3,37,4,20,5,15,0,2,2,2,4,2,5,21,8,4,13,6,14,12,7,4,3,6,4,1,2,13,5,2,2,5,9,8,11,3,4,0,2,3,6,4,9,15,5,10,13,5,15,4,7,6,3,25,4,19,6,3,5,32,2,1,4,3,25,6,10,24,18,4,4,4,10,12,1,18,2,1,1,5,4,3,11,11,3,1,9,4,4,12,4,6,0,4,2,51,19,2,4,5,5,2,7,4,4,7,8,6,2,9,13,6,11,9,4,3,3,4,9,7,9,1,7,2,1,5,15,5,9,3,0,14,4,17,15,5,5,2,5,6,9,4,9,26,15,2,2,3,5,14,8,1,13,14,6,7,1,3,30,7,6,38,2,6,7,21,6,14,2,5,11,10,4,19,14,11,2,8,4,6,3,2,3,4,9,8,13,7,4,4,3,7,5,1,4,9,16,9,6,22,4,5,5,18,7,13,3,2,2,4,18,8,12,12,5,14,13,7,4,23,6,15,9,7,3,2,0,3,5,3,12,10,8,8,19,1,35,12,7,2,1,7,8,2,10,6,1,2,12,5,26,6,7,0,121,21,12,3,5,2,7,24,7,2,9,4,4,6,17,6,3,6,12,5,7,21,8,11,7,22,6,3,6,8,5,7,23,14,6,13,5,6,6,2,10,6,8,16,20,5,8,5,1,10,7,1,4,5,3,3,9,13,6,2,1,0,4,3,25,18,11,6,8,3,4,10,2,3,11,5,4,3,2,3,7,10,17,7,6,10,7,11,2,19,11,6,10,2,10,12,2,10,20,4,8,10,2,1,4,0,7,5,16,5,6,6,8,0,2,18,12,9,8,13,9,6,3,7,7,4,5,9,5,8,11,17,3,7,7,4,1,5,2,3,7,6,9,3,7,3,6,20,7,9,3,2,7,7,6,2,4,1,3,4,6,5,6,6,8,7,4,3,4,3,3,5,2,7,2,3,4,0,5,1,4,2,9,6,1,3,9,5,15,6,3,4,4,2,3,10,4,2,3,6,7,19,9,4,2,4,2,4,7,0,2,10,4,3,5,1,6,2,2,9,11,3,2,4,4,6,7,3,17,5,3,3,5,3,2,0,1,7,3,4,3,2,14,1,5,7,2,7,0,4,1,4,6,1,9,2,3,0,4,2,15,10,1,5,1,7,1,4,7,3,3,1,4,3,8,0,3,2,12,6,1,9,1,7,4,3,0,9,2,4,13,5,6,1,2,5,4,6,8,16,2,1,4,1,4,5,2,4,4,6,5,6,8,2,7,2,11,8,2,0,11,4,6,8,7,7,4,4,2,13,4,14,2,3,0,3,3,8,7,18,2,3,6,3,2,0,3,4,1,4,4
thereby,2,7,3,79,4,2,2,16,1,5,8,9,5,37,4,5,6,9,3,2,3,42,6,13,15,2,10,6,4,9,9,105,74,5,40,31,15,14,15,6,4,8,2,4,17,15,30,4,177,3,38,3,11,19,11,5,69,13,0,4,9,2,1,15,18,2,54,10,7,7,10,1,5,3,35,17,14,2,58,14,44,4,8,4,160,29,18,0,11,3,2,6,0,15,39,24,10,3,16,9,2,11,13,7,2,19,10,4,17,1,12,9,5,15,1,10,1,7,26,149,26,5,22,37,5,0,2,1,5,2,13,4,5,38,17,14,2,2,2,2,3,26,20,4,2,37,2,10,16,15,34,1,7,5,5,13,14,4,8,11,11,8,7,2,3,7,5,12,13,9,8,43,16,10,1,6,115,0,9,13,7,3,6,10,1,14,17,18,20,42,2,3,5,0,2,4,15,2,9,9,19,5,6,7,25,6,13,39,6,22,56,4,14,23,1,0,0,3,13,0,1,9,3,23,20,55,17,23,7,10,10,20,20,22,21,49,18,5,10,1,48,29,7,2,6,8,0,19,27,7,12,39,9,14,6,13,8,8,1,6,2,18,18,2,5,15,11,5,8,5,93,12,37,6,4,0,11,8,1,2,50,4,1,19,10,1,3,10,5,3,0,1,32,2,4,14,26,3,6,11,12,15,1,3,5,1,5,4,4,1,1,15,24,8,39,15,20,27,15,0,29,6,9,7,32,5,2,11,1,16,2,7,4,5,5,4,10,0,3,8,7,5,17,7,9,8,27,28,12,5,10,8,4,30,11,0,3,9,11,11,9,6,8,13,3,1,33,8,5,7,3,17,5,4,5,12,3,3,10,4,45,1,27,3,4,35,6,12,17,10,13,3,7,5,20,16,28,5,26,0,8,1,5,0,2,2,4,1,22,7,2,5,1,9,2,6,3,4,2,0,2,2,16,7,0,1,4,6,6,15,20,0,1,5,0,4,0,1,4,5,4,17,3,11,1,4,3,7,25,5,16,1,2,4,36,1,0,9,6,24,7,8,16,15,8,0,22,4,3,0,13,3,2,3,4,20,6,13,10,7,8,11,3,3,3,3,12,4,5,2,32,14,1,3,13,5,2,12,3,5,16,6,3,1,6,44,6,8,2,6,12,0,4,5,17,9,2,8,1,0,3,11,4,19,7,8,21,8,16,22,8,5,4,11,5,4,5,6,38,18,4,0,1,4,11,3,6,24,6,4,20,4,5,25,3,7,12,11,2,4,19,0,19,4,10,12,7,6,21,19,7,7,4,2,5,9,6,6,6,9,4,9,14,7,12,2,6,6,5,2,14,22,7,2,12,2,13,8,17,12,8,3,2,0,0,14,5,16,8,8,21,9,7,6,16,20,14,10,3,6,21,18,3,28,5,0,2,3,2,27,22,8,16,16,3,5,9,7,0,10,7,2,10,12,8,11,3,2,4,89,7,7,16,1,4,5,38,12,8,11,6,4,3,7,3,3,0,5,7,10,18,5,27,11,20,4,2,4,0,6,0,15,3,10,10,1,8,1,1,5,6,6,4,4,1,7,7,2,17,9,0,2,1,7,8,2,12,1,11,1,6,3,9,10,9,14,4,5,5,5,5,1,4,15,2,11,9,3,7,4,8,15,14,6,8,3,6,1,18,5,9,3,3,6,7,8,16,7,7,8,6,4,0,0,5,5,0,7,1,31,31,5,0,6,9,15,5,2,6,10,1,6,4,9,3,12,10,3,3,11,3,4,3,3,9,5,1,11,12,8,7,7,2,3,4,10,3,9,1,4,5,4,2,4,2,2,8,2,7,4,13,1,5,4,2,1,3,2,7,7,4,5,3,10,2,3,0,6,25,4,7,6,10,1,2,6,2,22,5,3,4,5,1,4,7,4,7,5,5,8,7,21,3,12,3,2,3,11,1,1,9,3,4,0,9,7,2,4,8,8,2,2,6,19,7,5,2,8,3,0,4,4,4,2,8,0,3,2,6,7,1,6,1,1,0,7,4,5,4,1,10,5,1,3,4,0,0,28,2,9,6,11,6,11,6,4,1,3,1,3,8,4,5,27,3,4,2,5,0,4,1,4,4,3,1,4,6,5,3,11,3,11,2,4,3,21,8,4,41,2,1,4,6,2,4,0,0,1,10,2,5,9,5,0,1,6,3,4,1,7,5,8,6,3,2,0,0,6,2,8,1,2,4,19,5,7,3,0,9,4,2,1,0,0,0,3,1,3,0,0
texas,19,59,6,453,20,0,12,176,13,10,208,5,2,69,1,15,23,12,4,4,4,93,2,45,35,6,9,30,12,82,33,240,236,19,110,41,110,1,1,26,0,5,2,1,27,29,76,6,1091,6,137,22,4,62,0,17,71,31,4,8,29,7,1,4,13,18,255,0,17,23,16,0,1,21,45,13,14,0,99,58,16,0,29,1,389,5,6,0,45,1,22,15,0,70,67,0,12,3,63,1,2,11,50,12,1,21,4,2,21,9,59,5,1,21,2,79,68,11,283,276,48,21,0,143,3,1,1,5,5,1,5,4,11,76,24,10,20,10,0,12,1,50,103,2,9,120,5,29,16,2,87,1,11,12,0,30,7,8,159,4,2,7,2,1,1,2,0,19,17,25,34,121,11,0,2,21,313,0,19,5,36,15,0,23,2,11,30,36,76,175,0,24,6,0,1,4,11,0,8,11,3,0,0,2,51,16,0,7,51,39,79,2,105,3,3,0,0,0,22,1,0,5,34,13,68,111,13,28,6,4,9,14,13,37,17,30,30,0,5,36,91,36,2,0,27,1,0,11,11,12,8,17,22,8,28,12,27,6,3,19,1,26,56,17,1,29,0,7,41,9,143,1,10,2,1,0,63,2,26,0,58,1,1,20,19,10,0,0,39,4,18,3,2,1,0,6,83,26,1,5,37,35,1,0,11,0,30,10,2,0,4,1,43,1,10,5,0,48,2,3,75,0,29,0,66,22,0,58,8,34,3,2,4,6,0,13,17,21,0,50,22,27,4,47,3,19,127,187,9,14,2,6,6,8,23,1,56,9,9,33,0,1,2,37,2,2,73,39,1,9,1,2,4,1,1,18,2,0,34,19,58,1,29,12,1,61,9,11,54,0,37,0,25,56,58,18,80,4,158,5,12,4,8,1,1,1,3,0,7,1,18,8,1,18,6,2,10,1,4,0,11,72,17,58,3,3,2,25,36,27,19,14,10,90,3,4,0,35,46,1,9,6,21,33,0,9,2,38,97,11,16,16,8,18,31,10,0,77,13,38,26,32,18,6,3,0,5,2,0,0,11,0,0,0,0,8,25,48,6,1,10,82,6,3,10,34,16,8,2,18,239,50,1,14,6,63,0,21,9,3,20,1,0,0,5,3,3,29,0,7,0,2,2,1,2,28,6,2,0,4,0,29,0,24,1,5,23,0,6,82,26,4,5,0,12,11,38,4,96,6,4,0,13,2,8,1,28,30,3,0,119,30,3,67,2,10,33,0,4,16,22,16,14,1,9,4,24,8,49,14,16,14,5,0,0,11,1,4,1,51,2,31,6,21,10,52,0,19,12,14,34,60,0,2,5,8,0,3,194,30,58,0,5,37,21,10,5,156,1,18,112,16,40,0,13,42,7,0,7,2,17,0,0,82,1,1,10,1,13,109,0,11,25,60,73,10,2,22,0,5,6,3,11,56,15,60,1,19,6,655,12,12,11,0,29,10,66,112,70,18,18,7,95,8,27,30,0,26,18,10,27,4,830,44,88,1,3,0,0,27,1,11,32,11,31,4,8,6,26,53,138,1,6,26,10,6,21,18,15,42,0,0,14,11,17,21,24,25,2,27,6,8,12,36,60,184,50,38,68,0,38,29,75,25,1,165,6,0,0,1,6,7,3,5,6,6,17,6,310,21,17,13,0,3,16,0,15,1,9,4,16,18,1,6,3,25,21,22,16,6,6,4,20,4,120,5,20,9,3,10,4,3,0,23,0,22,0,0,18,37,2,11,32,20,60,2,11,1,13,45,10,36,0,4,0,31,1,22,1,9,0,21,5,14,3,0,8,7,8,28,7,1,33,23,0,7,9,30,6,9,25,18,1,0,14,1,1,23,0,20,27,23,0,57,18,25,3,29,11,8,19,54,3,17,0,3,5,14,18,20,15,89,22,0,2,0,2,5,17,0,5,3,2,4,3,19,1,3,4,4,2,18,4,0,1,0,1,16,27,0,1,11,6,18,13,2,30,34,35,2,1,65,1,12,21,38,26,19,14,3,0,20,16,5,29,5,0,3,3,41,0,0,1,8,99,20,3,21,0,0,21,24,16,1,1,8,4,85,4,5,2,0,8,36,6,0,1,3,5,0,0,29,1,5,0,14,6,28,17,0,2,13,0,6,1,17,41,14,29,3,12,26,0,1,0,5,1,1,1,4,4,9,0,2,29,4,0,8,5,51,2,1,15,1,22,0,16,0,98,8,2,2,15,0,0,0,0,40,0,0
equal,2,4,6,79,4,4,3,43,2,5,3,3,6,45,4,9,3,23,4,3,3,23,4,27,8,9,11,13,3,6,7,122,87,6,44,51,27,10,8,9,8,7,1,8,18,8,31,9,204,15,33,3,7,26,1,1,51,26,1,12,7,3,3,2,14,4,82,6,6,11,24,3,0,2,56,11,15,3,63,10,54,0,4,4,133,21,16,0,34,6,4,6,5,26,59,17,7,4,30,12,13,25,43,8,6,13,12,2,39,21,16,10,9,24,1,25,1,4,43,191,26,7,28,94,7,3,3,4,10,0,6,4,3,28,19,22,5,1,2,4,0,16,20,1,2,25,2,9,19,9,48,1,21,3,3,13,11,3,3,5,14,2,4,2,4,5,6,9,19,7,21,100,13,2,8,4,132,1,2,15,22,13,2,12,5,13,21,15,13,30,3,8,10,2,2,3,15,2,18,6,20,3,5,10,25,7,7,19,9,14,37,4,18,10,2,3,7,7,16,3,7,9,1,10,57,61,25,46,13,50,18,14,8,16,30,35,31,3,11,4,57,11,4,6,10,11,5,35,34,2,8,18,18,26,28,15,6,8,2,23,0,15,16,1,4,42,4,3,14,3,108,9,99,1,2,1,14,27,10,0,64,6,4,5,20,6,1,5,7,3,1,3,10,5,4,11,46,1,4,11,24,16,4,12,14,1,10,2,5,3,2,14,20,2,55,16,7,28,30,3,41,5,30,2,56,2,2,8,2,41,3,22,4,6,16,11,11,5,6,9,6,4,8,7,6,0,24,32,9,3,9,5,6,27,19,8,3,5,12,24,13,5,4,17,2,2,24,3,4,13,2,18,7,4,8,28,7,3,10,8,52,3,21,8,6,22,3,28,13,8,16,6,8,8,19,8,24,10,10,3,21,3,5,1,3,0,15,1,12,6,2,7,9,9,5,7,1,8,5,4,2,7,8,3,7,1,6,6,12,7,75,15,7,5,1,3,2,4,9,4,8,15,3,32,4,7,13,1,36,7,33,9,8,18,29,6,4,5,9,18,8,19,25,36,19,2,24,8,5,1,10,4,3,2,6,6,3,10,24,2,1,2,10,4,2,2,15,2,5,0,62,27,2,5,10,7,4,12,6,2,24,3,16,1,2,134,8,11,4,2,7,2,3,3,16,9,3,8,2,5,3,7,17,22,6,3,14,8,10,24,8,1,2,11,6,5,6,1,26,18,3,0,3,6,5,3,3,19,10,5,29,2,4,44,2,11,12,3,1,1,22,1,12,2,11,11,15,12,21,35,7,7,6,0,3,15,16,6,15,29,13,14,14,13,12,9,2,5,10,12,21,32,7,0,11,2,13,3,16,19,10,1,3,5,2,14,7,11,4,7,26,3,5,9,20,8,14,8,5,4,20,76,4,53,1,11,5,9,12,22,84,12,20,16,5,5,5,17,4,7,13,2,9,17,4,29,2,0,1,99,9,3,6,12,1,13,37,12,1,7,5,4,4,16,1,13,0,2,10,13,22,3,20,9,15,5,2,7,2,9,9,17,11,5,6,5,14,2,20,17,5,8,15,15,5,10,7,4,20,17,5,4,3,7,5,5,13,6,6,3,5,2,5,15,6,27,6,6,8,8,1,2,4,18,3,3,7,3,2,21,11,6,15,2,4,10,28,2,33,24,8,4,6,31,14,14,14,6,9,10,12,25,3,9,7,13,7,10,2,44,44,10,2,3,9,25,3,6,4,10,7,1,4,8,2,7,15,2,1,6,0,1,13,4,1,3,12,13,1,6,5,6,0,10,4,27,2,7,6,1,4,7,16,0,4,7,9,9,15,5,18,0,6,4,4,3,6,5,6,14,2,9,1,10,7,3,1,3,35,4,4,2,12,2,4,10,4,18,15,2,2,3,3,4,1,5,6,5,8,2,14,10,5,6,1,7,1,5,0,2,9,7,3,4,10,5,1,2,9,10,3,13,38,50,1,9,0,5,5,16,6,10,4,4,6,5,4,4,2,10,1,4,2,2,2,0,2,2,15,9,8,8,4,6,5,0,0,9,7,18,1,5,5,27,17,2,4,2,2,1,12,3,4,18,2,2,4,3,1,51,1,1,5,6,5,7,5,8,1,7,10,18,11,9,13,34,19,23,59,7,1,4,2,8,3,3,31,7,14,7,13,4,0,7,3,7,1,3,5,7,9,3,5,3,0,3,4,10,4,1,12,7,3,49,2,11,8,3,9,1,3,6,6,2,3,9,3,2,4,4
charge,17,37,13,156,8,8,4,23,6,3,28,11,9,63,4,8,7,11,3,3,10,62,7,30,24,11,7,13,7,31,13,244,125,7,61,53,25,13,18,5,15,6,7,9,34,20,19,22,382,28,60,4,13,33,13,7,110,60,5,19,22,4,0,13,26,3,86,8,9,20,17,5,6,8,82,14,21,5,69,20,66,4,25,4,274,16,22,0,39,4,20,7,4,31,80,42,14,4,27,6,14,31,47,15,10,28,17,3,17,5,21,6,11,13,4,20,8,9,83,172,51,16,28,73,7,0,1,5,11,1,11,3,3,71,18,47,5,12,5,6,4,40,30,5,1,89,9,24,26,34,57,1,30,7,8,38,32,2,8,7,38,6,8,7,8,4,5,20,28,12,24,90,27,0,3,11,213,3,10,40,34,13,3,21,12,15,48,30,46,67,4,5,15,2,0,2,17,5,4,21,44,4,12,22,26,26,7,43,10,22,85,14,27,9,7,6,5,8,20,5,7,16,4,16,67,160,24,29,4,15,8,19,36,30,44,34,30,10,12,5,87,59,6,12,18,7,3,41,70,11,9,21,20,13,19,19,17,7,9,25,3,29,33,6,6,118,5,4,14,9,111,14,42,8,3,0,16,35,18,6,50,9,9,24,9,2,19,17,25,0,10,2,21,7,7,10,75,14,10,25,24,38,0,9,10,2,13,12,12,4,5,20,34,1,53,33,31,54,11,8,42,8,26,13,53,12,7,39,4,38,2,13,11,13,5,19,14,7,2,15,10,16,16,11,1,8,53,51,21,8,12,16,9,33,28,19,3,4,10,27,28,10,7,25,7,1,56,14,6,33,5,25,4,11,7,57,16,8,15,10,61,2,55,19,7,67,24,37,37,6,23,2,15,13,24,14,65,7,46,3,23,0,3,3,10,4,8,3,22,15,1,8,13,20,9,13,5,10,4,2,3,6,10,10,4,7,7,34,11,26,19,7,1,27,3,19,0,20,12,4,21,35,10,17,2,7,9,9,37,10,11,8,2,9,48,17,1,15,10,46,17,19,32,36,8,3,19,14,8,2,25,9,5,0,5,10,4,23,21,8,4,14,7,2,11,6,16,5,4,4,80,45,1,4,15,5,7,27,17,10,13,10,4,4,21,22,4,21,17,4,5,6,11,11,14,27,9,18,3,13,8,32,9,27,7,1,49,11,27,36,26,4,3,10,17,12,10,9,48,30,8,2,3,10,13,8,12,21,17,11,37,11,10,57,11,14,37,11,3,9,22,16,42,3,18,15,8,5,42,50,17,14,22,10,10,4,22,7,6,28,11,32,15,13,6,14,9,12,5,10,22,35,10,9,24,12,7,2,51,31,24,4,8,9,7,23,7,37,12,16,37,46,24,12,69,17,15,10,14,6,27,7,6,29,4,8,13,13,14,34,22,25,21,20,14,12,10,8,7,13,14,6,15,26,7,64,11,16,6,236,11,9,10,4,12,14,35,8,5,21,6,6,17,17,9,9,1,15,13,12,22,15,42,41,31,2,8,14,6,3,12,27,24,7,10,18,12,8,0,17,18,13,28,10,9,11,12,5,21,14,5,4,4,8,18,13,25,4,10,10,6,12,6,37,14,28,10,17,8,11,10,14,2,71,1,12,8,2,3,5,14,26,11,9,5,17,29,9,36,12,19,9,9,21,7,11,19,4,10,11,11,14,4,13,11,16,11,21,7,20,26,9,5,13,17,20,14,15,18,12,10,4,5,27,11,24,13,8,40,8,2,7,14,18,21,7,8,45,6,1,9,20,3,9,24,21,8,12,7,15,5,9,12,7,11,4,9,6,28,3,19,7,12,11,8,12,5,10,16,22,3,5,2,36,12,9,5,6,8,8,24,8,9,6,8,6,10,38,10,15,12,10,3,12,18,8,9,10,17,28,23,43,14,2,3,21,6,16,24,1,13,9,30,3,6,7,8,3,3,16,20,12,15,13,11,3,12,21,15,5,1,15,6,6,34,3,8,10,7,5,4,11,0,7,9,1,5,7,10,5,7,17,5,13,9,7,3,20,4,20,9,13,5,19,19,6,8,11,4,6,7,6,5,12,2,18,4,42,4,11,9,2,6,5,2,5,9,5,9,21,4,19,7,8,5,28,22,10,56,12,6,7,6,5,9,8,13,3,24,13,3,4,18,7,3,28,19,6,1,2,5,2,10,0,16,7,5,9,10,7,23,8,9,12,7,4,6,3,20,2,7,5,12,2,1,12,2,3,2,0
renew,8,14,1,142,9,3,4,26,4,6,12,6,11,49,3,8,5,9,8,3,3,19,8,14,10,12,13,21,0,6,7,149,109,6,26,50,39,6,13,8,6,12,3,17,22,7,16,14,211,28,29,6,13,25,29,4,38,23,9,5,16,4,3,10,22,4,58,4,14,18,4,2,1,2,47,17,16,2,49,12,45,4,16,8,127,17,7,0,33,3,8,6,3,21,30,4,16,2,30,17,3,13,26,10,11,30,6,5,6,7,10,6,14,13,7,20,8,2,48,101,12,11,10,61,11,9,3,5,4,3,11,5,4,29,7,32,9,6,5,6,2,32,23,1,2,57,9,13,7,1,53,4,17,5,3,22,17,2,10,13,4,2,8,1,7,16,2,26,13,14,15,60,9,1,2,8,120,2,9,30,19,9,10,14,1,17,20,6,25,43,3,1,9,5,3,3,19,4,7,3,16,5,3,17,17,4,5,12,13,14,58,9,12,4,2,18,0,2,12,1,6,14,2,15,23,56,17,13,3,6,9,3,8,10,15,11,20,10,8,5,40,19,4,3,11,6,10,15,35,1,12,8,26,3,8,12,7,3,5,9,6,15,16,4,2,28,7,5,8,8,90,11,19,5,6,0,8,0,8,0,45,4,1,16,10,2,10,7,3,3,2,7,11,5,1,6,25,12,0,6,19,27,2,4,4,2,14,1,4,3,1,5,25,10,28,8,7,40,12,1,32,6,10,2,34,2,5,22,3,20,3,6,2,2,2,12,16,7,1,13,6,6,10,6,4,4,24,34,6,17,5,11,6,17,13,3,10,3,10,20,15,4,2,11,10,1,21,2,10,10,2,7,3,8,4,32,11,1,12,3,60,2,28,11,6,14,7,12,15,2,21,7,11,11,27,7,49,3,23,2,15,2,2,1,0,4,1,3,15,11,1,11,6,17,9,5,4,7,7,4,4,3,11,4,3,0,5,8,6,16,5,8,0,8,9,4,0,23,3,1,11,16,4,16,2,5,6,7,20,2,13,6,5,13,41,8,3,5,2,20,9,17,13,12,9,1,15,13,2,0,6,8,1,4,2,3,3,12,9,2,4,11,4,4,10,1,7,4,4,6,38,31,1,6,14,3,2,10,6,4,2,3,1,3,5,10,3,13,6,4,4,5,4,6,7,13,7,7,0,8,3,12,3,15,3,5,20,3,11,14,12,4,3,3,7,6,5,6,14,12,5,6,3,0,5,12,4,14,11,7,13,0,8,34,4,5,30,2,2,9,21,5,18,1,18,14,9,4,23,26,9,7,17,4,3,19,4,3,5,10,2,5,9,5,6,1,0,3,7,4,20,23,3,3,16,3,3,2,54,12,17,7,4,6,8,14,4,15,12,3,7,28,22,6,14,1,17,1,3,5,9,2,1,14,5,4,9,10,10,15,10,24,10,9,9,1,7,3,4,6,9,3,3,33,6,7,7,10,6,116,14,1,5,9,6,11,14,10,6,10,9,6,15,26,6,7,4,12,7,7,12,3,29,24,32,3,4,8,2,2,5,17,7,7,13,7,9,5,0,9,15,10,8,6,5,6,4,3,6,8,5,2,19,3,3,8,16,3,3,3,0,4,5,18,15,18,11,5,5,6,12,3,8,26,2,3,4,2,2,9,5,15,1,0,9,2,15,1,17,4,2,5,3,5,8,5,5,4,4,3,8,2,4,5,3,10,7,3,4,7,6,11,7,5,23,10,7,7,5,13,3,2,1,14,4,11,5,2,10,8,0,9,11,2,5,6,7,10,5,9,1,12,12,6,6,4,5,5,3,4,7,6,7,2,4,1,18,2,11,4,6,4,16,6,4,6,7,6,2,9,7,4,8,5,3,4,5,5,2,7,4,5,9,0,5,4,9,16,4,5,12,9,2,1,6,11,1,8,9,9,12,21,10,4,4,3,6,2,2,3,3,2,6,3,4,9,3,2,6,86,2,2,4,8,1,4,6,14,8,4,2,5,4,6,6,4,7,4,3,0,4,8,5,5,9,5,3,5,5,3,5,7,2,6,4,2,1,10,3,7,3,3,5,6,7,7,1,4,1,5,6,9,0,13,0,3,12,22,7,3,5,4,5,6,2,1,6,0,3,8,3,15,0,2,4,11,16,11,3,2,5,4,7,0,3,3,0,1,10,4,1,2,2,4,1,10,2,0,2,3,4,5,7,6,4,12,0,2,8,2,4,3,4,2,3,2,3,3,12,5,3,0,4,6,0,4,0,7,3,3
district,0,41,19,302,7,7,2,46,2,7,13,72,5,52,4,5,6,27,0,1,5,58,11,18,33,22,6,12,4,12,6,186,109,18,48,11,18,5,5,5,3,2,4,7,21,8,13,16,390,5,27,4,12,3,32,8,66,59,2,12,17,0,2,11,14,4,93,4,9,6,5,10,4,7,61,8,14,6,70,25,51,0,12,13,251,8,21,0,33,6,7,7,1,17,58,6,11,2,24,6,19,36,30,2,9,23,1,1,10,3,15,3,10,29,1,31,11,9,139,81,38,2,10,61,9,0,4,4,4,2,3,6,9,71,15,53,7,8,2,5,0,32,30,1,4,62,11,24,20,26,105,0,15,3,4,51,22,3,4,9,14,1,10,1,1,1,5,22,34,4,22,125,30,5,5,8,173,0,4,45,18,7,7,10,5,22,37,17,66,53,7,1,2,0,1,3,37,8,11,3,14,0,2,9,21,5,5,38,7,13,75,5,41,2,4,2,0,2,41,8,0,27,9,17,42,222,29,20,5,2,19,27,4,26,14,25,28,5,1,11,69,28,5,8,6,9,5,13,87,7,26,6,11,16,13,23,7,0,2,42,18,18,16,17,2,32,24,1,19,9,115,1,20,7,13,1,10,14,13,13,50,5,0,21,11,6,8,16,9,3,7,1,15,4,2,12,37,5,6,17,27,62,1,1,24,6,15,3,11,1,3,33,9,4,21,10,7,66,32,3,39,10,33,45,48,24,16,19,0,56,7,13,11,9,4,28,8,15,5,9,2,7,23,10,7,4,46,59,13,7,21,17,6,25,18,2,11,9,12,14,54,9,6,26,5,0,23,7,4,5,6,13,4,11,10,19,15,1,6,9,37,2,37,13,23,56,15,22,36,0,41,5,34,20,43,15,85,2,24,2,33,7,0,0,8,11,8,3,3,9,1,13,0,34,3,7,2,9,0,0,1,5,15,9,12,5,2,3,8,5,3,5,2,24,4,3,0,6,9,9,27,15,7,0,0,1,3,4,55,8,5,2,6,0,28,15,2,19,6,28,16,13,24,12,6,0,18,10,9,0,12,1,8,8,4,15,2,34,14,4,3,15,1,1,3,19,12,2,4,15,22,42,2,4,6,7,8,14,14,18,16,7,5,2,8,5,12,14,6,4,0,7,9,8,6,14,3,18,1,12,4,10,12,36,23,11,13,9,20,30,3,12,0,20,9,6,12,2,18,10,2,4,0,8,1,9,1,16,6,15,64,9,6,61,12,7,11,2,13,12,37,15,58,1,13,18,7,8,30,38,5,13,15,18,12,4,8,10,5,25,6,13,8,8,7,13,10,10,9,9,18,17,24,7,44,0,2,4,13,7,20,3,5,1,7,21,6,18,11,6,21,10,66,2,67,10,25,3,18,3,13,0,3,35,2,15,5,13,16,60,1,49,23,16,16,3,20,11,3,4,9,15,73,32,3,18,12,5,21,195,5,8,1,5,12,4,18,14,13,9,12,8,9,0,3,2,0,10,11,11,23,9,12,238,18,2,29,12,0,6,6,26,10,8,17,5,7,6,6,13,13,3,10,8,7,14,12,9,13,18,2,3,5,13,13,7,6,3,10,6,8,19,2,20,30,12,1,3,1,2,22,12,0,52,1,18,3,5,12,11,4,11,18,3,7,6,13,5,96,25,11,6,11,7,1,3,2,9,2,14,6,1,1,15,7,12,6,21,14,13,7,7,4,8,41,1,104,4,8,9,10,2,6,26,4,10,1,8,10,18,3,5,5,0,20,9,7,36,6,20,12,1,252,10,9,21,5,8,2,17,3,6,21,4,4,1,2,4,23,9,2,1,15,5,3,3,7,4,5,7,3,2,2,45,18,0,2,28,4,5,15,4,20,4,8,6,3,28,20,4,5,23,33,19,3,6,5,0,8,8,10,29,5,4,9,5,3,14,9,7,12,17,8,0,8,13,1,10,6,23,8,5,2,3,7,7,0,5,15,0,4,4,5,1,92,3,7,6,4,3,4,31,2,3,2,6,4,26,18,3,4,3,1,22,12,0,2,0,0,17,6,5,11,7,17,4,10,2,2,3,2,3,9,1,1,14,1,3,1,2,16,5,2,4,3,0,5,5,3,44,1,11,2,2,3,10,5,6,22,1,4,2,2,4,7,6,5,1,30,3,2,9,6,17,3,12,7,5,13,2,2,4,3,7,5,1,2,6,15,25,1,4,6,0,2,9,5,1,10,2,2,4,6,0,10,7,3,12,2,0
columbia,3,17,8,127,5,4,1,15,0,4,5,44,2,24,0,1,0,16,0,0,2,11,4,6,21,8,8,6,2,7,0,127,53,12,16,6,2,2,0,3,0,2,3,6,12,2,14,17,154,1,9,2,8,3,20,0,17,31,0,8,12,0,2,5,2,1,32,0,1,11,7,8,1,2,28,7,9,1,21,9,20,0,1,4,94,3,5,0,13,5,1,6,1,5,28,1,6,2,11,5,10,10,13,1,2,13,0,0,2,2,5,2,2,16,0,9,2,5,49,50,13,0,3,30,3,0,0,1,1,0,2,3,4,33,9,37,3,1,0,0,0,11,5,2,0,24,5,12,10,6,31,0,6,10,2,28,15,1,0,5,0,1,2,1,0,2,3,11,9,3,11,46,12,7,5,5,59,2,2,21,19,3,4,4,7,8,13,7,37,45,2,4,2,0,0,2,18,9,7,1,6,0,1,1,14,1,1,13,26,4,29,3,16,1,1,2,0,0,15,7,0,16,4,14,9,76,9,10,2,1,9,12,2,17,7,5,16,3,0,1,34,12,1,3,5,2,2,4,35,2,12,4,7,7,6,5,1,0,1,11,12,3,19,2,1,10,6,0,15,3,33,0,8,3,7,1,4,7,4,14,21,2,0,8,4,3,3,7,3,1,10,0,4,2,1,7,17,4,0,6,12,22,0,0,9,2,8,1,7,0,1,20,4,0,6,3,5,22,15,0,28,3,13,11,24,7,11,7,0,12,2,3,1,4,1,9,4,7,3,2,2,2,9,1,4,12,15,28,6,4,11,11,6,10,8,0,2,9,3,9,26,5,8,11,2,0,15,4,1,4,1,4,4,5,5,8,3,1,5,4,11,1,12,6,14,16,6,8,13,0,8,4,19,18,15,10,36,0,10,1,19,2,0,0,2,7,1,0,5,7,0,18,0,16,0,2,0,6,0,0,0,4,6,5,8,4,2,2,5,3,2,3,2,11,6,0,0,28,1,1,13,6,2,2,0,1,1,0,19,5,2,0,3,0,46,8,0,7,4,17,8,5,7,8,4,0,11,6,9,0,6,0,7,4,1,6,1,14,6,1,1,5,3,1,2,5,5,1,2,4,6,11,5,2,2,0,2,3,5,7,6,6,2,1,9,2,1,5,1,0,0,2,0,5,3,4,1,7,0,5,4,6,3,11,5,4,5,1,5,8,1,4,1,6,3,1,4,2,5,2,0,2,1,2,0,3,0,14,1,4,17,1,3,20,4,1,13,0,4,4,22,8,26,2,6,6,2,3,10,12,0,8,11,6,10,36,2,6,3,13,2,3,1,2,2,8,3,2,2,4,17,8,6,4,28,0,2,2,10,5,8,0,0,1,7,12,2,6,3,1,6,6,20,6,15,3,9,2,3,2,6,0,3,7,2,4,1,4,6,19,0,18,8,9,5,1,8,14,3,1,5,7,3,14,1,8,10,7,17,95,11,2,0,3,3,5,15,9,3,11,4,13,5,31,1,0,0,11,3,7,5,2,3,34,3,4,14,4,3,4,9,18,5,7,8,1,2,2,1,11,9,1,2,27,3,14,4,5,5,7,4,3,2,6,4,5,3,1,1,3,0,9,2,11,9,4,2,1,4,2,1,4,0,13,1,3,4,2,2,4,1,8,3,1,3,7,3,5,52,9,7,2,5,6,9,1,2,9,0,6,1,1,1,12,6,6,0,12,5,2,2,2,0,5,14,2,40,3,4,5,4,2,0,3,2,3,0,6,1,11,5,5,7,0,3,3,2,0,0,3,12,252,1,5,4,13,4,2,2,4,6,0,5,5,3,0,0,0,8,4,0,1,28,4,0,1,2,1,4,2,1,10,0,23,17,1,2,14,0,8,11,2,8,0,0,2,1,10,4,5,3,10,6,7,1,3,2,4,4,4,10,8,0,1,7,4,0,1,1,4,4,3,0,1,2,2,0,3,2,14,7,1,0,3,3,2,3,0,8,4,0,2,0,0,29,0,2,1,1,3,6,53,1,0,0,4,1,5,10,1,3,0,0,10,3,3,0,0,0,7,1,3,3,3,3,1,4,4,2,1,6,7,6,0,0,3,2,7,0,0,6,7,0,5,0,0,2,1,1,22,0,5,2,1,1,4,4,1,10,0,8,4,2,3,5,1,1,2,14,0,2,7,0,8,1,2,5,3,4,8,0,2,2,2,0,2,2,4,11,10,1,1,2,0,4,1,2,0,0,0,2,0,1,0,3,0,2,8,1,0
reference,1,9,3,84,4,5,4,22,1,0,17,6,4,36,3,7,4,10,3,0,6,21,3,11,15,2,5,4,2,5,5,102,69,6,24,25,19,5,6,1,4,2,0,1,11,8,18,4,158,15,21,1,7,18,3,2,50,23,0,9,10,3,2,12,9,0,47,9,8,9,8,3,3,2,38,5,5,3,41,15,21,0,6,1,120,3,6,0,25,0,0,1,0,15,31,4,5,6,14,11,15,17,17,6,8,15,7,1,6,6,8,3,3,9,0,10,4,5,51,63,12,7,9,40,4,2,4,1,2,2,5,0,7,25,11,17,8,0,4,6,0,13,16,1,3,28,3,17,4,2,29,1,9,3,4,3,12,3,2,4,5,1,3,0,1,1,2,6,6,2,2,46,6,0,1,5,98,3,2,13,5,7,0,4,3,9,8,13,25,35,1,6,4,1,0,1,10,3,7,11,13,4,0,5,12,2,2,25,4,20,33,1,11,9,0,0,0,6,16,0,4,6,3,13,22,52,16,20,2,8,13,8,8,6,16,23,14,6,5,6,38,14,2,2,7,0,2,13,23,5,6,15,6,8,8,6,9,3,0,12,2,12,11,0,5,24,0,0,3,1,75,4,22,3,2,1,7,9,5,1,27,2,0,18,5,2,3,1,10,1,4,3,13,3,1,5,17,4,4,19,14,14,0,2,7,2,11,2,3,2,0,6,18,0,23,16,13,29,5,3,20,4,13,1,27,2,8,6,1,10,0,4,7,3,7,15,5,2,3,10,4,3,10,10,5,1,30,31,10,3,6,8,4,10,12,2,1,5,3,15,13,4,5,8,5,1,18,10,3,2,1,8,4,6,5,20,6,3,19,2,28,2,20,13,2,22,2,20,12,4,13,1,8,5,24,9,39,8,22,7,16,0,4,0,1,5,4,1,15,4,6,8,11,7,3,3,3,3,0,1,7,6,18,8,1,0,2,12,2,7,14,7,2,4,2,4,0,6,6,1,3,17,4,6,0,0,1,4,19,3,8,3,1,5,27,8,0,7,2,15,4,14,13,12,4,1,10,2,2,0,14,0,2,1,2,14,1,14,5,2,1,9,4,0,3,1,10,0,4,1,34,20,0,1,4,4,3,10,3,4,4,3,6,0,6,24,2,9,2,3,1,1,1,3,9,11,2,14,2,3,4,9,8,15,2,0,15,1,8,19,5,3,2,9,7,4,7,2,17,6,0,3,1,1,4,3,2,6,9,5,14,2,4,16,5,10,14,4,4,6,19,2,19,3,12,15,9,5,16,20,10,7,16,0,5,1,16,5,7,10,5,6,2,5,5,7,3,4,2,3,27,22,0,2,16,4,8,2,23,4,15,2,3,3,3,11,13,17,7,1,16,6,7,3,17,2,14,0,2,3,12,12,1,12,0,7,3,6,14,24,12,15,19,9,4,2,3,3,4,8,6,1,8,7,4,27,5,0,5,91,13,2,5,2,3,5,16,6,3,11,7,8,10,10,6,4,8,5,10,5,17,10,10,6,10,3,4,8,5,4,3,10,10,4,4,10,7,4,2,8,6,1,8,13,1,5,10,3,6,10,2,6,9,5,10,6,9,3,6,5,2,9,6,21,5,3,4,6,3,2,4,5,4,10,2,3,2,0,7,10,6,7,5,2,3,0,12,2,13,7,4,2,1,12,8,2,5,6,3,6,9,5,1,6,4,6,4,12,2,4,4,3,2,3,9,12,3,6,6,4,5,2,2,7,4,5,6,4,5,7,0,6,4,1,3,7,3,4,10,9,6,10,5,1,7,10,5,4,3,15,2,1,8,4,1,1,0,3,6,3,18,4,11,5,2,2,4,2,2,5,1,2,1,9,7,2,0,6,6,1,2,4,8,1,4,10,8,11,5,6,2,1,4,7,2,5,4,4,9,6,13,17,4,6,0,5,4,3,2,2,12,2,5,2,1,5,3,3,5,12,5,6,1,11,1,10,2,5,6,0,6,5,1,1,9,3,2,1,1,7,2,5,0,3,6,4,2,2,2,0,2,4,2,2,8,2,5,10,2,9,1,3,2,8,5,4,0,2,2,1,5,8,2,8,0,3,2,11,2,11,9,3,6,5,4,6,1,4,1,10,1,2,6,3,4,6,13,14,21,4,0,1,4,3,3,6,6,3,9,4,6,2,7,4,1,13,6,2,5,3,4,3,0,0,3,1,1,5,6,3,3,4,6,7,5,1,6,0,9,0,4,2,6,0,0,3,0,3,1,0
railroad,1,7,3,153,15,5,5,53,3,9,18,7,8,57,3,19,7,12,0,2,7,17,12,47,52,22,17,9,4,21,4,251,105,11,78,52,4,8,9,0,7,10,4,2,56,12,23,25,169,8,55,10,25,13,8,0,34,47,0,21,18,1,1,12,10,12,61,11,10,54,6,8,14,7,127,21,26,4,57,53,70,2,11,8,266,24,11,0,58,1,21,7,1,19,135,94,9,12,20,27,38,62,23,11,12,47,10,9,16,2,34,6,8,13,0,28,11,6,65,224,48,25,11,88,9,1,9,2,11,0,6,1,2,57,14,59,8,4,13,7,10,37,19,1,4,65,6,18,38,5,127,4,15,6,2,54,41,7,8,10,15,1,13,3,6,21,10,45,21,3,30,117,29,3,6,4,202,2,3,68,59,4,5,52,39,41,49,31,31,34,3,8,11,1,8,9,8,4,2,22,114,3,4,8,16,8,5,37,9,24,130,4,28,9,10,6,1,0,9,3,3,20,7,13,58,190,51,30,4,4,10,6,29,77,40,12,30,12,3,18,40,18,7,9,12,4,3,21,90,5,3,24,17,8,10,18,17,1,1,33,95,17,15,4,17,49,4,5,15,5,59,7,56,19,4,1,20,19,8,2,43,16,6,16,13,3,2,10,27,0,9,0,14,6,8,8,36,8,4,15,19,20,4,6,5,1,5,5,16,6,0,75,12,7,37,33,18,53,15,6,25,7,11,9,57,5,25,15,3,12,2,23,11,4,14,43,20,11,1,9,6,4,12,10,16,33,46,27,17,6,15,4,6,43,41,66,2,2,6,51,63,16,28,18,14,3,22,10,9,24,1,10,1,15,20,58,5,15,28,5,79,3,56,12,11,62,13,24,15,1,33,4,9,2,17,7,58,14,34,4,12,1,2,1,5,26,17,0,22,22,3,16,7,15,5,10,4,9,10,2,15,11,36,11,2,12,4,32,7,5,5,9,2,12,3,3,0,4,2,11,59,29,16,8,4,8,22,4,40,9,33,5,2,2,43,2,0,4,34,43,19,29,28,55,7,8,7,21,23,1,35,20,8,4,4,72,1,13,31,6,9,2,2,2,17,7,12,0,11,1,27,55,0,0,3,6,5,12,3,14,22,2,8,2,72,8,8,14,12,6,5,3,9,36,12,17,1,13,55,13,8,34,26,65,22,5,46,52,21,52,17,12,0,32,13,4,12,37,48,127,5,0,2,13,11,6,23,10,26,29,28,2,8,49,1,16,92,22,2,18,16,14,12,7,18,24,16,18,24,73,6,2,24,2,7,5,11,8,10,27,5,16,21,21,9,17,9,10,5,18,12,38,16,9,43,7,19,19,18,15,21,10,4,3,8,22,7,10,9,2,40,115,8,1,40,3,14,19,25,6,14,0,6,19,1,8,14,6,14,21,1,37,56,22,5,6,21,19,5,20,5,1,19,14,8,20,9,6,30,75,16,8,3,1,18,10,28,19,5,18,12,7,4,1,1,1,2,4,19,8,23,8,8,34,22,4,3,8,31,2,12,46,9,10,10,1,8,4,6,8,7,8,14,74,1,24,5,9,8,10,11,4,16,23,12,3,8,6,4,4,0,12,4,11,31,11,7,3,4,12,2,21,12,14,19,5,14,6,5,14,17,19,18,11,9,4,3,6,21,7,27,13,6,22,3,6,14,16,7,11,6,11,11,35,22,9,8,3,16,19,23,15,2,7,16,13,11,6,5,8,0,3,1,15,3,18,6,6,8,11,1,9,7,15,21,3,4,0,4,24,6,9,4,7,1,20,79,14,7,2,4,5,4,1,3,8,5,8,22,3,12,13,21,9,5,5,7,7,5,9,4,9,2,6,15,1,8,9,2,2,24,4,1,3,4,3,4,30,18,2,0,9,9,17,14,25,15,43,8,14,9,41,18,5,12,0,13,14,5,4,5,4,7,8,7,4,3,7,1,25,4,5,13,3,3,4,1,0,6,3,0,8,2,1,12,3,9,10,0,8,16,21,2,2,5,12,0,1,7,2,6,1,1,4,1,7,2,3,5,16,4,5,1,14,11,5,2,4,11,4,5,3,0,3,0,8,0,1,2,2,3,8,3,5,4,8,10,16,16,8,1,6,17,0,8,13,20,14,26,3,1,6,2,0,5,5,28,12,9,1,57,17,0,15,4,19,10,3,3,12,4,4,2,5,5,5,0,2,16,4,50,9,4,1,4,9,3,4,2,0,3,1,2,0,0,2,9,4,0,0
ought,8,33,8,221,4,8,6,70,12,5,20,20,13,124,16,14,7,28,7,9,6,52,22,37,23,22,13,22,10,29,15,339,200,12,85,65,51,18,20,11,25,7,5,7,58,23,31,17,400,26,67,4,17,36,31,11,116,39,2,18,25,20,5,11,45,15,199,12,13,26,17,10,9,7,142,25,40,7,117,33,69,0,22,19,349,71,24,1,31,7,5,8,0,42,84,26,31,9,40,29,29,46,45,26,20,28,19,13,24,8,34,3,9,23,5,48,8,7,93,283,53,34,37,90,8,3,5,2,6,4,34,7,7,45,46,111,17,9,8,8,6,58,34,10,2,89,16,16,27,28,102,3,16,21,7,40,34,10,12,20,22,19,16,2,6,22,12,37,31,14,19,143,41,11,11,13,236,6,12,81,52,18,5,37,11,27,54,44,74,86,5,12,7,0,13,2,42,10,14,25,49,9,7,24,38,12,10,62,17,41,125,15,44,17,0,7,7,10,29,7,4,24,7,36,78,171,34,42,7,28,28,16,33,23,63,38,61,21,17,15,119,59,8,16,25,11,10,41,92,7,16,38,20,10,15,46,9,4,9,21,7,33,30,4,7,60,7,10,31,9,254,9,40,18,10,2,31,21,9,6,113,22,4,30,19,8,24,40,28,3,3,0,22,6,3,18,52,11,16,27,40,47,5,4,13,4,21,7,13,6,7,54,34,9,70,26,38,61,18,11,66,17,46,13,122,8,27,45,7,43,5,30,12,12,21,17,15,8,1,14,22,7,29,36,18,15,81,66,23,19,24,15,15,82,35,16,10,11,43,26,46,20,19,26,5,3,44,15,27,51,6,54,9,26,22,41,15,7,24,19,117,2,60,14,10,94,9,42,36,16,48,7,22,19,41,28,83,7,54,3,26,3,12,1,8,11,24,1,37,20,1,14,6,32,8,20,3,15,9,0,6,13,17,25,8,8,6,23,20,13,33,5,3,15,2,5,0,12,17,7,25,48,25,14,2,8,16,6,63,8,32,17,7,10,78,19,2,11,18,42,21,48,40,32,8,8,28,15,9,2,22,9,4,9,9,29,10,15,43,12,22,12,4,8,3,14,22,4,11,5,83,65,3,7,10,13,8,26,11,13,23,16,12,10,13,58,21,35,6,5,8,18,13,15,25,31,11,19,28,15,11,35,17,46,9,8,59,9,14,54,25,6,3,25,19,10,18,25,59,45,13,1,3,16,13,12,4,32,22,7,85,7,20,61,12,26,49,8,8,14,38,8,43,7,30,29,26,25,72,67,10,11,39,16,10,14,18,16,29,21,7,19,30,39,19,12,11,15,7,40,40,52,13,4,35,11,9,12,45,42,50,10,8,3,17,29,6,31,13,12,36,28,9,15,77,13,31,9,18,14,25,23,6,31,5,11,14,28,31,37,25,28,74,30,23,8,16,11,7,12,28,7,18,28,5,33,16,6,18,201,30,16,12,17,8,17,58,13,12,27,7,8,11,20,3,4,3,9,8,28,37,11,91,45,37,5,6,13,6,9,29,46,19,9,16,13,12,6,12,11,23,12,29,24,15,13,16,4,21,29,3,8,6,13,11,4,30,6,2,8,17,9,12,29,27,18,6,8,15,18,20,8,9,32,8,15,13,5,7,27,19,19,9,20,16,3,28,11,54,13,17,11,8,17,12,6,18,15,8,15,28,11,2,10,10,15,9,16,10,31,30,25,4,7,40,22,21,17,16,10,14,8,2,25,5,27,13,3,25,18,8,4,19,6,22,6,10,31,27,21,4,21,13,10,20,1,15,13,6,5,17,11,17,6,5,11,13,10,26,9,24,1,23,12,5,6,3,20,10,12,7,4,9,8,4,5,10,10,11,17,11,20,19,3,12,16,5,33,12,11,10,20,11,26,8,18,7,10,11,15,26,30,20,24,13,10,9,9,12,4,2,9,13,6,5,10,5,9,6,16,15,23,23,23,13,17,4,12,22,0,3,7,9,8,12,7,6,5,4,12,4,22,0,2,11,8,4,12,10,7,15,7,2,9,8,4,8,10,7,40,8,8,9,10,35,4,4,12,6,6,10,15,13,22,2,11,7,18,4,18,9,6,13,10,11,6,6,20,8,29,6,19,6,9,16,29,25,26,46,3,0,17,5,4,21,2,8,11,24,6,8,9,8,12,4,9,7,14,12,15,9,8,6,9,5,11,4,7,11,16,4,9,7,16,16,15,15,5,15,7,9,9,5,0,0,14,8,10,4,2
railway,2,2,2,86,2,1,3,12,5,1,13,3,15,21,2,8,5,10,0,0,5,10,4,13,33,3,5,5,1,8,0,116,57,3,34,18,4,1,1,1,3,1,6,7,17,10,32,14,140,5,36,6,12,8,1,1,7,18,0,6,10,0,0,1,10,9,19,6,1,36,9,3,3,1,60,9,18,3,18,33,36,2,1,13,102,12,11,0,19,1,6,1,0,10,60,50,11,17,10,13,49,22,10,3,3,18,3,3,7,2,6,0,8,9,3,25,2,8,36,82,17,10,1,26,10,0,3,2,4,4,6,1,2,25,6,42,7,1,2,1,3,16,18,1,2,38,6,5,13,9,46,0,7,13,4,16,15,3,5,4,49,1,3,1,4,2,2,19,18,5,7,50,27,0,2,1,103,4,3,47,11,3,0,23,35,20,25,15,19,15,2,4,5,0,2,0,27,8,0,3,39,7,4,2,18,2,8,26,7,22,67,5,12,3,2,0,0,0,3,2,0,9,4,8,12,96,46,12,3,6,12,11,10,29,24,3,12,13,0,12,33,13,9,7,2,2,0,9,44,4,18,21,10,2,4,4,2,1,0,6,26,6,16,1,14,47,1,1,9,5,59,9,35,3,1,0,13,5,5,3,20,6,2,4,5,1,0,0,8,1,3,1,7,3,2,4,22,5,0,7,11,22,5,0,10,0,6,2,2,7,1,16,15,7,22,28,7,55,11,7,4,0,15,0,39,6,14,10,1,4,0,4,4,2,2,46,10,3,13,2,4,0,2,7,5,3,22,16,28,3,4,3,4,22,19,39,4,3,4,21,19,1,7,11,7,2,6,4,5,23,6,5,3,2,15,43,3,10,7,0,23,3,44,7,2,29,0,14,14,3,15,2,7,2,10,4,30,4,17,3,14,0,4,0,5,11,14,2,5,6,1,3,2,10,0,4,0,1,7,0,6,4,21,3,0,4,1,6,0,10,3,13,0,4,1,0,0,6,3,8,20,8,10,3,1,0,13,10,22,2,16,2,0,2,15,2,0,5,10,25,6,3,6,23,1,0,6,16,13,0,16,6,1,1,0,21,0,8,31,4,8,4,2,0,6,11,8,0,1,0,13,27,1,0,3,3,8,10,4,13,13,2,2,5,43,9,8,11,30,5,1,2,2,21,10,8,4,7,63,4,0,17,12,21,7,4,36,21,20,14,10,4,1,9,31,1,7,13,18,55,2,0,6,8,9,8,2,17,4,16,8,5,8,27,3,3,59,12,2,9,5,4,19,3,10,8,11,12,21,36,7,3,15,3,2,2,2,8,3,5,1,9,6,3,4,2,4,2,0,9,15,22,11,12,27,0,7,8,11,5,12,4,0,0,3,15,11,4,22,0,26,69,3,3,33,0,10,8,15,0,8,0,2,9,1,4,10,5,11,24,1,13,16,3,1,2,7,9,4,10,2,0,9,18,10,11,8,3,9,72,7,6,2,0,4,7,19,5,1,4,3,2,4,5,4,3,2,0,7,2,7,2,8,22,11,3,5,9,24,0,22,45,7,3,1,0,1,3,2,3,8,3,3,39,9,19,1,5,5,4,19,2,7,13,8,1,14,5,0,2,0,1,3,5,17,2,1,2,2,6,0,9,1,1,5,0,12,1,2,6,6,8,2,3,1,18,4,1,13,5,16,3,12,10,10,8,12,21,3,9,5,0,1,1,1,3,4,11,5,13,10,3,3,6,11,5,14,8,7,12,3,2,4,6,9,4,15,4,0,0,0,0,2,7,4,20,3,1,2,8,5,5,4,5,79,15,1,8,5,1,17,1,3,1,2,4,3,5,7,1,1,7,6,4,3,4,3,3,2,3,1,2,2,5,2,3,4,4,0,1,18,2,4,1,1,3,5,10,8,0,0,0,10,23,11,7,14,21,7,0,7,23,2,1,0,1,15,9,1,1,6,4,1,7,2,3,4,1,3,13,1,9,14,2,4,1,0,2,1,7,1,5,1,2,3,1,13,4,0,7,8,3,1,4,7,1,2,3,2,0,4,2,2,1,2,3,1,3,1,2,4,24,2,2,8,3,0,4,3,1,4,1,2,2,2,5,4,1,7,2,1,9,9,3,2,4,11,1,3,5,1,2,5,0,1,9,4,6,10,2,0,8,2,3,1,10,13,5,9,1,11,1,0,35,1,4,4,0,0,2,0,6,3,0,1,1,0,3,7,0,71,1,0,1,1,4,0,1,1,0,2,1,0,0,0,0,2,4,1,0
contain,5,20,8,153,12,5,5,26,4,0,10,12,3,35,5,4,3,6,5,2,6,19,4,15,8,9,4,8,8,25,5,131,69,4,30,22,15,4,7,3,2,2,4,7,25,10,16,12,216,16,34,2,9,10,3,2,46,109,3,7,19,6,2,22,8,3,46,6,5,12,14,4,5,3,36,9,12,6,56,12,38,0,6,5,139,14,7,0,57,3,4,1,3,33,30,18,9,5,16,11,12,26,21,6,6,32,7,6,15,9,16,5,5,10,0,23,8,1,67,95,23,8,27,54,5,3,0,2,2,2,11,4,5,42,12,31,4,4,1,3,3,20,20,2,1,49,4,7,14,14,28,1,7,5,2,14,11,1,2,13,11,3,2,0,4,6,6,11,21,1,23,62,12,1,0,4,145,4,5,15,18,9,4,15,7,11,30,13,21,34,6,1,8,2,1,4,9,1,9,14,15,0,0,12,13,5,5,20,7,14,54,8,32,7,1,1,4,13,9,1,0,9,5,10,36,84,21,17,2,8,10,15,13,8,17,12,28,5,4,4,43,27,4,8,6,3,4,9,41,2,15,13,16,9,18,5,4,3,1,24,3,18,33,7,11,67,9,2,6,3,81,16,27,4,7,0,24,14,17,6,26,8,6,13,8,5,2,8,11,1,8,9,32,4,4,5,28,33,10,10,10,29,4,1,6,1,11,7,1,2,1,4,20,3,13,27,9,21,8,3,28,3,11,11,50,3,3,12,5,12,9,9,5,7,1,13,12,6,0,6,5,13,5,1,5,2,31,31,7,2,12,8,6,23,9,3,0,6,9,23,20,4,7,8,1,2,25,5,6,16,3,10,5,5,7,28,4,0,4,3,59,5,34,10,4,33,10,20,20,1,22,5,24,23,21,7,65,4,25,6,21,3,3,0,3,3,6,2,11,8,0,7,6,10,5,6,9,6,5,0,3,6,14,5,1,3,4,8,5,10,6,10,7,14,0,5,4,12,7,3,16,19,4,10,1,7,4,4,32,3,6,6,2,1,42,8,0,11,6,24,5,15,27,21,3,3,10,4,7,1,10,1,2,1,3,13,2,16,11,3,4,5,3,6,5,7,3,2,2,6,51,25,0,1,7,14,4,5,7,7,9,6,4,2,13,7,7,12,6,2,2,0,5,4,8,17,3,2,20,6,5,14,3,8,2,6,17,5,19,12,10,3,7,6,9,3,7,3,25,12,2,4,2,8,6,7,1,13,10,2,27,7,10,35,3,1,18,3,6,8,18,4,34,4,7,13,12,7,24,23,9,7,16,5,5,9,10,2,7,23,5,10,4,7,2,0,2,6,8,3,20,13,5,4,18,1,1,0,56,21,23,1,5,8,7,9,3,25,3,3,18,26,7,0,32,8,13,4,6,5,12,5,0,9,2,4,15,3,4,23,12,40,8,14,7,1,4,16,1,9,8,2,7,16,6,70,4,4,6,127,13,3,3,5,4,12,24,7,6,10,7,3,21,15,8,10,1,4,8,9,8,5,44,28,21,6,16,10,2,5,5,19,8,6,19,10,4,1,12,19,11,9,12,18,3,9,4,8,20,13,2,3,18,3,5,8,2,7,6,13,2,15,6,13,12,30,9,3,5,5,8,9,4,21,0,6,6,0,2,4,3,12,6,1,6,6,23,2,39,7,9,7,10,6,7,2,11,8,0,12,4,7,7,10,5,9,4,17,7,15,14,6,2,5,14,11,11,5,10,9,4,5,0,13,2,4,0,2,24,5,10,3,8,6,14,7,9,22,7,12,5,8,2,4,14,13,8,1,1,3,2,5,7,10,1,4,1,1,11,6,6,3,10,7,3,4,7,1,3,11,2,6,17,11,7,5,10,18,9,4,9,2,3,1,5,2,1,17,9,10,10,2,5,10,8,7,5,10,20,5,6,29,8,4,1,5,3,8,4,2,5,3,9,1,1,4,6,5,5,52,9,5,1,5,1,3,3,11,16,1,3,14,4,5,15,4,5,12,5,2,3,8,1,4,7,7,6,1,13,2,2,6,2,4,1,4,2,11,4,11,0,5,4,11,6,8,7,4,2,4,3,7,2,9,1,5,4,16,6,2,7,4,4,6,3,7,2,8,6,12,2,10,13,0,2,11,1,27,20,6,3,8,3,6,6,7,24,4,17,7,18,6,4,3,2,8,15,7,7,9,1,2,8,2,3,2,1,4,9,8,6,5,4,6,17,7,1,2,8,0,1,1,5,0,2,7,0,3,0,2
gratify,3,4,0,58,6,0,2,11,3,0,12,2,3,19,0,1,2,4,4,2,2,16,3,4,4,4,0,5,0,5,4,69,67,0,14,13,27,4,6,4,1,1,2,4,21,6,3,5,119,8,12,3,12,16,3,2,18,32,0,21,13,9,2,11,3,2,29,1,2,3,6,4,2,1,15,4,2,2,26,9,46,0,8,2,88,9,8,0,35,3,11,4,0,12,34,10,5,4,19,12,11,9,16,3,10,16,8,3,7,0,10,3,4,3,1,15,4,1,28,36,13,5,3,61,5,2,5,2,1,1,5,4,3,19,6,15,1,4,0,3,1,11,22,3,1,28,2,11,8,12,16,0,9,6,2,6,4,2,1,4,4,2,5,2,1,1,2,10,6,5,8,18,5,0,0,4,55,1,3,4,6,8,0,2,2,11,14,5,13,31,0,0,6,0,2,0,1,1,4,0,12,0,1,2,10,3,0,14,1,9,31,0,2,2,0,0,1,2,3,3,7,7,5,4,20,37,27,11,2,0,8,8,11,5,10,23,11,5,5,6,15,13,1,1,6,0,5,4,15,5,5,8,10,11,7,7,9,1,4,10,4,12,5,4,2,36,5,4,6,4,59,0,29,4,3,0,6,18,7,1,19,2,3,6,4,0,4,6,6,0,1,5,1,1,4,6,31,4,2,3,10,7,0,6,6,1,13,3,2,1,2,4,11,1,14,13,11,29,8,4,19,5,8,3,8,2,4,21,2,16,0,4,2,0,2,5,4,10,2,10,4,3,3,0,5,1,13,18,5,3,7,1,3,9,4,5,1,2,9,20,3,1,2,4,3,0,16,3,5,2,2,4,2,5,2,25,2,2,4,4,20,1,21,5,0,11,1,10,13,0,8,1,3,0,19,4,16,2,10,12,10,2,3,0,1,1,2,4,18,7,5,1,11,8,1,2,3,3,1,2,4,7,3,1,0,0,3,7,4,8,16,8,9,6,3,9,1,8,6,2,5,6,3,3,0,2,5,3,16,1,6,10,0,3,17,2,1,3,0,16,3,6,15,10,3,3,8,5,7,0,6,0,0,2,1,3,2,8,5,2,0,7,0,4,7,0,5,1,2,1,31,15,1,0,7,1,3,11,9,6,4,6,6,0,2,9,5,8,0,4,5,2,3,1,6,4,2,5,0,2,6,5,1,5,2,5,9,0,6,8,2,2,1,1,2,4,3,5,15,6,2,3,2,0,3,2,2,9,6,1,2,4,2,25,4,1,25,3,4,4,8,3,8,1,6,8,10,4,12,15,3,3,7,0,6,1,3,2,2,4,14,5,3,4,1,1,2,3,2,2,3,15,3,2,5,3,0,5,18,9,6,1,1,1,2,6,2,1,6,2,10,6,6,3,8,4,10,2,3,2,8,10,8,13,2,0,4,5,5,11,6,10,5,2,2,0,1,1,2,13,1,0,1,10,4,27,5,7,2,68,9,4,3,2,2,7,11,1,0,5,2,0,4,2,6,2,3,5,1,6,10,2,14,4,16,0,1,7,2,0,5,11,7,3,5,4,5,2,0,3,4,6,14,8,5,15,3,0,7,6,7,4,7,2,8,3,11,2,4,0,2,13,3,9,7,12,4,7,3,6,2,1,1,16,1,5,1,1,2,7,4,7,2,0,2,1,17,2,8,2,3,2,2,7,2,0,12,3,4,3,5,10,4,16,6,8,4,4,4,16,16,26,3,5,6,8,8,3,17,9,1,2,0,3,3,6,5,1,15,3,10,2,9,2,6,9,1,1,6,7,3,2,2,3,7,6,5,1,1,5,3,3,1,3,0,5,9,4,6,7,2,2,3,3,2,0,4,8,2,6,1,7,3,4,6,1,1,5,10,3,7,5,3,1,6,5,4,21,6,4,1,0,1,1,6,3,3,5,2,5,6,6,2,7,0,1,1,5,3,3,4,2,4,3,0,6,0,1,1,3,2,0,5,6,1,4,5,4,4,6,6,3,3,2,7,7,4,5,2,4,0,2,1,7,2,2,2,4,1,0,3,3,6,7,4,7,2,2,3,13,1,10,1,8,2,5,2,9,1,1,3,9,1,0,3,5,2,7,6,1,3,0,4,3,2,2,4,6,0,8,5,9,8,6,3,10,6,15,19,3,3,0,2,0,0,7,4,1,8,5,2,1,7,0,1,12,6,2,2,0,3,0,1,4,8,4,0,3,2,1,11,0,1,7,1,0,6,1,5,0,3,1,12,1,0,2,0,0,1,0
appointment,5,42,36,110,3,0,2,7,2,0,11,12,3,16,5,2,3,8,6,9,0,30,0,14,18,6,5,3,2,6,2,153,49,15,28,11,20,2,0,0,3,1,0,6,11,11,9,16,185,2,21,1,0,12,1,2,42,23,0,6,2,0,0,6,16,0,38,6,3,3,1,2,3,9,28,6,5,1,27,6,18,0,5,0,139,6,5,0,25,2,7,2,0,16,19,1,3,16,17,9,4,9,27,1,3,15,1,2,4,0,3,2,0,11,0,3,4,6,31,55,20,7,0,30,3,2,2,5,4,1,3,2,0,20,13,21,1,6,4,2,0,6,19,1,1,39,1,5,10,7,46,0,5,1,4,24,13,1,5,0,2,0,2,8,0,3,0,2,7,4,5,44,5,0,1,1,108,5,7,21,11,3,1,13,1,4,13,7,22,35,0,1,1,0,0,2,9,3,6,5,17,1,0,8,4,6,1,47,10,10,41,0,18,1,0,0,1,0,87,0,0,5,0,9,36,87,9,12,1,0,10,16,3,7,10,2,13,1,1,3,24,21,2,0,8,2,0,3,68,3,5,2,10,2,5,5,5,0,1,11,10,15,11,1,1,54,1,1,3,4,73,2,4,2,0,0,3,2,3,6,26,9,0,12,7,1,3,3,12,0,8,5,1,3,6,7,20,4,3,8,14,43,0,9,2,0,7,22,2,0,4,0,16,1,5,12,3,21,4,1,27,1,16,0,17,4,2,16,2,22,7,4,7,11,0,1,10,9,1,6,4,5,5,2,1,0,23,29,16,1,16,9,13,10,12,2,7,3,1,11,7,11,2,8,1,3,10,3,26,6,3,8,2,0,7,56,0,1,5,4,32,1,28,6,0,13,1,14,12,0,14,2,8,23,19,0,36,10,20,3,25,0,4,1,0,1,7,2,6,9,2,7,1,12,8,2,7,3,2,0,9,22,15,2,0,1,2,10,0,14,1,3,2,17,1,5,0,6,3,1,4,11,3,0,0,2,0,3,4,2,5,3,1,0,26,44,0,4,0,16,2,7,11,13,9,6,2,12,2,0,1,0,5,0,8,6,1,37,8,0,2,2,0,2,4,6,7,3,1,16,23,19,1,1,3,9,3,7,1,13,1,1,3,1,0,2,0,9,5,5,1,1,7,8,9,4,5,7,0,2,1,8,4,12,2,8,6,0,11,24,2,3,2,7,11,1,10,1,31,10,1,2,0,0,0,10,0,4,8,6,34,3,9,19,4,18,8,1,4,8,14,5,29,3,7,15,5,15,27,21,5,7,8,10,9,1,0,2,1,9,0,4,1,9,3,1,4,7,3,4,19,12,1,2,2,1,0,1,19,16,11,0,3,3,1,10,9,46,24,3,8,60,56,2,23,10,3,0,9,8,6,0,5,9,1,1,3,10,16,29,0,15,7,7,3,1,3,1,0,4,4,1,21,16,4,26,10,4,4,116,10,4,2,3,0,5,12,8,2,7,5,6,6,18,8,6,3,5,10,4,16,3,17,37,15,0,7,7,1,5,1,8,3,9,11,11,6,1,5,2,12,9,6,2,3,7,8,18,9,10,0,4,9,2,8,2,7,0,3,4,12,15,0,9,7,16,4,5,7,11,4,2,0,42,2,8,3,4,19,5,1,10,0,3,6,16,12,2,29,7,9,5,1,1,1,3,5,2,6,11,7,1,0,8,5,3,1,11,7,4,4,7,3,1,18,0,9,14,1,10,11,1,1,34,3,3,1,2,14,3,4,1,5,0,10,3,4,9,1,15,4,17,4,15,2,5,1,3,5,1,2,2,4,3,0,0,2,6,16,7,0,1,2,7,0,5,2,3,8,11,2,5,2,11,6,0,1,12,1,1,2,10,2,2,3,10,7,19,3,4,7,6,8,2,3,2,0,0,0,3,27,21,3,0,0,8,4,3,2,2,4,7,9,7,6,10,0,5,4,18,5,4,2,0,1,4,14,2,5,0,1,3,9,4,33,8,3,6,1,1,0,0,0,1,1,8,3,10,3,1,9,5,1,4,20,3,1,4,1,13,2,1,0,0,3,13,2,0,6,2,2,4,5,3,0,7,3,15,4,3,5,2,5,2,1,0,1,5,4,12,2,5,1,1,1,5,3,0,12,0,1,0,9,1,4,2,1,1,30,3,0,2,31,10,2,2,3,1,3,1,0,1,0,0,3,3,4,3,8,3,1,5,16,0,3,2,0,0,9,0,1,1,4,0,0,0,1,4,0,0
basis,4,10,3,80,3,2,8,19,1,1,15,4,8,38,2,5,1,2,1,0,1,24,3,9,9,3,11,4,1,2,5,102,54,4,23,26,19,2,7,4,9,5,0,1,30,4,24,13,131,6,23,4,8,17,2,2,24,20,0,6,9,3,7,9,10,1,34,2,5,8,2,2,2,3,49,11,9,5,37,8,31,0,4,3,97,19,9,2,23,0,7,2,0,7,21,15,13,8,16,5,4,11,17,4,7,13,6,1,6,2,9,3,2,7,0,13,0,1,38,104,11,11,13,35,5,1,2,0,4,3,8,7,2,20,7,36,2,7,9,6,3,20,14,3,3,30,2,10,8,2,27,2,13,6,5,10,15,1,11,7,19,0,4,0,4,1,0,10,11,3,5,41,12,0,4,6,98,5,5,13,11,4,10,8,2,7,18,9,22,29,1,3,4,0,4,1,13,7,2,11,23,1,1,9,14,5,5,35,10,9,40,2,4,1,1,0,4,7,5,1,7,5,1,5,12,29,19,6,1,6,4,7,9,10,7,12,11,8,12,5,23,21,4,3,8,4,5,14,29,0,9,9,18,5,8,9,3,0,2,6,1,11,18,6,6,34,5,4,10,4,65,6,22,1,5,1,5,12,6,5,28,0,1,6,1,0,5,1,3,0,4,3,5,8,4,9,16,5,8,13,5,15,3,0,3,0,14,3,0,4,2,7,21,6,20,13,3,30,3,7,14,5,4,4,24,1,7,12,5,7,2,4,3,4,2,3,4,3,3,4,5,4,5,5,2,4,15,18,3,1,2,5,1,19,11,3,0,4,12,12,17,3,4,16,1,0,16,1,5,3,1,15,2,6,5,12,5,3,6,3,19,1,33,7,0,14,5,8,8,1,15,4,4,12,28,12,32,4,17,4,13,0,4,0,3,2,6,4,10,5,2,9,3,7,7,2,3,4,1,1,7,3,4,3,0,2,1,3,8,9,6,6,4,6,0,3,3,22,3,3,5,8,1,18,4,4,1,2,16,4,5,2,1,5,31,15,0,6,6,15,3,10,11,9,2,5,7,11,0,0,7,4,1,1,1,2,0,8,8,1,2,8,3,2,5,8,4,2,5,0,19,21,2,1,6,1,3,9,4,5,6,3,1,0,8,25,1,6,14,2,0,2,4,0,6,12,4,5,0,2,2,5,2,9,4,2,7,2,10,15,4,3,1,3,13,2,8,7,14,7,5,2,0,3,3,5,4,13,12,3,9,2,1,18,5,7,22,3,2,4,14,3,9,4,10,5,12,3,13,17,4,4,13,1,5,13,15,4,3,10,4,10,7,8,5,10,4,3,3,4,25,22,3,3,11,4,4,3,26,11,13,0,1,2,6,14,1,10,11,3,10,13,8,2,14,5,18,3,5,2,10,5,1,11,3,2,6,7,5,28,8,7,10,10,5,1,8,3,3,2,9,0,2,9,11,12,7,4,4,83,14,3,5,1,8,4,13,7,1,4,7,4,6,17,8,3,8,4,7,3,5,4,4,10,10,1,1,7,4,2,4,17,5,3,5,2,6,5,1,0,4,3,7,3,4,7,4,5,6,12,0,9,2,0,4,0,6,3,5,1,5,8,0,10,4,5,0,5,11,7,2,2,4,7,1,3,3,0,6,8,1,6,0,8,0,7,0,1,9,4,10,2,2,1,4,4,6,5,3,6,6,8,2,10,5,5,4,10,4,12,7,9,2,5,17,9,3,2,6,12,3,1,7,3,5,8,14,3,8,5,5,3,5,6,3,2,5,0,4,5,7,3,6,2,4,17,17,2,3,2,1,2,6,2,4,1,4,4,10,6,14,2,10,3,3,5,3,6,4,6,2,2,8,10,1,6,3,5,5,4,2,1,4,0,4,1,4,7,4,2,3,2,3,2,5,4,4,11,1,5,16,8,1,5,2,5,3,6,2,0,2,3,1,2,2,5,1,5,8,13,4,4,9,13,4,4,3,8,7,16,2,3,2,8,5,6,6,0,0,1,1,6,3,3,0,4,2,5,3,1,3,2,5,3,2,0,0,7,8,5,5,7,3,3,7,3,0,7,1,4,4,12,0,5,5,2,1,5,9,5,4,6,2,2,2,1,1,3,3,2,2,4,5,0,11,10,8,19,19,5,0,3,1,5,1,6,0,1,13,2,0,0,1,13,2,7,6,0,0,1,0,2,3,5,1,2,3,4,3,3,15,2,5,5,3,22,11,2,21,0,1,2,1,0,0,0,3,4,3,2
near,3,12,7,61,6,5,7,10,5,1,18,2,9,39,0,1,1,16,2,4,3,22,12,8,11,4,2,9,2,13,7,113,48,5,24,47,28,5,6,2,11,6,3,3,21,5,16,3,180,15,22,3,8,12,4,3,29,7,2,7,20,1,4,11,11,3,41,1,6,10,61,6,5,0,37,4,8,4,39,7,35,1,14,6,102,10,5,1,39,2,12,3,0,15,17,4,9,3,22,6,7,17,16,2,5,13,4,0,10,10,8,3,3,5,2,13,4,3,41,71,21,21,7,52,5,1,2,4,6,0,12,5,9,26,16,23,4,2,4,3,2,22,15,4,5,38,5,3,7,12,16,1,12,2,1,7,16,2,7,14,6,3,2,5,4,6,6,9,8,7,12,49,9,1,1,5,80,2,4,20,14,8,2,17,4,20,16,8,15,23,1,3,2,0,1,5,9,0,8,4,6,4,1,11,17,0,2,11,4,15,40,2,7,4,2,1,1,2,8,3,4,10,5,14,14,30,12,9,13,10,10,5,14,9,14,11,20,5,2,3,20,19,4,6,3,3,1,18,13,3,2,12,22,9,6,8,8,4,2,19,1,18,9,1,2,28,10,6,7,3,68,6,31,0,6,4,9,8,6,1,21,2,0,4,4,2,2,7,5,3,12,2,3,5,7,2,39,3,7,5,14,14,0,6,5,1,21,1,2,0,0,2,19,3,20,8,8,16,10,2,27,6,12,11,19,2,5,23,1,13,1,8,4,0,4,3,9,10,0,5,5,12,13,8,1,9,14,26,5,7,7,3,1,12,8,2,6,2,11,24,9,4,3,10,3,1,26,4,4,6,1,8,0,5,1,7,5,2,4,3,26,1,23,5,5,22,3,15,18,4,8,1,7,7,20,4,19,1,28,5,10,2,4,1,4,4,2,8,8,3,6,7,3,11,11,3,4,10,4,1,2,11,8,7,2,3,1,7,11,7,9,13,11,10,3,3,1,8,7,7,7,10,5,14,2,29,7,2,23,1,6,2,1,5,17,4,2,5,4,15,5,16,13,13,3,5,7,7,2,0,14,2,2,2,0,11,3,9,17,5,5,6,7,2,5,4,5,3,1,0,44,17,2,1,6,10,1,12,2,8,13,4,4,1,10,23,3,8,8,0,7,3,10,3,3,1,3,6,0,1,1,22,4,9,3,2,15,2,18,11,5,2,8,9,5,4,7,7,20,9,0,2,1,3,7,5,2,6,4,3,11,4,5,29,5,2,18,3,3,6,12,0,11,2,3,9,8,5,21,17,5,4,8,0,2,1,1,6,8,13,7,11,7,9,5,1,3,3,1,6,6,20,2,1,9,2,0,1,21,11,10,0,4,3,6,9,3,9,6,2,10,6,7,3,8,3,8,1,10,6,7,10,1,17,2,5,9,6,7,25,12,11,10,9,3,1,2,8,3,0,5,3,0,18,7,17,2,4,3,116,19,4,4,3,6,15,24,15,2,10,3,9,7,7,5,4,1,7,2,2,11,4,30,14,15,3,3,7,2,3,6,12,11,7,7,5,4,3,9,14,10,2,10,8,12,9,5,4,6,15,1,0,0,3,1,5,9,6,0,4,3,5,2,10,11,13,20,4,3,1,17,5,8,18,2,5,4,0,2,8,5,14,5,1,5,8,7,3,20,5,4,10,2,6,8,2,8,2,1,4,5,19,1,5,0,9,7,8,4,3,4,8,4,0,11,3,9,2,5,8,3,7,4,7,2,4,3,4,22,7,6,2,11,7,4,7,4,21,7,9,6,6,0,1,5,11,1,5,3,2,2,1,4,3,4,1,3,3,12,3,9,7,9,3,2,6,3,6,2,3,4,4,1,13,8,2,3,2,4,4,6,11,3,5,1,3,12,18,4,4,6,5,2,5,4,7,1,1,3,10,17,12,3,5,5,5,0,5,5,1,3,2,6,2,2,4,2,0,0,7,0,2,0,5,3,5,5,3,2,0,0,8,7,3,9,2,6,9,12,3,6,10,1,1,4,9,8,5,3,2,3,8,3,7,4,2,6,4,1,5,1,12,3,14,5,18,3,8,4,3,8,3,3,5,1,3,3,23,3,8,4,2,3,3,2,2,5,8,2,4,2,5,2,11,4,15,3,9,37,2,1,3,0,1,4,9,7,3,12,3,3,5,2,0,2,20,2,1,0,7,9,3,3,0,4,2,1,3,4,4,6,3,9,7,0,3,5,1,13,0,3,3,0,1,0,3,2,3,1,0
accord,5,37,10,130,6,0,7,35,1,3,21,8,3,71,2,10,10,12,5,3,7,46,6,19,20,9,15,8,4,12,20,171,86,10,30,36,29,6,15,5,4,9,8,0,37,32,22,12,366,11,59,7,13,27,5,9,62,22,0,14,37,13,2,14,28,7,121,7,9,17,5,5,4,7,103,10,10,5,79,24,27,0,16,6,204,20,10,0,45,3,8,6,1,33,70,19,20,5,29,14,14,21,41,10,13,17,8,2,14,7,12,8,3,16,0,43,7,4,123,220,41,20,16,70,3,2,5,8,6,1,6,2,9,39,23,25,9,3,5,4,3,35,25,7,4,70,4,9,13,11,67,2,15,6,3,24,32,1,11,3,23,0,14,6,4,2,6,16,22,13,22,78,17,0,5,14,174,11,13,21,21,10,3,14,5,16,30,20,61,60,3,8,7,1,0,3,19,7,13,12,18,0,1,10,31,15,6,28,11,16,72,10,29,9,0,0,1,2,16,2,9,31,3,21,49,108,18,32,5,16,15,15,13,17,27,42,33,11,8,10,62,34,6,5,15,6,3,23,61,7,12,20,22,13,15,10,11,1,4,20,2,18,24,7,4,29,2,4,18,0,121,9,52,4,6,0,20,10,14,3,65,9,3,17,12,2,1,7,10,4,13,3,20,11,4,11,52,2,12,28,33,32,5,5,19,0,35,4,9,3,3,11,16,5,50,17,11,37,17,2,56,12,35,3,133,15,5,16,6,30,20,8,11,2,14,26,24,12,2,14,12,17,14,22,5,5,55,52,16,7,23,11,6,11,29,3,10,8,17,25,17,3,11,16,5,0,47,8,6,10,5,17,7,7,8,22,14,4,26,11,76,6,43,20,0,36,12,23,30,8,39,6,30,22,30,14,44,6,24,0,14,1,6,3,3,4,8,5,18,14,5,8,3,12,31,7,11,7,3,2,4,8,12,4,3,6,3,16,13,29,16,18,11,20,3,10,1,9,14,1,10,18,3,14,4,3,9,2,44,3,9,13,2,8,51,30,5,16,7,24,8,17,37,29,6,12,12,10,10,0,15,1,4,1,10,19,2,30,24,6,12,12,1,15,10,18,5,2,2,4,82,40,2,9,6,6,4,33,13,13,19,6,7,1,3,30,1,24,8,5,2,3,14,4,19,24,7,3,5,12,3,18,15,44,13,4,20,6,8,20,17,1,4,4,11,3,9,9,40,18,3,0,4,1,9,8,3,12,15,5,83,11,5,49,14,8,32,3,7,11,27,10,44,3,15,17,18,18,35,41,8,6,18,6,9,8,16,9,16,25,4,7,11,14,10,10,10,9,7,8,28,44,11,5,33,4,9,6,82,15,23,1,4,6,12,30,8,22,4,7,27,13,21,4,44,12,21,5,9,7,16,19,2,29,2,3,13,6,15,45,15,18,18,36,12,5,9,10,2,7,15,0,9,19,8,17,1,6,6,206,31,2,7,9,13,13,41,32,8,19,12,2,47,25,16,8,6,9,9,15,22,8,43,36,44,14,1,10,6,8,10,21,22,5,9,7,24,4,8,19,31,11,17,15,2,10,19,10,18,13,20,15,5,8,9,5,22,8,5,8,9,13,4,47,13,25,4,11,11,2,14,7,5,24,3,5,3,5,10,15,6,13,4,9,3,4,14,5,36,5,6,12,4,8,15,4,12,5,7,18,10,7,2,28,13,10,16,12,2,7,6,10,9,7,16,24,11,9,1,13,4,6,4,16,8,13,7,3,8,11,6,2,10,2,11,7,2,5,16,12,7,21,5,8,4,17,3,7,1,4,6,4,1,3,2,2,8,6,17,10,7,11,21,7,4,10,7,10,8,16,6,3,8,16,11,8,3,15,6,9,7,8,10,4,10,9,18,18,31,9,12,3,4,12,3,15,5,2,5,17,68,26,9,7,1,5,10,6,6,3,0,3,11,1,11,5,6,4,18,9,0,6,5,15,10,7,9,15,18,4,22,10,4,13,25,5,7,8,5,5,3,8,1,3,10,19,5,7,11,1,7,4,1,23,16,6,12,10,18,40,7,5,13,21,13,4,7,8,4,3,6,10,4,20,4,10,7,12,8,16,5,6,15,4,5,3,1,4,8,7,2,9,9,7,13,20,12,41,30,5,3,2,6,6,7,13,13,9,16,9,4,5,1,5,3,34,1,6,12,8,11,8,17,6,6,6,1,9,4,12,6,8,16,13,3,10,4,2,44,5,3,2,7,0,0,4,2,10,1,0
session,2,28,11,251,2,4,4,17,3,2,24,13,9,27,0,0,13,5,1,0,6,18,16,11,10,11,8,10,2,27,2,115,47,4,29,27,18,3,6,1,3,0,1,7,13,4,13,9,144,9,14,11,13,8,5,2,27,41,0,8,6,1,4,20,12,2,36,0,6,10,4,7,5,0,30,6,8,5,73,4,21,0,5,1,76,4,4,0,45,1,6,1,3,13,15,1,20,2,37,7,6,7,20,5,5,33,6,2,7,3,13,4,5,2,2,16,8,3,52,69,9,5,5,38,4,2,0,0,4,0,2,3,2,29,5,26,2,1,3,16,2,16,18,0,0,35,3,4,7,14,17,2,17,3,2,18,16,2,1,11,3,4,5,1,2,3,1,8,10,2,12,37,5,2,2,9,90,1,7,31,18,6,7,3,4,4,11,24,18,38,5,7,5,2,0,8,4,2,4,4,8,1,1,3,4,3,2,15,7,15,30,3,34,6,0,3,0,8,8,10,1,6,1,10,39,55,9,9,3,1,13,10,15,10,13,9,17,4,2,1,40,16,8,3,4,3,2,6,36,1,9,8,19,2,5,11,1,1,1,15,2,10,21,6,2,13,3,2,2,2,87,2,18,4,1,2,8,6,9,13,19,0,2,5,4,1,10,4,7,0,8,7,50,7,1,2,23,11,4,13,15,39,1,1,10,3,13,3,5,0,0,5,26,6,14,8,4,23,10,3,20,5,12,2,16,2,4,31,4,26,9,12,3,3,4,11,4,5,3,8,5,7,15,1,1,0,28,26,10,5,5,4,0,6,19,3,4,1,7,17,36,6,3,6,0,0,37,3,17,6,4,9,3,3,3,9,4,1,5,5,64,1,34,6,4,8,0,6,11,0,6,5,31,16,20,3,58,2,11,0,8,0,5,0,5,0,8,0,7,3,3,6,0,6,1,2,3,2,0,0,1,1,16,8,1,0,0,0,7,5,0,5,5,12,0,5,0,11,7,1,11,13,5,9,0,1,11,3,11,1,8,9,2,7,22,10,0,22,1,21,2,22,11,3,8,1,5,4,7,0,5,4,4,0,1,0,1,19,8,0,2,6,3,1,1,6,6,2,2,2,30,51,0,0,3,4,2,9,0,1,1,5,2,2,5,4,1,5,4,1,2,0,5,3,8,9,2,2,1,1,1,5,4,5,5,2,10,0,6,23,2,0,1,1,9,5,9,3,19,10,0,11,0,3,3,14,0,7,14,2,32,2,3,27,3,13,8,2,5,14,19,11,33,11,12,13,9,7,17,21,2,8,39,0,4,6,2,5,8,11,2,8,4,5,3,2,3,2,1,3,5,12,22,0,18,5,0,1,40,6,17,0,3,15,12,10,2,17,5,8,16,26,17,3,27,9,12,3,4,2,5,0,0,9,4,6,9,6,10,12,2,23,12,9,8,0,5,4,1,4,5,0,6,4,4,17,8,9,10,89,6,4,0,8,2,21,8,12,1,11,7,1,26,8,10,12,0,7,4,8,10,5,17,10,16,2,0,14,0,0,10,16,8,7,7,7,7,3,2,1,13,6,10,4,2,10,2,2,7,9,1,1,4,1,5,5,7,3,0,8,3,11,3,24,12,8,6,2,9,1,0,5,2,6,0,0,9,0,0,1,1,16,0,2,7,5,6,6,20,3,8,4,3,2,2,0,9,4,1,5,7,2,2,18,5,3,4,10,2,7,2,6,3,1,13,8,9,1,8,7,3,0,1,9,3,7,5,1,4,3,4,7,2,1,6,6,4,14,0,7,2,4,5,4,1,6,1,10,3,3,2,3,3,1,4,1,4,2,6,5,1,4,5,7,0,9,1,3,4,4,9,7,26,8,15,0,1,18,1,0,5,1,2,0,2,2,5,13,5,13,17,7,2,8,3,6,6,4,4,1,12,13,1,2,0,4,3,3,3,3,3,2,1,5,3,5,2,13,1,5,1,2,1,5,3,3,7,13,7,1,1,2,2,6,13,2,12,4,2,1,2,11,1,4,1,12,2,1,9,0,1,5,1,7,6,6,3,13,1,14,3,7,5,3,9,4,3,2,3,4,6,4,2,5,2,6,1,11,0,1,7,6,4,6,2,0,2,4,2,5,1,3,8,3,4,6,11,6,12,1,3,1,1,2,1,4,3,4,18,5,0,2,1,0,2,5,3,12,10,2,4,2,2,3,6,2,1,1,10,6,0,2,4,1,1,1,4,0,3,0,1,2,5,0,1,5,0,10,0,0
fear,2,12,2,40,11,24,2,19,1,4,8,4,11,74,0,15,14,22,16,4,8,15,35,29,7,10,25,25,12,24,6,96,75,22,42,113,41,3,5,8,8,27,3,6,23,7,6,4,90,65,65,8,15,71,7,3,15,9,19,11,7,4,0,12,17,18,70,1,3,16,8,6,9,5,88,18,18,1,58,37,21,13,7,14,100,11,3,1,15,0,9,9,9,23,34,15,13,3,28,7,4,24,17,27,11,25,8,5,11,0,16,5,13,25,8,22,0,5,25,110,25,30,10,47,8,13,5,1,2,2,30,7,19,16,34,57,7,0,14,9,7,30,6,6,1,62,12,13,11,8,36,3,11,5,7,9,32,2,6,33,7,1,12,1,3,17,1,16,16,5,11,93,21,2,19,8,68,5,7,43,8,7,14,22,4,16,23,15,13,22,5,6,3,7,5,3,10,14,2,5,34,1,2,10,14,12,2,9,9,13,45,24,9,6,13,13,3,3,10,1,1,9,3,14,19,59,10,20,5,7,3,6,11,21,23,7,14,7,2,10,53,18,11,12,29,4,10,42,14,5,5,5,25,1,4,21,2,0,5,2,0,41,12,1,4,13,5,28,27,2,77,5,10,6,5,4,19,6,0,2,59,3,2,14,3,1,14,11,29,2,0,9,5,6,3,7,16,2,16,25,14,6,0,1,4,1,20,4,11,1,0,7,16,12,15,13,9,19,7,7,32,3,29,14,47,3,8,66,3,21,12,3,6,2,8,1,25,3,0,2,5,12,17,7,1,9,6,35,9,12,3,7,1,18,8,3,8,7,3,23,12,7,11,15,2,8,34,12,20,41,4,36,7,27,7,8,4,0,24,4,26,1,21,4,16,14,13,12,12,4,17,5,7,1,11,9,16,3,17,4,4,12,5,12,0,8,7,3,10,15,6,8,0,2,4,19,9,12,3,28,3,12,7,8,7,2,2,11,4,7,5,1,2,7,8,2,4,11,12,4,10,8,4,10,1,4,32,19,13,9,24,3,15,5,26,6,12,4,5,15,16,20,28,46,4,3,25,5,4,3,24,9,1,2,3,15,4,6,13,6,12,6,3,9,5,1,2,11,3,0,58,9,5,10,15,1,8,1,5,10,9,6,1,3,0,18,2,12,1,3,6,3,0,4,3,12,4,4,1,8,2,14,1,9,1,2,18,5,4,17,12,10,12,6,2,9,2,11,27,12,8,0,6,3,4,6,6,15,6,0,13,3,2,24,4,0,10,3,2,2,10,3,5,4,15,9,3,5,14,12,5,3,1,3,2,1,3,2,2,15,3,8,16,21,6,4,2,5,1,8,8,15,10,3,9,4,2,3,3,13,8,3,3,0,1,10,7,8,4,2,15,3,3,5,10,2,8,4,4,3,7,8,1,16,0,1,0,3,4,14,19,2,28,8,4,2,9,3,4,7,13,6,6,10,7,5,1,1,5,39,7,8,6,1,2,9,8,11,3,2,2,7,1,1,0,0,2,1,4,4,2,6,9,6,6,8,0,1,2,3,8,14,7,0,4,5,10,3,1,4,5,23,2,3,0,8,9,4,10,4,5,1,0,3,4,0,10,7,3,1,4,1,1,12,12,10,19,2,2,4,5,1,4,16,4,1,8,3,2,7,3,5,4,6,2,7,1,6,10,0,8,7,3,6,6,5,2,1,4,1,21,1,0,2,1,2,7,3,3,10,12,11,0,2,10,14,4,5,3,3,9,0,8,1,2,10,5,4,5,4,2,3,7,1,2,2,2,3,4,11,4,4,3,1,3,5,2,1,0,0,4,4,2,4,1,6,19,2,16,4,0,0,1,1,2,5,1,11,6,2,1,0,0,6,12,5,6,3,5,3,7,6,4,14,11,13,4,17,1,3,1,1,2,8,6,3,3,4,4,6,1,11,7,0,3,3,6,3,3,0,1,5,4,2,2,4,5,0,7,2,6,4,6,7,6,5,1,7,8,3,0,0,2,1,2,1,2,2,7,0,7,9,1,0,2,2,4,4,3,20,5,1,6,4,8,1,0,5,1,3,3,5,3,4,8,1,4,0,5,2,9,9,2,0,3,2,0,4,0,5,3,2,1,3,2,2,2,6,4,3,2,6,2,0,5,6,9,1,8,2,2,6,3,3,0,0,1,1,5,7,0,2,2,0,2,1,4,1,3,1,17,3,11,10,1,2,7,8,3,2,1,0,4,14,2,1,3,12,1,3,5,5,2,4,0,2,7,2,0,14
task,4,17,5,42,5,10,2,13,9,4,7,2,10,29,0,3,2,12,11,1,3,11,4,21,8,8,11,17,1,12,2,95,44,5,16,75,26,3,2,7,5,16,1,3,17,6,8,15,74,21,29,12,4,40,13,4,24,20,2,12,2,6,0,5,12,17,38,4,1,3,9,3,1,7,77,8,15,3,26,22,10,0,3,9,98,8,8,0,14,1,7,7,1,8,14,1,2,3,16,5,3,10,8,8,4,11,1,2,6,6,13,3,12,8,3,15,3,7,16,45,26,24,3,36,10,5,1,0,1,0,12,2,9,16,11,55,3,1,1,7,2,18,2,2,5,31,3,11,4,11,10,3,2,17,4,9,21,9,6,18,2,1,6,2,2,7,3,15,13,1,11,34,25,12,7,2,45,4,4,32,19,1,6,9,8,10,9,8,10,15,1,4,1,3,10,1,15,2,2,5,12,6,1,8,10,9,0,14,2,6,35,8,9,1,4,5,2,1,3,0,2,7,3,9,18,16,7,6,3,3,4,10,12,4,20,3,19,10,4,11,29,21,4,1,8,6,4,7,11,0,6,5,10,2,1,13,3,2,0,5,4,27,6,2,3,12,7,5,4,2,43,1,13,3,6,0,6,7,3,1,37,1,1,12,5,3,4,9,7,3,1,0,1,3,1,2,11,6,0,8,4,9,4,1,1,2,4,2,4,1,5,4,15,4,9,1,6,10,7,0,10,1,14,4,18,1,12,20,0,5,1,6,4,1,9,2,4,3,1,7,1,5,11,9,3,5,11,18,5,5,5,4,5,11,4,12,1,1,15,24,6,13,19,5,3,5,7,6,5,15,3,3,2,5,6,10,21,0,8,2,31,1,14,7,9,8,3,7,13,9,6,9,1,0,8,2,7,1,10,5,5,1,1,5,4,2,3,0,8,7,3,10,8,4,10,0,1,7,0,6,0,3,15,7,3,5,0,5,4,9,1,3,0,2,3,2,0,1,8,3,5,8,22,2,0,2,11,5,20,1,18,2,5,3,27,4,2,4,8,19,8,10,11,29,2,3,10,11,8,9,13,4,3,4,2,4,3,3,9,7,0,3,0,2,6,0,2,3,3,2,26,13,2,3,4,2,1,3,6,1,6,15,0,1,0,2,5,2,3,0,0,1,3,4,6,2,3,9,0,4,4,1,0,4,1,0,4,3,5,7,1,5,2,2,8,2,0,21,11,10,1,2,3,2,2,1,3,3,4,3,6,1,0,12,12,6,6,2,3,3,4,0,8,3,7,1,12,2,9,13,5,1,5,0,2,0,0,4,7,9,3,7,6,6,6,0,2,3,0,14,3,12,4,0,17,0,1,2,4,10,8,9,1,0,2,6,1,14,5,0,11,11,6,1,11,4,4,2,3,1,7,3,3,9,1,0,4,3,7,7,2,7,9,2,10,0,4,3,0,3,1,0,1,4,5,6,5,0,0,40,13,10,2,0,0,3,7,5,3,6,0,1,1,2,3,0,1,3,15,2,4,2,1,1,5,1,1,0,4,0,8,11,8,1,3,3,4,3,1,3,0,11,8,7,3,8,1,0,0,2,1,0,3,1,7,5,8,6,0,1,3,3,1,5,3,7,0,1,3,13,3,2,3,4,1,3,6,2,2,7,1,5,0,8,0,0,3,2,2,2,3,0,8,9,3,3,7,1,3,0,0,0,0,11,9,9,2,2,2,4,2,8,0,2,7,8,8,3,2,3,2,2,1,3,2,8,6,2,2,1,3,2,4,0,2,4,2,0,7,4,1,1,0,1,8,11,4,4,5,0,1,1,2,1,6,1,1,3,4,1,0,4,13,2,0,1,3,8,4,4,0,0,2,2,0,1,9,2,8,4,4,2,1,1,6,2,3,14,4,1,1,1,0,0,2,0,7,2,2,3,3,7,0,1,6,1,0,0,0,1,1,0,2,9,1,0,2,2,1,3,0,0,1,2,2,0,0,0,1,3,1,2,2,1,1,0,3,0,3,1,2,0,1,3,0,1,0,1,0,9,1,0,3,7,1,2,4,3,1,6,3,1,2,6,4,2,0,0,1,0,2,4,2,0,4,2,2,0,2,0,2,4,0,0,2,1,6,1,1,2,2,4,3,3,0,3,1,2,3,2,3,3,0,1,1,1,0,1,1,1,0,0,1,0,0,5,2,0,0,2,6,0,5,2,1,0,0,2,1,3,3,1,3,2,2,1,1,5,8,0,3,2,3,3,2,0,2,1,3,6
confidence,1,16,5,76,7,6,7,33,7,2,10,4,10,79,5,11,5,22,11,9,5,31,17,18,11,8,16,20,5,17,5,106,82,11,50,72,47,3,5,8,2,13,1,4,28,15,16,12,174,41,21,6,15,58,6,5,37,11,8,20,15,11,7,4,19,21,112,9,8,3,13,7,6,1,93,31,25,7,50,19,59,7,11,13,166,10,8,2,17,3,6,7,2,15,48,12,15,8,29,17,11,23,16,18,11,18,8,5,6,2,18,9,21,33,3,18,2,7,26,111,24,22,14,53,6,18,5,4,3,2,28,5,8,27,12,28,7,2,8,19,3,39,15,2,3,42,4,15,10,9,48,5,20,10,2,21,30,9,10,15,6,1,5,4,6,1,4,14,9,30,17,54,13,4,3,9,104,5,13,23,14,18,5,13,6,23,32,28,17,31,1,3,4,6,3,3,12,2,6,15,27,0,4,6,17,4,4,25,9,34,62,13,22,4,1,2,7,7,6,5,6,16,6,7,36,53,14,21,5,11,12,5,12,19,17,15,25,8,5,3,55,31,18,5,16,3,11,16,21,2,14,25,40,6,6,13,14,1,5,9,2,19,16,2,4,9,3,18,8,9,122,4,21,3,4,1,11,13,3,0,61,5,0,23,11,6,3,9,14,3,0,4,12,8,1,11,30,4,5,15,15,16,0,1,14,1,19,2,6,1,3,4,40,25,23,13,7,27,15,6,30,9,20,1,28,5,3,24,4,29,1,8,7,2,10,7,21,3,6,10,16,5,16,2,7,1,27,43,16,3,9,26,2,9,10,2,0,3,12,17,17,6,8,11,6,4,28,5,4,8,2,29,4,13,2,6,2,2,22,14,48,1,35,4,3,12,3,11,14,4,32,18,5,8,19,14,28,3,19,1,22,5,3,4,4,2,5,6,22,20,4,7,3,8,5,15,3,13,2,2,6,5,24,8,3,5,7,20,4,16,20,1,0,3,4,3,0,3,7,1,4,10,3,11,7,5,8,8,17,7,15,6,14,8,42,8,7,5,7,17,12,18,21,21,4,1,28,8,5,0,11,4,5,4,4,11,8,12,4,5,9,10,2,5,6,3,20,9,2,1,49,18,2,6,21,0,3,10,10,5,9,3,4,0,4,28,2,8,4,1,14,4,2,3,12,12,8,7,3,10,2,2,1,6,3,5,12,8,7,19,5,8,6,5,4,5,9,6,23,30,6,0,2,3,9,4,1,13,16,7,29,6,2,20,5,5,28,3,4,6,25,1,7,2,16,18,13,4,20,24,8,6,10,0,1,3,9,2,5,11,9,4,3,15,15,3,5,9,4,6,17,17,4,3,9,3,4,5,11,23,11,1,1,1,4,18,7,20,2,2,17,7,4,10,22,3,18,5,8,0,12,15,1,24,2,3,8,6,17,18,11,4,12,17,9,2,10,4,2,6,6,2,6,10,2,12,8,1,1,72,7,4,9,1,10,11,31,13,4,9,5,8,2,11,4,1,6,2,6,11,17,5,23,15,17,7,2,5,0,4,1,25,10,3,8,11,10,9,3,3,8,14,5,7,3,7,9,2,11,11,3,4,3,6,5,4,11,6,6,1,9,5,9,25,6,6,1,7,3,6,5,2,3,18,0,1,4,4,2,12,3,8,2,7,2,0,12,6,11,7,3,1,4,11,7,7,19,5,11,9,8,5,0,3,2,16,9,4,2,6,9,14,6,10,15,13,9,3,11,7,10,3,2,4,3,16,29,1,2,4,3,6,6,6,4,1,8,8,9,9,18,2,0,0,5,13,3,1,9,2,4,3,8,4,19,1,1,4,13,9,8,2,5,2,4,1,5,2,3,6,3,2,0,4,2,7,7,3,3,6,6,1,20,4,4,8,7,27,7,6,3,9,6,9,7,10,12,4,8,8,9,20,1,3,1,2,7,5,6,1,2,3,2,7,4,8,5,2,9,13,4,5,4,15,5,5,2,1,14,6,0,0,11,4,4,5,3,5,7,1,2,8,0,10,3,1,3,1,8,8,10,1,0,15,3,0,0,13,2,12,7,6,6,10,14,0,4,1,7,2,8,2,1,5,0,6,4,4,2,9,1,6,4,1,2,5,9,7,3,12,6,5,2,5,4,13,19,6,34,2,2,3,3,12,4,0,0,2,12,4,0,3,7,1,0,8,0,0,4,3,5,8,11,3,4,6,1,4,3,3,2,8,2,8,8,8,5,4,3,1,5,1,3,1,0,4,3,3,2,1
owe,4,8,8,40,8,9,2,9,1,3,11,1,5,54,2,12,5,11,6,0,5,11,14,18,8,4,5,13,2,15,1,95,100,6,25,55,17,6,6,1,7,6,3,8,17,7,9,5,126,19,20,5,6,20,21,4,36,16,4,16,11,7,2,4,7,8,82,7,1,12,4,1,5,2,35,7,12,8,36,12,46,0,5,6,144,7,7,0,28,5,6,5,4,17,30,9,11,6,17,14,1,15,16,5,11,12,8,4,9,6,6,0,7,6,4,22,2,4,33,59,21,16,15,54,5,0,2,2,6,1,6,1,8,40,16,31,10,9,5,7,6,20,17,0,6,34,1,9,3,5,26,1,10,7,2,13,20,0,4,14,8,1,11,2,4,8,2,17,15,5,7,71,16,1,6,10,68,3,7,21,21,10,0,11,3,7,25,15,25,27,3,2,6,1,3,5,8,2,3,20,13,3,1,5,8,7,3,18,6,8,41,6,11,6,2,6,5,5,5,0,3,26,6,4,19,51,26,20,2,12,5,5,16,8,21,14,26,4,0,7,37,19,4,2,6,3,6,17,29,0,4,9,12,2,5,12,8,3,2,12,3,16,5,3,4,18,1,5,10,3,51,2,21,2,0,0,20,13,3,0,48,0,2,14,8,1,4,8,12,7,3,3,4,8,0,3,11,3,2,14,20,6,2,1,4,1,20,4,2,1,2,7,12,4,42,7,12,17,8,2,30,8,13,3,33,3,3,17,1,21,2,6,3,0,8,6,7,5,4,3,3,9,13,6,4,2,18,36,10,4,7,11,1,23,17,1,7,3,6,16,9,6,4,8,5,4,8,8,5,14,1,13,3,5,8,26,9,2,6,3,26,1,23,6,6,23,6,15,11,3,10,0,3,14,17,3,18,2,14,6,11,2,4,4,9,6,5,4,5,3,7,4,2,11,11,6,8,3,2,1,8,8,13,3,3,3,4,10,2,7,14,3,1,5,6,5,0,10,3,4,10,12,4,6,0,1,3,8,16,6,6,3,4,2,34,4,1,5,4,15,7,9,14,30,1,5,10,8,4,1,18,11,2,4,2,19,0,12,9,3,3,8,4,3,4,0,6,5,3,3,31,19,1,5,7,6,1,9,4,9,8,5,8,6,3,25,3,11,3,4,6,6,7,1,7,5,3,6,0,4,6,15,6,3,3,4,20,6,13,11,2,2,7,3,6,5,3,5,23,13,0,0,2,2,2,7,4,13,4,6,12,0,3,31,1,7,18,4,1,2,9,3,9,1,5,5,10,7,19,14,7,3,7,2,7,3,4,7,3,12,2,3,9,9,3,6,3,4,0,9,13,19,7,4,11,9,1,4,32,19,11,0,3,5,3,8,2,15,3,1,13,14,5,3,14,5,6,3,0,0,4,10,6,11,1,5,3,3,8,11,21,12,17,10,3,2,8,2,4,8,9,4,25,9,2,14,3,5,5,72,8,3,0,6,1,6,17,7,7,5,2,4,13,13,5,12,2,4,8,11,10,7,25,11,17,4,1,4,2,3,3,13,14,10,4,5,12,5,5,4,1,8,6,4,3,11,5,2,4,7,2,2,2,4,7,1,7,5,3,4,1,7,2,19,12,12,4,4,5,9,2,2,3,12,0,3,5,2,3,7,8,13,0,2,2,1,12,5,15,10,6,8,4,5,5,3,10,2,3,1,7,4,7,8,5,7,1,3,2,10,7,14,2,6,9,11,1,6,5,8,6,2,2,15,1,10,7,0,18,6,6,2,3,2,1,3,2,7,9,6,2,4,0,3,8,10,5,1,4,6,4,3,6,2,2,3,4,1,7,2,2,3,2,4,3,4,6,9,5,5,3,3,3,2,2,3,4,7,4,5,4,9,4,3,3,3,2,13,4,1,1,2,1,7,2,9,3,1,1,5,10,10,5,7,1,4,7,2,4,2,5,2,3,1,3,2,5,1,5,3,4,4,0,9,3,4,4,4,6,4,4,5,3,2,8,1,2,4,4,3,5,4,3,4,4,3,2,0,3,6,5,2,2,7,8,2,5,11,7,16,1,5,3,4,4,6,2,3,2,6,2,2,2,0,1,2,3,6,4,11,0,4,5,2,3,3,0,6,0,7,4,10,8,2,4,12,32,7,21,6,6,4,6,0,1,3,6,5,5,4,2,4,1,5,1,3,5,2,2,4,6,8,4,1,5,2,11,3,3,3,6,2,1,13,4,9,5,0,7,2,3,1,8,2,1,4,1,6,0,2
reason,11,40,13,187,10,14,14,34,2,5,34,20,9,89,7,11,14,21,10,7,13,64,17,27,49,21,11,18,11,17,12,284,171,15,69,85,63,7,20,8,18,11,13,10,99,30,35,19,432,28,45,5,18,51,13,7,113,36,7,17,25,12,8,18,46,8,121,9,17,21,15,13,5,10,122,21,20,6,88,39,74,3,28,11,365,21,24,0,58,4,13,9,0,37,77,18,27,9,43,17,25,54,54,17,17,39,12,4,27,1,19,14,15,22,8,42,17,10,56,190,49,28,44,78,11,11,2,9,4,3,22,6,11,73,24,57,9,11,5,13,5,45,43,5,1,107,7,23,19,19,86,1,29,7,5,31,43,16,10,18,18,2,14,4,4,13,12,24,36,22,25,134,24,2,5,14,258,5,17,62,34,33,9,35,7,38,46,34,60,72,6,11,8,1,3,6,18,10,10,18,37,1,6,23,44,14,9,29,31,42,126,9,36,18,2,10,6,3,25,6,3,39,13,22,57,178,35,37,4,7,21,16,18,27,53,49,50,13,19,10,84,63,7,7,30,10,10,30,64,6,25,30,47,13,13,28,14,2,18,36,4,50,19,7,12,84,2,11,12,9,208,5,46,12,5,1,35,19,21,2,95,10,4,28,16,3,17,13,24,10,4,6,17,14,8,6,84,10,13,30,31,73,1,5,19,3,42,6,5,4,2,28,35,9,71,22,17,61,14,6,83,14,41,7,82,13,19,57,4,33,12,19,11,9,22,28,21,20,7,17,15,13,26,18,7,7,54,70,31,6,26,24,12,34,31,4,10,8,17,30,36,10,11,31,9,2,51,9,11,20,8,23,8,10,19,33,13,7,21,11,90,8,63,20,6,47,14,29,35,4,41,8,16,19,65,14,107,12,42,13,29,3,8,1,11,10,10,10,24,23,2,15,6,33,23,18,10,6,6,2,7,14,24,32,3,8,3,25,15,17,24,5,3,10,9,11,2,24,12,16,22,40,9,24,3,3,12,11,35,5,16,8,4,14,67,18,4,12,11,41,25,29,35,26,13,8,44,16,15,2,26,4,4,6,2,24,6,12,25,14,9,18,11,9,13,18,10,11,12,7,75,56,4,5,14,11,8,31,14,17,17,3,7,4,24,19,11,28,12,9,11,10,11,6,16,39,9,19,6,9,5,27,7,37,7,11,38,9,36,54,19,7,4,25,12,18,20,10,61,34,11,5,7,11,9,29,7,21,25,15,53,7,11,58,11,13,49,5,7,14,32,16,34,5,34,28,20,10,58,47,18,22,53,7,13,9,23,10,6,28,16,26,23,26,12,7,9,14,8,12,36,53,19,7,39,3,5,4,82,41,29,5,6,6,12,36,18,32,22,8,40,28,14,14,55,10,23,4,15,12,20,5,8,30,3,11,17,15,28,51,36,44,34,24,11,6,14,12,2,18,21,8,16,38,17,43,4,6,14,251,39,9,7,8,17,22,41,22,8,24,15,7,23,28,15,17,10,11,19,22,30,25,52,41,69,7,8,21,12,12,28,43,17,22,14,10,26,9,9,21,21,15,23,27,11,24,14,12,24,22,12,4,25,13,17,8,33,10,10,10,13,12,7,39,26,39,15,10,16,8,13,8,12,53,7,8,12,6,9,15,14,26,8,8,11,8,22,6,61,12,19,13,8,15,15,4,19,4,3,15,19,7,5,16,12,33,11,17,10,15,19,27,3,3,28,21,24,14,9,21,14,9,11,23,4,17,11,8,26,10,10,17,16,8,20,4,7,8,15,28,11,23,8,6,22,26,7,11,6,16,10,12,17,6,16,4,13,7,1,14,8,8,13,12,9,12,3,12,11,20,12,4,6,9,14,14,7,9,11,7,15,13,15,9,15,11,14,39,11,12,16,10,10,23,12,18,7,6,9,16,34,39,16,11,5,9,9,12,8,3,17,12,23,3,12,18,5,6,5,29,13,13,13,13,16,9,15,16,27,17,11,10,4,7,19,10,16,12,13,6,13,9,0,13,12,4,9,8,7,5,10,16,4,7,7,2,19,18,14,34,0,5,9,21,19,5,4,12,3,5,17,10,9,20,11,11,14,35,8,4,11,9,16,13,8,9,3,9,4,9,7,20,13,5,17,37,8,14,34,6,7,7,1,5,11,8,3,8,28,16,8,7,18,15,4,21,15,16,6,8,13,8,15,8,10,17,2,12,15,9,11,16,14,13,13,17,10,2,45,0,9,0,6,1,2,7,4,12,3,6
several,6,7,4,85,6,1,2,18,0,3,7,5,2,38,0,1,3,3,2,5,0,22,5,12,6,1,3,10,4,8,8,112,61,5,29,16,25,4,6,5,3,5,3,2,16,15,17,15,202,5,19,2,6,8,2,7,28,32,2,8,13,2,0,6,10,4,33,4,4,8,9,12,2,1,19,5,7,1,45,9,29,0,11,2,111,7,10,1,25,3,5,4,4,13,24,6,9,6,19,4,12,13,24,2,7,14,4,0,6,3,14,4,4,9,3,29,2,1,34,67,20,13,1,42,2,2,1,4,0,1,3,1,4,31,6,26,1,1,1,3,1,14,34,7,0,31,6,5,10,8,33,2,8,4,5,13,5,1,13,4,5,2,4,2,8,1,10,12,20,6,23,41,10,1,5,8,82,5,2,18,10,13,13,7,2,3,16,12,20,37,2,0,0,0,2,1,5,3,4,4,4,3,2,7,16,0,3,26,8,19,53,5,13,3,1,2,1,3,6,0,2,10,5,19,26,39,13,17,9,11,15,9,12,8,15,16,15,2,4,8,30,24,5,4,4,2,2,4,28,2,7,12,11,4,8,11,14,0,2,13,3,13,15,4,5,27,3,4,14,5,72,1,12,3,1,3,14,8,7,2,14,5,4,12,8,1,6,2,7,2,8,1,4,6,2,5,23,5,7,14,20,13,1,2,10,1,8,1,2,0,3,8,12,3,22,13,7,26,6,8,29,1,21,1,20,4,2,8,3,18,2,7,5,2,4,8,6,8,0,10,5,12,7,5,4,9,26,36,12,3,4,6,2,22,11,1,4,3,7,10,11,9,5,10,5,2,16,2,8,6,1,13,1,3,2,28,3,3,7,4,28,1,29,7,3,16,4,10,16,5,14,2,6,13,24,6,30,8,17,9,16,0,2,4,2,4,5,2,13,11,3,6,4,11,15,2,7,4,4,3,2,6,10,9,1,2,2,10,5,13,5,2,3,9,3,3,1,7,4,5,11,15,5,16,0,1,2,8,25,2,12,4,2,1,28,9,0,7,4,8,10,7,23,18,8,2,8,15,10,1,15,1,0,0,3,1,4,8,7,3,8,5,5,1,6,6,4,7,3,4,47,21,0,4,5,8,9,3,7,4,2,2,6,0,2,7,1,10,3,3,2,5,5,4,11,12,1,2,1,8,2,18,3,20,3,3,10,0,10,15,3,3,5,3,4,5,8,4,15,6,2,2,1,1,5,7,2,11,5,5,12,4,3,31,1,8,21,0,4,6,13,3,12,0,5,9,5,5,15,22,3,6,9,4,5,3,2,3,4,12,7,15,13,6,3,4,6,8,4,4,14,24,5,2,11,1,4,3,35,7,15,0,3,2,2,20,6,18,4,6,12,14,12,4,8,5,7,1,2,4,9,3,2,10,3,3,5,5,12,18,1,15,9,5,6,1,3,3,3,6,3,1,6,16,9,21,7,4,5,114,33,8,5,2,8,12,21,15,4,9,1,5,6,17,10,5,4,4,6,7,16,6,53,13,12,4,1,6,5,1,7,10,11,2,10,7,6,6,1,10,4,5,8,8,6,9,5,3,10,9,7,1,6,4,3,0,12,4,3,1,1,7,3,20,14,19,11,4,4,11,10,3,10,23,3,13,7,3,3,4,5,3,1,5,3,4,17,6,29,13,5,6,4,9,7,2,2,2,4,6,5,1,3,8,3,10,1,5,7,7,7,8,2,1,16,11,13,7,5,12,7,2,0,19,1,12,3,2,18,5,6,1,5,0,13,6,4,28,5,3,4,9,4,3,3,9,1,6,7,7,6,3,10,5,4,1,9,2,14,1,2,5,8,6,6,2,3,6,1,7,6,3,7,9,12,2,0,7,2,5,6,5,3,3,7,9,8,14,6,4,7,8,0,2,6,3,2,4,4,8,11,19,6,8,0,1,2,3,4,0,2,8,7,3,4,10,5,4,4,11,0,0,2,1,3,5,2,12,8,4,4,4,1,4,7,6,4,3,10,3,2,16,1,3,9,7,7,3,9,4,5,2,1,7,6,4,5,5,1,11,4,7,2,8,12,3,10,9,0,6,5,3,6,6,1,6,5,20,2,3,0,1,5,6,2,3,5,8,3,7,2,5,3,4,0,9,2,7,16,3,7,3,2,3,2,2,2,9,13,2,1,5,5,5,1,17,6,1,0,1,6,4,6,3,3,3,1,4,4,6,1,7,9,1,6,1,3,5,14,1,2,2,5,2,2,0,0,6,0,0
import,0,5,2,78,2,5,7,16,0,6,5,5,4,26,4,0,0,12,2,6,4,38,4,12,1,4,4,5,1,14,3,130,158,8,47,45,13,25,55,1,18,2,0,8,13,8,8,10,211,19,40,2,21,32,1,0,335,22,1,8,24,3,0,16,15,4,82,14,16,8,42,0,2,4,62,6,29,3,59,12,124,0,10,2,120,28,30,0,47,6,13,2,10,28,50,38,18,13,18,27,1,17,26,16,10,16,29,10,27,7,21,4,4,15,7,24,18,12,108,147,19,25,40,125,9,3,2,3,10,6,0,0,3,23,29,12,2,4,3,25,0,30,30,5,2,47,2,18,40,11,35,7,12,5,3,6,37,15,3,18,12,1,6,7,12,7,7,2,27,4,19,57,21,1,7,4,160,1,4,14,13,1,2,7,0,56,36,11,12,34,6,1,33,3,2,2,1,0,8,9,32,2,4,13,14,1,1,31,7,23,43,3,18,44,0,0,1,0,1,0,20,10,9,10,38,62,39,26,22,18,4,8,37,8,25,95,12,13,52,4,53,51,6,0,14,4,1,19,34,4,0,77,8,52,18,15,8,6,6,8,4,9,7,3,1,19,0,0,33,11,82,11,122,1,1,5,17,19,13,1,30,6,3,10,8,14,4,5,3,1,7,2,7,9,6,5,37,1,3,9,21,25,7,4,14,0,17,0,0,9,5,6,24,3,118,27,30,38,16,4,27,2,17,3,21,1,4,26,1,12,3,14,7,5,6,2,8,0,3,10,1,5,16,2,1,2,38,28,3,2,21,4,6,42,15,10,1,1,9,43,16,5,5,14,5,1,28,3,2,3,0,15,0,3,8,6,1,9,16,7,43,2,42,17,0,9,2,31,34,2,17,0,3,7,29,8,66,4,25,3,7,2,6,0,5,8,6,2,65,10,1,11,138,7,16,5,2,3,0,1,4,5,6,5,0,1,6,7,4,12,5,3,16,14,7,0,0,8,2,3,8,24,5,28,3,5,12,6,37,15,11,10,2,11,38,3,1,3,8,56,6,25,23,5,6,2,49,9,5,0,6,1,3,0,1,1,2,2,12,5,5,11,0,5,10,1,19,2,1,0,30,32,0,2,45,1,10,13,3,4,6,7,9,2,2,27,5,17,6,6,12,2,3,6,9,6,3,5,2,6,0,7,7,7,4,0,19,8,10,33,7,1,0,14,11,4,4,7,22,15,4,4,0,23,39,3,1,11,12,4,9,5,0,32,6,16,44,15,15,3,22,4,21,2,5,20,9,5,19,35,7,3,8,0,2,4,90,11,3,21,65,8,19,8,3,3,1,9,15,3,10,7,6,3,19,11,5,9,32,6,18,1,0,2,7,18,5,10,8,33,18,7,2,5,25,2,28,12,3,3,2,8,2,12,3,13,4,6,4,23,21,13,24,12,1,9,5,3,3,11,2,0,0,11,11,18,6,4,6,147,20,2,5,5,3,10,48,4,0,15,4,3,17,17,12,5,0,5,3,5,11,11,24,0,13,6,0,5,2,3,3,32,11,1,5,10,7,0,7,13,13,12,10,2,2,1,2,5,52,15,5,4,6,6,8,8,10,6,10,0,5,28,13,18,5,8,3,2,3,1,7,0,2,9,0,9,8,1,5,6,5,16,28,4,7,0,9,6,5,6,9,4,1,10,13,1,15,5,5,6,5,17,24,26,36,4,5,6,2,140,131,9,4,19,8,131,5,7,26,3,9,2,4,3,1,9,5,0,0,13,0,3,15,3,18,5,13,7,18,19,6,2,0,18,12,24,1,6,2,0,14,9,7,1,0,0,8,2,8,2,1,7,61,5,10,1,1,5,0,8,3,13,0,2,0,5,2,4,7,6,6,6,3,4,3,5,2,23,7,9,5,0,0,0,8,8,11,8,2,3,8,10,10,13,5,9,8,14,16,3,21,0,6,4,9,4,4,0,2,11,2,1,5,11,3,7,0,6,4,4,3,10,3,0,3,1,5,4,2,3,4,2,0,1,5,10,0,0,4,0,8,6,7,7,0,7,1,12,32,14,1,6,2,30,20,23,5,14,2,3,3,15,10,80,11,3,1,9,7,9,3,0,12,10,10,19,6,6,1,5,1,10,39,13,27,36,19,23,48,4,0,3,0,1,1,6,2,1,19,1,0,1,0,0,10,44,2,1,0,3,6,4,0,2,3,2,0,4,3,2,0,4,5,17,12,10,2,3,36,0,2,3,4,1,1,3,1,4,0,1
central,5,18,3,28,2,5,1,14,0,4,71,15,4,23,2,1,3,2,1,0,4,30,3,7,3,5,10,12,1,6,5,58,65,3,20,28,39,1,0,0,2,18,11,3,14,5,4,6,218,213,10,3,13,25,1,2,16,6,2,13,15,11,1,7,10,1,26,0,3,17,5,7,2,4,29,9,8,4,24,13,13,0,9,8,154,1,5,0,23,0,4,2,3,12,20,1,1,6,24,1,35,10,5,2,8,21,0,0,6,1,12,1,0,11,1,23,2,1,24,80,15,23,0,22,8,1,2,0,5,0,8,0,4,19,17,22,0,2,0,3,1,28,19,1,2,34,5,10,2,3,24,0,3,4,3,1,7,2,6,17,1,0,1,1,0,4,2,18,5,4,25,34,16,0,0,0,70,1,2,4,7,7,2,2,1,10,17,3,18,40,6,0,3,2,2,1,8,2,3,2,4,0,0,8,17,4,1,3,2,5,25,6,18,3,1,3,0,0,3,1,1,8,3,3,7,3,5,2,3,3,10,6,0,7,11,0,6,6,3,3,20,10,1,0,11,1,5,6,16,0,1,2,15,2,1,3,4,0,0,3,0,10,4,2,4,5,0,2,3,9,34,4,13,2,0,0,6,0,2,1,11,0,1,13,8,1,0,3,1,0,2,9,1,2,2,9,23,2,3,5,6,7,1,0,3,0,26,0,1,4,5,0,8,6,9,5,5,12,5,3,15,1,11,0,42,4,2,18,1,23,1,8,10,0,1,13,4,5,3,3,7,8,3,17,1,3,9,41,16,0,2,4,1,8,19,4,5,1,8,5,3,4,5,8,3,1,12,3,2,5,4,11,2,2,2,11,0,1,12,1,20,2,8,13,1,7,1,7,11,0,1,5,2,13,10,8,15,1,13,2,17,2,1,1,1,1,4,4,16,10,8,48,3,13,2,3,14,5,6,3,2,7,12,4,1,1,1,2,4,7,0,5,0,3,1,5,1,20,1,2,9,9,8,17,5,7,4,5,7,4,11,2,5,0,66,0,1,4,2,11,4,16,12,5,2,1,6,12,7,0,10,2,2,0,6,0,1,14,11,0,6,5,7,0,0,2,8,6,2,0,19,21,2,2,9,16,0,10,6,1,9,1,1,0,18,3,1,3,3,1,1,1,11,0,3,1,5,3,0,1,2,10,0,15,1,6,6,2,6,7,3,1,1,4,1,0,4,7,23,2,7,1,2,0,4,1,5,1,12,4,3,2,2,15,1,1,31,2,8,5,14,2,4,1,12,4,5,6,23,17,6,1,1,0,2,1,1,4,3,16,3,4,6,6,2,0,1,3,0,2,2,7,0,4,2,4,1,1,87,10,4,0,2,4,7,6,4,2,4,2,21,14,8,5,7,3,10,1,5,4,5,3,1,12,0,4,9,4,3,26,5,2,1,9,8,2,1,4,2,6,0,0,0,8,8,13,1,2,0,150,7,4,2,0,1,11,13,11,1,15,2,7,49,50,13,11,1,5,2,5,8,1,29,1,20,3,0,8,13,6,11,15,7,7,2,2,5,2,6,21,0,1,3,47,5,5,6,9,1,7,6,3,7,2,6,4,5,3,0,3,0,7,1,4,6,2,2,1,7,0,3,3,2,1,1,5,5,0,2,11,3,2,1,1,1,2,4,0,17,1,4,18,3,4,10,1,2,15,3,0,2,2,1,4,1,11,2,9,5,6,2,1,4,6,14,7,15,1,1,9,0,14,1,2,6,7,1,0,6,9,2,1,4,0,5,6,1,1,0,7,4,1,1,4,13,1,7,3,2,1,2,7,11,4,0,4,2,3,8,5,7,1,18,4,5,4,4,6,5,5,1,0,13,7,2,3,1,4,0,0,9,0,1,0,2,2,9,10,3,1,7,3,0,1,3,12,2,3,0,4,23,18,0,3,2,1,1,1,0,1,8,3,1,7,1,2,9,4,4,3,0,1,7,1,0,3,0,2,3,2,3,15,5,2,2,4,4,2,3,1,16,12,2,2,2,11,1,0,11,4,5,6,2,5,1,3,78,9,3,8,0,3,2,4,4,4,6,5,4,1,4,6,0,1,6,1,0,17,2,1,0,2,1,3,4,0,5,0,1,1,4,2,1,0,1,1,3,3,8,3,0,8,2,0,1,2,3,12,5,3,2,2,0,0,0,8,3,0,0,10,2,3,2,0,2,4,0,2,4,1,5,1,1,1,2,0,5,0,9,0,1,4,0,0,0,0,0,2,1,15
port,6,19,1,158,0,1,7,16,5,3,30,4,11,72,1,1,2,3,1,1,7,76,2,16,6,5,8,7,2,20,14,202,158,9,29,52,19,3,3,2,2,0,8,0,15,14,20,25,539,28,55,4,2,10,2,1,220,17,0,9,34,11,1,2,7,3,24,7,9,20,1,34,7,4,61,5,18,7,47,13,25,0,24,4,155,7,17,0,41,8,6,1,0,28,29,14,14,5,34,8,19,26,19,2,1,21,12,1,4,1,19,9,3,10,3,40,20,6,213,146,40,59,5,43,3,0,1,9,4,2,5,7,0,64,18,28,6,2,7,2,4,55,38,2,1,90,4,11,9,15,45,1,24,11,2,1,60,3,5,0,8,1,9,4,0,6,1,15,13,4,44,76,18,0,5,15,185,1,15,29,37,5,0,24,18,38,19,21,52,100,5,4,18,1,0,0,2,1,5,6,16,2,2,26,25,4,6,25,34,11,100,5,29,7,1,0,0,0,14,3,0,28,8,19,43,135,15,19,2,1,15,11,16,17,27,35,21,11,34,12,75,37,12,5,15,2,6,10,40,3,3,36,7,3,13,14,11,7,2,20,0,47,19,5,1,18,0,2,21,5,123,6,31,3,2,0,21,9,17,4,46,4,4,18,9,3,5,4,7,2,23,0,10,2,9,14,55,3,17,6,25,49,2,2,16,0,21,0,0,2,0,4,13,2,75,14,10,42,5,2,72,5,19,1,68,15,0,27,3,22,2,12,21,8,5,24,13,13,1,7,5,15,11,12,0,8,44,87,6,0,18,5,12,27,35,12,8,8,5,17,9,9,8,22,5,1,42,8,2,12,4,10,0,2,5,19,7,2,13,3,43,0,37,15,1,27,9,20,38,1,23,1,14,15,23,3,98,2,42,2,25,2,4,0,4,1,6,3,65,12,3,45,35,14,28,19,4,20,1,0,0,13,10,4,1,2,1,13,4,2,1,6,10,15,5,4,0,33,19,6,18,17,7,25,1,6,5,4,25,7,15,7,0,0,82,8,0,24,6,58,5,19,20,18,1,0,18,40,20,0,5,3,7,0,3,8,4,12,13,8,4,5,9,5,2,6,3,4,0,3,88,15,4,2,8,9,4,16,6,4,8,6,2,0,8,1,3,14,5,3,4,3,6,20,11,11,2,3,0,18,1,22,7,19,10,6,16,0,14,20,9,1,6,10,11,2,13,3,22,7,4,2,0,0,11,5,0,22,12,5,14,6,9,54,0,9,75,13,15,8,27,10,41,4,9,7,12,10,33,29,5,2,20,3,4,45,21,8,6,29,23,27,29,16,4,2,4,4,20,9,26,37,23,0,5,6,0,0,95,17,16,9,2,3,12,26,7,13,3,23,22,6,16,28,29,9,16,5,9,16,5,0,5,17,1,11,18,6,12,52,5,15,31,23,7,10,3,8,3,16,5,0,3,21,11,21,7,9,7,433,41,7,5,8,13,12,25,25,11,49,9,23,64,60,11,6,1,13,4,16,16,3,70,24,42,14,1,17,13,3,11,53,22,7,13,5,11,3,9,31,17,6,22,32,12,8,16,6,40,14,28,2,4,8,2,6,18,6,0,1,0,42,10,22,19,14,8,9,11,4,13,3,7,36,5,38,6,3,3,5,3,13,5,3,4,2,34,13,36,0,9,12,3,48,39,8,5,6,0,15,13,4,3,30,11,3,13,12,7,43,49,2,1,2,37,11,11,6,1,15,2,2,1,19,3,4,1,0,3,7,1,6,16,0,5,6,5,33,6,12,16,15,28,11,21,23,6,10,3,2,10,9,21,5,1,13,5,2,13,8,61,18,1,13,11,5,0,20,10,11,5,12,7,24,3,4,3,15,5,12,2,22,0,5,9,3,6,21,10,7,10,9,0,4,14,7,6,7,3,8,63,22,20,9,6,5,3,1,30,2,46,7,4,7,6,9,0,1,6,9,4,1,3,0,3,3,4,39,13,11,10,13,0,10,11,7,1,2,5,1,9,45,0,7,13,38,5,2,19,4,1,3,6,4,0,22,8,7,23,14,2,0,16,10,39,9,19,40,3,5,10,11,6,29,10,6,7,19,3,2,7,12,2,15,9,4,19,3,5,5,2,8,1,0,8,18,2,5,23,11,11,11,2,2,4,11,11,17,20,10,0,5,8,9,1,233,4,2,0,22,17,5,4,2,9,28,0,6,2,11,15,5,10,1,17,0,8,8,98,2,1,0,0,0,0,0,0,11,1,0
immediately,11,28,10,144,8,1,1,25,7,3,32,7,21,37,3,3,12,18,3,3,10,32,3,10,36,7,8,11,4,24,14,137,71,9,33,42,29,11,4,1,7,1,2,3,27,22,22,7,232,12,39,2,8,19,3,0,27,19,1,11,8,7,2,27,21,4,52,3,7,8,17,7,0,8,57,8,12,14,49,16,48,3,19,6,168,15,9,0,39,7,16,2,8,21,37,15,18,6,28,6,14,22,30,5,8,24,4,2,16,1,15,6,2,4,1,27,8,1,84,126,27,6,13,83,7,2,1,4,6,1,6,4,0,39,8,32,6,3,8,4,1,25,25,6,2,70,9,10,13,12,43,2,17,8,0,14,35,6,10,9,8,1,4,3,8,3,1,19,9,12,19,67,15,7,3,6,158,2,10,43,15,2,3,15,5,21,17,17,42,45,2,6,3,2,3,9,8,3,22,3,21,2,2,11,16,1,14,10,16,19,63,2,25,7,2,2,0,1,10,5,6,10,4,14,34,80,20,20,5,6,11,22,19,19,27,29,24,6,3,1,53,30,9,7,9,9,8,9,47,3,11,7,16,15,10,10,6,5,4,11,0,13,22,9,4,31,1,4,4,5,94,15,43,4,2,0,16,20,13,2,37,7,3,6,10,3,0,5,10,1,8,6,9,8,4,7,45,5,7,22,18,25,1,4,12,1,13,3,2,1,1,8,17,2,28,14,5,26,8,5,25,3,26,2,25,4,12,20,5,29,6,14,6,8,9,25,11,9,2,15,2,14,8,13,8,2,31,46,15,2,14,5,4,29,12,5,3,9,17,22,14,5,11,13,3,2,36,6,2,8,0,12,3,8,4,19,4,5,4,5,62,2,42,16,3,35,5,10,27,0,9,4,12,21,28,4,69,4,41,2,16,1,3,1,9,3,0,3,16,4,2,9,6,13,23,4,11,2,3,2,3,3,22,9,0,7,3,11,12,19,30,14,8,22,3,6,0,18,7,6,18,13,3,7,2,1,12,7,30,9,4,11,3,4,51,3,0,14,4,37,9,19,15,17,7,3,8,11,6,0,12,8,1,1,2,5,2,23,10,5,6,10,7,0,9,7,15,9,4,4,58,36,0,2,3,4,4,7,7,4,7,4,10,1,14,34,2,15,9,3,1,4,16,9,9,11,12,8,1,6,2,12,7,13,6,2,23,4,20,22,7,1,4,9,8,9,15,3,30,17,3,2,2,1,6,11,4,14,11,4,23,8,3,27,4,2,21,5,5,8,15,11,23,7,17,8,12,3,29,29,11,4,25,4,9,5,9,3,7,5,10,14,4,6,9,4,7,4,6,6,20,19,13,4,14,2,5,3,65,6,15,3,4,12,11,18,8,14,5,4,16,34,23,2,17,10,15,10,5,5,15,3,1,24,13,4,9,8,8,26,17,18,21,15,3,3,5,6,2,10,1,2,7,24,8,33,3,4,9,144,36,5,3,4,11,26,30,5,10,7,1,7,16,30,13,11,7,12,10,15,17,6,26,15,18,3,2,17,15,3,7,30,8,9,7,10,6,6,3,16,22,6,9,10,13,14,9,6,9,13,8,4,7,5,8,9,20,6,1,11,1,9,4,29,11,23,13,5,13,11,10,8,10,17,5,12,5,0,2,12,2,12,5,3,6,5,24,5,28,6,15,4,9,14,11,1,16,3,4,2,13,13,5,14,3,15,6,11,4,29,30,13,7,3,18,10,13,11,10,10,7,2,4,9,3,7,7,2,10,10,2,5,6,1,7,8,4,23,4,11,6,5,4,5,9,12,4,7,3,7,3,3,7,7,1,2,2,4,12,6,5,4,13,1,3,11,5,10,13,8,3,23,7,9,9,7,2,7,2,4,10,6,7,0,6,10,5,29,6,7,9,13,1,13,7,9,5,11,6,7,16,15,3,2,9,3,2,9,3,4,9,3,5,5,6,4,7,3,4,11,2,5,13,3,6,6,8,20,10,2,3,13,8,5,11,6,6,4,5,8,5,4,0,9,6,5,0,18,12,3,4,14,4,8,11,13,4,8,2,17,3,6,7,18,13,5,5,5,3,4,9,8,1,10,2,12,8,24,3,9,4,8,10,4,6,6,7,4,3,5,9,6,16,2,9,19,8,15,40,6,1,12,3,7,7,14,2,4,15,5,13,1,7,2,3,20,1,1,4,4,9,7,5,1,16,2,3,6,12,2,6,2,5,7,4,6,4,2,17,2,1,2,1,0,0,9,2,8,0,0
merchant,6,2,3,44,1,4,2,7,1,1,4,2,7,40,0,2,2,4,2,4,1,15,2,10,12,3,5,3,3,2,11,79,66,6,30,20,17,7,6,0,3,1,5,0,12,7,9,4,108,19,18,3,3,25,1,2,34,16,0,9,11,7,2,7,6,0,18,2,4,14,3,3,1,0,27,1,5,2,27,7,33,1,11,3,54,6,18,0,12,2,2,0,0,5,27,5,10,5,9,6,4,15,8,7,5,13,6,4,3,5,9,2,1,8,0,18,3,0,28,65,11,16,0,19,3,2,3,0,0,3,5,0,0,24,7,21,7,2,0,3,2,13,11,1,4,26,4,3,9,8,20,0,4,3,0,3,12,0,4,0,10,0,3,4,2,6,1,7,10,3,14,35,5,0,1,3,84,0,7,20,7,1,1,4,1,18,14,13,12,21,0,2,13,0,0,1,6,4,2,5,20,1,2,2,14,3,5,20,3,22,25,0,6,7,1,1,0,0,3,3,3,6,3,4,14,35,11,15,1,4,3,6,8,9,16,13,13,10,8,4,41,18,1,6,5,0,6,14,22,0,6,15,3,5,8,8,4,0,4,9,3,9,7,1,4,22,0,0,10,3,57,2,11,2,6,0,9,6,6,0,33,3,2,4,3,0,1,6,13,0,1,0,2,5,3,4,16,5,1,9,9,11,0,2,2,0,5,3,3,1,1,3,8,4,25,13,5,22,7,2,30,3,15,4,19,5,2,8,1,10,0,3,0,3,4,3,6,4,1,2,2,5,4,2,3,1,14,22,22,1,3,1,5,16,6,8,1,1,1,5,8,5,6,5,8,0,18,5,0,5,1,6,4,8,5,17,6,5,9,2,31,2,27,9,0,9,10,7,10,1,8,1,5,3,7,1,28,2,14,3,9,2,1,0,5,7,2,1,42,8,1,12,6,12,10,8,0,2,0,1,5,4,4,1,3,1,2,8,2,5,8,2,0,5,2,2,0,3,3,0,13,15,3,19,3,4,18,2,20,3,10,5,3,0,34,4,0,7,3,13,6,6,17,19,8,0,14,16,10,0,7,0,2,4,0,8,1,2,10,2,5,5,1,0,6,3,6,2,0,1,36,28,0,1,13,3,3,7,2,3,4,3,7,0,3,15,6,7,4,2,4,1,9,4,3,6,1,2,0,3,1,15,3,14,1,1,14,3,12,15,7,2,0,4,5,6,5,2,15,5,4,0,0,13,11,3,0,14,5,1,1,2,4,13,0,2,51,5,1,3,13,2,4,0,6,5,6,4,16,19,5,2,3,1,6,3,9,3,1,3,7,2,6,7,2,2,5,1,2,3,14,12,3,2,12,5,1,8,40,7,5,0,6,5,2,12,2,7,4,2,11,9,6,4,15,0,8,3,3,3,7,1,3,7,1,9,5,3,8,14,5,9,14,7,2,1,6,4,4,9,10,0,1,10,7,21,1,2,3,64,14,1,4,0,6,3,15,15,1,12,3,5,11,11,11,4,0,2,4,7,14,2,24,5,14,0,6,3,1,1,0,25,7,3,5,1,6,4,3,13,3,3,6,7,2,3,3,1,5,8,16,4,2,4,6,4,7,0,5,2,0,1,2,12,4,9,1,1,1,2,3,4,1,12,3,15,1,2,2,7,4,4,5,4,3,2,31,2,2,6,5,2,1,51,34,2,4,5,2,4,3,1,2,3,0,5,3,13,4,15,11,3,2,0,13,10,4,6,6,0,4,2,0,10,5,11,9,2,2,3,0,3,8,5,3,7,2,0,4,8,4,3,0,2,5,5,3,3,2,0,3,2,4,0,2,0,4,3,9,6,10,5,11,3,1,5,2,3,3,8,3,2,5,17,3,1,0,3,3,1,1,3,3,0,3,2,2,11,6,9,2,1,0,1,5,15,3,3,4,12,7,9,3,5,1,9,5,4,5,0,9,7,2,2,3,6,5,2,2,7,4,5,2,11,2,2,1,7,6,0,0,7,1,1,3,0,1,0,5,5,3,9,0,2,7,5,5,0,3,0,4,2,0,0,0,0,1,13,5,7,3,5,0,1,5,1,7,11,1,0,6,2,3,10,2,7,3,8,3,4,2,1,3,4,1,2,5,1,5,5,2,3,2,3,5,7,5,7,16,2,2,2,1,1,0,2,2,11,7,0,0,4,0,0,1,49,2,0,0,5,3,5,3,3,1,3,3,6,2,5,4,4,3,2,3,0,5,3,5,0,2,0,1,0,0,1,1,1,2,0
conclusion,5,17,2,87,3,0,6,7,7,0,17,13,6,25,1,0,4,10,2,4,1,22,4,9,11,4,4,6,1,4,3,80,42,5,18,21,22,1,3,2,1,3,4,2,6,10,8,10,162,6,21,3,5,13,0,4,21,18,2,8,18,6,0,5,9,2,30,0,9,10,2,3,0,3,26,3,3,2,32,8,12,0,8,3,107,5,1,3,22,4,13,4,0,18,26,6,36,1,11,0,6,8,14,5,2,16,7,1,5,2,8,4,5,9,0,19,2,2,51,69,22,10,3,30,2,1,1,5,5,0,1,3,0,19,2,15,4,4,7,2,2,16,10,0,1,34,5,5,6,3,32,1,8,0,0,4,17,1,5,0,2,2,0,2,0,1,1,6,12,4,5,34,8,0,1,13,112,2,0,14,7,3,0,7,3,4,15,11,33,36,0,1,1,0,0,6,9,6,1,2,14,0,4,4,14,8,1,11,3,16,25,2,16,5,0,2,1,5,2,4,1,7,3,10,17,29,2,9,1,3,4,6,8,8,12,2,17,3,3,4,38,16,2,1,2,6,10,2,19,3,5,5,12,0,6,10,3,1,6,3,1,10,13,6,1,17,1,2,8,3,56,3,14,4,0,0,4,5,12,3,21,5,2,7,3,2,2,6,5,0,8,8,3,2,1,4,18,1,4,7,11,17,0,3,10,0,15,3,3,1,1,5,13,3,8,7,3,25,4,1,24,6,13,0,40,4,3,9,6,17,2,2,2,3,2,9,14,3,0,9,6,5,5,11,3,4,21,33,5,1,9,5,1,18,9,3,1,1,5,10,6,1,7,11,2,0,23,4,3,4,2,4,1,2,4,18,3,1,8,3,35,1,23,9,0,14,4,9,12,0,10,2,4,8,18,2,49,3,17,3,11,1,3,1,2,1,6,3,7,2,0,3,0,5,13,5,5,5,3,1,3,2,4,3,0,5,2,8,7,5,9,7,0,10,3,6,3,15,4,1,8,15,4,7,1,4,1,3,13,4,5,8,1,3,27,4,0,11,2,10,6,12,11,8,3,3,2,3,8,1,8,1,1,2,3,4,1,12,9,2,2,2,1,5,4,5,1,2,1,1,52,17,2,2,3,5,0,8,0,6,2,0,1,0,4,0,3,7,3,1,1,2,6,1,6,18,2,10,2,2,0,8,4,16,8,2,2,2,20,17,9,1,2,3,3,5,7,5,13,6,3,2,0,1,0,3,3,9,4,3,9,3,0,26,3,4,18,0,6,3,21,3,16,3,5,8,4,6,15,13,2,1,12,2,4,0,3,4,4,6,0,4,8,5,3,1,2,2,2,1,14,16,4,0,9,0,2,1,68,11,17,1,3,12,8,16,1,12,1,1,22,15,12,1,29,7,10,1,7,4,3,1,0,9,0,2,7,5,3,17,2,6,14,15,1,2,5,3,1,3,0,2,16,12,5,17,2,2,1,110,10,3,4,0,5,3,21,12,3,7,1,4,18,17,13,10,4,11,3,6,9,3,38,12,20,5,4,4,7,4,6,13,14,8,4,7,6,9,3,4,11,6,13,2,2,7,4,7,7,5,6,6,1,5,1,4,8,4,0,2,3,13,2,20,14,6,4,5,11,2,3,4,3,8,0,9,3,1,1,3,2,7,3,2,4,2,5,1,25,1,7,4,0,8,8,1,12,2,3,4,2,0,0,5,0,8,9,3,4,13,15,8,4,2,14,3,7,3,2,8,1,1,0,5,5,10,3,0,3,4,0,3,4,0,6,4,1,7,3,12,6,3,1,2,5,6,4,4,0,5,5,6,10,9,5,1,1,4,12,2,1,4,5,11,5,1,6,6,5,7,3,1,21,17,5,1,0,11,3,2,1,2,2,0,1,6,8,11,8,4,3,0,0,10,3,8,1,6,2,9,26,17,6,3,2,3,4,2,2,4,5,2,5,1,2,4,2,2,6,6,4,2,5,4,4,0,8,13,8,3,1,7,1,6,6,8,6,4,3,5,0,8,0,0,4,2,2,6,4,0,1,3,4,5,7,2,3,4,0,21,5,2,2,3,7,3,0,7,0,1,4,5,1,4,3,6,2,9,10,0,6,2,2,2,3,0,3,2,7,4,2,6,3,4,1,5,2,3,8,2,0,4,1,0,7,1,0,2,12,4,0,1,1,1,2,13,2,3,2,2,1,2,5,1,5,3,0,4,2,1,0,4,3,3,3,3,3,2,22,2,2,2,3,0,0,1,0,1,0,0
full,3,9,3,60,7,4,6,28,3,2,6,2,7,36,4,2,1,4,2,4,5,15,6,13,12,8,14,10,4,5,3,71,51,8,25,39,17,7,8,1,9,14,3,4,24,12,15,8,140,14,14,4,5,20,2,8,29,32,5,8,15,4,0,9,7,5,66,2,2,7,7,0,2,1,43,8,13,6,31,8,24,3,4,7,128,15,7,0,11,1,4,0,4,15,25,4,5,2,17,8,6,12,10,7,8,8,2,1,7,7,6,4,6,2,4,15,1,3,37,58,24,19,6,35,5,4,3,1,0,1,10,4,5,29,7,27,2,3,9,7,5,17,14,3,3,34,4,8,8,1,32,2,14,7,4,19,11,4,6,9,6,0,4,2,0,6,3,12,13,7,13,52,20,3,3,2,84,1,5,32,21,4,8,10,2,9,18,13,10,17,0,2,5,0,4,2,6,2,6,5,15,1,2,3,18,10,2,12,4,21,42,1,13,3,0,5,0,1,10,2,1,11,4,9,25,49,15,9,1,2,3,5,5,10,17,6,14,6,2,5,26,16,6,6,11,3,7,8,22,1,8,13,16,5,7,3,4,0,2,12,2,5,18,2,8,20,7,3,5,3,56,2,17,1,2,0,16,11,6,3,36,4,1,9,9,3,1,6,12,1,0,1,9,4,1,9,20,5,3,10,11,6,2,0,5,0,11,4,3,4,2,14,18,4,28,12,8,21,5,5,21,3,15,5,36,1,9,16,1,14,3,3,7,3,1,14,12,4,2,5,1,3,9,7,3,5,15,26,13,4,4,3,3,22,8,3,2,4,4,19,5,6,8,11,7,2,14,5,3,3,0,10,3,6,2,9,5,0,9,1,36,3,26,11,3,24,6,14,10,3,13,5,6,5,13,16,29,6,14,3,12,1,4,2,2,3,5,2,5,9,4,7,5,10,8,8,3,3,2,1,2,1,17,2,2,2,5,9,4,13,8,5,1,5,6,2,2,5,3,4,11,10,3,10,1,1,1,7,19,6,8,2,2,3,29,2,1,4,7,16,4,9,10,7,4,5,9,7,7,0,14,6,4,3,1,6,2,7,10,3,3,6,1,3,2,3,6,4,5,4,31,22,0,4,3,4,2,12,4,4,5,4,2,3,5,5,3,5,1,5,3,1,3,5,5,10,3,6,1,3,6,11,3,9,11,4,14,6,11,10,7,5,2,8,6,5,7,2,17,12,0,0,1,2,8,2,2,9,8,5,15,6,2,18,4,6,8,3,4,2,11,4,8,1,8,5,3,2,13,16,4,7,6,7,6,3,1,3,9,8,2,12,5,7,7,11,1,4,1,4,7,22,3,2,11,2,5,1,15,7,11,1,7,0,2,9,7,13,6,3,18,9,3,2,16,2,9,0,5,2,10,4,3,14,5,4,4,5,8,9,9,11,10,9,3,4,5,3,6,3,5,3,7,14,4,28,6,2,4,58,17,3,5,3,6,8,17,11,2,4,2,3,5,11,1,1,2,5,2,3,7,4,7,24,22,4,3,6,0,0,6,10,4,6,5,3,12,8,2,7,2,8,8,7,4,14,2,4,12,5,7,1,2,2,2,2,9,3,1,2,3,4,6,16,11,6,5,7,5,3,3,0,8,14,3,3,4,1,4,11,2,10,4,3,2,3,7,1,21,8,8,6,1,2,2,2,7,13,5,9,7,7,3,6,4,2,5,11,1,2,2,7,0,2,10,12,3,2,10,10,2,3,1,8,2,7,6,2,10,7,5,1,5,2,4,3,3,9,6,5,7,7,2,4,7,3,3,7,4,2,3,3,7,1,1,3,5,6,3,3,1,4,0,5,2,6,1,1,3,4,4,2,2,3,6,1,2,4,2,4,3,4,8,1,1,5,3,12,5,9,1,6,5,5,4,5,5,3,10,4,5,15,2,3,4,3,7,5,1,1,3,3,1,3,5,2,0,1,3,13,3,5,9,4,7,2,5,5,4,18,3,1,7,1,4,1,6,6,1,12,2,4,2,5,3,2,1,2,0,3,2,5,3,6,14,2,4,5,1,7,3,3,7,14,5,1,3,2,1,1,7,3,1,1,1,3,1,3,5,3,2,1,5,3,1,6,6,0,3,4,4,5,6,2,4,10,7,3,16,3,2,2,5,1,2,0,6,2,9,1,3,4,1,2,1,3,3,0,2,3,2,3,1,5,2,3,0,2,2,2,2,0,7,7,6,9,3,4,11,0,6,1,4,0,2,4,1,4,2,0
agree,7,16,8,113,4,9,8,21,14,1,13,17,8,73,1,5,13,9,12,4,4,29,49,47,16,14,20,25,15,17,16,166,102,16,38,91,36,4,4,3,5,2,4,8,38,18,30,11,278,45,66,10,8,41,24,6,39,27,21,16,11,9,2,15,19,3,53,2,16,11,12,10,4,8,71,9,30,4,66,22,25,1,13,9,209,14,15,6,45,7,22,4,4,35,39,12,28,3,39,3,7,36,23,15,13,26,17,13,17,2,14,5,11,18,15,38,9,1,45,125,25,34,18,62,7,2,3,9,11,2,20,6,9,50,25,83,9,4,6,6,6,25,14,6,0,74,6,14,10,9,59,8,18,1,4,4,32,4,12,26,9,0,14,7,9,21,6,22,26,7,17,102,33,4,15,1,187,5,10,48,22,5,10,18,1,27,23,16,44,70,3,5,8,5,4,0,19,8,5,9,26,4,7,10,18,9,5,11,13,15,54,6,31,10,9,26,9,7,12,2,5,10,5,24,26,56,22,25,6,9,7,19,20,23,24,16,29,2,6,10,59,23,8,10,12,5,2,25,46,4,8,12,21,2,4,28,5,3,2,14,4,30,29,3,4,20,4,22,18,3,104,6,25,1,7,6,13,13,14,6,56,2,4,8,7,3,12,14,16,8,10,14,8,6,10,10,44,2,10,8,20,22,1,6,9,6,22,5,5,2,4,16,38,10,33,16,11,39,11,2,58,2,21,3,58,4,19,53,2,28,17,14,11,6,10,13,25,13,0,13,5,18,19,10,3,7,21,55,12,17,8,8,7,30,19,4,6,2,13,28,20,6,6,3,5,6,37,7,19,36,9,35,5,18,1,23,3,1,10,6,67,2,37,9,16,24,5,18,20,13,17,4,19,36,29,11,43,2,31,4,15,10,5,15,4,1,3,2,16,8,1,3,6,10,13,18,11,12,8,12,4,8,20,6,1,3,2,11,10,9,5,6,1,14,8,7,7,34,14,7,21,9,12,11,2,3,20,12,21,5,27,5,10,3,60,13,7,13,6,26,18,12,24,18,5,11,15,14,10,6,14,8,1,1,0,3,4,16,21,6,6,7,7,3,1,5,3,8,3,6,56,23,1,4,13,3,3,12,1,3,4,8,6,4,2,6,4,16,10,1,3,3,9,7,10,15,11,9,0,9,2,8,11,11,2,5,20,0,11,19,13,4,4,3,17,3,5,13,52,7,9,9,8,3,6,10,2,8,11,7,9,4,5,31,10,1,18,3,3,6,24,4,28,5,13,11,16,9,39,26,6,3,11,5,2,13,8,1,7,19,2,14,9,17,4,3,4,5,4,10,27,23,9,6,12,6,0,4,74,16,19,1,3,6,10,18,8,12,9,3,25,29,14,2,24,10,10,1,8,7,7,2,5,17,2,6,7,7,7,18,17,14,17,15,4,11,10,5,4,9,6,2,3,16,11,27,3,8,8,203,33,4,5,5,6,13,23,25,6,18,5,9,40,43,8,12,31,19,5,10,5,5,50,26,57,4,2,10,2,2,4,33,11,8,15,4,9,5,5,15,20,15,9,9,2,17,4,7,8,12,25,9,3,9,4,5,19,7,2,6,5,9,8,13,11,14,12,7,19,6,4,11,8,17,2,17,5,1,1,8,7,5,5,4,6,1,6,3,11,2,7,5,1,8,17,3,7,7,3,10,7,5,3,11,6,13,8,13,3,28,24,18,5,5,7,10,19,9,7,27,6,2,3,6,5,9,8,2,17,4,10,0,8,1,12,4,2,30,5,10,6,4,1,2,7,20,3,1,8,3,6,6,10,3,11,8,2,9,12,6,5,6,20,10,3,6,1,1,6,8,3,3,18,18,5,3,8,13,7,5,6,7,3,3,11,3,5,16,7,2,5,5,0,15,3,9,6,43,2,8,39,20,5,4,1,3,2,7,6,1,14,5,7,4,1,1,3,6,8,9,2,1,13,12,2,5,14,17,14,4,8,8,4,7,30,8,7,1,1,4,6,18,2,5,7,13,0,6,2,9,8,3,10,5,6,4,7,14,6,16,2,8,4,20,8,11,4,8,4,9,10,15,4,20,6,8,16,18,12,2,4,12,9,9,1,3,3,3,4,3,5,15,4,1,7,10,17,4,15,9,0,6,1,1,3,3,10,8,13,13,1,6,4,1,5,20,4,2,20,8,10,5,3,9,2,5,4,4,0,4,10,0,7,10,2,6,4,8,32,5,2,5,1,4,1,3,2,10,2,9
withdraw,4,12,2,55,2,0,1,12,3,1,11,6,11,10,1,1,2,6,0,0,3,13,2,18,11,4,2,5,1,12,8,98,49,1,10,18,23,6,6,1,1,0,2,2,18,4,20,7,188,4,24,4,4,8,0,0,20,10,0,5,5,3,0,8,4,3,24,0,3,37,4,3,2,1,19,2,8,8,40,8,13,0,19,2,129,12,3,0,20,3,9,0,0,21,24,9,7,2,22,3,10,24,22,7,8,6,4,2,8,2,5,0,2,8,1,13,8,6,24,130,21,4,8,20,2,0,0,1,1,0,5,2,1,15,4,17,7,1,3,1,0,9,16,0,1,29,3,8,12,15,38,0,11,2,1,5,9,2,2,0,6,0,2,1,0,6,0,5,6,11,9,40,11,0,1,3,90,3,3,8,12,7,0,7,5,4,11,8,28,36,0,4,3,0,0,2,4,4,7,4,6,3,1,9,17,3,7,5,8,15,36,3,15,2,1,1,0,0,10,1,0,12,2,7,29,32,9,7,2,3,3,1,14,12,14,5,19,6,1,3,41,17,8,3,3,1,3,9,18,4,2,8,11,1,4,7,3,1,1,6,0,26,11,4,4,15,3,1,5,3,52,5,18,1,0,0,9,2,3,3,10,3,3,9,5,1,1,5,7,1,4,2,8,2,2,4,34,1,4,6,12,10,2,4,2,1,7,2,2,0,1,0,7,2,11,5,6,20,16,4,30,3,12,2,30,4,3,17,2,23,0,1,3,6,4,18,8,9,1,6,5,7,1,9,2,8,21,32,13,0,4,3,6,12,14,5,5,2,11,8,9,2,5,12,2,0,27,3,1,8,0,7,1,6,1,11,3,1,8,4,26,2,30,4,3,39,6,15,24,1,3,2,7,6,19,1,26,2,28,1,5,1,4,1,8,2,3,0,10,1,1,5,0,8,12,7,2,6,0,2,3,5,7,9,0,0,2,9,4,6,18,9,5,6,0,3,2,15,0,2,7,16,5,5,1,5,3,7,18,8,12,5,1,8,20,3,0,6,3,13,3,5,10,8,4,0,2,12,4,0,3,1,0,0,2,0,0,7,5,7,5,7,3,1,4,7,3,1,4,1,41,20,6,2,5,9,2,7,4,5,9,4,1,0,9,22,1,7,5,3,5,0,8,0,9,7,7,4,1,9,1,10,1,14,4,1,14,4,6,13,2,0,11,4,0,2,10,4,14,12,10,1,0,1,5,3,4,3,7,3,18,4,0,26,4,3,12,5,1,5,16,6,6,1,9,4,9,2,19,8,5,7,4,4,1,13,4,5,4,4,0,14,10,4,1,4,1,1,1,5,12,13,2,2,7,1,3,1,32,4,5,0,4,0,14,12,5,6,6,0,11,7,15,5,13,5,5,3,5,4,6,7,1,17,1,2,10,6,9,21,34,4,7,8,3,0,2,2,0,9,2,0,0,25,4,16,2,6,2,127,16,3,3,0,2,3,23,8,12,7,1,1,6,14,1,4,1,9,8,11,7,3,37,5,14,3,2,7,1,3,2,9,6,0,8,4,7,2,2,5,2,5,10,6,8,7,5,3,6,10,14,3,7,4,1,3,9,1,3,2,5,9,4,10,6,18,17,5,3,0,5,2,6,8,0,4,7,0,0,5,3,8,8,2,6,16,3,4,18,2,10,12,2,10,8,4,5,1,4,4,13,5,2,6,2,5,3,2,3,6,6,0,7,6,13,9,7,4,3,12,1,0,1,7,3,5,7,1,7,9,0,4,11,5,8,3,7,6,6,16,2,5,4,2,5,10,2,3,2,8,4,2,8,4,6,4,3,5,11,1,0,5,10,13,3,5,3,6,1,4,3,3,5,7,2,2,1,4,1,9,3,3,7,7,4,2,5,14,4,7,7,0,1,4,4,13,11,3,3,8,8,13,3,0,1,3,3,7,3,1,1,2,4,2,12,2,0,3,1,2,0,6,21,3,7,2,12,12,4,0,2,11,4,6,9,2,6,2,7,3,1,9,1,4,5,9,4,1,6,1,5,4,1,10,2,3,12,6,1,7,3,3,5,7,5,6,3,3,2,5,10,5,2,7,4,8,3,26,2,9,5,4,4,4,3,4,6,4,1,3,0,4,0,1,5,12,5,4,34,2,2,6,0,1,2,5,2,2,10,4,2,1,0,0,0,10,8,1,1,2,19,4,1,2,6,3,1,3,5,8,5,2,3,14,1,0,3,1,18,1,1,0,6,0,0,0,0,6,0,0
except,6,29,5,129,3,3,5,32,2,3,17,7,10,59,7,14,5,14,3,4,3,39,14,31,19,8,4,8,7,13,10,186,106,9,51,56,29,17,11,2,18,5,2,3,30,19,20,12,284,16,41,2,10,25,4,8,47,33,0,17,25,10,1,9,15,7,141,6,7,10,4,7,7,3,67,8,18,5,75,19,46,1,11,6,281,32,20,1,38,3,3,4,0,36,52,15,19,7,35,17,20,22,37,8,6,21,9,4,14,2,23,7,12,16,0,22,7,5,73,180,40,7,30,67,10,4,3,1,2,3,5,1,2,40,22,38,9,4,6,7,1,21,26,3,0,67,6,11,15,13,101,3,25,8,3,15,29,3,14,12,7,1,8,2,4,6,3,17,18,7,16,89,22,1,10,5,191,10,14,20,35,16,6,11,3,22,31,16,35,47,2,4,10,1,4,7,20,10,8,20,23,4,2,26,26,13,15,36,10,23,72,5,22,4,2,3,4,9,20,5,8,26,5,15,57,113,30,29,2,18,12,24,21,45,37,31,29,5,14,9,89,26,2,4,12,4,6,28,43,6,9,16,19,17,18,12,5,2,5,16,7,28,23,1,6,49,1,8,18,5,138,7,35,6,2,0,23,32,14,2,48,8,1,12,9,6,3,9,23,2,2,3,18,9,3,15,52,3,9,25,20,38,1,3,14,6,18,2,5,3,3,19,22,6,52,23,17,41,12,4,35,7,27,0,97,16,7,19,2,37,5,19,12,8,13,13,18,5,11,20,9,10,7,11,5,5,44,49,12,6,22,12,14,32,24,3,1,9,24,33,20,5,6,13,5,1,43,7,7,10,3,14,8,7,7,30,10,7,14,15,119,4,52,15,0,27,6,18,30,11,24,1,15,4,24,10,52,5,40,3,25,5,8,0,10,10,5,1,31,10,0,14,11,8,23,7,8,10,2,0,2,5,4,18,4,3,3,8,9,20,32,4,1,16,5,9,3,7,8,6,13,22,8,27,1,6,10,4,25,14,16,10,1,9,60,24,1,12,6,23,12,23,24,12,4,9,13,15,17,1,10,1,1,3,6,9,7,10,14,6,12,6,8,11,9,9,12,8,2,4,84,42,0,3,3,8,1,18,8,11,12,6,3,0,10,31,2,16,11,7,4,3,9,6,5,17,7,6,2,8,5,22,12,45,20,6,27,9,22,26,15,7,6,9,4,2,7,14,48,24,7,3,9,8,2,11,3,15,14,7,66,4,13,48,2,12,19,6,7,9,20,4,16,5,13,23,9,8,39,36,12,9,22,3,6,7,13,8,9,25,6,28,5,25,9,3,7,12,14,8,36,31,8,7,23,10,9,8,43,17,37,2,4,3,4,25,3,27,6,11,22,22,10,3,49,13,17,3,11,5,10,20,5,37,4,6,7,9,13,25,53,14,26,25,11,2,4,7,1,17,24,6,14,24,11,22,11,5,5,157,45,6,5,8,7,8,39,24,7,17,4,6,26,26,5,3,2,11,12,13,11,5,22,26,23,9,4,8,3,13,5,23,15,4,10,8,18,9,7,13,22,12,18,10,7,17,6,9,17,19,5,10,7,9,10,8,16,6,6,5,6,12,9,30,24,22,3,8,15,4,7,6,6,18,0,9,12,2,6,7,8,9,12,5,1,5,17,5,50,7,15,7,5,10,15,3,16,7,4,9,7,14,6,9,5,7,16,7,6,17,17,23,4,5,22,21,7,11,6,9,12,3,0,21,5,15,6,4,9,20,7,8,19,11,9,3,7,9,14,22,9,7,2,5,9,12,3,11,6,11,6,3,16,4,2,4,6,5,20,7,8,5,11,8,8,7,4,8,4,1,7,6,5,16,8,6,2,15,20,4,13,8,16,8,11,13,8,23,18,4,9,11,3,7,5,13,10,8,3,5,37,41,7,3,5,6,4,6,10,5,4,7,9,3,7,8,7,10,10,15,9,2,24,27,5,2,6,19,9,3,2,9,3,5,11,8,5,1,6,6,0,17,0,2,7,8,10,7,4,3,6,6,2,14,13,2,2,17,6,25,9,4,9,15,20,5,6,7,3,1,5,7,5,21,2,8,8,6,4,8,11,4,5,11,7,7,2,10,4,8,3,18,14,10,7,36,26,20,41,5,1,1,4,4,8,6,14,8,26,5,6,10,4,6,1,36,7,2,12,9,10,11,8,3,7,8,6,5,9,8,11,8,6,20,8,15,5,3,34,2,2,0,3,1,0,6,0,4,0,1
regret,2,17,1,72,11,0,0,15,2,0,24,7,1,31,1,4,0,4,2,5,4,15,6,33,13,5,2,5,0,5,7,100,77,1,29,31,32,4,4,0,2,3,1,1,16,13,6,5,204,9,31,1,7,8,2,5,29,9,0,13,20,4,0,4,8,1,36,0,7,10,0,0,0,4,28,10,4,2,34,16,10,0,7,3,136,1,2,0,29,0,4,2,0,21,21,0,4,1,23,8,2,7,40,6,3,9,4,0,1,1,4,2,0,3,0,18,11,1,41,79,13,6,0,13,4,1,0,5,0,0,1,1,4,20,8,6,12,0,1,1,1,12,25,2,0,31,2,5,6,3,22,0,9,5,1,4,6,3,9,2,2,0,2,2,0,1,0,17,9,8,12,37,9,0,1,9,90,0,5,6,8,8,0,5,0,8,19,14,28,49,2,4,3,0,0,2,2,0,0,8,4,0,0,10,10,5,0,8,14,12,42,1,16,2,0,0,0,0,3,0,0,10,7,3,12,38,6,7,0,0,4,3,3,4,14,5,31,4,3,2,47,15,3,1,4,1,6,3,12,2,9,10,14,0,3,5,11,1,4,5,1,13,9,4,2,11,2,2,7,4,52,2,12,1,3,0,13,0,11,4,20,2,1,15,4,2,1,4,8,0,1,0,7,1,0,8,29,6,4,13,22,18,0,1,11,1,20,1,1,0,0,4,8,1,12,2,3,21,2,2,53,5,11,1,35,3,1,23,4,6,6,7,2,0,3,2,14,8,0,4,7,8,4,3,1,2,26,47,7,3,4,4,4,13,9,5,2,4,8,5,6,4,0,7,3,0,26,5,1,1,2,3,1,2,5,10,1,1,8,5,22,2,22,7,0,7,4,13,16,0,18,4,7,10,27,2,43,2,20,3,17,0,1,0,4,0,1,3,13,5,2,11,2,3,13,8,7,2,4,4,1,4,3,9,0,2,0,9,12,9,6,0,2,9,2,12,0,16,4,0,10,13,1,9,0,3,3,2,19,7,2,5,2,5,24,3,1,6,4,18,4,13,15,6,3,0,5,6,0,0,5,0,1,3,0,1,3,11,11,1,4,4,3,6,5,1,7,4,2,1,28,12,0,6,5,5,1,19,4,6,2,0,5,0,7,0,0,10,2,5,3,2,0,2,5,7,0,2,3,2,2,12,4,3,0,2,18,0,6,24,7,2,1,2,4,0,11,7,17,2,2,0,1,0,5,19,5,10,17,2,23,9,0,17,3,1,17,4,3,5,13,2,16,0,13,7,7,6,15,14,7,9,15,1,3,4,6,4,0,8,6,13,8,6,4,3,0,8,2,3,8,15,4,1,6,0,1,2,42,15,10,0,2,7,8,10,4,8,0,1,9,7,5,5,19,4,12,4,2,2,6,2,1,7,0,1,4,7,11,10,0,19,8,13,3,0,3,0,3,8,5,2,1,15,11,12,3,3,0,127,9,1,4,3,7,4,16,6,6,12,2,3,12,17,3,3,5,7,6,12,7,3,48,5,29,4,0,6,2,1,3,17,13,5,11,6,7,6,2,6,3,1,8,11,4,4,11,6,5,11,2,0,9,8,3,3,12,3,1,5,2,5,3,11,9,13,7,6,5,1,8,1,9,12,0,3,5,1,0,5,5,8,0,1,1,5,5,2,36,1,4,5,2,4,4,3,9,3,2,7,8,2,0,1,0,3,9,5,3,4,2,12,1,0,10,5,8,3,1,14,0,0,0,7,2,8,4,0,8,3,5,2,11,2,4,5,4,25,2,3,7,3,1,1,4,7,1,2,1,2,2,4,6,9,1,0,3,3,12,6,3,1,5,3,3,3,4,3,3,7,1,2,0,1,3,3,5,4,2,2,6,2,3,2,1,6,11,32,3,6,9,6,2,2,1,4,3,5,2,12,8,21,5,3,0,1,2,2,11,0,3,5,1,2,4,4,6,2,2,3,1,3,0,0,4,3,13,22,8,0,2,5,1,4,4,3,5,5,8,5,1,2,0,7,6,3,8,2,0,0,2,7,3,9,3,4,1,3,4,9,1,1,6,3,4,9,3,6,2,1,13,12,2,10,2,7,1,34,7,0,2,1,8,3,3,2,1,2,4,2,0,4,0,1,1,9,5,2,5,2,0,1,1,1,3,0,1,6,7,8,0,3,3,3,1,11,3,1,0,2,3,4,1,3,20,5,0,1,3,5,3,1,3,3,2,2,7,0,26,0,1,0,3,0,0,0,0,3,0,0
precede,5,9,1,72,3,0,5,17,1,2,6,2,4,18,1,0,1,3,0,3,2,12,1,4,14,0,5,3,0,18,2,75,61,8,14,11,14,9,6,2,1,1,0,5,17,3,17,13,104,5,16,2,6,6,1,1,30,45,2,8,9,0,1,3,13,4,22,3,4,8,34,3,1,1,21,2,5,2,33,8,115,0,4,2,61,3,5,0,57,2,19,4,4,8,25,9,5,8,15,5,5,13,9,2,5,15,5,1,19,2,12,5,3,3,2,24,9,0,35,45,3,3,5,221,3,0,0,3,11,2,2,1,0,25,9,5,1,3,2,12,1,21,21,5,1,21,0,6,18,20,13,0,9,1,0,8,9,2,4,0,17,1,3,7,3,1,2,6,10,5,16,24,6,1,0,14,52,0,2,9,13,3,0,11,0,9,10,5,13,23,1,2,5,1,2,2,4,0,9,5,16,2,0,3,13,5,7,15,12,13,16,1,8,2,1,0,5,1,12,0,8,11,3,4,12,50,38,38,7,8,10,20,14,10,11,53,19,2,2,2,22,17,5,0,0,5,1,2,17,0,6,15,6,33,8,9,7,2,5,28,4,5,11,7,6,57,0,2,19,2,34,5,119,3,1,0,5,62,13,0,10,5,2,6,5,0,1,3,3,0,3,2,8,3,3,8,16,7,1,11,7,12,10,2,3,1,4,1,4,0,2,1,7,0,24,27,1,19,5,2,12,3,23,1,14,7,0,9,0,8,3,8,2,3,2,5,2,3,0,18,2,2,5,4,6,5,16,23,11,2,3,6,4,11,10,11,1,2,5,67,19,8,0,3,1,0,5,3,2,3,0,4,4,1,3,26,3,1,6,15,4,0,9,1,0,14,1,6,19,4,4,1,4,2,10,7,20,6,6,8,7,0,1,0,1,3,2,0,10,4,1,8,34,6,4,1,0,4,0,1,2,4,6,0,0,0,0,6,3,14,5,3,16,8,0,3,0,14,3,1,10,6,0,3,1,0,5,1,20,11,5,3,1,2,32,4,1,5,0,10,5,12,12,5,2,1,4,4,0,0,7,2,1,0,1,0,2,5,4,0,0,8,2,0,2,0,14,3,0,5,37,19,3,1,2,3,1,15,2,2,5,4,27,1,1,11,4,7,2,3,5,0,2,2,6,5,2,1,0,8,0,4,6,9,3,9,4,3,4,7,1,1,0,3,2,3,3,0,3,6,3,0,4,2,4,3,0,13,4,2,18,2,3,19,1,6,6,2,2,2,10,5,6,0,5,10,4,1,12,9,3,5,6,2,4,20,3,6,1,25,0,4,3,9,8,1,4,3,3,3,11,8,7,5,6,1,3,0,7,5,6,0,3,0,8,9,0,7,1,16,18,4,3,5,12,4,4,2,2,1,9,2,0,8,4,2,0,4,5,22,17,12,4,9,6,3,5,5,4,5,8,0,1,9,4,23,1,5,4,59,7,3,5,4,5,12,19,6,4,2,2,3,6,21,1,0,1,6,6,7,6,1,8,7,10,1,3,7,1,2,6,8,2,3,3,3,3,5,4,3,4,0,7,9,1,3,5,1,4,4,3,1,3,3,7,5,3,2,3,4,1,9,2,3,10,9,2,1,3,9,3,2,1,3,4,11,4,2,2,8,2,3,9,1,3,5,15,1,19,2,0,1,1,8,8,2,15,5,2,1,4,48,33,58,49,8,6,11,6,59,61,6,1,3,24,20,1,2,6,7,3,0,0,6,2,3,3,0,3,7,1,3,3,1,6,2,5,18,9,5,4,2,10,2,9,4,2,6,7,5,2,4,3,7,0,0,2,3,4,3,13,0,12,23,2,1,2,3,3,6,2,1,1,4,2,0,0,3,11,6,11,6,1,2,2,5,5,11,3,1,1,1,2,2,3,5,3,0,7,2,3,6,2,9,2,3,2,11,2,1,4,0,0,1,1,7,1,2,1,5,1,0,4,7,1,6,2,5,5,4,0,4,0,1,0,8,2,4,3,2,0,16,0,1,3,3,2,1,8,1,2,5,1,2,4,10,0,2,15,4,2,3,6,27,8,12,5,0,4,3,6,5,1,6,2,2,3,2,2,1,1,2,1,12,1,11,7,3,0,2,4,1,45,1,6,10,4,15,35,0,3,2,7,2,6,13,22,1,5,1,19,2,2,3,3,8,3,29,3,1,5,1,2,1,0,0,1,6,4,5,31,0,2,13,6,1,4,0,6,0,3,0,8,0,0,4,0,6,1,0
conference,6,22,16,91,6,2,18,19,20,1,45,73,13,97,3,1,5,1,6,2,3,17,2,21,15,11,9,21,1,9,10,131,95,4,19,35,62,0,3,0,3,2,18,6,21,15,71,16,274,23,30,5,6,40,1,1,20,25,1,18,8,15,2,33,7,7,30,1,4,14,9,2,1,3,26,13,11,3,63,9,15,0,13,3,173,5,3,0,40,6,6,5,0,25,38,3,41,1,28,5,5,26,23,1,9,46,4,0,6,3,15,1,2,3,0,16,19,0,36,121,20,51,6,42,1,2,0,1,10,2,5,9,6,23,2,44,0,0,7,5,0,30,12,2,0,70,10,7,5,4,53,4,2,9,3,23,29,5,2,8,4,11,9,11,0,0,8,31,12,1,8,46,24,0,2,2,163,1,5,30,12,7,15,17,0,27,26,10,39,55,2,2,2,0,1,22,12,3,7,3,35,1,0,8,16,12,4,5,20,20,42,3,16,1,0,2,0,1,8,5,0,22,7,12,5,34,14,12,0,6,9,11,12,12,23,5,18,9,5,3,20,18,5,11,12,0,7,15,58,1,15,4,35,1,0,6,4,8,4,16,2,20,23,15,6,31,7,2,3,6,82,3,0,1,3,0,15,3,4,6,17,2,2,5,12,1,6,11,3,3,21,34,10,4,9,2,35,14,7,14,4,21,2,7,8,4,24,3,2,3,5,5,42,9,1,9,6,65,25,10,15,4,10,4,31,1,19,14,0,109,3,10,0,4,3,7,11,10,0,16,5,17,2,5,2,6,20,52,14,14,4,4,4,28,10,2,2,1,9,21,8,3,25,7,0,2,35,6,3,6,0,9,3,2,3,6,5,0,11,0,46,3,30,32,1,17,2,8,24,1,19,2,33,28,44,4,55,3,30,7,10,2,3,7,0,0,1,10,35,9,4,13,1,8,2,2,6,10,2,7,0,12,22,14,2,5,1,4,2,19,11,11,2,13,9,3,1,21,0,0,5,23,6,17,0,5,3,2,17,1,4,14,2,0,49,19,0,0,3,20,13,7,40,5,3,0,4,12,4,0,12,4,0,1,0,3,0,77,29,2,1,6,3,0,9,4,8,5,8,1,54,23,2,0,4,8,1,5,1,9,2,4,0,0,4,1,3,5,2,0,7,2,13,12,1,3,3,7,0,3,3,7,1,6,7,6,10,0,3,18,5,2,4,6,6,5,4,11,12,7,0,55,1,9,2,7,0,6,8,2,1,3,2,33,10,2,28,2,2,10,33,5,25,13,9,6,6,12,36,31,6,8,7,4,13,12,9,4,11,12,1,6,1,4,1,2,4,6,2,9,28,28,6,0,28,0,3,0,62,13,40,1,2,10,4,23,0,13,15,3,27,25,15,1,16,5,15,3,11,7,6,0,2,19,7,8,10,14,1,29,8,14,1,11,1,0,9,2,3,4,4,0,2,8,9,18,6,6,3,197,15,2,4,2,1,2,29,9,0,15,7,0,68,37,14,10,22,15,7,13,17,8,38,30,9,1,0,8,5,1,1,10,5,12,23,8,5,12,0,4,18,9,8,3,5,18,4,3,12,11,16,11,0,10,1,7,15,8,0,11,13,28,2,35,14,11,4,2,17,0,2,1,6,3,0,1,0,0,0,4,1,5,0,6,6,0,8,4,5,6,5,0,4,2,23,1,11,9,1,2,3,0,2,10,0,9,2,11,16,1,1,11,8,7,9,3,21,5,3,12,1,3,0,4,4,12,1,2,3,0,2,1,4,0,58,7,3,1,1,2,8,2,0,1,2,9,2,17,3,2,8,1,8,26,0,2,0,3,6,7,0,13,7,7,5,21,2,18,5,5,0,1,1,23,0,1,1,6,1,2,4,0,3,3,1,3,7,14,0,6,12,0,0,14,3,1,1,33,8,10,11,11,4,0,9,1,5,1,0,13,16,0,3,8,6,20,5,9,14,24,12,2,3,3,4,3,9,14,33,10,1,6,1,11,16,1,9,2,5,4,6,2,0,3,3,11,3,10,12,5,3,5,4,3,1,14,3,19,4,50,6,1,6,0,1,13,4,2,3,6,2,7,2,9,14,2,38,9,2,1,22,23,1,0,0,0,13,3,15,4,5,3,0,0,0,0,1,2,2,7,0,3,2,0,0,3,0,2,12,4,0,0,1,2,1,7,0,2,2,7,5,10,3,12,5,5,0,1,3,0,0,4,2,16,5,0,4,6,13,2,0,4,8,4,0,1,2,0,1,3
board,7,45,35,195,6,2,6,4,5,1,13,20,12,25,0,0,2,18,4,3,8,58,5,29,22,10,8,15,4,10,19,256,101,25,44,7,12,4,14,6,2,2,6,3,30,13,39,29,283,10,44,2,11,12,7,3,102,113,0,17,12,0,3,22,8,2,30,13,7,23,5,12,5,2,29,5,19,3,67,16,38,1,29,12,214,21,29,0,50,9,21,2,12,24,28,48,21,8,36,19,31,36,33,5,4,36,5,2,8,1,20,3,9,35,0,19,8,7,118,101,42,14,11,85,8,0,4,6,12,6,2,6,3,60,10,96,9,1,4,2,1,29,36,4,1,105,5,9,8,24,42,0,13,7,3,43,29,8,3,2,33,8,17,7,2,5,3,7,19,3,24,81,11,0,2,2,164,6,4,37,26,1,2,21,10,16,32,17,24,90,0,0,8,0,2,10,62,10,31,15,42,6,3,18,27,9,18,46,8,24,57,0,18,7,1,2,1,2,17,7,1,14,4,23,47,111,31,27,4,9,12,78,17,38,13,5,23,8,25,2,56,20,15,8,13,17,9,30,78,10,13,12,13,18,12,12,9,9,1,30,21,16,44,10,8,101,10,0,7,6,101,13,44,2,10,0,15,13,18,10,43,5,11,23,8,6,12,12,13,2,28,3,37,8,11,6,40,9,7,19,12,44,1,8,2,0,20,11,2,10,3,27,17,7,36,27,10,44,5,7,35,8,4,10,28,6,14,20,4,23,0,15,1,17,7,17,15,6,6,18,17,14,11,7,6,7,29,39,14,3,8,12,4,33,13,10,4,16,14,9,14,7,6,4,2,1,51,4,4,11,1,21,7,2,4,85,18,3,7,3,70,2,66,12,4,25,1,24,36,5,7,2,18,8,38,14,63,9,57,2,22,4,1,1,1,3,3,0,29,11,1,9,7,7,14,14,4,4,3,0,1,15,42,12,1,4,10,24,8,15,17,14,11,35,2,10,1,5,8,11,17,22,19,12,0,2,10,8,22,7,1,9,9,4,33,13,0,11,11,40,23,16,29,54,10,13,12,8,17,4,10,3,7,2,1,10,1,29,22,7,4,5,3,0,8,27,17,2,3,18,85,34,2,3,15,12,12,30,10,6,5,11,3,0,12,37,45,10,13,0,1,3,13,18,16,23,5,10,3,1,4,16,2,27,2,5,33,14,8,25,9,3,2,5,15,8,2,7,32,19,3,9,3,23,11,8,0,11,13,10,5,11,13,50,29,7,28,11,2,7,29,10,45,3,14,20,11,7,42,64,11,11,15,9,12,2,64,11,0,10,9,49,19,3,8,6,9,5,5,12,24,25,13,3,45,5,5,10,42,9,11,8,0,3,2,30,2,26,11,6,47,54,68,0,30,19,18,3,17,7,27,9,10,31,5,7,15,3,25,52,11,42,12,32,14,8,11,8,2,15,1,1,6,34,5,71,4,10,10,205,37,5,11,5,11,15,28,26,1,27,3,3,42,12,10,2,3,7,7,18,15,6,33,32,53,10,10,21,3,5,19,37,13,19,30,24,2,8,5,32,27,4,20,3,9,44,7,9,14,20,4,9,6,18,7,25,23,5,2,8,3,15,3,13,26,35,7,5,2,22,25,11,1,83,2,13,11,4,4,12,5,30,8,8,13,7,76,8,10,3,15,7,20,30,21,11,11,4,11,10,11,2,1,23,13,19,4,22,4,9,8,7,9,7,13,13,21,19,59,3,7,1,1,36,11,25,14,13,8,3,0,3,5,14,14,2,10,0,10,36,5,45,23,9,6,8,5,11,4,11,10,13,16,8,6,2,4,2,9,9,2,7,24,9,17,17,3,18,7,16,1,4,23,1,34,1,4,29,11,1,6,8,7,0,6,1,6,28,1,17,4,3,3,32,3,22,9,10,7,13,14,33,6,0,6,26,2,1,11,5,18,2,24,6,2,5,4,13,4,28,23,10,1,6,4,3,14,7,14,2,19,7,5,6,66,8,6,7,0,5,7,20,6,4,2,25,3,23,21,0,2,9,14,6,2,6,2,20,8,29,15,19,7,16,3,10,9,9,8,8,12,4,11,24,1,20,3,21,11,8,11,9,6,11,7,4,12,2,1,28,11,0,7,2,14,18,1,36,36,5,14,2,10,12,7,2,1,3,44,7,2,9,11,10,5,59,9,1,0,5,6,4,3,0,2,2,4,0,14,5,8,7,9,8,1,0,1,3,9,0,3,26,15,0,0,3,3,8,6,0
survey,2,9,0,143,2,0,11,11,1,1,4,17,8,14,0,0,1,4,1,0,4,12,3,9,21,3,4,14,0,0,1,196,47,1,12,10,10,7,5,0,0,2,3,2,14,3,19,4,134,12,20,0,4,9,0,3,10,73,0,32,10,0,2,17,12,0,12,5,5,18,9,43,4,2,29,13,2,2,47,5,31,0,13,5,84,5,13,0,42,0,0,0,0,23,8,7,8,5,18,8,22,18,20,1,6,8,3,0,25,3,13,7,7,2,0,15,0,2,81,47,11,4,0,39,4,0,5,1,1,1,7,1,1,41,5,75,0,0,1,3,1,20,14,2,1,35,0,4,9,8,13,0,8,8,1,15,8,0,1,3,12,0,3,1,0,2,1,2,13,1,33,39,15,1,0,5,87,1,6,14,14,4,2,3,27,10,16,19,12,39,0,2,8,0,4,3,27,0,2,3,12,0,0,4,7,3,3,10,6,14,30,2,11,3,1,1,1,0,30,14,0,11,3,35,23,49,17,6,16,5,11,17,6,11,13,3,19,3,2,0,17,14,3,0,7,4,5,5,38,0,4,6,7,3,29,14,6,2,3,19,0,7,19,4,3,51,16,6,1,5,80,16,33,1,4,0,4,11,8,0,15,2,5,4,7,13,2,3,2,0,4,0,7,6,4,6,19,0,3,8,7,26,1,1,5,0,3,4,0,1,0,3,17,0,11,15,6,21,1,10,8,3,6,0,19,3,1,8,6,12,0,6,1,4,9,20,5,8,0,6,1,8,5,2,6,10,14,48,9,5,5,3,5,25,7,6,1,5,11,6,9,6,5,4,11,0,14,0,1,4,1,1,16,1,1,25,1,0,1,7,13,1,35,3,0,104,0,3,14,2,3,1,7,4,35,5,42,2,22,8,7,3,3,0,5,5,1,1,11,7,0,10,2,22,1,2,1,2,0,1,2,3,5,1,0,0,2,12,1,13,0,4,32,8,1,2,0,7,10,1,10,8,10,4,0,4,6,0,12,4,1,3,0,2,53,6,0,0,3,14,5,4,4,7,15,0,11,10,46,0,13,1,5,1,0,0,3,2,10,6,9,4,6,1,1,1,10,0,2,1,19,19,1,0,1,5,6,7,0,1,12,6,0,0,3,0,3,7,3,3,1,0,4,2,8,10,0,2,3,0,0,4,4,0,3,4,4,1,9,8,1,1,2,2,21,6,18,0,13,22,0,2,3,0,20,7,0,11,3,6,1,3,0,37,3,1,9,3,0,2,21,13,23,2,6,8,9,7,23,26,3,12,34,0,11,4,0,1,1,27,2,10,6,2,4,1,4,7,7,1,4,25,4,5,12,3,2,3,14,6,8,4,3,2,2,13,4,2,8,0,8,29,17,1,9,4,30,1,4,10,8,0,4,5,3,7,5,8,6,29,0,16,7,6,14,0,2,14,0,32,4,1,0,21,8,25,3,2,4,75,19,5,2,0,4,19,5,1,0,15,0,15,5,13,4,0,0,8,10,1,17,3,43,1,8,2,4,23,1,9,88,16,14,10,6,7,3,2,15,75,9,5,12,22,5,66,3,2,2,12,2,3,4,3,7,14,14,3,0,5,1,4,1,6,13,3,1,0,1,5,3,4,0,36,1,13,4,0,0,5,2,7,21,1,19,13,28,11,44,4,7,5,9,9,6,0,19,4,1,7,8,11,5,8,4,7,1,11,3,2,2,2,1,0,18,7,11,3,10,21,11,9,1,2,2,7,0,4,5,8,1,2,4,7,0,3,2,14,7,12,3,18,17,7,15,4,2,7,6,6,1,8,11,15,12,0,2,2,14,12,0,2,3,9,3,5,6,5,2,8,3,2,0,34,1,8,0,12,2,2,2,6,6,0,1,3,2,11,9,5,5,0,0,3,0,4,3,3,5,4,14,17,0,4,4,5,1,21,0,4,8,0,2,2,3,6,5,9,4,15,27,6,0,1,0,2,7,1,5,2,0,4,3,0,31,4,8,6,2,14,15,115,7,0,1,31,6,2,2,1,3,5,2,1,0,3,9,2,2,9,0,0,1,8,3,0,6,18,1,5,1,5,7,0,0,7,4,6,2,2,5,1,4,3,3,5,2,6,0,32,1,0,12,0,1,3,0,42,11,4,39,0,1,2,6,5,30,20,32,3,119,22,1,2,0,3,15,1,0,9,4,1,1,1,5,2,2,1,44,3,7,3,26,1,2,0,2,1,2,0,6,0,7,2,0,2,0,8,0,0
suppose,2,19,7,65,9,1,3,16,4,0,5,3,3,22,3,1,4,7,1,2,1,18,1,11,10,7,2,2,7,6,2,100,53,1,22,27,13,3,4,1,3,5,1,0,21,6,14,6,168,7,38,1,1,4,7,2,27,4,1,11,7,3,2,6,7,3,55,2,8,13,2,5,2,3,43,5,18,4,31,11,15,0,10,4,112,16,8,0,15,2,0,2,1,8,22,4,13,3,18,5,6,14,16,11,4,11,2,3,8,2,6,0,1,7,0,17,2,2,43,82,11,7,4,14,5,2,3,2,0,1,7,1,0,23,10,24,4,3,4,7,0,19,9,1,4,26,1,5,5,4,48,1,6,3,1,5,8,2,1,4,1,0,3,2,0,3,2,5,14,4,13,34,5,0,2,4,88,1,6,12,9,3,1,5,5,2,20,11,20,19,4,5,3,0,1,2,6,0,5,7,5,1,0,6,18,1,5,21,8,6,41,4,16,3,0,2,1,0,6,0,2,6,4,15,16,64,16,18,3,0,9,3,4,12,22,12,17,2,3,9,37,21,3,3,7,1,2,12,16,2,3,18,5,4,4,14,9,1,5,2,0,6,13,0,3,7,0,1,9,0,85,2,10,2,0,0,11,4,5,1,35,3,1,7,9,1,0,2,4,1,4,0,6,4,1,8,20,7,7,9,12,11,1,1,5,1,9,5,6,0,3,4,10,4,16,9,8,21,3,1,15,4,18,3,33,5,1,12,2,10,3,6,4,5,8,10,12,4,1,8,5,3,10,9,0,10,22,37,7,1,7,3,4,23,22,1,2,2,9,7,12,5,1,5,5,0,23,3,4,9,0,12,2,8,7,2,6,3,6,9,24,1,30,5,0,18,4,5,22,1,6,1,4,8,16,6,40,2,9,1,11,1,6,0,5,0,5,0,8,2,1,6,3,6,7,2,3,8,1,0,2,2,6,11,1,3,3,9,5,11,4,5,0,5,0,1,0,11,2,0,4,16,3,4,0,3,2,2,11,6,4,3,2,6,28,4,0,5,8,22,2,12,17,13,2,3,6,11,2,2,5,2,3,3,3,4,2,9,8,4,3,6,4,4,6,4,4,1,0,3,26,17,4,4,5,3,1,10,5,8,5,1,1,0,4,19,2,11,5,2,2,7,5,3,8,16,1,1,2,4,0,7,5,20,2,3,15,3,4,20,9,3,2,5,4,3,7,5,15,5,6,0,1,0,7,3,4,2,7,4,36,3,4,14,4,4,23,3,5,0,7,4,18,2,14,6,10,4,25,16,9,1,11,1,2,4,7,3,7,5,0,8,2,7,5,3,5,6,0,3,15,17,7,0,8,5,1,4,38,8,14,0,1,2,0,20,4,5,1,5,16,9,8,6,25,8,19,4,9,2,4,4,1,8,1,3,4,7,9,19,9,13,13,14,2,1,2,2,1,3,6,1,3,29,4,7,3,4,2,95,15,2,5,5,4,2,22,2,4,7,7,7,6,14,5,2,0,5,5,7,6,9,21,4,11,3,0,3,1,6,11,13,5,6,4,5,7,0,4,10,13,0,13,4,2,5,4,8,3,10,3,0,3,2,3,4,12,3,6,2,8,3,5,16,3,17,4,5,6,3,5,2,5,16,2,5,4,3,8,5,4,7,7,0,4,0,6,5,23,3,1,4,0,8,9,3,3,2,3,3,6,5,0,4,0,5,4,7,1,3,4,7,0,2,11,9,3,4,0,4,1,4,1,6,0,4,3,3,5,5,2,2,6,1,2,4,3,1,3,9,4,0,1,2,1,5,3,5,1,0,6,2,8,0,5,1,7,3,14,2,5,3,4,7,1,1,1,3,2,6,3,0,1,1,8,1,5,1,7,3,6,4,15,1,3,7,9,13,4,6,4,6,0,4,2,5,6,2,2,8,11,22,3,11,0,3,2,3,9,2,2,3,12,1,5,3,4,0,4,2,4,7,4,8,3,3,4,8,5,0,0,4,2,1,7,4,0,3,3,3,1,19,0,1,7,8,9,2,5,4,4,4,3,4,6,3,4,5,1,7,0,7,7,2,9,3,2,4,7,3,6,6,0,5,2,9,6,15,4,2,3,0,3,1,2,1,1,1,2,5,3,9,0,0,3,5,8,6,20,3,4,0,2,1,3,4,3,2,7,3,4,3,5,0,1,9,0,4,2,5,5,5,4,0,3,5,0,5,6,1,2,6,6,9,6,6,8,0,6,1,2,3,2,0,0,1,0,6,0,0
sure,6,13,7,71,6,13,2,14,1,2,5,4,6,52,1,2,6,8,11,2,3,13,45,32,15,23,11,16,10,27,4,244,71,18,28,67,35,2,7,13,5,14,3,7,31,16,14,8,59,66,22,8,10,59,55,3,21,8,21,12,6,8,0,3,20,6,71,14,4,7,14,1,6,3,97,19,32,2,39,23,22,0,11,13,89,15,10,3,12,1,7,4,4,16,26,9,9,2,16,13,3,19,15,14,6,19,5,7,5,3,20,1,16,13,26,34,1,2,24,66,12,29,16,42,8,12,2,1,3,0,21,11,3,24,25,77,2,4,8,7,7,29,8,5,1,44,7,12,7,7,30,14,7,6,4,10,28,7,3,32,9,2,7,5,6,25,4,13,28,5,8,80,24,6,5,6,69,3,8,74,23,1,9,24,7,22,17,9,14,22,3,3,2,7,3,4,20,10,7,7,20,5,7,7,12,15,0,23,8,16,58,22,10,18,5,28,6,11,6,2,1,7,2,10,13,27,11,14,2,4,7,7,13,16,23,6,16,11,2,8,35,28,6,5,16,12,4,31,26,2,11,5,18,2,1,10,4,0,1,4,4,25,5,3,5,28,12,15,15,0,66,17,4,4,5,10,26,8,0,1,68,3,5,12,2,7,21,19,10,4,0,6,7,1,1,2,12,0,4,8,12,8,1,5,6,10,10,6,9,1,3,7,22,7,24,2,8,13,6,3,16,10,19,23,36,2,9,47,3,8,7,6,6,5,3,9,18,4,4,1,10,9,20,4,3,5,11,24,13,27,6,5,3,26,6,4,10,2,4,21,8,9,9,9,0,8,14,7,16,34,4,28,4,21,3,12,5,1,15,6,28,1,19,1,13,14,5,9,7,1,16,6,7,7,9,4,15,5,10,2,8,8,1,7,6,7,5,1,14,11,3,5,1,10,2,5,4,3,6,8,0,3,6,9,5,4,1,7,5,6,1,2,0,3,8,3,3,3,14,4,8,4,3,6,2,4,21,7,14,5,22,2,13,5,18,3,3,1,11,6,25,24,9,42,6,2,21,8,8,11,20,6,0,2,8,14,8,4,15,9,5,7,0,5,12,1,3,10,1,2,33,10,4,7,10,1,4,2,5,2,6,4,2,11,7,5,5,7,6,4,2,2,0,9,10,5,7,7,0,11,6,4,6,10,5,3,7,6,8,10,12,3,6,7,3,5,1,12,11,8,2,0,2,6,3,4,3,11,6,5,4,0,2,13,8,4,13,2,3,1,5,3,2,4,7,7,3,1,14,13,4,4,9,5,2,1,4,4,5,11,2,10,4,14,8,7,2,4,5,20,11,15,5,4,15,2,7,4,3,12,5,1,1,0,3,15,2,5,1,0,9,15,5,2,5,2,7,1,8,0,5,1,2,7,3,2,0,4,3,8,11,11,9,11,3,4,15,7,5,3,7,6,2,5,2,7,1,4,5,28,5,6,1,2,2,4,13,8,4,5,5,3,0,2,0,0,0,2,5,3,8,2,3,5,2,4,2,2,0,1,1,15,3,5,4,4,6,4,1,9,2,13,4,8,6,5,3,0,9,2,5,1,0,1,2,8,6,13,1,1,0,0,1,3,3,19,7,4,1,6,3,3,3,7,6,1,5,9,0,8,0,4,0,11,0,1,27,4,2,3,3,1,1,3,9,3,3,6,7,3,3,1,0,1,1,8,2,2,3,1,1,8,0,2,10,10,9,3,3,2,3,2,1,2,3,7,2,2,8,1,1,1,6,5,4,0,0,1,1,5,5,2,2,0,8,10,4,10,1,1,3,3,3,1,6,9,7,4,7,0,2,1,3,2,0,0,2,8,1,2,5,0,1,4,0,5,1,8,2,1,9,4,7,5,4,5,3,5,4,6,1,1,2,3,4,0,4,5,1,7,6,13,1,3,6,4,2,0,0,6,0,4,3,4,3,7,6,3,4,6,1,0,5,2,6,2,0,1,5,1,0,1,2,0,2,0,3,1,3,0,11,0,13,3,1,1,2,3,2,6,3,2,10,3,0,0,0,3,2,5,4,2,4,2,7,2,2,2,5,1,3,4,2,1,2,1,5,2,1,2,4,7,0,0,1,1,2,2,2,6,2,5,3,0,3,2,4,4,4,0,7,3,2,3,2,0,0,2,0,3,0,0,4,1,1,0,1,5,8,1,4,1,3,9,1,3,5,2,6,0,0,1,0,12,2,2,7,8,1,13,0,3,1,4,0,3,12,0,8,6
approve,5,81,21,270,5,0,3,32,0,0,9,17,9,37,4,0,4,10,5,1,6,25,4,31,16,28,6,6,1,20,4,163,59,9,39,32,10,12,9,1,2,1,2,5,27,17,35,10,245,16,20,2,8,19,3,0,32,28,4,7,13,4,6,12,11,3,68,9,2,11,12,2,3,5,49,5,16,3,43,12,38,1,11,4,136,14,6,6,34,7,7,2,9,25,30,10,16,8,19,3,16,28,31,3,9,29,13,9,11,2,12,7,15,18,5,18,12,1,172,113,27,9,16,78,4,4,2,6,0,14,10,0,2,48,12,29,4,0,3,6,1,20,21,5,2,47,7,8,11,16,57,6,15,2,2,20,10,6,5,14,7,3,8,9,15,9,2,13,18,6,18,48,6,0,2,16,132,1,4,18,22,5,16,6,3,10,22,13,20,48,2,3,9,0,4,4,35,10,11,7,14,0,1,5,7,9,7,18,8,13,62,7,67,3,1,4,7,9,32,6,2,12,3,8,40,90,11,10,6,3,7,18,19,14,12,15,24,5,10,0,59,20,6,3,3,8,7,8,68,4,12,13,12,8,4,9,3,6,5,13,2,23,31,20,6,59,8,3,6,2,99,10,32,2,8,1,11,24,13,5,29,3,0,12,8,3,6,6,12,0,11,16,60,14,20,9,22,6,6,9,7,51,0,13,5,0,8,5,3,5,3,13,23,4,31,13,7,24,10,4,18,3,21,4,36,4,1,24,0,14,25,12,5,4,7,21,8,4,6,3,2,6,11,5,7,6,24,39,10,2,8,8,4,20,18,4,11,2,11,23,20,13,6,16,2,1,23,4,12,8,2,14,6,1,5,18,11,1,6,3,86,5,36,9,1,39,2,20,10,0,11,3,61,41,25,4,52,2,20,2,17,1,0,1,5,3,7,0,15,5,1,8,5,6,4,7,4,2,5,1,2,1,11,7,1,1,3,7,11,11,11,3,8,36,6,5,3,11,9,0,12,9,10,6,4,1,5,5,18,3,8,17,0,6,28,16,0,16,7,24,11,14,13,12,4,0,6,9,3,1,10,1,4,0,4,3,1,30,7,1,5,7,3,4,5,8,8,5,6,2,40,36,0,1,3,4,2,7,3,4,9,6,1,1,5,12,3,14,1,8,0,4,8,5,2,18,5,2,5,5,1,7,6,20,7,7,8,6,13,26,6,2,5,7,8,1,7,9,43,15,2,7,0,3,4,14,5,7,9,7,83,8,11,25,10,8,12,0,5,7,30,8,46,5,7,10,6,5,35,37,5,7,36,7,12,6,5,2,8,18,3,6,10,8,5,2,2,9,5,8,19,15,13,1,8,1,0,1,48,10,16,1,1,20,15,12,7,39,9,0,16,22,26,1,24,5,9,2,14,3,6,4,3,34,3,6,6,7,5,20,0,20,12,27,3,5,2,5,7,7,5,1,12,20,8,40,1,10,12,127,13,4,8,13,3,14,28,8,6,15,4,8,22,11,10,12,6,7,5,9,13,5,13,11,23,8,10,11,8,6,20,28,6,5,13,8,9,4,1,3,32,13,5,10,5,14,6,7,4,17,17,8,2,4,14,10,6,0,5,6,1,20,3,26,9,10,2,3,18,4,12,6,1,26,1,2,2,0,6,11,2,14,8,3,11,4,18,3,24,8,10,2,14,11,9,5,14,8,1,19,3,8,4,24,9,13,5,13,14,13,10,8,4,14,13,7,11,8,6,12,3,3,2,10,6,9,3,5,4,8,6,4,4,3,7,5,6,23,3,6,5,28,14,6,9,10,4,18,5,12,5,2,15,18,3,2,3,7,9,7,4,4,15,7,3,11,4,13,4,15,4,3,6,29,12,1,8,1,1,8,9,8,9,5,6,2,7,14,4,3,3,8,1,11,3,4,5,31,9,3,16,28,14,2,4,5,5,4,6,4,4,2,3,9,0,5,0,24,2,24,4,11,18,6,4,2,3,7,9,4,6,2,6,2,16,3,10,5,0,8,3,4,1,3,2,21,1,17,13,2,3,7,0,5,20,10,7,13,4,15,2,17,5,16,9,11,4,0,0,5,0,9,5,8,5,15,3,6,4,1,5,7,6,8,3,8,2,9,2,12,1,6,10,5,5,12,7,14,31,11,6,3,2,11,12,10,9,2,26,13,41,1,4,6,6,15,5,5,12,3,3,14,2,6,7,3,7,7,4,4,10,5,0,5,1,3,4,2,15,0,3,2,4,1,5,2,0,6,2,1
paper,15,14,3,75,1,2,6,16,1,0,6,5,2,24,3,3,10,38,1,2,4,49,23,12,6,5,8,13,4,16,4,142,142,9,48,51,16,29,23,1,2,1,5,2,23,11,27,0,181,10,56,3,13,13,2,1,44,21,4,7,3,2,1,7,16,3,107,0,3,7,23,1,7,3,36,7,18,3,83,20,24,1,11,4,216,59,31,0,34,5,4,9,0,20,39,11,10,4,36,15,10,9,40,21,5,27,12,1,28,16,11,17,13,21,2,17,0,8,30,177,29,8,2,36,2,2,2,0,6,0,8,3,0,31,13,15,2,10,3,6,2,16,25,10,2,53,2,3,8,17,54,0,29,1,0,6,16,2,2,10,2,1,13,2,0,6,1,12,15,8,8,80,26,0,8,6,99,7,6,19,12,16,3,10,1,19,32,13,3,30,3,9,3,1,3,5,7,5,15,13,39,6,3,6,29,14,3,52,2,5,40,4,8,2,2,4,0,2,18,0,0,9,1,10,53,102,33,32,31,32,8,23,6,19,28,28,25,8,12,4,59,26,1,2,2,13,2,37,29,7,21,30,16,15,19,26,12,7,1,6,0,27,20,10,5,38,1,8,10,3,115,14,82,4,1,1,11,4,12,0,53,7,0,4,22,0,5,10,4,0,3,12,47,3,3,10,40,12,4,13,28,22,2,2,18,0,8,1,0,0,0,6,29,10,36,23,19,24,28,15,16,1,9,1,23,1,1,23,9,27,4,16,3,6,10,7,23,4,4,8,5,9,13,2,8,3,32,30,11,4,6,11,6,43,20,2,1,4,20,16,9,2,2,10,2,1,34,3,5,13,5,23,19,19,6,6,10,5,5,4,31,1,25,2,3,6,0,29,28,12,2,1,5,1,26,23,38,8,31,1,14,3,0,2,7,0,5,1,44,5,0,0,14,3,2,7,7,5,2,5,2,1,7,6,3,0,1,20,2,30,95,8,1,8,1,5,1,4,4,6,8,14,0,9,1,1,11,2,24,3,27,1,4,7,29,1,3,3,4,27,5,8,31,9,11,6,29,5,2,0,6,1,3,1,0,13,4,9,10,12,1,11,3,2,7,3,16,5,0,0,26,13,1,2,17,6,1,16,5,16,8,6,31,2,1,211,0,9,5,5,4,5,4,1,14,13,3,5,2,10,0,17,21,18,1,2,27,14,19,17,6,13,2,2,5,2,1,7,38,17,2,0,5,4,6,2,3,24,17,5,25,3,1,28,5,5,11,11,6,9,19,1,14,2,13,30,9,5,38,38,13,5,5,0,6,11,2,2,6,4,2,7,9,15,8,0,4,8,10,8,18,25,11,2,6,2,11,3,13,13,18,1,9,0,0,19,3,12,0,7,23,9,4,2,23,13,10,2,2,8,38,134,3,96,2,4,0,3,9,18,114,13,18,16,5,5,3,7,2,9,14,1,5,2,1,19,1,8,0,79,5,6,13,2,5,8,46,2,7,8,3,1,6,7,5,2,0,4,11,8,14,11,8,1,16,5,0,3,0,2,1,10,8,4,18,2,16,2,7,1,1,5,17,2,4,2,10,0,2,7,1,2,2,1,4,12,11,2,4,6,5,1,7,11,6,9,6,5,4,4,2,3,1,20,1,2,16,2,4,12,18,12,11,8,5,2,6,5,3,3,4,4,7,0,2,11,15,0,3,2,3,5,0,0,0,4,3,7,2,20,20,7,2,0,9,42,1,3,1,1,12,0,0,6,0,6,33,4,3,2,1,3,22,11,2,1,25,0,35,8,2,4,0,6,2,11,0,9,10,1,5,4,6,1,5,8,3,4,11,2,7,0,5,2,3,3,2,7,1,20,2,11,1,11,2,7,2,1,1,2,13,3,17,3,10,10,6,32,16,5,8,6,0,1,14,10,10,3,4,8,3,20,6,13,0,15,1,7,2,3,8,1,8,0,17,18,3,3,7,7,2,6,13,119,4,11,3,4,3,1,3,6,4,0,11,4,15,14,0,8,1,2,0,1,4,1,2,3,6,4,6,7,3,3,0,2,3,42,0,10,3,18,0,5,4,1,0,0,9,1,10,1,6,5,1,2,1,5,3,43,4,0,6,5,2,7,9,12,1,1,6,30,3,4,2,55,18,2,66,1,0,0,2,2,5,3,0,0,23,1,0,3,7,0,1,7,1,1,1,1,1,5,3,3,0,4,2,13,10,5,0,3,10,101,2,2,9,7,7,1,1,2,4,1,0,1,0,5,0,3
yield,8,14,5,54,3,2,3,21,4,0,17,3,5,27,5,1,4,12,1,3,3,16,6,12,5,5,7,7,2,15,5,93,72,5,25,30,18,9,8,6,8,5,2,2,14,15,16,7,163,5,26,5,7,18,2,2,42,9,0,3,2,4,2,11,5,5,57,7,3,12,11,2,2,3,48,6,14,2,41,10,33,0,9,4,105,12,9,0,23,4,7,2,0,17,49,26,7,6,15,12,3,19,23,3,12,12,12,1,12,1,10,2,3,5,4,18,11,5,38,100,20,9,27,37,2,1,2,1,1,2,6,2,2,19,11,11,7,1,4,5,3,9,15,1,1,20,1,6,17,12,31,0,10,1,8,8,18,3,5,4,11,1,5,5,10,6,3,11,12,2,11,35,14,0,7,6,90,1,8,10,11,4,3,1,4,10,17,11,26,36,0,4,5,0,7,1,6,3,3,5,11,5,6,4,21,4,5,18,14,12,38,0,18,5,0,2,1,2,8,0,8,8,5,5,23,40,6,23,4,21,8,7,17,14,11,47,13,8,9,2,26,12,8,7,9,4,2,4,12,6,1,17,11,6,6,6,0,2,4,12,0,14,15,5,8,17,1,1,11,1,52,5,24,1,2,1,6,12,2,0,23,3,1,6,6,2,4,2,7,2,4,2,15,3,3,8,18,1,2,10,9,9,4,3,4,3,8,2,2,0,0,7,10,5,19,12,10,18,9,1,20,5,12,5,27,1,11,16,2,12,4,3,3,3,5,8,8,3,5,4,3,4,11,8,5,3,22,27,7,4,5,7,3,10,12,0,5,2,13,9,13,5,3,7,4,0,27,4,2,5,1,9,3,1,5,8,4,4,13,10,28,4,20,4,0,23,1,10,11,2,10,2,9,8,9,5,22,0,13,2,7,1,1,0,2,5,3,1,9,3,0,11,3,4,1,3,4,2,1,1,3,3,6,9,0,1,2,3,7,11,3,6,3,7,3,2,0,13,2,1,4,14,4,4,2,1,1,3,14,6,6,4,0,5,36,7,1,7,0,25,6,9,14,4,4,0,11,4,3,1,8,1,3,3,1,2,7,7,10,2,1,9,6,2,6,3,9,3,2,2,24,17,2,1,9,6,3,9,8,2,5,6,3,1,5,10,7,9,4,2,5,0,3,1,8,11,4,5,1,9,3,11,2,9,1,0,4,2,7,14,5,4,2,4,1,5,4,9,16,6,6,1,1,13,8,3,3,12,3,3,24,3,0,23,0,2,12,4,1,0,20,4,9,2,8,12,3,1,7,23,10,2,7,1,4,20,5,4,4,11,14,6,13,4,3,2,2,1,3,9,17,13,4,3,10,0,1,3,29,10,12,4,5,6,5,12,3,14,5,4,7,2,6,11,13,4,9,5,5,3,3,2,2,10,0,0,6,1,4,25,6,3,11,8,6,4,6,3,0,5,7,1,4,12,9,4,2,6,3,92,7,2,5,2,3,7,19,5,6,7,4,7,6,21,4,7,0,7,7,7,15,4,23,13,17,7,1,2,4,4,6,4,5,5,1,6,8,4,2,3,6,5,9,14,2,3,6,3,13,7,0,0,5,3,8,4,22,3,5,3,4,6,4,22,11,6,3,3,7,2,10,1,0,3,3,9,6,3,1,7,4,7,10,7,4,4,2,2,27,8,6,4,1,3,3,1,8,5,1,5,9,13,5,4,2,7,6,6,2,25,26,3,3,1,19,10,5,4,13,6,1,2,1,3,2,4,2,2,0,8,6,8,8,0,6,4,4,20,4,8,7,5,8,1,2,17,1,4,3,1,4,4,9,0,3,4,6,5,7,5,6,0,12,4,1,2,4,5,9,4,2,6,2,1,2,3,1,8,2,1,2,5,7,3,6,7,3,17,3,2,4,4,3,5,5,4,4,2,2,2,6,7,3,8,0,3,1,13,3,1,2,6,3,2,3,0,2,1,2,6,0,2,12,5,1,3,0,4,6,1,1,2,3,1,4,4,1,1,2,0,4,22,0,4,2,2,0,2,6,4,4,4,1,3,4,1,0,8,5,8,4,1,4,12,8,2,2,5,4,1,9,10,2,5,0,1,2,15,3,3,0,2,3,5,3,1,3,5,1,6,2,5,5,6,11,7,12,15,26,2,0,4,0,3,1,6,3,0,3,2,7,0,0,3,3,0,0,0,2,5,11,8,5,4,7,3,1,6,4,3,3,1,4,2,6,8,3,2,9,0,4,0,2,0,4,8,1,3,2,0
account,6,14,12,104,6,8,0,16,0,4,16,8,7,42,2,3,7,12,3,0,4,29,15,21,19,13,7,16,5,34,6,207,84,7,32,38,13,17,20,2,5,5,8,9,30,11,23,17,198,24,39,8,12,18,19,2,29,57,5,8,11,4,2,15,14,4,69,3,5,15,80,4,1,5,59,3,10,4,68,20,57,3,11,8,172,39,15,1,55,4,7,4,7,50,76,18,19,7,34,5,11,21,23,7,13,30,19,10,16,9,16,3,16,14,4,34,8,4,50,78,25,26,19,127,8,2,3,1,9,2,10,3,1,48,16,49,7,8,6,4,2,19,37,4,2,76,7,18,13,35,64,3,13,7,5,16,20,0,12,19,35,1,18,6,12,9,0,13,16,4,9,61,20,3,8,11,94,3,5,36,22,1,8,24,2,19,32,23,15,21,4,5,11,1,4,1,24,3,12,5,32,17,5,10,17,8,3,26,5,14,73,5,15,4,3,14,6,3,28,2,41,7,7,5,25,84,36,44,12,35,7,17,26,22,22,40,25,7,12,7,40,29,4,4,3,12,6,25,60,3,7,27,10,23,4,12,7,5,4,24,11,15,21,7,4,85,9,10,9,2,78,34,145,5,2,3,19,76,10,7,45,8,4,14,9,0,28,18,6,3,4,3,8,17,7,4,40,6,7,15,16,35,7,2,13,8,9,8,0,1,2,15,36,10,67,15,7,41,7,2,24,5,15,2,32,3,5,21,6,29,7,13,4,7,5,9,12,9,6,16,8,8,13,2,5,4,34,39,17,9,25,17,1,39,13,9,6,3,18,65,12,10,1,6,2,4,36,4,13,15,1,21,3,16,11,32,9,5,4,19,38,1,35,9,7,17,4,14,42,0,13,3,11,7,19,7,43,10,16,3,25,5,4,2,7,14,3,1,12,7,0,5,7,5,2,14,5,8,2,5,4,9,14,6,5,5,1,12,2,6,32,28,19,27,2,5,1,8,9,2,23,14,2,9,2,0,10,8,24,15,25,5,9,3,28,3,4,6,5,23,8,10,27,20,0,1,12,10,7,2,17,4,2,4,0,13,2,9,9,8,22,13,2,4,5,2,13,5,5,2,55,44,2,2,11,8,27,41,6,9,19,13,11,10,15,35,2,5,9,7,6,3,6,7,6,4,7,3,7,7,0,13,2,27,3,8,17,16,15,26,13,5,4,3,8,8,12,10,30,19,6,0,8,7,10,6,2,13,17,4,12,5,3,34,6,8,31,3,5,1,21,5,20,1,8,7,7,4,28,30,3,11,45,2,5,3,10,4,4,60,4,13,5,12,6,0,3,5,9,9,9,18,23,6,36,2,1,10,25,16,14,6,0,1,3,9,8,15,17,10,22,20,8,5,23,6,25,7,7,8,8,10,2,44,6,4,4,5,4,13,17,19,17,10,8,6,3,19,3,17,9,3,21,18,3,38,1,4,7,118,1,9,3,4,2,21,18,14,2,16,2,4,6,7,12,2,0,14,10,13,21,12,43,15,36,7,3,5,3,5,4,19,3,11,10,7,12,2,6,7,5,12,24,23,5,9,12,5,4,12,9,0,2,7,10,4,15,4,4,4,2,27,6,17,8,25,5,5,6,13,7,2,3,25,1,3,10,2,5,8,7,19,3,5,4,13,12,4,10,8,10,3,0,7,8,3,14,0,2,16,8,48,38,58,43,10,7,15,2,19,15,14,2,15,7,12,13,6,13,15,6,3,2,20,2,8,14,7,10,8,0,3,9,23,13,2,7,27,4,24,4,15,11,2,24,11,18,9,7,2,2,6,7,5,7,4,6,4,15,6,6,9,2,10,1,1,3,6,3,13,6,11,4,6,2,6,9,9,13,2,1,14,6,3,5,7,6,22,2,7,6,5,0,5,7,13,13,15,3,8,8,22,5,11,0,6,5,8,4,1,6,5,12,2,5,7,5,3,1,11,11,0,16,4,5,2,1,9,9,0,5,12,3,0,9,2,6,8,1,5,3,5,4,2,8,5,2,1,11,6,5,1,4,4,4,4,3,3,12,13,2,21,0,52,8,17,3,5,4,8,2,2,3,6,1,4,0,3,4,17,8,2,9,1,2,11,4,11,2,7,4,12,44,48,12,70,19,56,130,3,0,2,0,3,11,50,3,0,11,5,2,5,7,10,3,6,3,33,5,5,0,2,6,7,2,1,6,3,4,4,24,2,12,4,5,2,2,13,6,3,2,3,6,4,1,4,6,8,2,11
quarter,0,11,7,60,6,1,6,24,4,2,20,2,7,54,2,5,3,4,7,2,3,16,3,13,13,2,6,9,2,7,2,113,68,1,27,35,41,6,6,3,1,2,2,5,21,7,16,3,194,15,22,1,6,25,8,6,39,27,3,11,12,1,1,7,9,3,51,1,5,7,34,2,4,1,20,7,8,4,49,10,35,1,9,8,107,9,7,2,37,2,8,5,7,54,49,14,14,6,20,5,9,20,23,4,15,18,13,7,18,9,23,1,4,7,1,28,5,1,28,54,26,11,8,99,13,1,1,2,7,1,4,4,5,32,17,21,4,7,1,6,0,15,24,2,29,25,4,5,6,15,34,2,11,4,5,12,13,5,6,5,8,3,4,4,1,2,8,13,8,11,7,59,5,0,0,5,78,0,7,14,8,7,4,10,3,6,23,10,21,45,0,6,1,0,2,1,6,3,11,4,15,2,1,6,10,4,3,17,6,19,48,0,8,3,0,4,6,1,18,1,22,9,3,8,29,41,20,28,8,8,14,61,24,13,15,27,18,3,4,2,44,22,2,2,12,7,7,9,24,1,2,18,6,6,12,15,7,1,6,13,2,29,12,1,5,27,5,2,7,3,80,9,43,7,2,0,17,37,5,0,56,2,3,11,6,3,9,10,11,1,3,1,5,11,1,8,35,1,6,8,12,10,10,3,7,0,7,2,5,0,1,0,18,8,20,17,8,32,8,2,33,7,14,1,31,2,5,15,3,8,0,11,4,3,6,15,9,8,7,8,2,5,6,7,2,16,28,34,13,0,15,4,6,10,12,0,0,2,7,59,3,5,3,7,5,1,15,5,8,3,0,5,1,2,5,30,1,2,12,14,35,3,32,4,0,28,8,8,30,2,7,3,7,7,23,2,39,4,16,4,11,0,3,0,4,3,5,6,16,10,2,3,5,7,0,7,5,12,3,0,2,9,8,12,1,4,1,12,10,23,15,13,14,7,2,9,1,11,7,2,8,27,0,8,1,3,2,3,12,7,5,5,2,3,30,4,1,1,3,24,7,16,21,7,2,0,8,9,4,0,19,3,0,0,0,1,5,9,5,4,3,4,5,0,3,4,9,2,5,1,48,50,2,1,5,7,0,12,7,8,9,3,4,4,5,8,1,9,2,10,4,6,3,1,8,6,1,3,1,9,4,18,8,14,4,3,21,0,11,17,5,0,5,9,3,4,4,7,20,9,2,0,1,0,5,10,1,10,7,5,7,3,0,28,2,13,31,5,1,7,9,3,11,1,6,8,5,6,25,11,12,8,8,1,0,6,3,4,3,13,5,11,9,12,1,6,2,4,3,11,20,17,7,3,5,2,1,0,33,14,9,2,4,1,3,9,6,10,4,3,9,4,5,6,18,5,13,3,1,3,7,0,2,14,0,5,3,3,9,13,2,17,4,9,3,7,1,4,3,12,1,1,4,11,12,25,2,3,1,120,10,3,7,4,3,7,28,5,6,10,2,3,33,15,5,1,0,6,9,8,17,7,40,11,22,2,2,7,1,5,3,15,9,6,14,6,1,4,4,18,7,5,10,8,2,11,5,3,4,12,9,0,3,2,6,7,17,4,1,3,0,25,5,19,10,16,7,4,9,6,9,2,11,19,2,3,11,0,0,8,8,12,9,3,6,6,8,6,30,10,2,4,12,4,7,2,4,4,3,9,8,35,17,52,45,10,5,11,3,2,1,8,4,17,16,7,4,5,3,4,4,4,0,9,1,5,3,0,12,13,13,3,5,1,4,9,6,23,2,8,5,4,2,4,4,20,2,2,5,10,1,11,8,1,6,2,1,9,13,5,6,0,22,6,3,2,4,7,3,8,2,6,0,8,6,4,4,8,3,5,14,1,10,3,10,8,7,25,8,8,5,1,1,4,7,3,3,1,10,5,21,8,2,9,2,4,4,12,2,1,4,2,4,6,2,7,2,4,2,7,0,5,4,6,3,4,2,15,3,14,0,7,4,5,9,1,6,3,4,5,2,11,3,4,5,9,15,0,5,3,2,5,2,5,0,10,5,0,5,9,1,7,4,17,13,14,1,7,7,2,9,6,4,4,5,7,1,7,3,1,4,3,5,4,6,5,1,9,2,6,2,4,52,13,20,19,15,93,61,4,1,3,3,1,5,22,5,2,11,5,15,7,3,2,2,9,3,1,1,9,8,3,4,4,7,7,0,6,7,4,4,3,4,0,7,5,14,1,15,4,7,0,5,0,2,4,1,19,4,0
institution,0,33,10,142,18,4,6,61,6,3,24,11,8,74,14,32,5,27,18,6,9,55,11,19,25,12,23,12,6,16,12,131,168,15,63,77,33,5,4,11,12,24,1,4,20,24,23,17,306,21,34,5,18,40,7,5,73,21,1,20,15,8,9,9,18,8,171,9,5,6,8,0,13,3,69,12,16,6,72,26,36,1,19,9,286,27,12,0,21,4,6,9,0,22,53,7,16,7,32,20,5,30,23,17,14,28,11,4,9,7,24,10,13,36,1,31,0,2,48,160,41,21,8,56,8,12,0,1,1,0,20,10,18,44,26,35,5,2,6,18,4,28,23,8,7,55,8,17,12,14,99,3,11,5,4,40,26,11,13,8,3,4,9,1,0,1,5,9,35,13,18,70,11,1,6,10,204,8,11,23,16,30,5,9,2,29,31,20,14,22,2,5,4,0,1,3,19,9,8,33,33,5,6,8,18,6,8,69,12,28,74,4,34,5,0,2,1,0,14,2,5,17,10,19,44,100,26,35,3,8,14,8,10,40,49,18,34,11,5,7,80,46,10,5,26,9,5,22,33,5,9,27,12,12,15,23,14,1,6,9,0,26,26,1,10,27,25,8,22,5,160,20,17,8,7,2,24,13,5,2,70,9,1,32,10,3,5,11,17,3,2,2,16,6,1,14,16,2,2,26,17,39,1,3,15,3,22,3,5,3,2,24,19,18,20,21,28,45,19,10,45,13,14,16,65,2,3,38,6,34,3,6,10,12,11,10,25,10,9,12,19,3,18,12,7,2,55,41,27,9,12,19,11,37,16,4,5,7,26,28,24,6,12,16,12,3,43,14,19,20,5,30,8,30,7,22,17,5,34,16,60,5,44,11,3,24,11,11,26,14,21,2,11,3,32,20,65,4,20,4,33,3,6,2,10,9,8,5,42,31,3,9,2,12,0,8,3,5,2,1,4,2,13,21,1,6,4,21,8,18,23,4,3,12,1,2,0,1,5,1,11,14,7,16,2,1,10,5,39,15,24,6,2,6,56,3,1,11,12,28,9,38,38,27,7,1,21,6,2,0,19,0,5,3,4,14,6,23,12,3,5,19,3,5,5,9,15,4,5,7,42,49,6,6,21,2,3,23,6,20,9,3,3,1,5,135,1,15,7,9,13,10,4,7,22,20,11,14,2,16,9,16,29,39,25,5,16,15,12,21,6,14,3,17,8,12,9,10,36,22,5,10,0,2,3,6,8,32,13,21,67,4,5,30,18,15,14,6,12,10,26,4,21,4,24,22,20,1,32,36,13,13,14,0,8,3,2,5,4,12,6,20,16,23,13,7,6,10,4,15,33,37,8,1,18,8,9,2,5,23,13,3,15,2,1,22,3,24,7,9,20,5,12,23,24,10,35,1,3,5,19,9,7,26,4,5,10,11,21,43,10,30,27,43,10,4,10,5,11,17,10,5,13,24,7,22,3,2,1,127,6,2,15,8,3,9,45,10,4,12,14,6,8,11,2,1,0,7,4,11,29,9,14,14,9,11,8,2,0,11,2,17,11,5,18,12,13,4,5,2,8,17,20,9,5,1,14,3,11,17,0,3,5,4,19,12,20,10,5,7,10,6,9,37,8,25,5,8,2,12,2,4,18,25,1,15,3,9,5,28,15,25,3,8,3,0,13,9,20,15,6,2,3,1,2,1,12,13,10,9,24,8,3,7,4,12,7,25,4,13,14,8,3,4,16,33,9,1,11,4,11,3,4,7,7,21,32,5,5,9,1,15,19,13,7,6,10,0,12,9,9,20,8,8,1,19,4,3,3,2,4,3,10,2,4,1,20,4,15,3,3,1,0,7,3,2,8,3,7,16,3,1,3,7,6,15,7,9,17,7,6,10,1,9,6,30,13,19,14,10,5,16,6,6,2,9,13,4,4,5,11,29,5,14,7,5,6,11,5,2,3,5,16,6,5,10,1,5,7,15,8,2,13,28,11,8,1,7,15,12,0,1,6,6,6,2,2,3,0,8,0,3,6,1,7,0,2,2,6,3,12,7,10,20,24,3,0,21,4,17,13,4,16,6,10,0,4,1,5,4,15,4,6,5,0,10,4,2,1,21,5,2,8,11,5,2,15,5,6,23,3,17,4,6,7,25,19,14,36,5,2,5,10,11,5,3,4,3,15,6,0,2,7,2,1,0,4,1,11,2,9,7,4,7,5,16,0,9,14,6,0,16,5,7,8,10,11,9,1,1,12,9,7,1,4,1,1,6,9,6
defend,4,25,6,70,5,3,2,18,2,0,13,3,15,68,5,9,3,4,6,5,0,12,18,15,11,9,14,7,4,9,15,89,78,17,25,59,79,1,10,7,3,42,0,1,11,6,6,5,125,39,19,3,4,53,7,5,24,9,11,6,3,10,0,3,3,4,75,2,7,40,4,6,7,3,69,9,16,2,39,6,17,0,6,3,78,5,6,1,6,1,3,6,0,15,22,1,6,1,23,1,9,14,19,7,6,12,3,4,4,3,10,3,4,6,7,5,6,0,47,118,18,12,0,23,0,5,1,0,1,0,14,2,10,30,27,20,10,4,6,5,7,16,9,1,4,30,4,6,10,8,29,1,4,7,1,9,20,9,15,31,3,0,7,0,0,6,1,17,4,3,6,53,12,0,1,2,91,4,8,27,11,15,7,3,3,11,8,10,8,19,0,9,3,3,4,5,4,4,2,13,7,0,0,4,26,13,4,8,9,20,25,8,12,5,2,6,0,2,7,1,0,12,2,11,22,49,4,10,0,4,9,2,5,7,21,3,18,6,5,2,21,6,7,5,16,1,4,18,16,3,3,3,7,0,4,7,5,0,0,7,1,46,11,5,0,9,0,17,3,2,68,2,0,6,2,2,54,4,6,0,28,6,0,7,1,3,1,3,9,6,4,1,6,0,1,4,26,6,4,12,14,13,0,1,3,1,19,2,0,1,5,5,11,5,7,8,6,10,7,5,24,8,18,4,67,2,4,16,3,27,3,1,5,1,4,2,18,5,3,4,8,8,10,9,1,7,11,29,9,8,1,3,0,25,10,1,5,2,4,10,10,7,6,16,2,3,21,7,3,11,3,15,1,7,2,11,6,1,12,2,26,4,34,0,4,10,2,11,11,2,12,2,10,4,11,11,11,7,33,3,9,4,4,4,3,6,5,0,5,4,2,0,4,7,3,14,2,6,6,12,0,11,9,10,4,3,3,4,5,17,2,1,0,6,4,2,4,4,33,2,8,12,3,5,4,7,10,14,12,5,28,2,2,1,12,3,2,12,4,4,7,21,13,25,8,1,14,10,0,1,9,5,0,4,2,18,5,11,12,6,7,9,0,4,3,5,5,1,2,3,105,9,10,2,9,11,3,6,2,4,1,5,0,0,6,1,0,8,2,3,4,5,3,1,4,6,1,4,0,15,2,7,1,12,3,5,14,4,5,15,10,8,23,6,7,3,12,3,27,3,5,1,8,2,3,1,1,13,5,1,35,7,3,16,4,5,13,0,1,2,5,1,3,2,8,2,3,0,19,21,4,0,1,3,3,1,3,2,1,10,0,10,9,13,5,0,1,3,2,8,12,4,2,0,3,3,2,4,11,3,12,0,3,0,3,5,2,15,6,6,13,3,3,4,13,2,4,0,3,0,5,2,2,13,0,0,2,4,6,18,4,7,17,10,9,1,1,1,0,6,11,1,3,10,2,6,2,4,3,74,2,5,2,3,5,0,12,14,12,7,2,1,8,1,6,1,1,4,2,1,11,8,49,12,4,6,1,3,2,1,4,10,7,1,5,8,8,0,3,17,8,6,5,3,2,2,3,1,4,9,2,4,1,5,4,10,6,15,1,3,2,1,7,7,9,58,15,2,7,3,10,2,6,10,5,10,7,3,1,5,6,5,0,2,0,17,28,4,23,2,15,6,0,10,7,1,5,3,11,1,7,0,0,1,0,6,4,6,0,1,0,7,0,1,19,13,7,1,2,3,8,1,0,11,3,6,0,1,3,3,1,2,15,0,5,1,1,57,2,6,0,4,0,1,3,3,1,1,1,2,0,5,4,0,14,1,4,3,9,3,4,0,5,0,0,0,1,3,7,8,2,2,3,0,0,1,5,5,3,3,3,3,9,1,7,5,7,15,3,3,1,5,4,7,2,0,2,4,2,13,6,9,3,1,3,2,9,1,5,3,1,5,4,0,1,4,0,3,9,1,1,0,4,6,3,1,1,1,3,1,1,0,1,4,1,2,4,3,10,2,2,5,0,2,4,4,9,1,2,24,3,2,10,5,10,1,0,0,3,6,1,1,3,0,6,1,0,4,2,0,4,2,1,1,2,2,1,5,0,0,0,0,1,6,3,0,3,1,3,2,0,4,0,1,1,10,4,0,4,1,1,4,0,4,1,0,2,2,9,1,0,5,0,1,1,6,12,1,1,6,41,6,1,3,3,0,9,8,4,9,0,2,0,5,2,1,0,3,1,0,0,3,3,5,1,1,0,4,1,5
none,2,20,15,81,3,14,2,35,2,0,10,3,7,70,4,5,8,12,10,5,3,35,23,31,11,10,8,17,13,19,11,112,86,10,41,83,46,5,6,6,5,11,4,8,24,8,9,3,139,33,26,5,9,58,4,3,43,13,5,18,13,4,2,6,29,4,84,11,9,5,4,11,5,4,57,8,18,5,56,18,28,2,11,3,144,16,10,0,21,1,3,4,2,24,26,5,8,5,18,17,10,21,26,10,4,22,1,5,8,2,9,5,12,12,6,29,1,4,42,101,30,16,9,52,8,4,4,3,2,1,18,1,10,30,18,45,4,4,6,4,3,18,16,0,1,56,8,8,6,7,71,5,13,8,4,12,33,5,13,14,7,4,10,3,1,15,3,10,21,9,13,84,10,2,13,1,103,4,7,33,10,23,11,15,4,21,14,17,16,21,9,3,4,1,2,5,13,6,3,10,14,0,4,8,25,7,5,37,15,16,56,6,13,5,4,13,1,2,8,0,0,11,3,10,28,91,11,32,1,5,14,8,11,12,27,25,37,9,5,5,46,21,13,3,14,3,5,31,16,8,6,15,13,0,10,11,13,1,2,17,5,23,8,2,5,12,4,14,16,6,108,4,11,4,6,2,23,15,8,3,54,4,4,12,5,3,11,18,10,2,4,5,11,2,1,8,30,1,10,20,9,22,1,1,9,3,15,3,7,1,1,9,22,8,20,10,12,20,5,4,39,8,27,9,38,3,8,30,3,21,11,6,9,8,12,13,16,3,2,4,2,7,15,5,5,4,32,33,5,4,4,10,4,19,16,3,7,2,9,18,11,7,6,3,2,4,14,15,13,21,2,33,7,13,7,8,7,2,18,10,60,3,33,3,5,13,4,14,19,3,12,6,18,14,17,4,34,8,14,4,17,5,4,3,1,2,6,11,20,7,3,14,7,5,10,8,5,5,2,6,5,9,11,4,3,2,2,5,6,10,7,0,0,4,4,2,3,11,14,4,13,13,3,9,2,6,12,15,12,6,21,4,8,6,23,7,7,5,7,13,6,15,29,20,11,1,19,8,3,6,22,5,3,3,5,16,5,19,14,12,6,9,2,7,5,3,8,4,5,3,51,20,2,6,15,7,3,6,3,6,4,3,3,1,2,8,3,14,7,6,3,1,6,0,8,16,2,17,1,8,4,17,2,16,5,3,11,1,16,18,7,10,3,6,3,7,4,9,15,7,2,2,4,7,4,11,4,9,11,4,43,9,4,27,8,4,36,2,4,4,11,3,15,3,8,8,7,4,22,19,5,8,12,0,2,5,11,2,3,10,16,14,12,13,9,0,4,4,6,8,27,21,13,5,14,12,1,3,16,15,11,1,1,6,3,14,8,15,7,7,19,9,2,3,12,5,20,3,2,4,7,5,3,8,1,3,4,5,14,18,7,17,23,14,4,3,6,1,6,6,18,4,3,3,5,14,3,2,4,76,14,5,3,4,6,9,20,20,5,10,6,10,6,1,5,2,1,3,4,9,16,6,39,11,15,4,2,1,1,3,7,20,4,3,8,6,11,6,1,7,4,12,17,4,4,11,4,2,21,6,7,1,4,4,6,3,6,4,7,1,5,1,6,7,9,11,9,6,8,7,2,4,4,8,3,8,9,1,3,8,5,10,2,3,5,3,15,0,21,11,4,7,1,9,5,3,7,5,8,6,13,1,0,1,0,4,5,12,1,5,4,10,1,2,11,14,2,4,10,6,4,2,3,9,2,10,4,1,6,6,1,6,5,1,9,3,2,18,4,8,5,8,0,4,4,12,1,5,6,3,4,1,10,2,11,6,4,3,15,7,3,2,9,6,3,1,1,11,4,11,1,2,1,6,1,3,4,6,10,6,5,10,6,7,1,16,9,15,8,6,2,11,7,3,4,6,3,6,4,8,18,8,8,11,2,6,2,3,3,2,0,5,7,2,2,4,3,4,7,6,2,5,3,10,1,3,7,2,8,4,0,1,3,1,6,4,4,4,2,3,2,4,0,1,4,3,3,5,2,6,4,2,6,5,20,2,0,4,4,10,1,5,3,0,10,4,8,12,1,0,4,5,5,14,3,8,4,7,1,5,5,1,3,4,1,2,5,4,0,12,2,17,0,3,4,11,5,3,7,3,0,4,2,4,5,2,5,3,10,1,0,1,1,3,0,14,2,0,8,5,11,3,6,5,1,6,2,3,5,2,2,6,3,5,6,6,6,7,23,1,2,4,3,2,1,1,5,10,0,4
influence,2,24,13,83,11,9,4,46,6,1,21,3,10,62,5,11,2,22,7,6,5,30,12,17,25,6,6,15,4,10,9,114,127,4,50,71,60,7,17,14,4,14,2,4,22,14,16,8,252,20,60,6,12,57,3,9,48,13,1,21,14,4,4,4,21,6,120,11,5,9,5,1,4,1,90,18,20,6,55,20,50,3,7,3,157,25,16,1,21,1,7,12,0,21,64,4,10,6,29,16,10,22,24,10,14,23,6,0,4,3,13,5,4,23,2,21,1,3,35,114,38,7,10,46,4,11,3,6,2,0,12,3,14,40,19,43,3,2,6,6,2,38,19,1,5,46,3,15,12,11,114,0,6,14,8,24,21,2,9,5,6,0,2,1,0,7,4,15,28,5,8,72,16,0,4,5,166,11,5,25,16,23,4,9,6,12,20,20,32,24,1,3,7,0,1,1,4,8,5,12,20,0,4,11,24,8,3,38,8,38,69,4,22,9,6,5,2,1,17,2,0,9,8,11,29,102,27,30,2,2,17,8,9,44,43,19,27,12,9,8,53,35,5,3,22,7,5,16,20,4,8,24,14,6,14,12,10,0,7,13,0,21,18,2,9,32,5,14,22,4,130,7,17,6,3,0,14,19,5,1,67,8,1,18,12,1,0,1,16,0,1,3,7,4,0,14,20,4,8,27,17,17,2,0,18,2,28,5,5,4,0,14,14,13,15,19,13,44,13,2,30,13,18,7,35,3,6,29,2,23,8,4,12,6,10,14,20,6,6,6,16,6,11,10,7,0,40,36,14,4,11,7,5,37,6,3,10,13,12,24,29,3,12,15,4,1,27,9,12,8,4,22,3,12,10,7,5,8,28,9,40,3,24,9,2,20,3,14,27,7,23,6,17,13,31,13,49,3,17,4,15,4,7,4,3,14,11,4,33,27,7,12,5,11,2,8,4,11,4,1,10,8,16,9,1,9,5,23,14,23,12,2,0,6,3,3,1,9,5,4,4,19,5,10,1,3,11,11,27,9,17,7,3,3,52,4,2,8,8,21,14,29,36,29,4,2,14,15,3,2,11,1,4,4,5,16,2,20,19,6,3,22,7,6,15,8,14,0,4,4,43,36,1,12,9,8,2,5,10,11,14,8,2,2,7,39,5,21,2,10,4,6,7,6,12,20,7,15,11,8,11,27,14,37,9,2,23,6,13,26,4,6,0,5,8,8,5,9,29,12,3,1,3,3,16,1,3,13,10,3,43,3,4,35,9,10,20,8,5,6,24,2,15,5,17,10,31,7,26,31,16,13,8,3,10,4,7,6,3,15,4,25,9,16,13,10,10,12,2,9,30,20,7,1,22,6,10,9,25,19,20,3,7,5,4,21,9,35,7,4,22,14,7,9,14,8,22,7,5,6,11,8,2,10,4,5,4,8,15,15,5,14,24,21,10,5,6,11,2,3,24,6,0,15,11,17,6,2,3,121,10,4,15,3,6,8,51,14,1,5,6,5,3,9,5,9,4,4,4,10,16,12,27,6,16,5,3,7,4,8,4,16,10,10,10,12,13,1,1,1,16,8,15,14,4,8,17,3,9,13,8,7,2,6,10,4,20,3,8,2,6,6,3,37,14,6,4,10,8,10,5,7,4,11,3,5,3,5,11,18,7,12,4,5,3,0,15,10,35,13,5,11,3,5,6,4,15,6,7,8,14,4,1,4,3,13,6,11,1,7,3,12,1,0,22,22,9,6,6,9,10,2,1,11,3,10,19,4,21,9,8,11,8,7,5,9,6,25,10,6,4,6,2,10,3,16,3,2,5,10,1,3,9,2,13,2,8,3,11,9,5,2,3,10,2,6,5,3,2,13,6,5,3,1,3,7,5,2,10,7,7,8,30,5,16,1,10,29,12,2,0,9,7,10,5,10,8,9,10,6,10,25,7,9,1,6,8,7,6,0,3,2,6,1,6,13,2,4,7,7,2,7,4,22,0,9,1,7,15,5,0,2,4,1,3,6,6,3,3,14,0,4,0,3,4,5,6,1,3,3,7,6,5,9,32,0,2,7,1,15,3,4,13,4,14,0,2,2,12,7,6,10,3,4,2,4,2,5,2,8,4,1,10,9,4,3,6,3,5,10,5,2,3,0,9,7,6,16,19,5,0,3,4,3,5,1,2,6,9,6,3,4,9,1,1,4,3,3,10,4,12,6,7,4,7,2,0,7,9,1,1,11,8,15,10,5,11,2,8,2,8,6,12,1,0,1,2,3,2,4
occasion,6,38,8,107,11,2,6,25,9,0,34,8,7,69,7,7,3,9,13,4,4,36,11,16,14,13,6,15,7,8,13,135,123,12,39,52,54,4,2,4,3,5,7,3,17,18,24,10,252,21,33,6,8,29,4,11,45,25,1,15,22,10,2,8,15,3,77,5,6,3,7,5,2,6,44,10,10,4,57,10,34,0,10,7,180,12,10,0,32,1,2,3,0,24,39,1,14,5,23,13,16,18,30,11,10,37,2,0,9,9,12,5,3,7,0,24,4,1,68,156,23,17,3,43,2,4,2,5,1,0,14,4,2,40,20,20,6,0,4,11,5,18,27,1,7,71,5,5,4,10,45,1,14,2,4,12,15,10,7,6,3,3,8,3,0,1,6,8,14,14,18,70,10,0,0,14,164,3,7,17,17,7,5,13,6,20,20,24,29,46,3,13,3,0,1,0,13,3,6,9,10,0,1,11,23,11,2,30,10,25,58,2,24,3,1,0,3,0,10,1,3,14,3,9,36,50,18,15,3,1,10,8,0,15,34,12,25,9,3,5,66,26,8,5,15,5,4,11,31,5,11,14,21,9,12,26,14,0,4,13,5,27,22,3,5,26,1,2,10,5,122,3,20,11,3,0,11,7,10,3,45,6,2,25,7,1,7,10,12,1,4,2,8,6,4,9,23,2,2,23,19,32,1,1,14,0,21,1,5,1,3,10,16,7,13,16,8,33,9,3,55,5,28,0,72,5,4,24,1,23,3,9,6,0,6,11,20,11,3,19,12,9,14,18,4,4,44,46,16,5,7,13,4,23,21,1,6,3,10,17,12,8,6,12,3,3,38,7,4,12,4,15,3,9,6,39,12,5,19,6,51,3,38,12,3,20,9,19,30,0,23,3,15,6,47,7,58,2,25,8,29,3,5,1,10,5,3,11,20,23,2,8,1,10,21,8,4,10,3,1,5,6,19,10,1,4,2,14,13,19,8,1,0,17,4,7,0,5,7,2,9,18,3,16,2,3,1,4,26,6,12,8,2,4,39,18,1,6,4,34,6,24,18,26,8,0,14,10,7,0,19,4,2,3,7,13,10,20,16,4,4,13,7,7,12,6,18,4,6,5,79,52,6,4,6,7,1,7,8,8,12,2,0,1,7,25,1,10,6,8,2,7,2,5,21,18,3,8,4,7,3,28,5,35,5,7,32,1,13,21,11,4,4,9,6,5,24,13,23,7,6,4,2,0,2,14,9,27,19,5,29,8,2,38,12,9,29,0,4,8,22,5,21,4,24,14,14,7,38,24,5,17,17,2,2,5,4,5,8,10,3,11,9,12,12,7,6,6,2,13,32,41,4,4,8,2,1,0,48,12,18,3,6,3,7,25,7,18,2,0,19,13,7,3,28,10,19,1,6,2,15,2,3,6,0,8,13,11,15,25,2,21,17,23,8,1,2,5,2,9,7,4,6,24,10,29,10,4,2,166,17,2,10,6,9,20,30,14,6,8,5,6,14,17,12,10,2,3,10,4,22,10,17,11,16,5,7,15,4,4,4,18,19,14,15,13,15,2,4,9,4,10,14,13,7,9,7,4,15,25,14,8,4,7,8,4,27,9,7,5,8,13,9,40,6,21,13,9,9,13,21,3,14,23,4,7,6,5,5,18,8,9,1,4,4,3,24,7,17,4,12,4,5,11,17,4,8,2,2,5,11,1,1,5,3,4,11,15,7,3,3,6,7,5,22,11,16,8,3,6,8,2,0,15,5,12,8,2,10,8,5,4,13,5,11,5,2,3,4,10,9,3,1,8,4,5,5,1,4,7,4,12,18,5,4,3,7,2,14,8,2,9,6,5,2,8,3,5,5,8,11,5,7,6,2,9,3,7,6,3,6,7,13,7,9,10,1,17,10,1,7,10,2,3,12,3,12,4,8,15,32,30,4,5,0,1,8,2,6,1,5,0,3,6,15,14,5,4,13,5,0,4,4,8,8,9,9,14,16,13,1,6,1,5,7,5,6,4,3,9,4,5,0,5,5,6,8,10,3,4,9,14,1,14,4,6,15,11,1,33,4,4,7,10,9,3,4,4,4,4,11,1,5,6,2,5,7,25,4,1,4,1,9,4,4,12,3,7,2,5,5,7,5,1,3,9,2,12,14,8,3,8,6,6,7,5,5,7,17,5,3,8,5,5,1,24,2,2,1,4,6,16,16,3,2,7,1,12,8,4,3,9,6,6,7,2,16,1,17,2,2,4,9,0,0,2,0,9,1,3
cause,12,41,12,228,35,14,9,87,12,9,41,22,12,182,11,32,7,46,14,22,23,90,33,39,53,26,24,33,11,51,28,356,267,25,104,174,193,12,36,19,11,74,14,12,77,36,39,23,542,59,91,14,41,105,18,21,123,46,11,48,40,10,8,23,65,15,221,16,35,21,45,5,10,9,133,34,33,25,184,67,115,8,41,15,456,35,28,4,81,2,22,20,4,53,115,18,40,18,100,39,10,55,80,23,34,68,19,8,30,7,29,26,18,22,7,56,13,8,108,311,64,46,22,144,19,12,9,6,9,5,30,8,21,86,62,72,54,12,12,28,13,74,79,7,11,166,18,40,23,32,148,3,45,10,11,42,51,14,23,29,27,4,21,8,5,12,9,49,55,26,44,195,46,10,8,36,379,6,33,58,55,38,11,30,12,54,71,52,85,120,7,20,11,6,5,15,31,17,17,36,59,7,7,60,60,22,5,48,26,49,182,16,42,15,4,9,5,15,40,4,9,34,16,27,72,208,62,65,9,18,28,32,42,46,50,44,77,25,22,5,159,65,21,24,64,29,15,39,76,24,23,57,47,24,18,50,34,7,9,35,23,61,37,7,10,75,21,21,42,12,301,20,69,11,14,6,47,33,22,2,143,23,5,45,27,10,14,24,55,6,9,5,36,13,8,12,102,15,11,50,87,54,1,14,28,6,47,9,13,4,7,17,51,16,62,34,33,102,30,10,113,23,55,7,140,17,24,69,9,53,16,26,22,8,15,17,51,21,5,22,23,22,23,20,16,12,110,129,40,15,17,28,12,56,48,10,7,9,41,67,56,15,17,49,22,6,104,19,16,22,9,46,9,21,40,47,18,14,39,24,124,4,104,27,11,66,25,42,61,16,78,16,7,18,68,26,108,7,78,11,52,9,11,5,4,26,17,16,47,32,9,21,18,33,30,30,13,34,8,8,16,3,42,42,7,12,8,43,37,50,23,14,8,33,17,18,4,26,12,17,34,55,11,33,3,16,11,19,80,18,31,16,10,13,113,11,9,14,23,58,33,58,94,48,13,4,49,22,15,7,52,6,6,6,12,46,20,34,29,11,19,59,10,15,30,19,25,21,14,15,186,72,10,19,28,24,7,36,30,32,24,11,18,3,14,34,11,28,13,17,15,16,21,9,26,37,15,22,8,34,6,48,14,33,10,26,46,13,45,60,19,18,11,17,27,15,28,25,103,36,10,5,7,12,20,35,22,32,54,10,44,12,13,83,17,26,66,26,19,22,36,8,40,14,39,32,31,12,90,80,36,17,26,11,22,14,34,12,16,28,24,27,35,32,24,11,9,11,10,19,48,71,27,7,75,16,12,13,121,52,45,14,16,23,20,42,11,32,14,12,54,34,41,27,67,27,34,10,20,13,32,32,5,51,2,12,11,17,26,64,51,48,50,52,18,10,28,11,5,19,26,9,32,67,39,68,7,17,14,314,39,15,20,7,13,32,96,30,22,37,17,23,36,48,18,19,13,22,36,38,41,17,134,96,62,13,6,10,8,16,7,64,36,15,27,16,20,17,8,25,18,24,35,22,14,18,20,8,27,28,41,9,14,15,11,17,39,12,5,11,8,18,18,37,38,41,12,19,15,7,30,15,29,48,8,16,21,7,8,50,17,27,15,16,22,5,32,22,58,25,33,13,8,16,18,14,35,10,21,14,26,14,9,21,11,31,17,32,11,28,36,32,10,11,51,51,30,14,14,35,18,7,9,35,10,28,22,6,35,27,12,15,31,13,18,15,22,29,18,38,16,28,10,11,30,33,10,17,21,19,7,18,18,13,17,14,27,13,39,14,23,10,21,29,11,11,12,16,14,23,32,11,14,28,11,13,5,14,32,17,22,25,19,15,15,29,17,1,15,23,28,5,16,18,24,16,17,17,12,44,48,64,14,8,11,11,29,25,21,7,12,15,18,4,14,23,15,9,21,20,4,9,20,26,44,22,23,27,27,10,6,11,3,15,31,9,12,15,4,8,8,16,0,15,34,21,11,9,17,25,17,13,9,21,16,8,14,34,11,33,10,6,15,28,16,19,6,12,13,6,24,32,9,14,16,16,14,54,14,18,7,5,12,14,9,10,9,22,10,26,12,34,8,8,9,37,23,26,58,15,5,17,13,7,6,7,6,5,27,20,2,9,31,14,7,30,13,17,10,13,24,16,24,10,15,15,1,32,20,11,14,23,16,32,11,3,13,3,36,2,13,2,9,1,3,7,7,16,4,12
possess,8,11,10,113,4,2,3,36,2,3,22,7,3,95,4,21,7,15,2,2,3,30,4,21,10,2,9,7,1,10,16,120,93,4,41,53,45,7,4,6,3,11,4,0,17,32,14,16,355,14,53,13,14,35,5,5,45,13,1,13,40,15,3,17,18,4,105,5,9,13,5,5,5,6,79,10,13,6,79,27,23,0,20,10,216,25,14,0,26,0,3,6,0,42,49,14,28,5,29,14,7,28,24,17,13,9,2,2,11,6,16,9,4,17,0,29,6,2,73,231,45,8,5,35,8,4,3,6,3,0,10,5,10,39,23,23,6,5,1,9,0,27,20,3,4,51,5,3,18,3,114,1,16,11,4,20,20,4,16,4,5,3,15,1,0,6,3,12,9,8,28,80,15,0,2,10,127,5,11,23,19,27,0,9,4,20,23,17,57,34,1,10,7,0,0,3,5,4,7,7,14,1,1,8,34,13,3,26,12,14,71,2,28,8,1,2,0,0,6,1,3,20,4,19,65,87,19,23,2,2,11,9,11,40,47,11,25,5,6,17,65,36,7,3,11,2,4,15,38,17,9,17,16,6,18,15,7,2,3,10,2,30,12,4,1,16,7,5,29,1,159,3,9,8,1,1,22,2,11,1,57,10,0,10,7,5,3,8,9,2,2,1,6,3,1,7,46,4,1,16,16,23,0,1,28,3,26,2,4,2,0,18,18,5,21,8,17,47,9,7,44,7,24,3,147,10,5,19,3,21,4,12,8,2,4,17,20,7,2,6,23,14,20,23,8,7,44,37,17,2,20,9,6,22,41,7,4,2,12,21,17,3,13,12,5,3,55,5,1,7,2,13,6,8,7,18,14,4,12,5,84,6,48,7,1,38,5,16,30,6,32,3,8,9,35,5,56,2,22,6,16,2,2,0,2,8,3,8,12,6,1,8,4,7,32,7,2,4,4,2,3,9,16,11,2,4,4,13,12,12,7,1,2,6,0,8,1,4,16,2,12,22,4,21,0,5,8,6,39,5,8,11,0,4,56,22,1,21,11,19,5,22,23,20,15,0,13,19,25,0,12,6,1,1,8,16,9,9,22,9,7,16,9,19,9,14,5,5,0,5,110,41,0,7,11,7,5,13,6,16,17,4,7,1,8,18,3,6,3,2,3,8,5,11,17,21,5,10,2,10,7,30,14,47,20,5,23,4,14,21,23,7,3,7,12,5,11,7,38,20,9,1,3,3,3,8,2,13,13,6,47,6,2,68,3,8,44,4,5,7,11,2,15,5,4,25,13,11,25,30,9,9,10,2,2,3,8,11,12,21,5,11,15,16,16,8,5,8,13,13,25,53,8,5,15,7,7,2,54,22,16,3,6,5,13,22,5,21,2,5,32,24,12,9,41,18,11,4,12,6,9,12,1,14,2,6,16,9,16,38,11,15,31,28,13,1,5,12,5,10,10,3,14,18,7,14,4,1,5,192,35,12,4,3,10,8,49,43,10,13,7,7,9,15,13,8,3,7,12,8,15,5,51,49,20,20,4,4,16,11,9,18,13,3,8,7,17,6,13,25,10,11,14,29,6,6,7,8,15,14,4,13,5,7,10,10,13,11,6,5,7,4,4,41,19,32,5,11,9,9,15,8,7,20,5,18,8,2,4,16,5,13,3,5,5,3,21,3,65,15,5,12,6,2,20,6,13,4,6,6,6,1,0,2,0,9,12,6,7,4,2,12,4,0,22,13,10,1,4,7,3,3,2,13,6,17,5,2,9,7,1,4,11,2,3,6,5,11,15,10,4,20,4,5,18,12,8,9,6,3,4,4,31,5,1,4,7,4,11,6,7,3,10,6,6,8,5,7,4,18,3,3,0,1,9,4,4,4,16,3,2,8,14,3,8,12,10,15,1,8,4,6,12,8,1,9,10,5,6,7,68,26,9,8,4,5,1,4,3,2,2,14,6,2,10,10,2,0,23,3,1,3,5,21,2,3,0,9,12,15,4,5,3,1,10,3,5,5,12,4,6,11,2,2,9,1,13,4,1,7,4,7,9,15,13,1,3,9,2,32,8,3,7,3,14,2,4,22,3,2,6,7,0,5,4,8,4,19,3,2,2,0,9,8,2,2,7,6,8,8,7,12,2,2,1,21,20,16,7,0,4,3,4,6,4,0,25,25,6,2,8,8,1,3,1,41,1,0,2,10,13,7,18,2,4,1,0,6,12,15,7,12,3,10,4,3,16,0,33,8,9,2,6,0,1,0,2,5,2,0
information,5,25,7,132,11,3,3,41,6,1,6,7,6,36,3,4,3,4,7,4,2,16,3,14,15,10,6,11,3,14,9,104,77,4,30,24,22,2,3,4,3,3,5,1,20,4,5,17,225,16,19,2,9,16,5,2,34,52,4,13,18,1,1,21,13,3,43,2,2,5,3,2,1,3,32,4,6,4,77,13,16,0,13,2,116,5,8,0,33,2,7,2,3,11,26,3,8,0,19,9,7,16,16,8,4,30,4,4,4,2,8,0,3,13,7,10,6,5,33,42,21,14,8,47,4,3,6,1,0,1,7,2,5,27,12,32,3,2,1,7,0,24,14,2,0,42,4,9,4,4,26,2,7,1,2,7,18,3,2,12,12,1,3,1,3,7,2,13,7,8,9,38,9,2,2,4,100,0,2,22,13,6,6,11,3,20,13,12,20,28,3,13,4,2,2,0,14,2,1,3,17,2,1,6,11,7,3,12,4,12,65,3,16,8,2,7,1,4,14,3,1,10,3,6,34,45,16,7,3,3,5,10,4,8,19,11,11,7,9,2,29,30,5,1,9,0,1,10,29,5,9,7,8,1,5,15,7,3,3,7,4,6,16,4,1,65,17,3,4,4,69,5,8,8,0,3,14,5,17,6,46,9,1,14,5,1,17,16,10,1,6,5,3,1,2,3,64,9,2,11,13,25,0,1,10,0,16,5,4,4,4,7,23,10,8,10,6,16,3,2,35,3,7,3,9,3,7,29,5,10,0,2,0,1,3,5,10,10,2,7,5,9,9,3,2,2,19,45,13,5,4,7,3,17,12,2,4,2,6,11,15,8,12,7,4,6,18,5,5,8,2,12,1,9,5,31,8,0,9,9,49,0,42,8,1,14,5,5,8,0,10,5,15,13,20,4,36,5,20,7,17,1,3,2,2,1,6,3,18,13,1,7,8,9,5,8,4,1,2,2,3,3,10,7,1,3,3,3,12,12,5,6,3,11,1,1,0,8,5,2,13,15,5,4,0,4,8,5,17,1,7,3,9,0,19,4,2,7,4,17,4,8,10,9,2,0,8,6,6,1,5,2,3,3,1,6,2,15,5,1,3,9,0,6,3,4,11,2,3,1,22,27,1,1,5,7,3,7,1,2,10,5,2,3,5,3,1,10,3,3,1,2,10,5,8,8,4,5,2,3,1,10,2,6,3,5,12,4,22,15,0,2,5,5,15,6,12,1,26,11,2,1,0,5,5,9,3,9,7,3,28,3,2,29,3,14,27,2,2,1,23,3,14,2,7,9,10,6,26,19,8,9,8,1,5,4,15,6,3,12,4,8,5,5,7,4,1,2,1,4,7,28,4,5,12,5,1,4,23,7,9,2,0,3,1,9,7,20,5,19,25,13,10,2,12,1,10,1,6,4,10,1,0,12,3,2,8,4,6,25,0,18,10,11,4,1,8,3,8,9,3,1,8,13,10,31,3,5,2,108,11,3,3,3,7,12,18,9,1,10,5,6,10,2,6,7,1,2,7,8,4,2,25,5,16,4,7,5,0,7,2,12,12,10,4,12,8,1,4,6,6,21,11,8,7,2,3,4,10,12,1,3,4,7,7,5,11,5,0,16,2,5,1,11,3,18,8,1,2,3,7,1,8,16,0,5,4,1,4,7,4,18,4,1,3,4,9,2,25,4,6,5,3,3,1,3,13,5,2,3,3,3,2,6,3,9,5,12,1,3,3,11,4,2,7,18,8,4,10,3,4,6,1,14,5,6,4,6,13,7,4,1,6,7,9,3,3,8,2,15,5,4,5,6,2,11,0,10,4,4,2,4,9,13,3,1,6,1,12,4,9,1,7,7,9,4,9,2,7,4,6,1,6,17,5,6,6,3,5,2,7,8,10,3,6,2,1,23,8,1,24,4,0,7,1,3,5,8,6,6,14,16,1,9,7,3,6,10,8,1,4,2,5,2,2,7,3,4,3,13,18,3,3,1,1,1,4,6,3,0,2,6,2,3,17,3,5,12,4,3,5,8,1,3,1,5,4,3,6,0,0,6,3,9,3,3,1,6,10,12,16,1,2,5,4,6,1,4,3,1,6,5,0,2,5,7,1,10,7,4,4,4,4,5,3,1,3,2,2,11,3,5,7,1,5,12,3,12,15,7,2,5,13,2,2,1,0,2,10,2,3,3,2,1,3,13,7,8,1,1,4,3,0,2,10,3,0,2,10,1,0,1,13,0,1,2,5,7,12,2,8,8,2,0,1,1,2,6,2,4
communicate,17,13,2,168,8,1,5,25,3,0,31,20,0,27,2,8,3,2,1,2,9,33,2,8,9,9,3,10,3,11,6,115,57,1,16,21,28,1,3,0,0,6,6,2,13,13,11,8,280,12,26,2,5,3,2,4,40,34,0,17,19,2,0,13,5,0,27,1,12,13,1,5,1,4,11,3,2,3,58,15,8,0,27,3,155,7,2,0,53,0,7,2,0,21,24,1,7,0,20,7,7,12,28,8,5,25,6,1,4,1,9,6,2,1,0,26,7,3,54,72,18,10,0,17,2,0,1,4,0,0,3,2,1,28,10,3,6,1,1,3,0,25,31,0,0,42,4,2,2,5,32,0,12,2,0,2,2,2,7,0,3,1,2,3,0,0,5,7,6,10,9,42,6,1,0,7,99,1,7,7,11,13,2,5,5,5,10,16,30,43,3,6,2,0,0,1,3,1,3,4,7,0,0,11,14,5,0,7,14,6,66,0,21,4,0,0,0,1,8,2,2,12,9,8,19,38,10,6,2,0,9,8,11,11,11,7,21,1,2,2,48,20,7,3,4,5,1,4,13,0,2,7,19,3,2,11,11,1,8,6,0,15,16,5,2,25,2,0,5,3,88,1,19,4,1,0,3,9,17,3,22,2,0,10,2,0,2,6,13,0,9,8,1,2,3,5,48,12,8,5,12,23,0,1,10,0,16,3,0,0,4,5,13,2,12,6,7,40,6,1,42,5,6,0,28,4,2,23,9,13,0,2,2,0,6,8,11,10,1,10,3,9,7,5,2,2,24,53,9,1,8,7,2,8,16,0,2,2,16,9,4,2,4,11,4,0,23,2,2,2,2,4,0,2,1,13,2,1,3,6,42,0,27,7,0,12,2,16,20,5,9,4,17,20,31,2,70,3,18,1,33,0,3,0,5,1,2,4,19,7,1,8,3,8,8,3,7,3,2,2,3,1,6,7,0,2,0,7,14,8,5,5,6,19,1,7,0,34,4,1,14,15,5,5,0,1,1,4,19,2,8,5,0,10,37,0,2,9,1,14,5,8,14,7,2,2,1,7,3,0,3,3,2,0,0,1,1,15,9,1,1,8,0,4,12,8,2,4,3,0,51,22,0,2,2,4,3,9,5,5,4,3,1,0,3,0,0,6,4,2,2,1,11,3,1,10,2,1,0,6,0,16,4,12,2,7,12,0,20,11,1,0,3,1,1,3,20,7,17,6,1,2,0,0,3,20,3,14,10,4,18,5,1,21,5,4,21,0,0,6,21,1,23,1,9,8,7,8,15,17,4,11,13,0,3,6,4,1,1,7,3,16,3,7,1,0,3,3,1,5,15,19,2,2,6,3,0,0,61,16,12,1,2,16,12,15,4,24,0,6,23,14,18,4,30,1,13,1,6,7,8,0,7,10,1,4,9,4,11,14,2,23,13,13,3,0,2,4,3,14,0,0,5,19,7,43,2,8,3,181,22,1,5,2,5,17,8,5,3,11,1,6,26,24,9,15,5,10,9,13,9,5,75,9,30,2,1,17,0,3,4,13,22,6,10,11,4,3,2,11,13,4,20,8,5,6,5,5,6,25,8,3,8,3,2,7,19,1,2,13,2,17,3,19,13,12,5,10,15,0,10,6,8,14,0,11,5,0,2,1,2,17,2,2,10,8,11,5,25,3,5,8,1,5,14,2,6,2,2,6,5,9,2,9,1,7,3,9,6,2,1,3,10,3,6,4,5,4,0,5,3,0,0,13,7,7,0,1,5,9,2,2,5,1,5,4,4,19,2,12,12,5,3,2,0,10,0,10,1,7,3,6,12,17,1,1,3,1,16,7,5,7,10,9,2,3,1,5,7,9,9,1,12,4,5,4,1,3,8,4,6,5,5,1,2,0,7,28,4,24,1,13,0,15,4,3,0,3,1,9,22,26,5,7,2,3,2,4,4,0,4,3,11,1,3,7,2,1,5,2,0,2,0,3,3,4,18,19,10,1,9,12,3,5,16,5,13,9,6,6,0,6,0,12,7,15,6,10,3,0,0,19,3,7,2,5,6,10,4,20,2,6,2,12,11,6,1,7,0,2,15,8,3,10,2,8,3,52,6,1,12,4,8,5,3,2,4,5,5,4,0,5,2,3,0,6,3,5,18,13,2,2,1,1,9,4,0,1,16,9,3,4,1,1,0,11,1,2,0,1,3,0,5,0,15,5,0,3,10,7,2,4,11,2,2,0,4,1,30,0,7,1,4,0,0,2,0,9,1,1
legislature,2,21,43,176,9,3,1,52,3,0,23,12,0,27,3,11,6,17,0,3,7,44,8,18,23,6,9,6,6,18,3,91,54,7,30,26,13,7,4,0,5,4,3,0,11,18,23,9,323,3,25,1,2,5,9,2,48,5,0,9,14,1,1,14,13,7,99,1,8,3,0,7,0,2,37,12,8,3,48,9,12,2,7,7,144,6,7,2,15,1,0,7,0,21,40,2,5,1,16,6,5,23,26,10,2,40,4,0,9,1,11,2,3,7,0,13,5,5,91,136,32,8,6,22,2,3,6,2,2,0,4,2,2,37,11,46,3,0,1,4,7,15,27,4,1,57,3,7,9,14,60,3,7,2,0,27,10,1,6,3,4,1,10,0,0,9,0,13,8,11,5,71,8,0,4,4,126,3,8,13,22,8,0,6,2,17,17,19,35,36,2,10,3,1,0,2,13,0,11,14,19,1,0,8,12,9,0,10,10,8,68,2,30,3,2,0,0,4,6,2,2,12,7,9,45,115,13,15,1,1,8,7,9,29,24,16,23,3,1,4,48,21,5,17,8,2,2,13,50,3,5,11,9,2,5,11,12,1,2,10,0,21,32,4,4,14,7,4,6,11,97,4,11,8,4,1,9,8,7,5,33,12,0,17,4,2,6,4,15,1,1,0,8,4,1,8,20,3,8,10,10,33,0,1,8,1,12,4,9,3,1,32,33,3,8,10,4,32,2,4,16,3,10,12,44,4,17,11,2,35,17,4,9,7,5,12,7,6,2,8,10,4,14,9,3,4,39,37,11,4,8,14,8,16,18,0,28,0,14,17,13,6,5,9,4,0,31,4,10,11,3,12,4,8,11,9,8,0,12,5,66,5,20,10,4,19,9,9,15,2,19,3,23,13,26,20,50,2,14,0,19,2,3,0,5,6,6,0,5,14,0,3,0,9,0,11,1,7,0,0,1,3,18,10,2,6,1,5,12,8,9,5,3,13,2,0,0,7,8,4,6,9,7,6,0,0,2,7,18,7,7,6,1,5,21,7,0,12,9,22,11,9,23,10,0,11,7,2,14,0,8,5,3,4,2,16,1,29,7,8,7,11,0,10,3,19,5,3,4,4,23,35,2,4,3,4,6,10,4,12,3,6,3,0,0,16,2,6,5,3,1,11,4,9,8,16,4,10,2,10,0,16,11,26,4,4,10,6,18,23,7,10,0,7,18,5,14,3,18,12,2,1,1,3,3,9,1,21,18,5,135,4,8,37,5,7,12,3,7,12,25,5,18,1,10,16,9,5,31,23,2,7,13,5,9,4,3,2,6,4,3,12,8,6,11,2,0,1,4,3,15,16,3,5,15,2,1,1,16,6,28,2,1,26,2,11,1,44,26,6,13,5,16,1,17,8,14,1,6,3,10,3,9,14,1,6,6,4,2,26,3,25,37,29,10,4,8,3,5,7,4,4,20,13,5,6,1,2,11,93,20,4,3,17,3,9,25,9,8,10,10,1,32,4,7,8,0,7,7,5,17,6,5,40,15,4,6,5,0,4,2,18,19,6,8,11,5,8,4,4,11,6,17,4,6,5,7,9,11,15,0,3,2,2,14,3,9,3,7,3,3,5,2,36,17,5,0,7,7,4,3,12,1,15,2,11,4,1,2,7,5,14,4,8,3,0,5,4,33,5,3,11,5,4,5,1,8,7,0,1,12,5,0,0,0,7,4,12,4,5,5,10,8,0,15,4,14,5,3,0,6,0,0,7,0,9,4,5,7,11,1,1,10,5,15,4,5,54,3,10,9,23,10,1,9,20,0,2,0,6,2,5,3,7,1,1,9,2,10,8,0,3,9,13,1,0,6,5,0,11,6,1,0,3,0,6,1,8,6,4,5,1,16,5,11,9,10,5,6,4,13,1,11,12,2,7,6,0,2,9,26,25,7,5,5,1,11,4,6,2,1,8,5,1,2,5,1,7,13,6,4,3,6,4,6,8,4,5,21,0,0,1,0,1,9,3,4,0,3,5,1,16,2,0,5,0,0,32,4,1,0,5,0,8,43,1,0,4,2,15,6,2,6,1,31,1,2,7,1,2,6,7,4,17,0,16,2,0,0,6,4,2,5,4,3,0,6,0,0,8,2,5,0,0,2,5,6,1,18,5,0,1,3,4,4,1,1,0,27,2,2,10,1,0,1,10,1,0,14,4,1,3,2,5,4,5,1,5,8,8,0,5,4,5,2,3,14,1,9,0,8,3,1,0,1,1,0,6,1,0
supreme,2,13,18,92,2,2,2,44,1,1,2,4,1,24,3,7,6,7,1,0,3,13,16,14,13,1,8,2,8,11,0,88,46,10,27,25,13,1,4,2,4,6,2,3,13,9,7,15,212,3,17,1,6,8,1,0,42,6,0,9,3,0,3,4,13,3,41,14,3,9,4,1,1,1,32,6,13,2,46,8,30,0,2,4,77,3,2,0,13,1,0,4,0,15,16,21,12,5,15,5,3,14,10,4,4,9,1,7,3,0,9,1,1,8,0,14,3,2,39,100,30,5,50,22,8,1,3,2,7,0,3,0,6,24,14,5,4,1,3,1,2,17,11,4,1,28,3,7,7,12,53,0,12,0,0,85,12,0,6,3,9,0,4,0,0,2,2,11,17,3,6,63,13,0,1,0,95,2,7,11,10,13,0,15,1,8,23,14,43,27,1,6,1,0,1,1,8,0,5,11,36,0,0,5,10,1,3,25,8,2,34,0,28,2,2,2,0,0,3,0,0,15,3,7,25,129,12,10,0,4,6,14,7,24,13,3,20,2,1,7,54,16,3,7,6,6,1,8,36,7,10,8,4,5,2,8,8,0,1,9,1,7,11,3,2,7,1,1,2,0,77,0,11,3,4,1,11,5,5,5,27,5,0,2,4,0,4,0,6,2,1,2,9,2,3,5,23,6,6,13,9,12,0,0,8,0,4,5,3,2,0,14,7,4,4,5,9,19,5,2,17,3,11,5,58,13,2,3,2,27,1,10,8,3,2,5,6,5,0,2,12,1,1,4,3,3,25,15,7,2,9,14,10,5,13,5,3,0,11,8,30,4,0,12,1,2,18,3,10,10,3,2,1,0,10,7,6,0,7,1,31,3,16,3,1,11,3,4,17,0,49,0,7,7,18,9,34,3,10,3,10,2,3,0,1,4,5,2,5,4,0,7,0,9,0,1,1,6,2,0,3,2,20,11,0,5,1,9,4,10,3,1,0,1,1,2,0,1,0,6,3,9,1,1,0,1,0,3,16,2,3,1,1,1,22,13,0,18,9,19,7,7,18,10,2,1,3,10,0,0,5,3,0,2,2,10,4,9,13,7,4,10,1,4,4,22,8,1,0,12,9,26,1,2,1,1,0,13,7,19,5,2,7,0,3,3,0,5,5,0,1,7,4,6,4,9,4,6,27,7,3,18,7,25,12,5,15,11,14,10,13,1,2,7,7,2,3,2,16,9,5,0,3,0,0,16,1,11,14,4,54,4,25,25,11,6,13,3,7,5,8,6,14,0,13,8,3,19,26,19,5,4,0,6,3,1,1,9,9,11,0,11,10,9,9,4,6,1,4,4,14,11,3,2,7,0,7,1,3,10,9,1,3,1,5,16,4,14,6,0,20,22,9,5,52,9,14,3,18,1,8,2,0,10,0,10,1,10,6,13,0,13,12,22,3,1,10,8,0,4,11,0,55,5,4,2,1,0,8,83,3,1,8,9,2,0,19,13,4,5,4,6,4,7,1,2,0,3,4,6,16,5,1,337,10,2,6,3,0,1,4,13,4,6,3,7,0,1,2,4,16,3,3,3,0,1,2,1,24,4,1,3,3,3,8,1,9,0,8,2,8,3,3,9,10,4,1,6,4,6,4,6,1,8,0,2,6,1,5,10,2,13,0,1,9,0,5,1,32,7,7,2,1,0,1,3,11,3,3,2,4,0,0,1,0,6,1,4,1,5,4,9,0,1,16,5,1,7,0,5,4,0,1,9,5,11,0,1,3,9,0,1,12,2,5,2,1,3,3,3,2,33,6,4,9,11,10,5,1,8,3,2,4,2,2,0,6,1,10,0,0,0,0,1,0,0,5,0,1,3,2,2,0,3,0,0,2,1,0,3,0,1,6,4,7,7,2,16,12,0,0,11,1,40,2,3,2,4,5,5,6,26,9,1,0,5,7,1,4,0,0,13,3,0,3,6,0,1,4,9,1,4,0,0,2,7,1,3,9,0,6,0,6,1,3,0,1,4,2,0,0,0,0,0,2,0,1,0,4,0,7,0,0,9,29,1,0,3,0,10,1,0,7,5,5,1,1,1,0,0,1,1,2,0,0,11,0,0,0,1,1,5,1,3,8,3,1,0,3,6,1,9,0,0,0,0,0,3,6,0,1,6,3,2,3,0,1,2,1,3,0,0,1,2,0,0,0,0,7,3,2,2,2,0,3,2,0,1,3,3,0,2,0,0,1,11,9,0,0,0,2,2,5,0,0,6,0,2,1,0
decision,5,44,12,153,16,1,1,30,6,0,18,12,8,41,10,19,21,22,11,2,10,20,12,22,28,9,14,12,3,12,9,204,75,27,36,34,23,1,3,2,6,11,5,3,29,22,33,7,286,8,45,3,6,15,9,1,48,22,7,17,12,1,4,10,13,7,92,12,9,11,6,0,2,1,68,14,20,3,40,16,12,2,10,7,141,10,8,0,28,1,5,1,0,24,34,13,27,2,23,5,9,25,28,4,9,18,5,3,6,1,10,2,6,19,4,15,8,6,52,110,34,19,6,38,5,3,0,7,4,1,16,1,4,30,14,36,7,1,3,4,0,34,27,1,4,59,11,7,15,8,74,2,13,5,1,22,24,3,9,13,5,0,1,1,3,3,3,22,14,5,13,58,17,4,10,11,154,7,17,30,15,21,1,21,3,16,19,22,96,53,3,1,7,1,0,3,6,14,5,4,27,2,2,9,23,11,2,9,9,8,70,8,28,8,1,9,0,4,22,3,2,13,13,12,33,133,24,11,4,4,9,20,4,25,19,4,20,1,1,10,73,21,11,13,6,3,3,13,34,12,11,12,13,5,2,13,2,4,12,10,9,19,52,8,7,44,3,2,9,2,148,4,14,4,1,3,12,9,30,6,44,8,5,22,7,3,17,12,13,5,6,5,17,4,2,7,31,5,5,18,12,21,1,1,18,1,3,3,6,9,2,7,21,2,19,12,14,50,12,6,30,10,19,2,50,10,5,26,8,26,10,10,8,9,15,7,7,8,0,4,13,9,3,14,0,1,36,35,13,4,18,35,10,15,19,3,4,2,11,17,27,6,3,10,3,5,38,9,3,21,3,16,8,7,15,13,8,2,8,3,60,5,33,10,5,30,4,8,28,1,31,5,12,19,27,9,85,2,35,3,31,2,2,0,3,1,12,3,9,5,0,3,0,2,8,6,9,4,5,3,1,6,23,17,3,10,3,11,8,17,4,6,1,1,2,3,6,9,2,9,6,6,7,6,1,3,2,9,18,9,9,7,4,6,59,17,0,13,11,26,6,9,17,15,2,0,5,11,9,5,25,3,2,3,6,10,2,18,14,3,7,12,2,2,5,61,5,1,2,0,27,35,0,6,1,1,1,13,9,14,12,1,2,2,4,11,2,16,6,7,1,5,8,5,3,30,7,7,44,7,1,16,4,21,7,7,35,2,18,29,9,4,4,10,18,9,12,7,38,25,4,9,6,5,3,10,0,14,22,6,55,10,16,27,6,6,13,7,9,7,14,5,26,5,14,16,6,8,33,42,8,8,6,6,7,0,1,2,3,7,0,7,6,13,20,3,2,4,2,15,17,34,4,0,26,1,14,3,76,13,12,0,1,10,15,14,5,48,4,1,31,30,18,3,76,6,17,3,29,0,9,2,1,21,4,6,3,10,13,31,3,14,40,27,4,4,14,5,4,10,4,0,38,21,12,15,6,7,11,166,9,4,14,6,10,9,38,18,6,10,1,3,34,28,13,17,13,11,8,8,26,5,35,166,38,2,2,5,3,2,1,39,11,9,5,16,10,1,1,1,19,9,11,4,11,4,4,9,9,16,1,6,5,5,9,1,16,0,2,5,9,8,4,20,13,10,5,7,16,3,7,12,1,13,0,6,9,1,7,8,4,8,3,2,14,0,4,3,28,1,6,6,0,2,7,5,5,7,7,3,5,1,0,4,1,9,2,12,3,1,3,16,4,0,7,2,6,5,4,10,11,2,1,7,5,21,3,1,7,4,1,1,9,0,12,3,4,17,4,12,1,19,7,7,17,26,23,10,1,2,2,5,12,8,8,0,9,7,23,2,0,1,4,13,1,10,5,15,4,7,2,2,14,32,3,4,3,11,1,5,5,4,6,7,3,10,3,18,8,7,15,12,40,1,7,9,6,10,5,7,36,26,13,3,4,4,10,4,10,2,7,4,6,1,11,6,4,6,5,7,3,0,0,2,0,4,18,18,12,2,24,7,7,8,29,3,8,5,0,4,3,5,0,5,7,2,2,1,4,2,11,7,1,2,11,5,0,9,2,14,1,0,5,13,9,2,3,5,2,6,3,6,9,11,7,14,11,21,3,3,8,6,8,2,3,4,1,5,2,6,2,1,3,0,1,10,8,2,13,2,0,9,2,2,1,3,1,1,8,8,1,0,4,7,2,6,3,0,11,3,4,8,2,3,12,2,5,9,1,1,0,4,9,0,4,0,7,5,15,2,6,1,1,5,1,0,10,1,2,1
loss,4,3,3,70,3,2,1,11,1,1,2,2,7,33,3,2,1,12,2,3,5,36,6,13,10,5,3,1,3,6,7,109,75,7,24,23,15,8,23,0,1,8,7,5,22,10,15,10,151,11,30,3,6,18,8,10,41,18,1,10,5,12,1,6,14,3,58,3,1,8,24,6,7,7,37,10,19,3,45,7,43,3,9,4,135,26,16,0,27,4,4,2,1,11,21,8,9,9,17,23,9,13,28,2,10,33,15,6,13,8,11,3,7,9,4,21,5,4,28,99,30,23,14,54,6,0,2,3,1,7,10,6,3,32,8,34,7,4,2,1,3,20,18,5,0,43,4,13,14,5,16,0,6,1,7,9,11,2,6,4,21,6,12,5,8,5,10,10,16,6,16,45,6,6,3,30,105,2,3,19,8,3,3,12,4,11,24,16,19,27,1,5,7,1,2,2,9,4,11,13,40,4,1,3,9,2,6,32,4,9,51,3,9,6,1,4,10,0,4,1,1,9,6,10,34,33,21,11,7,12,7,20,13,9,27,27,18,4,8,2,59,21,11,3,6,11,3,22,34,1,11,18,10,5,13,11,20,3,6,9,24,16,17,0,2,43,0,3,7,6,57,7,35,5,5,2,21,4,7,3,40,6,1,13,11,5,6,7,8,1,4,2,4,4,5,5,33,4,7,9,18,13,5,5,17,0,4,4,4,0,2,12,19,2,37,20,9,42,16,3,49,7,14,3,25,4,9,22,0,11,0,14,11,1,7,1,6,6,1,6,5,6,8,4,8,5,16,35,3,5,8,6,2,44,18,5,0,0,6,8,19,5,7,12,4,1,23,3,3,3,1,7,7,8,7,15,3,11,7,5,22,0,28,6,4,12,1,19,20,1,7,1,6,0,13,6,50,3,24,7,9,1,2,1,6,3,6,2,21,11,1,6,4,15,2,6,1,10,2,1,2,3,8,6,2,2,4,12,7,13,11,11,1,7,2,3,0,8,7,2,15,14,6,13,0,2,4,4,8,8,16,4,2,0,44,3,1,2,1,22,3,8,14,21,5,2,14,5,6,1,30,5,1,3,3,9,3,6,3,4,5,6,0,3,6,4,8,4,4,0,42,11,2,2,7,4,1,9,42,3,5,3,9,3,5,49,16,14,9,4,5,0,7,4,17,8,4,7,1,15,2,17,2,8,0,2,19,6,11,15,7,5,4,3,7,5,4,1,20,26,5,0,11,19,15,6,1,14,13,3,17,4,2,13,2,8,17,4,10,3,14,1,17,3,10,14,14,5,9,20,15,7,7,2,3,2,6,9,5,18,13,8,9,10,6,0,12,6,7,6,15,24,9,2,20,4,5,9,21,1,9,1,1,1,3,19,3,10,4,16,16,11,4,7,19,1,11,3,1,4,18,9,4,9,0,1,2,8,9,18,19,16,16,16,1,2,8,2,3,15,9,0,0,11,8,14,18,4,4,89,14,5,8,5,6,5,26,6,3,7,6,0,2,15,1,0,4,2,9,10,13,3,6,10,49,4,0,8,0,3,1,24,13,3,4,4,9,1,4,9,3,8,17,5,5,3,5,7,7,5,10,3,5,7,18,1,13,5,7,0,1,3,3,17,12,11,6,7,3,5,14,1,4,37,5,4,8,5,3,3,5,16,2,5,2,7,7,6,10,2,16,2,5,12,8,5,15,1,7,10,3,5,3,2,4,6,13,19,1,20,23,6,2,13,16,16,12,5,16,4,5,7,3,11,0,22,12,2,1,5,0,2,8,7,5,10,7,0,1,18,6,3,1,2,14,8,11,8,6,3,5,4,3,3,6,2,7,2,12,6,8,3,14,7,5,3,4,3,4,5,1,3,3,3,0,2,4,3,14,5,7,7,2,2,4,5,12,24,1,1,4,2,2,7,1,2,8,2,1,4,9,10,3,5,2,10,4,4,2,3,3,7,9,2,4,6,10,1,1,11,0,0,8,16,17,2,3,4,9,1,9,3,1,0,9,3,6,4,1,4,2,3,0,1,17,1,2,1,0,1,12,2,0,4,0,1,1,7,2,7,2,15,1,7,5,2,8,4,8,1,0,3,3,12,3,3,3,7,4,9,7,0,6,2,0,4,7,6,2,8,2,14,8,1,13,12,1,11,40,4,1,9,1,3,3,5,1,1,13,2,0,5,4,13,12,24,0,0,0,7,15,3,14,4,5,6,3,6,3,0,17,0,6,23,4,3,4,0,19,0,1,0,5,0,0,14,2,1,0,1
contract,1,9,1,148,4,2,0,15,0,1,21,3,13,38,0,13,4,13,0,0,3,33,19,21,7,7,7,4,3,21,12,188,86,2,34,41,17,20,18,5,11,7,1,1,24,17,21,14,208,19,33,0,15,22,8,2,36,31,0,23,7,9,4,10,13,2,51,5,3,40,68,8,8,6,53,7,11,5,72,16,56,1,14,4,180,35,15,0,44,12,13,5,0,24,72,18,23,9,16,12,49,31,26,19,12,36,8,2,20,13,15,5,7,20,1,19,9,8,58,158,22,23,17,80,8,3,3,2,10,3,4,2,5,50,15,79,9,4,4,5,2,30,21,7,1,43,7,5,10,19,53,3,28,9,2,17,23,4,3,3,23,1,15,10,48,0,2,9,20,9,39,60,15,1,6,6,158,4,16,45,12,5,10,11,3,13,25,26,20,52,1,3,15,0,2,8,10,7,14,13,39,2,2,8,20,4,11,37,9,18,52,6,21,3,0,0,4,5,16,10,7,8,7,10,67,92,26,28,3,68,9,20,26,15,42,25,29,15,6,2,51,26,2,12,14,12,2,16,79,3,10,10,11,12,14,13,5,10,4,16,14,11,8,5,1,77,3,2,11,8,139,12,61,3,4,1,22,22,11,5,38,0,0,13,17,0,2,4,7,1,2,1,9,22,25,4,28,7,1,15,15,42,22,15,14,3,15,0,2,1,5,12,30,6,80,13,16,46,14,2,37,3,22,6,50,10,0,5,3,22,0,15,1,1,6,11,8,11,3,13,7,3,7,8,10,0,51,41,8,2,15,5,1,25,24,24,0,2,14,48,32,4,10,11,2,1,34,6,0,8,7,8,4,8,7,51,8,13,10,12,81,3,57,12,6,20,17,11,19,3,8,5,3,2,24,18,68,2,12,5,16,0,5,0,11,10,3,1,35,8,0,17,6,8,0,8,11,7,5,1,3,3,7,3,1,7,3,6,4,11,11,4,3,19,0,2,0,10,7,8,9,22,6,13,3,2,16,5,39,6,7,5,0,10,44,3,0,7,4,24,9,16,23,18,1,2,13,6,9,0,6,0,2,1,4,7,3,1,8,4,7,10,5,1,4,19,10,2,2,3,88,27,0,2,14,6,5,25,9,9,16,4,3,6,46,31,0,8,9,5,6,10,4,7,13,11,6,5,9,14,5,28,12,12,6,4,18,15,12,24,3,3,0,1,10,4,5,1,39,19,3,0,2,1,11,10,3,7,17,15,14,4,28,56,1,8,38,5,11,3,18,9,37,6,29,26,16,4,21,46,13,2,38,6,3,7,2,7,9,20,5,12,19,5,9,6,4,11,4,8,12,17,4,5,48,7,5,0,42,15,16,0,2,4,3,23,4,9,11,5,20,17,6,5,27,5,14,12,6,10,17,8,3,27,4,10,12,15,5,24,40,23,28,15,3,8,8,24,1,14,18,3,12,14,6,38,9,7,7,107,23,6,6,4,6,10,23,8,4,33,1,0,9,10,4,3,5,12,6,5,15,8,10,25,23,6,3,7,12,1,17,46,7,8,16,13,35,5,4,4,25,6,11,22,3,32,14,3,15,10,23,3,2,7,3,6,21,9,8,6,3,12,5,20,23,9,1,4,1,5,5,3,0,13,0,6,6,0,2,6,4,20,4,5,1,17,28,3,12,3,7,10,10,13,14,4,33,3,4,8,7,19,15,20,14,16,9,13,5,50,34,14,7,6,18,32,24,8,0,17,6,2,2,15,6,33,33,2,12,6,1,7,9,11,7,4,4,3,5,8,11,6,3,5,25,18,7,7,3,2,4,7,15,6,3,0,10,9,18,3,8,12,7,9,15,8,5,9,13,13,4,5,1,22,4,5,0,4,10,4,13,3,9,0,6,10,3,16,9,3,3,7,3,9,2,1,12,19,2,16,21,29,15,8,2,3,2,17,6,2,12,3,5,0,6,3,0,1,8,17,5,3,22,52,9,2,7,2,14,5,7,17,2,11,12,8,12,3,1,2,10,11,0,1,4,6,2,0,18,0,3,0,0,4,3,8,22,15,1,12,1,31,7,26,5,12,17,12,3,4,6,7,11,5,4,9,5,2,5,1,4,2,13,6,6,9,5,4,5,20,5,13,26,19,17,46,67,28,48,1,2,2,0,5,7,17,23,8,40,3,3,4,5,9,10,41,5,3,1,11,1,11,0,2,1,1,0,6,9,3,56,1,6,14,3,6,12,10,0,1,3,2,4,8,3,6,0,16,1,0
otherwise,3,9,0,76,4,6,1,22,1,3,8,2,13,50,3,7,5,14,2,4,4,35,5,27,12,3,3,7,1,12,6,121,80,8,39,45,19,9,12,1,10,5,3,1,22,9,17,18,188,9,37,5,8,14,2,4,39,17,1,13,14,5,1,3,16,7,67,6,9,12,11,3,4,6,76,15,12,7,62,23,40,0,18,7,147,20,8,0,26,2,4,2,2,21,43,9,14,3,33,15,19,18,25,11,8,23,9,7,11,3,17,4,10,15,7,19,3,5,57,154,33,12,13,42,5,2,2,2,3,1,18,0,5,38,9,37,6,3,2,6,5,22,14,6,4,57,4,9,10,11,45,0,8,9,4,19,24,2,3,6,13,14,9,3,1,3,5,13,28,6,19,55,15,3,7,9,108,0,12,24,22,9,8,10,9,22,19,16,33,22,0,10,14,0,3,5,17,2,5,12,20,3,10,7,24,2,7,26,7,17,49,1,23,4,4,2,0,0,6,1,5,9,7,13,36,53,19,28,4,5,10,11,9,21,29,18,23,6,10,7,54,25,9,1,12,10,7,14,39,6,9,15,10,4,13,17,3,4,5,8,6,12,8,5,6,18,4,1,12,2,107,12,18,2,3,1,26,7,7,5,44,14,1,14,7,2,5,14,5,3,0,0,7,4,5,8,23,3,3,15,26,26,1,2,11,1,11,1,6,1,0,20,26,8,43,10,24,31,14,5,43,10,33,5,32,7,9,22,3,26,2,8,5,6,11,11,10,2,6,14,10,8,6,4,9,3,29,29,26,7,11,11,6,39,15,14,1,7,9,18,19,5,9,16,6,0,49,9,0,11,3,13,7,4,8,28,7,8,9,5,57,2,32,9,2,47,2,7,23,1,14,3,8,3,20,3,40,1,19,1,17,4,2,2,8,4,7,1,23,10,2,8,7,14,3,7,1,0,2,2,5,4,20,9,4,8,3,13,12,14,10,3,0,3,1,0,0,6,3,2,8,21,7,13,4,1,10,4,29,10,15,4,4,4,28,6,0,7,6,17,4,13,22,36,5,5,18,16,11,1,11,8,3,4,4,11,5,4,11,5,9,12,3,3,2,4,9,1,5,2,36,32,4,1,13,4,3,15,6,8,7,2,1,2,6,32,17,11,3,11,6,5,8,8,13,10,7,9,6,10,1,21,6,22,4,1,26,16,16,21,12,3,3,5,5,6,8,16,35,32,3,2,2,8,13,7,4,18,15,9,19,7,11,27,6,5,20,11,1,8,19,0,25,4,9,13,11,14,30,41,9,7,10,2,7,1,10,6,8,11,7,20,15,9,4,3,6,8,3,19,15,29,13,6,12,3,2,7,19,10,9,6,5,2,3,15,2,13,2,4,17,7,3,5,20,5,23,7,4,2,11,6,4,13,6,6,2,7,6,27,5,16,22,11,7,3,7,8,1,5,4,1,6,10,5,18,6,1,8,92,16,5,13,8,6,8,30,4,6,14,6,5,3,6,2,1,4,5,12,7,8,6,7,17,16,5,1,6,2,8,4,18,10,6,4,6,9,7,2,1,6,9,7,6,4,12,6,7,4,10,9,2,3,8,8,8,11,7,6,0,1,3,8,29,15,8,6,7,7,10,8,6,3,21,2,5,7,3,5,8,10,11,6,2,5,3,14,2,15,8,10,5,3,6,13,4,11,8,3,11,6,4,1,3,3,13,3,8,6,26,30,14,1,1,10,14,12,6,7,9,9,5,2,23,1,10,18,4,7,12,3,1,11,10,10,2,7,5,6,9,1,5,2,4,15,7,14,5,3,0,4,1,5,6,3,7,12,3,7,2,11,2,6,5,3,1,5,6,11,10,3,3,1,9,3,6,4,5,10,4,13,3,13,2,3,8,12,17,10,5,0,6,2,6,8,12,1,6,7,4,11,15,5,10,0,4,1,18,3,1,3,2,7,1,9,6,9,1,10,5,4,5,10,14,6,4,0,0,4,2,0,3,3,3,2,2,7,3,3,3,2,10,0,2,3,4,2,3,5,3,6,1,3,5,2,3,0,4,5,12,5,6,6,15,7,4,8,6,7,5,4,3,3,10,0,2,0,1,1,7,4,3,4,6,2,6,8,2,1,8,7,16,5,2,14,12,14,10,43,4,2,1,3,6,9,5,3,1,15,4,7,4,1,0,2,7,8,5,2,4,3,2,5,3,2,0,2,3,7,4,6,9,2,7,2,7,12,4,6,0,2,6,4,0,3,4,4,6,0,2
agreement,12,18,10,136,4,14,4,27,3,3,15,18,11,81,2,13,20,2,4,4,2,15,26,32,12,21,12,20,13,13,17,200,88,7,36,69,52,2,12,4,6,4,6,11,21,17,31,9,205,42,54,11,5,70,7,9,31,16,6,30,13,16,2,18,13,9,30,6,10,16,11,8,1,3,76,15,24,12,32,24,25,0,11,8,188,6,4,1,47,2,11,8,4,27,42,30,89,3,41,4,17,30,27,4,9,22,8,8,12,6,18,3,6,18,6,21,6,1,69,87,26,34,4,58,4,9,4,6,7,7,29,3,5,58,15,55,1,5,13,4,12,25,16,6,2,67,6,17,10,5,57,3,4,8,4,24,47,11,10,28,5,2,7,12,7,8,1,34,26,11,13,65,33,2,6,2,129,5,6,29,16,6,6,31,1,24,14,19,30,74,0,2,13,1,5,3,8,12,4,7,28,0,4,16,20,9,7,12,15,19,58,5,33,4,2,3,9,11,11,3,1,9,1,13,19,57,22,14,4,5,14,19,28,43,15,4,29,2,4,12,43,20,6,6,23,5,5,19,71,2,6,6,20,0,2,11,4,2,5,9,13,37,42,17,12,14,0,8,11,4,51,15,30,4,1,5,28,1,10,7,26,1,3,6,5,3,2,6,11,0,9,31,13,8,11,7,28,10,15,11,10,20,1,10,7,1,25,7,5,11,3,17,41,11,17,13,11,42,6,9,32,1,24,1,42,2,14,14,4,16,4,12,3,4,3,8,18,10,1,9,10,22,9,8,0,11,17,38,6,5,7,9,0,34,18,4,3,1,5,28,25,8,14,12,0,1,27,2,6,20,1,44,4,7,8,6,3,0,8,5,46,7,36,23,5,42,0,9,13,12,13,4,5,32,28,1,52,6,32,4,22,5,11,8,6,2,5,2,75,22,6,15,28,1,16,18,28,12,12,21,5,11,26,15,1,3,5,13,4,8,5,8,2,21,8,4,21,56,12,3,18,9,9,13,10,8,13,6,15,2,30,2,10,3,55,14,4,6,9,36,13,5,37,6,7,3,13,34,15,1,22,12,2,0,0,5,7,17,28,3,5,9,3,1,2,2,11,5,3,0,46,25,2,3,12,4,5,13,3,4,1,2,3,2,17,9,0,14,11,0,4,1,20,8,1,10,9,6,30,12,2,9,9,27,8,2,22,3,13,8,10,3,9,3,12,6,6,5,31,23,3,22,6,4,13,13,1,10,10,5,8,6,11,37,16,7,31,8,4,3,11,2,19,9,7,11,3,6,29,61,4,2,14,1,4,12,16,3,2,26,1,15,1,3,3,1,8,3,2,9,15,17,11,7,16,1,8,7,73,10,20,3,1,19,14,8,4,11,17,1,22,83,17,0,30,0,2,5,10,7,7,1,3,16,0,6,3,2,2,11,10,14,9,11,8,3,4,10,1,5,3,1,4,15,10,21,2,9,3,167,23,3,5,1,4,6,24,17,9,28,1,13,25,42,24,21,44,23,5,9,4,1,23,18,53,1,0,9,10,1,12,45,13,7,4,5,11,17,0,21,35,15,8,22,4,17,4,15,4,12,34,23,5,10,5,10,4,5,1,6,1,21,2,11,11,14,15,7,16,4,8,4,5,3,1,9,4,1,3,6,4,8,3,6,2,4,9,1,6,1,13,0,2,7,20,4,5,16,1,10,7,3,3,7,3,10,4,10,9,16,10,13,7,4,13,5,6,5,3,43,3,9,0,4,1,9,3,4,26,5,12,0,5,4,12,3,5,14,5,10,8,0,4,4,43,10,21,10,5,0,11,1,2,4,4,2,4,1,6,4,8,3,7,11,3,6,3,43,3,8,5,0,33,10,3,2,5,31,3,2,15,1,4,4,6,9,4,17,5,8,3,0,4,10,2,19,6,1,1,7,42,34,15,0,3,4,8,1,3,2,14,2,10,9,6,3,5,14,6,8,3,3,13,4,5,0,11,18,5,8,16,17,5,9,6,10,8,5,6,5,4,12,0,4,9,19,3,7,9,10,6,4,6,1,2,8,3,16,6,13,0,7,7,11,3,13,2,4,4,3,7,9,2,12,19,12,7,13,11,4,7,10,3,4,2,6,1,0,5,5,5,8,0,0,2,15,7,1,7,2,1,9,3,2,1,3,3,6,16,4,6,5,4,0,3,9,6,0,6,8,0,9,2,8,0,4,2,3,2,2,0,1,5,6,2,0,6,12,8,1,2,11,0,6,0,0,2,2,0,6
suggestion,3,5,2,134,3,1,1,15,4,0,4,3,7,12,5,0,1,4,5,1,6,17,4,8,16,7,5,11,2,3,4,124,58,4,36,8,14,7,1,5,0,2,0,9,20,11,38,8,152,3,31,3,3,7,2,5,19,65,1,6,19,4,1,2,18,3,47,3,1,5,3,0,2,0,20,14,10,4,37,10,33,2,3,3,93,15,5,0,20,0,1,2,0,12,46,5,12,5,15,6,17,14,10,3,3,26,9,0,11,2,8,5,3,9,0,9,1,6,50,111,21,4,6,45,2,0,0,3,4,0,3,2,3,25,4,32,1,1,3,1,1,21,10,1,3,33,1,7,10,10,19,0,12,4,0,18,6,1,5,1,14,1,2,1,0,2,1,6,15,3,5,31,6,0,0,3,91,1,4,24,15,2,0,11,8,10,23,12,15,26,1,3,5,0,2,2,24,0,11,6,18,1,2,3,10,6,4,22,8,22,45,1,10,3,0,2,7,5,12,2,3,6,5,4,33,53,13,17,1,1,12,6,15,13,17,14,10,9,2,4,47,12,5,2,7,11,0,8,12,3,12,10,18,6,11,23,3,2,1,8,2,13,29,3,10,55,8,0,4,4,95,2,21,4,15,0,7,20,17,2,21,5,0,14,5,2,2,6,8,0,4,0,14,2,1,6,29,3,6,6,4,34,0,0,15,1,8,4,2,0,0,10,12,3,16,23,12,27,10,4,15,8,12,3,33,4,9,10,4,11,0,4,6,0,1,25,12,1,3,5,8,7,8,5,3,1,21,23,16,1,5,4,1,13,12,11,5,3,9,19,15,8,3,6,2,1,30,4,7,6,5,8,3,8,6,33,6,0,9,5,43,2,23,7,1,24,8,8,15,5,10,6,14,7,36,7,59,7,25,7,18,2,3,0,4,1,5,2,13,10,1,4,1,19,8,4,1,4,0,0,2,1,13,4,1,3,1,6,6,9,16,1,4,6,0,0,0,9,5,3,3,7,4,2,1,2,2,5,31,1,9,4,0,1,13,4,0,2,2,15,4,8,19,19,3,2,4,5,4,0,5,1,1,0,1,5,0,17,9,4,1,9,3,3,5,1,15,0,0,2,36,39,1,2,5,9,0,6,2,7,2,6,2,3,7,17,5,11,5,8,4,2,3,3,10,15,1,11,6,0,1,6,5,6,7,3,9,4,13,12,3,2,1,9,4,8,9,3,7,16,1,0,1,4,4,2,0,8,10,7,5,6,7,21,7,1,18,3,1,10,46,5,15,1,15,14,5,2,21,18,8,9,12,0,9,11,10,5,3,6,2,11,4,9,5,7,3,4,0,6,15,36,3,2,8,0,3,2,28,16,18,3,4,2,7,21,18,20,8,3,11,19,9,2,19,8,15,4,3,1,16,8,1,19,0,9,8,15,16,14,10,39,11,7,1,2,3,8,11,7,10,2,5,24,4,62,3,4,1,80,16,3,4,9,4,6,19,7,1,5,11,3,3,3,4,3,1,4,7,4,12,8,22,29,14,5,30,20,1,4,1,12,10,6,17,3,5,2,0,4,9,3,9,10,4,12,6,6,4,16,6,5,7,0,13,4,10,9,2,8,4,2,0,24,9,16,2,9,4,10,9,1,3,26,1,2,7,1,4,8,4,11,3,2,6,6,41,2,28,9,7,3,3,9,5,2,6,2,1,12,11,6,1,10,5,9,8,29,7,2,2,7,1,3,9,9,10,5,6,5,2,1,0,6,3,9,0,4,8,4,3,4,5,1,3,6,5,18,8,17,9,8,4,9,8,11,7,20,2,0,1,3,5,4,4,2,8,1,9,4,2,0,3,6,4,2,10,2,3,3,2,7,8,7,5,2,1,9,4,2,3,10,4,2,4,10,8,12,6,6,1,2,5,5,1,2,7,1,1,10,14,18,5,4,0,1,8,2,10,0,7,0,4,5,2,6,1,7,6,24,1,9,5,10,2,0,2,3,9,5,0,1,3,4,16,3,7,6,1,13,0,4,0,6,2,0,2,3,2,0,6,5,3,6,2,4,1,7,4,19,3,0,3,6,8,2,0,2,0,2,12,1,7,2,1,5,5,1,5,10,4,4,8,4,3,9,7,3,6,9,5,2,5,1,3,10,1,7,27,5,2,1,1,5,2,2,10,2,12,2,6,1,2,9,1,18,14,3,0,2,0,3,2,1,5,2,3,2,7,2,25,5,3,8,8,2,7,0,9,1,4,0,9,2,1,7,0,8,1,0
commit,9,20,17,110,9,5,10,33,6,4,32,13,5,80,8,10,9,14,5,8,5,40,17,26,39,15,13,16,1,16,28,178,139,5,48,72,65,9,8,7,2,11,5,4,19,15,16,11,329,29,40,12,7,42,12,12,43,30,10,14,17,10,1,9,8,7,114,3,21,17,22,7,3,7,88,5,26,4,55,25,33,4,14,5,217,10,9,1,37,2,17,9,2,22,34,6,15,2,46,15,10,36,36,17,12,42,0,3,8,2,17,3,9,9,3,24,3,2,91,163,39,42,4,57,5,4,1,3,4,1,20,7,8,52,18,55,46,6,6,8,7,36,30,3,4,78,25,9,15,7,83,4,14,17,3,30,28,7,11,21,6,2,9,5,4,14,2,18,23,19,21,98,16,2,0,25,162,5,18,31,21,13,5,33,6,25,28,20,34,60,3,10,1,2,1,4,7,2,9,13,39,0,1,15,32,9,2,13,10,30,69,8,21,5,9,4,1,6,9,4,0,28,3,12,33,109,23,23,1,12,11,15,16,16,32,9,32,14,4,6,83,36,3,17,23,5,8,18,52,5,13,14,26,3,4,16,13,1,5,10,2,45,12,4,5,33,12,4,9,3,122,6,19,4,3,4,32,8,15,4,70,7,1,33,11,3,12,14,15,2,8,6,10,6,0,3,38,3,8,25,27,34,4,1,10,5,28,10,15,5,2,12,23,10,26,5,11,36,14,5,160,7,41,22,74,25,9,33,6,34,8,16,11,4,14,16,15,16,2,13,9,18,20,14,6,13,44,48,18,9,6,18,9,30,33,5,8,5,17,29,13,8,5,24,8,3,52,5,2,21,2,23,4,31,16,19,15,1,26,4,69,2,37,13,5,19,84,30,34,2,46,6,9,4,25,4,68,3,53,7,27,2,6,6,9,10,8,8,15,12,8,5,7,18,13,8,6,15,5,4,9,13,19,12,7,3,2,14,6,16,3,3,5,11,7,3,3,15,16,5,22,30,14,11,1,8,6,7,30,12,24,8,1,2,43,6,2,15,15,17,10,33,38,47,4,2,21,14,6,4,31,8,3,4,1,46,6,13,20,9,15,9,5,7,9,21,11,4,9,6,86,23,9,3,10,8,1,24,6,15,15,2,3,0,13,18,6,18,4,6,4,9,12,2,12,19,9,15,3,16,2,53,4,29,11,5,42,10,23,40,12,12,10,8,8,6,21,12,35,21,7,4,7,6,3,10,4,6,36,11,32,10,11,48,9,13,29,2,8,6,29,2,27,4,15,15,15,15,31,40,5,10,5,5,7,5,6,7,3,10,6,13,8,12,9,9,1,12,4,4,20,30,6,6,37,14,2,7,89,26,14,4,4,7,11,16,3,20,6,3,23,36,15,5,51,6,20,0,8,2,10,5,2,14,0,7,8,7,13,36,4,21,44,33,15,8,17,8,2,18,15,11,17,21,4,20,2,8,2,217,32,9,7,7,2,6,28,33,13,18,0,5,12,17,13,7,3,13,13,10,17,6,96,55,66,3,6,5,3,4,1,29,19,8,9,12,10,5,4,23,13,19,15,20,7,10,16,7,7,10,24,5,5,4,8,3,19,6,2,3,4,5,6,15,18,28,15,12,5,6,11,8,16,37,8,7,10,6,4,10,3,16,2,3,16,9,17,13,32,8,6,11,1,9,7,5,14,8,4,8,9,1,8,2,1,6,10,7,4,0,2,11,8,1,15,9,11,6,10,14,8,7,2,40,6,19,3,3,19,8,10,6,22,5,12,7,8,20,2,28,9,8,4,6,14,15,0,5,5,3,5,10,17,1,6,3,8,5,16,8,3,4,8,7,12,9,4,8,8,5,12,2,10,13,4,8,7,3,8,2,8,5,5,13,8,6,15,44,7,6,9,9,5,7,4,16,4,7,10,1,20,52,23,1,1,4,20,2,19,6,9,9,6,1,8,11,5,2,7,11,6,7,0,4,2,5,8,12,14,3,6,7,1,2,7,0,11,5,13,3,4,3,7,7,29,21,12,7,8,3,8,10,6,7,8,2,3,2,1,19,1,13,10,5,9,14,0,4,3,0,5,12,5,5,2,14,2,39,8,4,8,4,7,7,2,2,5,8,12,2,4,12,3,0,1,14,9,1,5,11,3,6,5,3,3,0,4,7,15,7,4,3,0,3,0,28,7,1,7,8,15,3,3,2,5,6,0,16,7,11,4,9,7,3,12,0,15,7,22,1,6,5,8,6,1,1,0,7,3,4
party,20,67,46,214,11,13,5,63,11,4,55,31,13,137,3,9,18,12,35,11,11,76,50,53,47,28,16,37,11,27,39,248,216,8,73,114,68,5,5,3,9,10,19,6,57,75,45,37,681,49,99,18,9,43,9,26,82,18,14,18,78,27,3,16,38,30,137,8,28,27,9,4,7,17,138,15,30,13,157,42,31,1,48,19,387,10,10,4,68,3,29,5,3,72,130,4,72,6,78,2,9,42,61,25,14,22,20,8,18,5,21,5,5,28,9,77,7,7,169,436,80,47,27,85,13,5,3,22,16,1,11,4,7,71,34,69,9,4,10,15,4,75,48,5,10,102,13,26,14,9,104,4,30,5,4,21,43,6,29,15,10,6,8,4,3,30,5,25,23,15,22,196,38,4,5,19,348,6,18,34,45,19,6,35,3,35,56,45,146,156,4,9,3,4,3,2,12,6,11,9,27,3,5,52,40,43,4,28,31,24,138,8,59,9,9,27,10,10,40,3,9,44,11,38,103,141,26,26,6,5,24,23,24,44,39,20,62,4,12,24,166,68,13,16,22,14,16,25,68,19,16,37,63,4,4,49,21,2,9,19,3,73,39,11,13,19,9,8,49,7,205,9,21,5,6,6,36,4,39,5,77,33,2,23,14,4,7,15,22,11,17,8,19,11,3,23,75,4,10,39,48,35,1,3,58,10,36,6,9,3,3,21,47,4,40,19,18,91,15,5,106,18,67,3,284,16,19,78,5,60,26,13,42,4,13,37,58,19,3,13,45,46,53,52,5,10,81,116,33,12,40,19,13,35,129,6,20,9,18,44,23,11,19,20,5,6,120,8,34,25,5,32,5,6,19,15,19,0,38,4,149,6,58,37,3,46,9,40,41,0,64,9,36,44,75,11,89,4,55,2,35,5,10,14,15,1,13,14,63,18,3,18,12,26,103,22,8,41,8,3,7,13,19,32,1,9,6,21,30,21,8,17,2,22,12,23,3,53,25,11,31,32,5,41,2,5,1,10,69,2,18,32,5,14,120,56,4,27,11,59,19,35,32,17,4,2,19,38,29,7,24,12,5,4,24,13,10,26,45,9,12,10,14,41,25,20,8,8,8,2,198,63,8,14,9,10,1,29,11,34,10,8,1,6,28,3,3,26,15,6,3,5,17,10,26,42,5,6,29,13,4,34,21,71,29,15,55,11,28,42,42,3,5,11,26,20,26,11,66,15,9,4,8,3,5,16,7,17,33,6,60,8,25,99,12,19,83,8,10,17,37,8,37,3,15,33,19,25,57,37,10,12,7,4,12,25,19,7,24,33,22,25,29,43,20,6,15,13,8,20,66,120,8,5,42,8,6,8,165,70,47,1,12,27,32,61,11,32,10,4,56,40,35,9,73,30,26,8,20,12,12,1,1,38,3,6,31,27,27,59,4,18,31,60,9,19,6,6,10,13,7,4,33,33,36,12,2,9,7,444,80,4,11,15,11,25,76,76,15,22,14,19,101,80,43,18,30,28,23,16,23,8,55,79,78,39,3,8,6,18,11,53,37,11,20,16,32,5,11,23,43,28,54,32,15,10,28,21,26,17,16,35,7,11,10,10,42,19,6,13,10,8,14,89,24,13,6,31,37,4,12,10,10,28,2,13,9,8,3,23,8,15,4,8,10,3,12,11,63,8,14,14,2,14,26,9,26,2,0,25,20,5,0,22,3,14,29,17,6,7,7,15,5,6,29,13,10,14,1,27,8,12,3,30,7,23,3,8,12,13,5,7,17,9,29,19,7,15,14,23,12,10,10,13,9,26,7,6,6,27,16,17,68,12,1,3,9,10,34,11,8,23,63,16,7,26,5,39,8,37,8,3,11,14,14,11,6,16,3,6,8,21,11,6,18,10,32,48,68,14,22,26,6,36,9,21,11,42,14,20,1,50,13,4,3,6,13,7,21,4,36,13,12,9,14,15,2,5,59,5,0,7,12,5,5,18,15,36,24,8,19,18,10,23,34,17,10,5,8,9,16,25,3,9,34,18,8,22,7,7,12,14,3,39,19,18,27,22,17,84,21,1,5,9,38,13,4,32,6,11,18,15,8,30,7,23,10,42,16,0,9,14,16,4,10,6,3,7,16,11,5,13,2,0,4,26,9,4,8,26,3,13,5,2,0,5,5,23,13,19,6,4,16,6,8,120,0,0,18,29,5,23,38,4,9,19,0,15,14,24,3,12,7,0,20,4,34,5,138,20,9,2,5,1,1,4,4,17,2,2
authority,38,97,23,420,17,7,15,59,15,6,51,22,14,90,11,33,10,25,11,10,12,110,11,49,41,45,8,19,14,37,28,415,241,16,101,71,77,28,17,8,5,14,8,5,70,35,65,44,860,36,113,17,19,47,9,10,137,61,5,37,30,14,3,19,43,12,185,6,13,35,45,27,12,7,147,22,24,12,131,38,80,1,42,13,579,50,41,3,94,5,24,17,6,70,80,34,35,7,64,21,48,67,68,17,19,70,6,13,23,13,38,13,21,31,5,62,13,8,227,288,77,40,6,113,16,4,8,15,15,4,18,14,5,115,30,78,24,7,14,7,4,62,47,7,10,154,17,21,30,25,274,2,23,21,6,102,49,12,30,10,25,7,12,11,13,15,7,31,31,24,38,163,46,3,6,24,384,17,28,76,70,22,13,43,21,27,54,60,82,105,6,11,11,1,2,9,43,13,15,47,60,3,6,33,72,40,17,49,21,44,261,10,72,21,2,7,5,12,36,4,4,34,9,29,99,306,35,59,10,34,25,36,25,114,61,33,67,15,16,16,193,64,15,17,34,12,8,36,124,23,30,29,39,26,21,32,29,9,13,39,5,66,62,19,16,89,8,11,20,5,332,24,60,16,6,0,53,31,36,16,98,19,7,51,26,3,3,12,34,1,17,2,51,10,15,18,85,17,13,34,36,76,8,6,24,1,47,11,12,2,10,83,60,21,58,27,21,71,25,14,141,19,54,7,141,42,13,51,12,74,19,24,23,14,14,80,29,11,16,28,26,32,22,38,10,12,105,112,49,7,31,35,23,88,86,16,10,13,33,52,62,13,10,31,14,2,83,21,13,20,7,36,4,14,23,57,15,7,27,9,157,17,112,30,0,66,23,52,48,7,60,12,30,21,71,30,137,16,142,10,38,8,10,4,19,12,14,2,41,20,3,18,12,28,33,25,23,24,9,1,7,23,57,48,7,21,9,42,29,39,56,15,12,45,13,12,0,21,19,11,36,45,19,11,3,10,13,10,90,25,33,15,10,9,92,27,0,30,24,68,40,34,54,57,10,21,24,19,38,1,37,5,11,4,7,13,9,40,33,20,12,31,5,6,14,38,18,6,12,12,110,68,7,5,10,19,4,40,20,27,20,8,8,4,41,72,6,22,16,11,6,22,28,18,27,40,18,24,11,17,4,75,37,141,57,26,79,26,41,70,29,7,22,21,25,15,28,19,61,51,12,5,7,2,21,14,4,34,40,15,154,21,21,135,30,16,97,14,26,20,42,14,61,23,38,40,27,25,116,72,23,17,43,20,20,14,16,17,14,46,7,47,14,19,15,16,6,18,12,17,47,63,16,20,49,8,5,11,108,39,38,11,10,14,17,44,16,128,9,15,72,102,45,8,98,20,38,7,33,12,47,24,12,76,8,9,19,22,29,71,43,48,47,57,27,12,44,12,8,28,9,4,34,84,14,86,13,24,16,468,98,13,14,18,20,20,85,36,31,39,6,20,39,42,17,13,11,19,29,15,42,23,140,116,90,13,9,25,16,11,28,60,48,16,22,29,34,10,13,30,38,20,35,25,18,27,13,17,40,43,11,9,19,11,23,16,38,19,12,23,18,34,19,41,49,52,18,17,23,18,37,11,22,70,1,20,23,3,8,21,21,30,20,12,11,10,46,14,108,9,29,24,13,28,16,13,30,18,11,21,25,12,19,28,8,29,23,40,17,30,25,26,6,7,40,29,20,17,4,27,20,4,2,52,15,33,18,9,36,19,1,8,31,26,26,9,21,89,10,43,21,29,8,17,41,30,23,29,6,21,8,12,26,13,11,7,20,10,39,19,10,18,22,15,9,17,15,20,13,41,21,6,11,33,17,22,13,28,20,7,22,8,29,9,8,25,30,64,26,16,26,25,26,26,10,29,15,34,18,52,50,1,32,32,5,16,14,21,24,5,13,26,20,12,17,21,11,18,30,29,6,10,44,18,6,16,21,25,25,6,6,18,13,10,26,8,18,5,14,14,12,47,3,11,29,36,7,41,18,5,19,28,15,27,25,9,13,34,17,27,20,46,27,30,23,25,7,17,7,5,20,7,16,8,4,23,8,42,22,22,9,15,11,17,15,13,13,14,17,12,6,23,12,7,17,30,24,13,89,21,7,8,10,30,9,18,20,9,83,30,3,14,23,6,6,47,9,2,9,24,10,9,5,7,15,11,4,17,28,20,18,13,13,18,14,3,16,6,68,1,11,8,11,0,9,1,3,14,2,8
enforce,3,22,15,96,6,0,4,18,3,3,33,6,3,58,2,10,11,16,2,13,0,27,14,22,23,9,13,4,8,12,11,135,104,10,36,42,30,2,3,3,7,9,2,1,27,15,10,11,254,9,43,7,7,12,7,7,45,12,3,7,10,7,0,3,10,14,81,6,11,18,4,3,5,5,66,5,15,1,45,15,21,0,11,2,184,6,11,2,24,1,5,8,1,18,29,12,19,5,31,8,1,25,25,9,6,13,3,3,7,1,15,9,5,6,5,26,4,1,92,128,29,12,6,32,3,2,6,6,5,2,4,2,5,26,17,30,22,3,5,3,5,25,15,3,3,63,6,10,9,9,72,2,7,1,4,36,37,7,18,5,3,2,10,1,1,8,8,25,17,9,7,70,17,0,7,11,114,2,8,22,24,12,3,21,0,26,27,21,34,40,3,3,4,0,1,3,10,8,5,23,24,2,3,16,24,5,1,12,10,17,67,7,29,4,2,4,1,3,9,1,2,14,2,7,30,247,12,12,3,4,10,6,12,25,25,9,22,6,2,12,62,30,6,8,13,8,6,21,43,5,9,9,7,3,2,16,7,1,2,16,8,25,12,7,4,39,7,8,16,5,122,1,12,4,1,1,33,2,8,1,32,10,2,17,14,0,6,6,12,2,1,4,3,0,5,9,18,6,15,14,16,31,0,1,12,3,17,9,3,2,4,20,12,9,14,5,14,33,9,1,61,9,21,8,93,12,2,23,4,26,7,3,8,6,9,10,2,3,1,7,13,4,4,17,2,3,37,53,15,7,10,12,6,24,20,6,5,6,18,31,21,5,2,20,3,4,20,7,7,16,7,17,3,14,9,13,11,2,13,2,58,3,31,11,5,26,26,12,22,0,39,3,10,6,17,6,46,1,26,1,19,0,4,2,7,4,9,3,25,10,4,12,0,16,10,4,2,11,3,0,3,9,19,16,2,5,5,24,8,22,5,1,0,10,4,5,0,11,3,6,19,30,10,8,3,3,4,2,27,5,8,17,2,2,29,24,2,13,6,22,13,24,23,16,0,3,7,14,6,1,14,9,1,2,2,9,7,7,23,9,6,7,5,10,6,8,10,1,4,11,40,21,0,6,4,4,2,13,10,7,7,3,2,1,9,6,0,8,5,7,4,8,5,15,6,15,7,6,16,11,4,20,13,22,9,7,33,13,15,26,19,5,1,13,5,4,9,6,25,17,6,1,3,1,2,5,5,11,10,5,38,11,25,27,6,6,15,4,3,8,11,6,13,7,13,17,9,2,39,48,5,2,11,30,15,4,8,2,3,12,2,14,4,15,10,7,6,12,3,8,13,27,14,4,21,0,1,1,46,16,27,3,4,3,7,12,3,35,7,4,21,34,9,4,30,4,10,4,5,7,6,2,6,11,5,7,1,6,7,23,4,10,29,17,9,4,14,1,1,11,12,6,16,21,6,15,12,2,12,155,17,6,6,9,9,5,31,21,11,10,2,7,11,16,9,2,2,12,7,7,15,3,51,51,10,6,1,3,5,4,0,20,6,5,8,7,25,2,0,11,15,12,13,3,8,3,13,4,13,10,14,4,6,7,5,9,13,3,3,4,3,4,4,19,18,12,6,3,8,6,7,2,7,26,1,4,5,2,3,11,7,16,0,7,3,1,11,4,18,2,4,3,2,5,8,17,9,4,5,13,1,1,1,5,1,11,5,7,8,8,10,7,7,4,28,0,7,7,1,9,4,5,2,16,1,12,6,0,9,6,4,4,14,0,7,4,3,22,5,14,10,5,0,4,18,20,2,8,2,3,1,3,9,1,7,0,1,5,16,6,10,0,20,3,3,6,2,5,3,7,5,2,4,6,0,3,1,14,6,3,5,2,5,3,8,7,4,14,9,1,5,7,9,13,3,15,5,15,5,23,13,32,1,1,0,2,5,2,15,2,5,6,10,4,5,7,3,5,2,13,3,17,2,2,5,3,3,6,13,1,4,4,0,2,5,5,10,5,11,1,0,3,0,4,10,9,5,2,9,4,6,5,6,8,14,3,4,0,10,9,6,1,8,2,12,7,3,2,6,4,5,12,6,3,1,11,2,13,0,1,13,3,6,7,3,1,2,4,9,1,2,4,2,1,1,11,13,2,8,4,0,5,3,2,4,2,4,1,7,8,5,0,5,7,0,24,6,1,5,3,3,5,0,5,1,13,1,10,1,4,2,3,5,2,5,2,9,2,12,7,2,3,1,0,2,2,1,2,0,3
derive,3,6,4,70,5,2,1,26,0,2,4,1,0,28,1,2,1,10,2,2,1,21,2,4,7,2,2,7,1,3,5,92,86,3,29,16,14,9,6,6,10,4,6,1,20,11,19,7,186,7,31,1,7,17,2,0,82,23,0,8,12,5,0,11,12,5,69,13,5,4,26,8,0,5,40,6,11,0,34,12,45,0,9,3,145,35,13,0,35,4,11,5,0,16,30,21,6,4,23,7,16,13,18,4,2,8,9,1,14,9,9,3,2,9,0,17,3,0,33,106,27,2,26,34,2,0,0,1,1,2,6,1,2,30,15,27,0,0,8,3,1,10,22,2,3,18,5,0,21,10,70,0,5,5,1,7,9,6,2,2,9,0,9,2,0,3,2,6,17,8,12,43,11,0,0,5,98,0,5,13,10,5,2,5,4,9,19,13,13,16,0,2,5,0,2,1,4,0,4,15,20,0,5,5,13,2,2,44,5,19,52,1,10,24,0,0,2,0,5,0,17,6,2,15,39,49,12,34,3,9,14,12,21,18,19,92,13,1,8,6,30,22,7,1,7,3,2,9,15,0,6,30,6,16,15,10,4,2,6,7,0,9,11,0,6,22,5,2,9,2,103,16,69,5,3,0,11,23,7,2,39,4,5,12,7,0,1,5,4,1,1,0,6,7,3,10,28,2,5,15,17,17,1,2,8,2,6,1,1,0,1,11,10,5,34,21,23,31,8,1,20,3,15,0,26,2,1,16,2,14,3,10,4,7,4,15,13,0,5,13,3,1,10,11,5,6,28,29,7,2,14,7,2,30,11,3,1,3,10,26,13,6,1,13,9,1,12,7,0,2,0,18,2,5,6,13,2,9,9,24,32,1,39,0,0,29,1,8,25,4,5,4,4,4,21,8,43,5,14,7,15,2,3,0,3,8,4,1,16,7,0,4,10,12,4,3,2,2,0,1,2,3,5,9,1,3,1,13,6,14,7,5,14,3,0,0,0,4,5,2,15,37,5,7,0,1,3,1,13,5,12,2,1,3,34,3,2,3,9,16,2,17,21,11,2,0,12,13,9,0,9,0,5,0,1,7,4,10,8,3,5,9,1,2,11,1,13,1,0,3,37,19,2,3,5,3,4,7,5,7,7,2,4,0,3,31,3,9,2,3,15,3,3,5,18,11,0,8,2,6,1,9,7,26,7,3,12,10,14,23,1,2,0,14,5,7,11,3,18,23,10,0,0,9,14,0,2,28,11,4,30,6,5,26,3,6,31,8,5,4,14,1,18,2,15,9,10,2,34,21,10,5,18,0,2,4,8,4,4,18,13,16,35,7,6,5,5,4,2,8,11,18,7,3,15,2,11,1,22,8,13,0,3,3,3,13,7,16,1,20,17,3,1,11,14,9,25,4,3,5,7,11,4,10,1,6,6,8,6,27,13,7,12,12,3,6,0,11,1,3,12,0,6,14,10,18,1,0,4,84,3,5,14,4,7,5,34,5,6,16,7,6,3,11,6,1,1,1,6,11,15,11,21,8,11,4,2,8,0,5,9,14,10,3,5,6,5,3,6,8,4,4,14,8,0,9,3,4,26,11,3,2,4,1,16,3,18,4,5,2,3,15,11,22,8,6,0,5,4,5,11,0,2,7,1,3,9,3,1,8,5,6,9,4,2,3,8,3,13,10,4,1,0,9,9,1,6,1,6,4,10,24,11,16,9,6,3,14,2,27,27,4,1,7,9,26,2,3,9,4,5,1,1,4,2,6,5,1,5,4,5,3,12,4,1,2,12,0,6,2,4,4,1,6,5,24,1,4,7,0,5,5,7,2,0,1,3,7,11,8,13,3,9,2,5,3,3,4,0,3,3,9,0,0,4,11,3,2,13,8,11,9,14,1,11,9,5,8,8,9,7,5,1,3,5,8,10,0,4,1,4,32,1,1,2,2,2,30,2,1,3,6,5,0,9,6,0,0,4,7,3,0,9,16,1,5,1,3,7,2,0,2,4,1,3,3,3,3,4,3,1,7,0,1,3,2,6,0,3,0,2,2,8,2,3,2,8,9,20,4,1,27,0,20,4,1,5,18,4,4,12,5,6,26,0,8,4,2,1,1,2,0,6,9,4,4,9,6,3,9,7,16,13,13,4,23,10,30,69,2,6,2,4,0,3,13,6,4,9,3,6,6,2,0,1,7,8,6,0,13,1,7,4,1,3,3,4,1,13,5,5,3,5,4,3,18,14,0,4,0,4,0,5,0,0,9,0,6,1,2
study,3,7,6,58,3,7,5,6,8,3,3,2,12,18,7,5,1,8,0,2,2,8,10,11,14,10,8,5,0,6,0,100,46,10,14,20,6,0,4,0,3,0,3,4,12,2,8,13,82,10,17,0,4,16,19,0,12,32,6,4,11,1,1,8,8,2,23,0,4,10,21,2,2,2,43,14,9,3,25,9,18,0,6,6,55,3,9,1,4,3,0,2,0,7,3,4,8,1,12,10,4,21,10,1,7,12,1,1,5,3,8,0,6,10,5,8,1,0,13,39,12,8,12,46,6,5,4,1,2,4,5,7,5,20,7,52,0,0,5,5,4,16,5,3,2,22,2,14,4,2,15,2,3,10,3,15,14,2,2,15,7,1,7,1,1,7,5,9,10,0,5,25,12,3,2,3,56,1,5,36,17,5,3,16,5,18,7,14,17,17,0,2,6,3,3,2,10,3,7,4,18,0,2,6,5,2,10,10,1,13,42,7,9,5,3,12,1,4,8,7,2,7,1,8,15,32,18,11,9,17,4,10,8,13,9,1,9,2,10,3,16,10,3,3,8,1,0,16,19,1,11,15,8,1,2,2,1,5,0,7,2,13,18,1,1,38,20,6,6,4,39,7,5,0,5,1,5,8,5,20,25,3,7,6,6,1,5,9,8,0,2,2,6,3,3,5,12,6,1,7,8,22,1,1,2,2,3,2,2,4,4,10,12,3,6,4,10,25,5,2,6,5,11,20,8,0,25,9,0,9,1,5,1,1,1,3,10,11,3,2,4,12,4,3,3,12,11,16,8,2,1,2,1,17,5,6,2,2,9,5,14,9,22,0,2,3,6,1,2,3,2,9,4,0,2,13,4,4,2,4,19,2,25,7,1,20,4,3,4,3,2,5,11,5,13,6,25,1,11,8,4,0,3,5,1,1,3,2,9,7,0,1,7,14,0,2,0,1,0,2,2,1,11,4,3,4,1,10,1,4,1,3,0,3,3,0,0,3,3,5,9,5,7,5,1,4,9,7,18,4,4,1,0,1,23,1,1,2,5,10,4,9,4,13,7,6,8,2,16,3,17,1,5,3,2,7,1,14,7,3,4,6,0,3,4,0,4,1,3,1,25,12,0,1,8,0,2,2,0,1,4,1,0,3,0,2,4,2,2,3,0,8,2,1,4,6,0,0,0,2,2,4,1,4,4,2,2,1,7,9,1,6,3,5,9,0,2,2,15,7,0,0,0,16,8,2,0,7,5,1,5,0,1,12,10,4,10,0,2,9,8,1,7,4,2,9,2,0,10,13,1,0,8,4,10,0,4,3,1,7,5,7,3,2,4,2,4,0,0,9,6,10,2,2,11,4,3,1,2,4,6,3,1,0,3,8,1,14,18,3,13,28,12,3,9,3,2,2,3,1,0,0,3,5,7,1,4,5,7,10,0,8,7,9,3,3,6,2,0,0,4,1,3,4,6,19,2,0,5,40,12,3,1,0,2,1,8,2,2,3,0,3,0,2,0,1,0,0,0,3,4,1,1,2,3,0,2,2,1,3,0,11,5,12,1,0,1,5,0,10,3,8,0,5,7,9,0,1,5,0,10,3,0,2,9,5,7,2,0,2,0,1,0,8,0,14,4,1,1,5,3,1,0,11,4,9,1,1,4,1,4,5,3,5,1,1,13,1,4,2,7,4,8,1,5,2,5,10,1,0,10,0,1,2,1,7,0,6,8,2,1,5,0,5,7,6,4,2,14,5,4,5,3,0,4,7,4,3,6,3,1,1,2,2,3,4,3,2,1,3,4,9,7,0,12,13,0,1,0,0,2,5,1,0,3,6,1,1,5,0,5,2,6,9,1,2,4,1,1,5,0,2,9,6,4,0,6,4,0,0,0,2,7,3,2,1,0,11,4,7,2,5,0,4,2,2,0,3,0,1,3,5,0,2,1,2,1,0,0,1,1,1,0,5,0,0,1,6,1,23,10,0,0,1,0,0,1,0,1,3,0,4,5,0,10,0,4,4,0,1,2,6,5,0,0,1,0,6,3,2,4,8,4,2,5,0,2,1,2,10,4,1,1,1,2,1,1,1,6,2,1,0,1,1,0,3,0,0,0,1,4,3,1,0,2,0,3,0,0,8,2,3,0,0,3,0,1,6,5,0,5,0,3,1,2,0,0,2,4,1,0,6,0,2,3,2,7,1,0,3,1,0,0,3,0,0,9,3,5,0,1,3,2,0,1,0,1,5,2,3,3,4,0,0,0,2,3,1,5,0
transfer,2,17,10,62,5,3,1,10,0,0,6,6,4,18,1,0,6,10,2,1,0,24,6,9,4,2,9,6,4,15,3,104,47,18,21,18,19,3,3,4,6,3,2,4,20,5,5,12,187,13,24,2,5,18,4,0,38,18,5,9,13,2,1,5,10,2,28,1,4,3,7,2,3,1,22,2,9,5,33,8,23,0,6,4,118,18,8,0,24,2,1,3,1,17,16,6,2,1,15,9,7,11,17,7,5,10,1,4,6,6,21,5,7,12,1,16,5,2,55,71,26,11,4,39,3,1,3,3,3,0,12,3,2,19,8,40,2,5,1,0,1,13,19,3,1,40,2,9,5,8,22,1,8,4,2,17,13,2,2,10,10,0,3,4,4,7,3,7,11,3,11,49,6,0,5,3,56,5,1,16,13,8,6,7,1,9,16,4,22,23,0,2,3,1,1,6,10,5,6,4,21,0,1,6,9,10,8,20,5,13,35,6,8,1,2,2,0,1,21,0,2,8,3,8,20,55,10,14,8,12,6,8,12,19,10,8,11,8,2,5,33,18,1,2,4,2,2,27,42,4,3,10,5,2,6,2,6,1,3,14,4,19,10,5,2,86,0,6,7,3,61,11,31,1,1,1,7,8,5,1,34,1,0,6,9,2,5,6,8,0,4,4,2,3,2,3,27,1,4,3,8,20,1,6,7,0,8,5,2,0,0,10,10,5,34,16,11,15,9,1,7,6,9,11,22,5,2,15,1,14,3,9,1,9,3,2,5,2,2,11,6,4,8,7,5,2,22,21,8,7,5,7,10,23,6,1,1,2,6,17,14,5,3,5,0,1,17,2,3,13,3,16,0,10,6,28,4,4,5,1,31,1,24,5,3,20,3,10,12,1,9,6,2,10,10,3,30,8,13,2,13,3,1,2,3,4,6,1,8,8,0,5,8,8,14,8,9,2,1,5,1,9,5,4,1,0,7,13,4,3,14,5,2,5,3,0,2,7,4,3,6,8,3,7,1,0,11,2,20,5,14,3,5,1,31,4,3,2,4,19,4,8,18,14,5,3,19,5,1,0,8,1,0,0,2,7,1,5,12,5,2,2,2,2,5,4,8,5,2,4,54,7,1,3,12,2,1,7,4,0,3,2,4,5,3,84,1,7,2,2,2,0,6,6,5,7,5,3,2,5,0,10,7,15,1,2,16,6,10,15,5,4,1,1,4,4,7,2,21,7,0,1,1,2,3,3,0,5,10,9,14,3,5,27,16,7,14,5,3,2,9,8,11,2,3,10,3,4,21,19,5,6,9,7,4,3,1,7,2,12,2,8,9,7,1,2,4,4,6,9,8,14,6,2,7,4,2,0,11,6,8,2,3,4,4,14,3,21,5,7,3,20,19,3,15,5,3,1,3,5,11,20,1,13,0,4,1,4,7,22,13,11,6,8,3,0,4,5,4,6,5,2,3,13,2,36,4,3,4,116,19,1,1,3,6,8,18,2,1,5,3,1,7,15,1,5,1,5,3,8,11,3,7,17,9,2,0,7,4,2,5,10,11,5,6,7,4,1,6,6,2,10,7,2,5,3,7,2,2,9,1,4,2,1,18,6,3,2,3,1,2,7,5,11,6,16,8,3,5,7,4,0,1,19,0,2,6,1,1,9,5,8,2,2,6,3,19,2,15,2,7,6,6,6,4,3,7,6,2,5,4,4,1,2,0,11,4,9,1,4,3,5,6,5,6,8,8,7,7,7,3,1,0,12,5,7,7,3,13,7,1,0,7,8,3,2,2,0,7,21,3,5,4,5,0,10,1,5,1,8,5,5,5,4,3,1,2,4,9,1,9,1,5,3,9,3,3,3,3,6,1,3,1,26,5,3,4,5,15,3,6,4,5,2,6,6,1,11,5,3,3,1,5,4,10,3,4,4,1,4,6,16,2,2,2,1,5,5,2,3,3,0,8,7,4,3,2,2,2,12,14,3,2,15,0,2,0,8,2,2,1,5,3,3,5,3,4,1,4,2,4,9,0,0,2,4,1,5,3,2,4,2,10,6,3,8,1,11,4,9,9,4,7,4,3,5,3,4,1,0,2,4,6,7,4,6,0,11,3,30,7,1,3,4,4,0,4,4,0,11,3,7,2,1,8,11,5,9,39,1,1,3,0,4,4,5,2,0,13,3,1,5,5,4,2,4,8,5,0,2,1,0,1,3,4,1,5,2,7,6,1,4,3,9,5,1,1,6,14,1,0,2,0,2,0,0,0,2,6,3
tend,1,9,5,60,9,2,2,20,3,2,9,4,6,63,4,8,3,12,5,2,4,20,1,16,17,9,10,10,3,3,6,86,93,11,25,34,44,10,17,5,6,4,4,4,29,8,14,9,124,8,27,3,11,21,8,4,56,8,0,13,13,5,3,10,14,6,59,3,9,21,9,4,4,2,74,6,8,4,49,14,45,3,4,8,130,4,13,0,14,3,5,4,0,11,38,11,7,5,16,12,4,24,22,5,12,19,4,3,6,3,3,3,3,10,3,16,3,3,33,155,34,8,6,25,2,0,4,2,2,3,8,9,3,36,15,35,23,0,0,2,7,45,12,0,4,30,7,8,11,10,39,3,10,2,14,8,19,3,3,1,3,1,6,4,0,9,0,18,26,6,11,70,20,0,5,6,128,1,8,21,17,13,0,16,0,31,35,17,23,30,1,2,6,1,0,2,19,8,2,27,41,0,1,8,18,1,2,27,5,19,58,4,15,6,0,1,0,0,14,2,1,32,4,15,23,88,29,19,3,3,6,3,10,21,30,11,22,7,7,10,39,22,13,10,14,4,3,22,24,3,2,32,8,3,4,7,11,0,3,12,5,22,7,0,9,38,2,5,8,7,78,5,6,6,2,1,11,5,3,0,40,14,1,22,7,1,4,5,11,3,4,3,3,1,1,1,20,5,2,10,13,15,0,1,15,1,28,9,12,5,4,15,21,8,9,12,9,36,15,11,31,11,19,9,47,3,14,13,2,22,2,5,10,1,9,5,15,8,1,7,16,3,11,8,2,4,29,28,11,7,4,5,10,15,26,1,1,4,7,15,22,9,8,17,4,0,23,7,2,11,2,14,4,15,16,31,6,2,23,4,37,1,31,12,1,15,12,15,10,3,30,3,2,3,26,9,36,5,24,3,9,0,8,0,6,11,14,3,15,12,6,3,7,14,2,9,0,6,7,0,6,10,20,6,1,4,4,8,4,16,5,1,0,3,4,4,0,7,1,4,8,9,2,10,1,2,6,8,28,8,18,1,3,3,31,11,0,1,18,22,6,13,31,33,5,3,11,17,7,0,14,5,3,1,3,32,3,7,13,2,3,12,2,7,3,4,20,5,8,1,46,26,3,0,8,3,2,11,3,17,7,2,4,0,5,10,8,10,1,9,9,5,6,12,15,12,3,12,22,5,6,14,7,18,4,6,42,11,12,28,5,7,6,15,13,6,7,3,30,23,5,2,4,19,10,4,3,14,9,8,15,4,3,34,5,16,41,7,5,1,28,3,22,3,13,10,11,8,21,41,6,7,7,4,3,1,10,10,8,5,6,11,10,7,7,7,6,5,5,6,15,12,6,1,43,3,10,5,24,15,10,2,3,2,5,15,4,19,17,6,26,17,5,4,26,7,13,15,8,7,3,5,5,18,1,5,6,9,8,27,11,11,26,13,5,4,13,7,2,3,23,12,21,14,7,15,4,5,4,70,10,3,8,3,4,10,25,12,5,10,5,1,11,8,5,1,3,5,5,7,15,6,17,16,11,8,6,0,7,2,4,28,13,9,11,6,5,6,2,7,9,13,6,6,1,4,3,3,7,7,13,7,3,8,10,4,12,2,1,1,4,6,5,23,8,16,6,4,4,10,1,10,3,10,2,6,7,4,6,6,13,12,4,10,3,6,10,8,15,6,17,8,2,3,2,2,13,8,7,2,8,2,0,3,0,8,10,10,7,13,11,6,0,0,14,24,9,14,11,6,5,2,5,17,2,12,8,2,10,9,9,5,11,3,9,4,3,2,1,6,6,3,0,4,13,9,15,3,1,4,3,0,10,3,6,0,7,7,9,2,8,1,3,2,5,4,7,2,3,4,2,2,5,2,1,2,2,5,1,1,5,4,6,9,2,8,8,29,1,6,2,11,7,10,4,2,1,8,8,20,13,14,5,2,1,5,1,2,9,1,5,4,4,0,6,6,2,2,6,6,12,4,5,12,7,1,1,3,6,1,0,1,4,7,5,6,3,4,5,5,3,2,0,3,6,0,1,3,1,3,6,5,3,9,1,1,0,2,8,13,1,4,1,3,7,1,6,3,1,6,2,6,2,5,4,5,4,7,4,5,4,1,2,5,3,2,3,0,7,13,0,3,0,2,4,11,6,7,17,4,1,3,1,3,0,2,2,3,4,6,2,3,2,2,1,2,6,1,2,3,13,2,8,3,1,8,3,6,7,3,0,6,2,4,6,5,5,1,4,0,3,1,2,0,0,2,3,1,0,0
sale,0,2,0,92,3,0,1,10,0,7,2,1,2,21,3,1,2,13,1,1,5,20,1,16,11,6,3,4,2,12,7,128,52,8,20,19,7,51,53,0,3,2,2,0,23,5,7,11,181,6,18,0,17,10,7,0,47,39,4,5,6,0,6,13,9,4,37,10,2,4,34,0,5,3,41,11,7,10,59,8,59,3,5,0,187,22,15,0,48,4,16,1,5,34,38,24,14,12,18,17,8,21,27,2,7,18,8,4,21,6,14,6,5,16,7,15,13,1,61,128,21,4,5,88,4,0,3,1,5,6,5,0,3,34,7,17,0,8,3,4,0,22,30,2,2,34,2,8,19,23,29,3,17,7,4,21,11,4,0,6,19,0,6,1,12,0,9,7,16,11,14,42,11,0,2,3,130,5,11,14,14,3,4,4,23,20,23,8,21,25,0,5,14,0,0,4,13,4,7,9,24,1,5,3,15,1,23,44,23,38,51,1,16,18,1,2,1,0,23,2,29,12,0,10,50,53,16,26,2,18,8,16,30,25,14,51,15,6,12,0,44,32,13,1,7,5,9,15,21,4,6,37,8,20,14,9,10,5,7,18,2,7,14,8,15,29,3,0,7,3,98,23,110,2,3,0,13,23,3,7,21,2,2,8,4,3,0,5,5,1,0,1,5,8,13,6,44,0,2,14,22,32,3,10,10,0,12,1,2,0,1,5,14,0,57,24,17,27,29,2,33,3,11,0,24,4,2,6,3,22,0,10,0,2,4,31,5,2,5,19,6,3,7,7,2,1,19,6,12,10,9,16,2,28,8,5,2,3,12,35,23,4,3,18,7,0,26,0,5,2,2,9,7,6,5,7,1,6,6,18,37,1,28,2,0,222,2,10,29,1,2,7,6,4,21,8,47,4,16,8,9,2,0,0,9,10,5,1,18,9,1,4,13,3,0,2,6,3,2,0,4,3,10,6,0,2,4,6,13,23,20,14,9,18,2,2,1,2,5,3,14,17,3,8,1,1,3,4,21,15,5,4,2,13,27,1,0,10,2,25,8,9,23,5,3,0,24,5,3,1,4,1,0,0,1,2,0,3,9,0,6,14,0,0,3,3,8,2,2,1,20,28,0,1,23,7,5,19,6,9,9,1,0,0,23,38,8,14,21,5,7,0,8,2,12,16,6,8,12,8,0,33,6,2,6,3,15,10,14,32,6,1,0,3,4,8,8,3,40,59,6,1,1,14,47,5,2,22,21,1,11,2,5,54,0,3,12,8,8,4,19,2,14,3,17,19,5,2,41,42,9,4,15,1,4,2,10,3,3,31,18,20,5,4,11,1,6,5,3,12,10,23,8,15,14,12,5,1,17,5,28,2,6,1,3,12,6,6,5,6,18,11,2,4,19,9,15,16,10,2,10,5,4,25,2,3,3,5,5,19,28,13,20,12,8,0,4,11,1,4,9,0,2,29,3,34,4,4,4,86,0,14,5,5,1,6,41,4,1,13,5,0,0,2,1,2,0,9,8,5,16,8,6,29,15,3,3,2,3,5,6,19,8,3,9,4,5,1,7,4,9,13,14,26,2,7,8,2,11,9,3,3,8,7,6,3,12,4,4,3,0,18,6,15,27,9,1,6,2,2,15,3,0,10,0,6,9,1,0,4,5,15,50,1,27,2,8,0,21,4,5,4,6,8,1,3,18,5,1,12,5,33,22,26,23,9,5,13,5,40,41,6,11,9,16,40,4,2,3,20,4,2,0,14,0,14,35,2,27,11,10,0,3,16,7,7,11,5,5,16,2,14,1,3,14,9,9,8,5,3,6,5,6,3,3,0,5,2,12,3,14,1,1,9,4,2,5,7,7,6,2,11,1,1,21,3,0,4,7,13,8,12,11,1,3,7,2,25,4,10,4,4,1,4,4,17,18,1,2,2,7,21,2,30,0,5,2,1,3,2,1,2,6,2,1,7,3,1,4,17,2,3,36,16,1,3,1,2,5,3,1,5,5,4,8,2,2,3,4,2,1,2,2,1,2,5,3,0,11,0,6,1,4,9,0,2,0,17,18,10,8,17,9,56,6,6,1,1,0,2,6,5,7,19,1,5,4,0,3,22,5,1,11,6,7,0,11,5,3,11,0,10,11,14,26,27,34,30,84,4,3,3,0,6,11,31,2,4,26,9,74,7,0,2,5,14,18,1,0,6,1,0,6,3,5,1,2,7,5,2,1,2,8,6,5,6,2,1,1,0,1,0,5,0,5,6,1,7,1,0
violation,5,23,6,81,12,1,3,20,6,2,13,4,3,40,4,4,8,5,2,2,4,23,5,16,11,3,2,4,2,19,11,103,77,2,22,16,29,2,7,2,3,5,4,1,21,15,11,7,276,3,38,1,4,6,0,4,63,11,0,6,13,2,3,6,9,1,41,4,4,2,2,5,2,7,20,3,4,1,40,8,11,0,8,6,158,13,4,0,16,2,8,4,0,16,30,12,7,1,23,1,5,13,23,7,7,23,1,0,2,0,6,5,3,9,0,12,9,5,65,100,19,14,8,27,1,3,1,4,1,1,4,2,0,23,13,8,9,1,7,5,3,19,26,1,1,59,2,11,8,8,35,0,10,0,1,29,10,0,9,0,5,0,2,0,0,4,3,12,11,9,9,30,11,0,0,10,115,3,6,3,27,5,0,13,0,22,15,10,28,35,3,1,4,0,0,0,3,2,2,7,20,1,1,5,21,2,2,16,3,10,35,0,20,6,0,0,0,1,13,1,0,7,6,5,28,148,5,16,1,3,3,5,9,18,11,12,9,4,11,3,82,17,5,6,9,3,5,3,27,4,7,10,12,2,6,3,8,2,3,18,5,22,12,5,2,16,1,1,5,3,70,1,8,0,1,0,13,1,8,1,32,6,0,11,4,0,0,5,5,1,8,1,12,0,8,5,22,2,6,12,19,12,0,1,8,1,10,2,1,0,2,6,13,5,22,5,6,18,11,3,79,8,14,2,64,21,0,24,10,12,10,4,7,1,2,9,9,6,0,6,8,5,3,9,4,0,22,37,11,1,7,20,1,20,20,7,3,4,9,11,2,1,3,9,2,0,29,4,2,5,4,7,3,6,6,12,8,0,7,4,46,3,15,7,1,17,20,14,13,1,22,0,11,4,17,2,44,3,28,1,18,0,3,1,3,0,6,5,13,2,0,3,1,7,3,12,2,2,0,0,4,5,12,18,0,7,0,11,4,14,5,4,2,7,1,3,0,3,1,5,18,12,2,1,2,1,0,4,7,2,5,8,2,2,26,7,0,15,5,20,10,11,16,16,2,0,4,6,7,0,8,3,1,0,0,4,3,6,2,5,7,7,2,3,5,11,6,1,2,6,37,17,0,2,3,3,0,13,9,9,4,0,1,0,8,8,0,10,4,7,6,7,1,5,2,10,4,3,15,8,2,29,8,16,4,6,29,11,11,11,8,5,0,9,7,4,6,7,22,5,7,0,4,1,4,5,1,12,11,4,52,9,25,25,2,12,22,5,3,3,14,2,15,2,4,10,8,5,32,22,3,2,0,9,7,2,8,6,1,6,7,13,8,5,0,1,1,6,3,4,15,25,0,2,6,4,5,1,58,10,9,0,3,3,5,16,3,13,7,4,14,10,5,3,49,10,13,13,13,2,3,3,1,21,0,2,7,5,7,30,2,8,12,15,3,1,3,1,1,5,6,3,6,19,5,11,4,5,6,198,6,1,3,11,6,2,19,11,8,13,3,5,12,17,9,0,0,5,3,9,11,3,60,48,12,1,1,2,2,6,1,19,12,3,6,10,20,2,2,8,9,9,9,2,5,2,7,3,14,8,7,4,6,4,10,2,7,2,6,4,5,14,7,8,3,8,9,4,2,1,8,2,7,22,0,1,3,0,1,5,5,11,3,2,4,2,4,4,36,1,8,3,0,2,3,0,1,1,3,3,6,0,0,3,3,4,12,2,0,10,10,4,0,7,4,12,8,4,0,2,1,1,1,30,4,17,3,3,0,5,0,3,10,4,5,0,1,17,0,24,2,9,1,2,5,12,1,4,3,2,2,5,6,3,3,0,6,4,8,4,16,0,30,3,5,2,1,6,3,10,11,2,0,11,0,9,0,6,2,3,4,2,5,5,3,6,6,21,3,8,4,6,4,10,2,6,3,3,10,19,21,24,15,2,0,2,9,3,1,0,4,7,12,3,2,5,4,1,4,6,5,2,12,2,4,7,2,11,4,0,0,6,0,5,2,1,5,5,5,5,1,3,0,4,8,6,6,5,3,1,1,7,5,6,10,0,0,2,14,11,0,0,4,0,9,1,1,3,0,3,6,6,2,11,6,9,1,26,3,3,0,0,4,2,6,1,0,5,6,1,1,7,0,2,0,8,5,1,7,0,0,4,0,0,0,4,4,2,12,5,0,1,3,1,2,39,2,1,3,2,2,14,0,3,7,1,0,5,2,8,2,4,2,0,4,4,11,0,18,0,1,2,1,0,0,0,0,6,0,0
third,2,14,1,23,2,6,2,13,4,4,6,4,5,24,2,0,3,2,2,1,2,5,3,7,0,2,2,6,2,2,3,52,11,6,7,21,15,9,2,4,2,11,1,2,8,3,8,7,52,15,7,3,10,25,10,0,13,10,4,4,6,2,3,5,9,1,29,1,1,9,12,3,4,0,35,4,5,0,22,6,30,3,6,0,51,2,5,4,11,3,4,2,12,5,14,13,3,2,22,3,9,17,9,3,12,7,8,8,6,8,33,5,6,6,9,8,3,2,14,16,5,16,19,35,1,3,1,1,2,3,4,5,4,16,2,16,0,3,0,2,1,11,7,1,5,15,1,8,4,5,13,2,5,6,2,25,8,7,1,19,5,3,2,1,10,7,1,6,6,6,5,44,3,1,0,3,27,3,0,14,8,5,9,4,0,8,11,2,4,13,0,2,2,2,3,34,9,6,8,3,6,2,2,5,15,4,4,6,3,7,12,1,3,6,1,6,1,5,2,11,4,11,0,4,8,20,7,7,1,4,2,24,11,5,7,15,4,3,3,2,17,3,3,1,2,6,4,14,19,1,3,5,6,1,0,4,3,3,1,7,0,7,5,2,2,16,2,7,6,2,24,4,4,1,2,3,5,5,1,1,12,7,1,1,6,3,5,5,0,0,2,3,4,5,5,3,11,6,1,5,4,8,2,4,1,0,8,1,0,3,4,9,12,6,15,7,1,13,20,2,10,0,6,6,10,2,2,4,3,14,3,3,1,0,1,1,10,4,3,7,3,2,6,4,3,4,7,13,0,6,3,1,0,17,4,1,1,2,3,10,5,6,5,3,0,3,5,2,7,2,0,8,2,7,4,19,3,0,1,1,15,4,14,10,0,4,2,3,9,1,4,1,0,4,3,3,10,2,5,1,5,1,1,0,0,1,2,2,6,2,0,3,10,7,0,2,2,1,1,5,2,0,5,0,1,0,2,1,1,2,4,3,0,6,5,1,2,5,11,0,3,2,2,2,2,4,10,1,2,1,7,5,5,0,9,2,0,1,4,6,2,7,5,6,1,0,1,5,2,3,6,0,0,3,1,1,0,3,2,4,1,5,1,3,3,1,4,3,0,2,13,5,1,3,4,2,2,6,2,0,3,2,2,0,13,8,0,1,5,2,2,1,1,3,5,3,1,1,1,3,1,4,1,1,1,1,3,4,1,5,5,3,1,1,1,0,0,0,11,3,0,5,4,5,2,2,1,1,2,0,4,2,5,15,5,0,0,1,3,1,4,1,5,4,2,1,1,1,6,10,4,1,3,7,0,1,3,1,1,6,3,4,3,2,2,2,0,0,2,1,4,7,2,1,7,2,5,4,6,4,5,1,0,2,2,4,2,4,7,3,8,8,8,1,2,2,3,0,1,0,1,4,0,7,1,0,2,4,0,10,6,4,1,7,1,2,2,1,1,1,5,0,3,7,0,9,0,2,3,30,1,2,0,1,1,2,5,3,1,3,1,1,5,2,3,1,1,4,2,1,5,2,9,5,1,0,0,0,2,0,1,5,2,3,3,1,6,6,0,3,2,4,1,2,0,5,0,3,1,2,1,0,1,0,3,1,3,4,2,0,3,9,0,3,5,14,3,0,4,4,1,1,0,6,7,3,4,0,1,2,2,1,2,1,0,0,12,1,2,7,1,0,1,3,3,0,6,12,6,0,3,1,0,4,4,3,2,3,4,2,0,7,4,6,5,4,1,1,2,0,2,0,1,2,2,1,5,1,0,2,0,0,2,0,2,2,1,0,2,1,3,7,4,2,4,4,1,2,3,2,0,1,3,3,0,1,1,2,3,0,3,1,2,4,0,4,1,1,1,5,0,1,13,5,4,2,6,4,3,1,1,1,2,3,2,0,1,7,2,1,0,2,0,2,3,2,1,2,0,6,4,5,2,1,1,3,1,2,0,1,3,1,1,4,1,1,0,0,1,3,3,3,5,7,0,1,2,1,2,2,0,0,4,0,1,3,2,0,2,2,4,3,3,1,0,1,1,0,4,4,2,0,3,2,3,1,0,1,0,3,3,2,0,2,1,0,0,1,4,0,1,5,1,2,0,2,0,1,1,6,6,1,3,3,0,2,1,5,0,1,2,6,3,1,3,9,7,7,10,2,9,2,2,1,1,0,2,0,2,0,0,0,1,3,2,4,0,2,1,0,2,1,3,5,0,0,3,2,0,1,0,2,1,5,2,3,0,4,1,2,0,1,2,1,3,7,1,1,9,3
arrangement,5,6,5,79,3,0,5,11,2,1,25,13,5,27,3,2,6,6,1,1,1,39,4,9,14,6,2,8,3,1,10,136,85,1,35,40,13,5,5,2,4,1,3,5,27,10,31,6,242,11,29,0,8,5,1,1,86,9,0,12,20,2,0,10,2,5,29,1,10,11,2,4,0,3,25,6,4,3,36,10,23,1,20,4,149,3,6,0,23,1,9,0,0,28,48,8,14,0,19,4,6,19,24,4,2,8,10,0,10,0,5,4,3,3,0,25,10,4,81,91,17,31,3,30,5,7,4,11,10,0,1,2,2,38,1,23,0,0,2,1,0,23,27,1,0,55,3,10,4,5,23,0,12,4,2,2,26,3,1,3,1,3,6,3,3,1,6,7,9,3,11,54,14,0,0,4,96,1,8,14,3,4,2,6,2,13,17,18,40,63,3,4,12,0,1,2,6,1,4,4,13,3,0,16,14,6,8,11,13,20,52,2,15,6,2,0,1,1,4,0,0,8,8,5,19,37,8,14,2,0,6,3,11,16,8,19,23,1,12,3,25,17,1,5,10,7,2,9,38,2,4,15,15,2,11,33,6,7,7,11,0,29,16,2,5,14,5,2,8,6,84,4,17,0,1,0,15,6,11,4,26,2,3,6,4,0,1,7,5,1,8,8,2,6,7,7,25,2,5,9,15,22,0,1,12,0,16,2,1,0,2,10,24,2,37,9,20,29,4,2,27,3,6,7,27,3,0,5,5,16,1,6,8,5,2,2,10,1,8,9,2,5,5,6,3,2,28,57,6,2,5,7,6,10,11,3,0,0,11,14,8,3,6,20,9,0,37,5,1,5,0,5,7,3,8,9,6,4,4,0,49,0,26,14,1,12,0,11,5,5,16,1,7,18,29,7,63,7,24,3,11,1,3,2,4,2,6,5,50,8,0,8,13,6,14,10,6,12,3,0,2,5,8,0,0,2,0,7,8,9,8,1,5,11,3,4,0,33,2,2,6,19,9,9,0,5,1,4,20,2,3,1,2,6,76,3,0,6,8,41,2,11,18,1,4,3,8,24,9,0,5,2,2,0,0,0,2,9,9,1,1,10,6,2,6,2,17,3,3,0,32,14,0,0,2,5,7,8,4,4,8,0,0,0,13,12,5,13,2,5,2,0,5,10,5,3,2,5,0,2,0,8,9,5,3,5,18,2,11,10,2,3,3,5,5,4,7,7,27,5,7,3,0,0,9,10,2,15,12,6,11,2,3,27,2,5,26,7,11,2,32,4,31,2,16,9,15,8,23,28,10,4,10,2,3,22,6,4,5,12,5,7,15,5,6,1,5,3,5,4,17,17,16,2,6,1,2,2,57,19,11,1,3,6,7,7,4,14,3,12,14,12,5,6,23,8,17,10,3,6,12,1,4,10,2,4,5,7,7,15,10,8,23,14,2,3,2,4,1,11,2,0,3,6,10,14,1,7,2,177,14,2,7,2,3,6,23,4,5,30,1,12,32,57,31,9,12,11,11,11,7,9,10,3,25,2,2,9,1,7,5,19,14,11,12,4,11,7,0,13,12,4,11,13,5,16,10,7,7,11,1,4,6,2,5,2,13,3,2,6,2,17,1,9,12,6,3,4,6,3,7,1,2,13,2,8,0,1,3,3,5,8,2,6,4,2,16,0,32,5,5,7,4,12,8,9,3,1,0,11,6,1,0,8,5,12,1,11,1,20,22,3,0,1,11,8,3,9,3,13,1,4,1,6,2,11,0,1,14,9,14,5,5,5,5,10,9,5,9,13,3,12,4,12,5,2,6,5,4,4,2,3,0,3,1,1,2,5,17,2,21,8,46,9,9,5,3,14,1,4,3,4,16,18,8,2,0,4,8,2,6,4,3,1,0,3,5,12,2,4,4,1,0,7,3,12,3,14,7,9,36,13,5,3,1,3,5,1,4,3,1,3,9,2,2,11,2,6,5,10,3,2,12,10,7,4,14,8,3,6,6,7,3,10,7,10,5,2,6,10,3,8,0,4,7,13,5,5,7,0,12,15,0,4,0,9,16,12,5,16,0,4,5,10,15,4,2,9,3,2,9,7,4,11,1,4,5,23,6,2,9,5,8,11,8,0,6,0,3,5,2,3,1,3,5,25,13,2,18,8,0,3,0,0,3,0,1,3,11,8,0,11,8,2,0,47,2,0,0,5,2,3,7,0,8,9,0,4,6,5,4,2,3,8,7,1,4,0,41,0,1,1,13,1,2,0,0,8,1,0
deny,12,19,6,80,3,6,1,17,2,1,4,1,4,63,2,15,3,12,5,5,0,19,17,21,14,6,7,10,7,8,8,86,46,7,15,22,18,4,6,3,6,13,2,2,12,10,18,5,167,19,25,3,10,34,8,4,18,3,5,6,11,7,0,13,9,5,83,3,5,9,12,2,1,6,44,9,15,1,40,9,19,2,9,5,118,5,2,0,7,3,4,2,3,13,21,10,2,3,16,8,1,10,24,4,7,13,2,1,2,1,15,1,2,6,4,11,4,3,34,69,22,18,5,37,9,3,1,2,7,1,8,3,8,23,14,31,18,2,2,4,3,10,17,1,2,52,9,6,8,2,57,0,4,1,3,10,17,2,4,6,5,0,5,3,0,7,2,10,18,7,6,48,10,1,2,3,88,4,11,13,13,3,2,7,0,4,17,8,30,27,3,2,2,1,0,0,9,3,1,12,14,1,4,6,11,6,2,16,6,5,46,5,20,4,1,13,1,1,8,0,1,8,3,9,19,74,6,10,2,3,5,3,9,21,15,6,20,2,6,9,42,17,4,10,14,5,3,7,20,3,6,10,8,3,4,6,4,2,0,4,1,18,9,0,1,15,9,2,15,1,90,0,8,1,2,1,17,0,5,2,27,7,1,10,2,3,8,4,10,2,0,4,14,0,1,9,12,2,3,18,9,7,0,2,4,3,10,3,5,1,2,3,8,7,15,6,7,20,16,11,47,2,19,12,95,11,6,21,0,19,20,9,15,3,4,12,15,9,3,4,4,4,6,10,0,2,31,28,9,10,12,4,3,19,18,3,9,2,4,9,12,6,3,9,2,1,23,2,1,11,2,14,0,8,9,7,2,2,7,3,47,3,21,3,7,22,9,26,14,2,21,1,8,7,11,5,36,3,16,4,11,3,3,2,1,10,6,6,11,5,2,4,2,3,7,4,0,3,4,4,2,2,9,6,4,4,2,15,5,8,7,3,0,2,0,8,0,4,2,3,11,15,1,6,1,5,8,3,21,5,16,2,1,5,31,7,1,21,6,17,13,9,14,15,2,0,7,16,9,3,21,2,5,1,2,10,4,16,7,2,13,9,6,4,5,11,5,5,0,2,27,13,2,6,5,2,6,3,4,7,7,1,3,4,17,10,2,6,4,5,1,3,3,1,6,9,2,6,3,6,3,21,5,23,11,3,14,9,14,14,3,6,9,3,9,1,5,5,16,13,6,1,0,5,4,3,5,10,9,6,43,2,7,32,1,3,15,1,5,8,4,2,22,1,8,11,1,2,14,22,1,6,2,2,1,2,4,1,7,10,1,10,3,8,2,2,3,3,8,2,23,12,2,1,25,6,0,4,32,13,7,1,3,0,3,15,3,21,5,1,15,5,1,5,18,4,3,7,4,1,6,4,0,17,1,1,8,3,5,18,8,5,18,14,2,6,3,0,4,9,8,5,9,9,8,6,4,3,8,89,8,0,1,5,12,6,18,12,9,8,2,4,12,25,9,1,0,2,3,5,7,0,1,51,26,9,4,1,0,0,0,10,9,3,3,7,7,2,2,4,6,9,10,2,2,3,1,7,10,13,2,3,0,10,6,2,7,4,4,2,3,3,5,12,14,5,4,5,4,4,4,2,3,3,3,3,5,3,5,8,0,2,3,2,2,1,5,0,22,6,8,3,1,6,11,0,10,3,0,6,3,2,0,3,1,6,6,2,1,19,19,3,0,0,13,6,2,3,4,3,1,2,1,15,1,3,4,2,4,5,0,2,14,4,8,4,3,3,7,9,2,17,3,2,4,9,4,3,2,7,3,2,3,2,5,0,3,2,12,8,0,3,7,3,7,2,3,5,2,7,5,0,0,2,0,3,4,2,1,6,5,2,5,5,5,2,0,15,14,2,3,8,13,4,7,3,2,2,0,9,13,26,6,6,1,0,4,2,7,1,3,1,3,1,1,4,6,2,7,4,4,5,8,5,5,5,2,22,8,0,1,3,3,4,0,1,5,0,7,1,7,7,0,2,6,6,7,1,2,11,3,2,4,7,5,0,1,3,3,9,5,0,8,0,14,0,2,14,5,6,1,2,0,1,2,2,4,8,3,3,5,0,4,3,1,0,7,3,7,2,1,11,0,3,1,6,5,2,8,6,0,5,1,1,1,0,3,4,11,5,2,8,5,1,1,18,1,9,7,3,11,4,6,2,3,3,0,3,13,9,0,4,5,2,6,5,10,2,18,1,1,1,0,0,0,4,4,1,1,5
agent,7,22,8,73,5,0,1,10,5,3,2,7,2,27,2,4,5,9,1,5,4,44,1,14,23,4,4,0,4,8,5,118,69,6,33,24,12,3,2,1,11,3,8,2,21,7,19,18,209,2,35,1,1,9,9,3,58,31,4,6,10,2,5,8,7,1,69,5,5,4,8,4,5,2,48,7,7,2,42,7,26,1,7,5,176,19,6,0,26,2,1,0,0,16,26,6,15,3,7,9,5,10,19,8,8,17,2,0,9,2,6,5,8,9,0,11,4,5,58,100,31,5,7,26,0,2,0,5,2,0,5,1,6,37,17,28,5,7,5,0,1,26,19,1,0,44,4,10,10,10,46,1,7,1,1,21,36,3,6,1,2,0,7,1,1,6,3,21,11,3,19,53,7,0,0,6,104,1,9,15,17,7,2,9,4,10,20,11,25,21,2,5,1,0,6,1,13,4,3,16,15,1,1,11,16,4,2,30,6,12,61,4,13,5,1,5,0,2,16,1,0,17,5,10,26,92,9,14,3,3,4,7,3,15,11,15,21,0,3,3,31,26,3,7,10,6,1,25,36,5,7,14,5,7,9,4,8,2,2,14,10,9,16,5,3,37,3,5,6,2,93,8,22,6,2,0,14,0,12,0,28,6,4,11,3,1,1,10,11,0,5,1,13,4,4,5,62,2,6,12,7,16,0,0,5,1,23,4,7,0,1,5,15,3,25,11,10,24,10,3,36,10,10,3,29,6,2,16,7,25,2,7,3,8,3,13,10,5,1,6,8,19,11,6,0,3,24,34,8,6,4,8,6,22,14,1,3,5,6,17,15,2,0,9,0,0,29,4,1,9,3,17,4,10,6,23,12,2,7,7,47,0,24,7,1,21,5,5,18,17,11,0,8,2,23,9,52,5,29,2,17,1,3,4,4,3,4,3,12,7,1,4,2,5,6,6,1,0,0,0,1,8,5,12,0,6,0,23,5,11,11,1,0,12,1,10,0,1,4,2,9,21,6,10,1,1,2,2,17,6,10,4,0,3,28,3,0,7,10,11,8,22,18,10,8,0,5,2,2,0,12,4,2,0,3,12,1,15,15,5,8,8,3,3,5,7,4,4,4,2,34,13,1,1,5,2,11,19,10,2,0,2,0,0,13,19,2,9,7,3,3,0,8,7,6,24,9,1,3,10,8,5,8,29,7,5,12,9,9,14,6,4,0,5,5,3,1,12,35,14,2,0,3,1,5,1,2,17,12,7,24,8,4,25,1,14,14,7,4,6,21,1,24,0,16,6,10,1,19,32,15,5,10,5,15,0,2,3,6,18,1,20,2,7,7,2,4,3,2,7,10,31,8,4,11,0,9,0,29,14,5,5,2,1,6,12,1,19,3,9,23,15,31,5,36,7,14,3,7,3,17,6,2,12,6,3,5,3,13,20,5,11,14,10,6,3,9,7,5,12,10,3,2,26,3,20,6,4,1,132,17,6,3,6,3,7,30,4,2,5,2,2,6,10,6,0,2,3,5,10,14,7,27,21,29,3,3,10,1,5,0,21,17,4,8,11,1,3,4,20,12,7,23,5,10,5,4,4,5,12,8,2,6,1,15,7,15,3,2,5,4,7,4,20,21,10,13,10,5,3,12,3,9,51,1,8,6,1,3,6,8,13,5,2,6,3,5,9,14,1,5,4,1,5,3,7,16,1,6,7,10,9,0,4,3,14,4,9,3,5,3,9,3,2,14,10,4,9,2,6,5,0,12,18,1,12,2,11,46,13,5,6,5,9,2,3,4,2,3,30,6,8,0,5,7,13,1,9,4,9,1,6,11,1,4,2,2,3,23,7,6,1,4,5,2,5,1,7,4,9,1,0,3,24,2,12,3,3,8,3,12,4,16,4,7,6,3,18,6,5,11,5,3,6,9,5,7,10,4,6,12,20,10,5,0,8,4,6,12,1,9,3,1,4,1,11,2,2,3,9,3,1,2,7,2,4,5,5,19,3,8,12,3,1,21,7,0,5,12,3,2,4,0,3,4,6,5,5,1,3,2,5,1,8,7,5,2,9,6,13,14,5,3,12,7,11,7,1,2,5,12,3,3,3,7,9,4,19,3,7,7,1,6,3,2,2,7,4,3,8,3,8,2,0,2,12,5,2,43,8,0,4,3,1,4,1,1,1,19,6,2,2,9,7,0,20,3,2,1,2,1,5,5,1,4,5,1,6,1,4,0,5,13,5,3,0,2,1,1,0,0,2,2,0,0,1,3,1,0,0
cooperation,2,18,18,78,3,7,2,9,1,1,5,6,5,44,2,1,2,8,8,6,4,9,8,13,8,5,3,17,3,3,1,91,64,6,24,28,33,3,2,1,1,4,1,4,17,13,18,14,104,25,13,13,7,40,4,2,15,5,3,12,10,20,3,8,7,8,36,2,3,2,6,1,2,4,51,13,12,5,37,15,15,1,4,6,84,5,11,2,7,3,5,3,5,8,28,5,8,5,25,10,16,14,18,3,14,7,4,2,6,0,16,1,9,6,4,8,2,1,17,57,12,16,5,40,5,1,4,1,1,4,8,3,1,22,15,58,2,5,1,9,1,17,7,2,2,20,0,13,10,6,33,1,3,10,3,22,16,9,5,27,8,3,1,4,7,1,2,25,14,6,14,37,8,3,1,2,56,4,5,20,5,3,16,10,3,13,17,10,11,23,1,5,4,2,0,2,12,6,17,3,24,5,4,9,15,11,5,12,2,34,39,7,3,4,1,1,2,3,11,2,7,4,3,5,20,23,11,11,1,5,9,5,21,14,20,4,6,8,8,5,18,13,3,2,13,6,4,9,29,4,4,11,10,2,3,5,1,5,2,9,2,15,4,2,2,20,7,1,6,6,33,2,15,2,3,12,4,10,3,5,28,2,1,11,4,5,0,3,4,0,1,2,6,5,1,3,4,0,5,6,2,9,3,2,6,5,16,4,5,4,9,13,20,16,6,7,8,27,10,7,9,3,9,5,13,1,15,6,4,13,1,2,0,0,0,9,15,3,6,10,3,7,5,6,7,4,7,26,9,2,2,10,4,13,5,3,0,5,12,25,17,8,16,5,4,5,10,2,14,6,0,15,6,8,2,6,11,3,14,1,32,2,19,10,4,15,1,9,9,4,4,12,18,6,11,6,14,3,15,5,16,2,3,2,3,3,5,1,20,20,5,2,6,5,0,8,4,1,3,4,4,2,19,12,1,4,6,7,2,10,4,1,0,1,6,5,3,1,10,5,6,5,6,15,7,2,9,3,6,3,8,2,5,8,17,6,1,3,7,11,11,6,28,16,7,5,3,1,6,2,10,0,1,2,1,4,2,17,11,1,1,8,3,3,9,0,11,2,3,0,29,20,1,0,4,3,5,10,3,5,6,2,0,1,9,10,6,2,3,4,0,2,0,2,6,5,1,4,3,6,4,6,3,6,4,1,10,1,3,11,4,2,4,2,3,2,1,5,13,5,0,12,1,4,8,3,2,5,5,3,10,3,1,15,23,4,14,1,4,5,6,2,6,9,4,8,5,0,18,19,7,2,6,3,7,2,5,0,3,9,2,7,4,1,3,1,2,1,4,4,13,8,0,1,23,2,2,5,9,9,8,7,1,0,1,5,4,28,13,1,10,7,10,2,7,2,3,5,0,1,4,1,3,6,3,2,5,2,5,13,6,6,5,6,6,4,8,5,2,5,4,4,3,15,4,6,7,8,2,42,13,3,0,4,1,6,12,6,5,5,2,2,1,3,0,1,3,3,9,6,8,7,15,2,3,0,2,5,1,2,0,16,2,3,6,2,1,5,2,7,6,8,4,7,3,7,3,1,2,3,9,0,4,4,12,5,5,0,1,4,3,1,1,15,3,11,6,2,4,5,3,1,0,8,1,0,3,0,0,10,4,8,0,1,1,3,12,2,12,6,7,4,1,2,3,3,6,19,4,3,4,0,0,9,10,5,5,2,2,4,4,14,0,2,11,5,1,7,7,3,6,2,1,4,2,4,0,4,5,2,1,2,2,5,7,5,0,4,4,3,3,0,1,2,8,6,7,1,3,7,2,2,1,5,2,9,7,1,3,3,4,7,7,5,2,1,3,4,2,3,2,1,8,6,2,1,4,9,0,2,2,6,6,0,2,1,6,4,2,2,1,1,0,1,2,0,1,9,5,1,9,12,4,0,5,7,0,2,3,4,2,1,4,1,4,5,1,3,5,3,6,4,2,1,0,3,0,3,3,5,0,0,5,1,4,3,1,1,2,6,3,4,0,1,0,3,4,7,3,0,3,2,2,3,2,0,0,2,3,9,4,10,1,4,3,0,1,1,7,0,4,7,3,3,7,2,1,5,1,1,1,2,3,5,3,3,5,1,0,3,2,3,5,3,1,7,3,3,6,2,1,0,1,3,3,0,2,2,2,2,2,2,4,0,2,5,4,0,1,3,6,2,3,6,2,1,1,0,0,1,1,2,1,9,1,2,4,8,0,0,2,11,0,5,1,2,3,2,10,5
compel,3,10,3,52,4,2,1,20,2,3,10,3,1,26,2,7,6,10,1,2,4,20,4,6,6,4,7,6,2,4,13,86,64,4,19,28,25,10,9,3,6,9,1,0,15,15,9,5,151,8,26,3,5,16,3,3,41,5,0,4,10,8,3,8,7,5,45,4,3,4,2,3,3,3,38,6,8,4,37,12,21,1,12,5,98,12,6,0,16,0,1,3,0,16,18,1,12,3,24,8,3,12,25,6,6,13,2,1,9,5,7,2,3,11,0,12,0,1,48,87,23,4,4,26,4,2,1,3,2,0,8,2,2,15,10,14,7,5,4,4,0,14,7,1,2,32,5,7,6,10,47,0,10,5,0,10,19,4,4,1,10,2,9,1,0,1,4,10,10,8,16,49,4,1,4,6,85,1,5,12,15,7,1,9,4,10,22,9,14,25,1,6,1,0,1,3,1,1,2,4,20,0,0,7,17,2,0,19,2,12,26,1,20,8,0,1,2,1,9,0,0,7,0,10,28,72,13,10,5,15,2,3,9,13,17,12,16,6,3,3,26,17,3,1,10,1,3,10,18,8,2,17,7,2,7,5,9,0,2,12,8,19,10,0,5,17,0,1,8,5,68,1,19,6,1,1,12,3,5,3,23,4,4,9,4,1,1,2,5,3,1,1,8,1,1,5,18,0,0,6,16,15,0,1,7,1,14,0,1,0,2,7,12,4,28,7,7,24,10,1,25,3,20,3,36,5,2,5,0,22,5,8,11,6,4,2,15,4,2,5,7,8,7,3,5,0,32,19,8,2,9,8,3,23,16,2,1,2,4,14,15,5,3,7,3,0,19,4,0,5,1,10,1,6,2,10,10,3,9,1,41,2,28,4,1,12,3,15,15,1,15,2,8,2,12,3,27,0,24,3,12,0,0,1,4,4,11,2,15,7,3,7,3,7,11,7,1,1,0,1,1,1,7,4,3,2,1,10,4,9,21,3,1,3,1,1,0,2,7,5,15,18,4,18,1,0,2,1,14,4,10,3,1,2,23,8,2,2,3,15,2,13,19,14,6,2,11,11,2,0,16,4,4,1,1,2,3,6,19,3,5,8,4,2,3,12,8,5,1,5,54,25,1,3,2,2,1,10,3,19,3,2,2,0,7,54,1,1,4,3,4,7,2,2,11,12,2,5,4,4,1,17,5,22,5,2,22,8,19,15,6,4,7,4,5,4,4,4,14,10,8,1,4,2,8,7,1,4,4,3,14,7,2,30,3,8,12,4,1,3,9,3,18,2,9,14,4,4,15,18,5,6,4,1,2,0,3,4,6,4,5,7,7,12,7,2,2,3,5,5,7,15,10,2,14,0,4,3,15,9,13,3,4,1,2,14,4,13,7,4,14,5,4,3,24,6,9,4,6,5,6,20,6,20,2,6,2,5,10,11,31,5,17,9,6,1,5,3,1,8,5,2,4,16,6,6,4,1,4,85,9,2,7,4,3,6,17,10,6,11,4,1,1,13,4,0,1,4,7,6,9,2,27,23,14,6,2,3,0,2,2,11,8,2,2,5,7,0,3,1,4,1,8,2,3,2,9,3,11,4,2,5,3,6,2,2,4,2,6,1,5,3,1,21,11,15,13,3,7,2,7,5,5,15,0,2,4,1,5,10,3,8,10,5,4,3,6,1,18,15,6,4,6,3,2,7,6,1,7,4,5,2,2,4,2,3,4,6,2,5,5,6,3,1,9,20,3,3,6,6,6,0,2,16,1,5,11,0,13,8,3,6,8,5,8,1,9,3,10,6,4,8,2,1,7,5,2,1,0,6,2,2,11,3,2,1,4,3,12,4,9,1,6,6,3,2,5,1,12,7,4,1,6,2,3,5,3,0,17,3,5,2,5,1,2,6,15,14,10,2,3,2,3,11,4,6,9,6,2,8,14,17,5,9,0,4,6,1,2,1,2,1,1,4,1,6,1,6,6,4,0,1,5,17,8,4,0,7,4,0,2,3,2,1,4,1,3,3,3,2,0,1,0,1,5,1,3,1,2,1,5,0,2,5,10,2,0,6,0,9,2,6,2,5,7,0,5,3,3,1,2,2,1,9,2,7,1,4,1,11,1,1,4,0,0,3,2,3,2,2,2,8,1,0,0,18,2,2,17,0,0,3,3,4,3,2,3,2,9,2,0,0,1,5,1,7,2,0,4,4,4,1,5,3,8,4,2,9,4,4,5,4,6,31,4,2,7,3,10,1,0,2,2,0,0,0,0,7,0,2
attend,5,18,12,101,4,3,0,23,3,5,16,8,2,40,4,12,7,8,4,7,1,35,5,15,13,4,5,6,4,6,3,96,102,3,40,26,30,13,7,8,5,7,6,4,18,17,18,3,220,7,32,0,11,16,8,11,35,28,0,12,19,9,4,10,21,5,47,4,8,10,8,2,5,0,59,12,8,3,63,12,40,1,11,5,173,7,10,0,35,2,2,3,0,16,41,2,11,2,14,9,7,15,24,11,8,23,9,2,8,6,11,5,3,9,1,20,7,2,32,93,36,8,5,48,6,3,2,1,1,3,12,6,4,39,7,12,2,3,1,5,2,28,28,1,4,38,10,8,13,19,43,0,9,2,0,12,12,5,13,2,12,4,3,1,0,0,2,18,12,8,13,52,10,0,1,10,110,3,14,13,14,10,1,10,1,9,17,24,24,52,1,4,6,0,2,5,18,1,5,12,9,3,3,13,22,9,6,26,14,32,58,1,10,4,0,0,1,0,10,0,1,13,3,10,26,64,15,15,4,1,7,9,9,19,26,25,21,6,4,1,57,31,3,5,5,5,5,14,34,2,8,16,17,3,11,18,10,2,5,15,1,24,16,4,6,25,6,3,5,4,102,7,17,6,3,0,8,8,6,0,28,3,1,9,9,0,0,5,7,4,2,4,4,6,1,8,27,2,9,6,19,27,1,1,12,1,17,2,4,0,0,8,25,2,16,17,6,44,11,2,43,4,22,4,31,2,6,15,6,34,3,11,7,1,0,9,13,5,4,8,4,8,13,5,3,4,46,45,13,7,17,10,2,19,23,5,1,5,16,30,13,5,7,22,10,3,25,6,4,5,2,16,9,6,8,25,8,4,10,3,29,1,27,8,1,27,13,7,23,10,14,1,14,5,29,18,56,7,23,5,14,2,3,0,5,6,4,7,24,13,5,11,4,15,11,10,3,4,1,0,5,4,14,12,1,2,1,14,7,9,23,5,3,2,4,2,0,8,7,1,11,20,4,11,0,2,0,4,23,5,8,5,1,4,40,8,1,12,1,21,12,15,24,13,2,2,14,16,2,0,20,1,1,0,2,4,6,21,13,4,1,8,5,3,18,6,15,9,2,5,67,18,0,5,5,10,1,11,7,6,6,3,2,1,0,28,6,16,5,4,3,5,6,3,17,23,1,9,5,6,2,25,8,14,0,6,13,3,13,27,6,5,1,5,9,10,5,2,17,8,4,3,0,0,6,11,1,28,13,6,10,4,5,31,2,11,22,2,2,7,26,1,19,3,14,12,14,9,27,24,6,10,12,5,1,6,6,4,5,5,1,11,7,12,8,5,3,8,3,11,18,22,8,3,10,7,2,1,33,21,18,0,7,3,5,20,5,35,9,14,17,13,11,3,9,7,21,3,2,4,9,10,3,19,4,5,0,11,15,27,11,14,16,20,5,0,2,4,1,15,7,1,12,22,7,20,5,5,4,142,6,2,11,2,5,9,34,10,2,10,9,7,10,21,5,4,3,10,13,6,12,8,57,30,26,8,5,7,2,6,0,10,16,8,7,10,11,4,7,11,11,10,16,8,6,6,12,4,5,5,4,3,12,8,9,5,20,6,4,3,3,5,5,17,19,16,11,7,7,4,14,5,15,25,0,5,6,4,5,7,6,13,5,3,3,2,11,8,29,16,2,6,3,4,4,4,10,5,4,6,10,6,3,7,3,15,2,10,1,4,2,7,4,3,14,13,11,6,6,14,10,5,5,19,4,12,10,6,28,10,7,6,10,6,12,6,7,19,5,7,9,13,2,5,4,10,3,4,6,10,5,4,5,5,4,0,8,2,18,10,4,2,9,4,6,4,2,1,2,8,4,7,20,5,6,3,7,5,18,0,7,7,10,4,4,13,14,23,10,7,7,5,6,6,6,3,6,3,6,11,15,21,7,6,0,3,6,7,5,1,11,4,11,5,6,1,5,2,12,17,2,3,1,20,2,10,3,7,13,3,2,3,7,5,13,4,5,6,7,8,2,4,3,5,8,9,6,4,2,0,10,1,3,3,13,4,0,10,1,19,3,4,3,3,7,5,4,4,3,2,6,8,7,4,2,9,5,17,0,4,2,1,7,4,2,5,8,4,5,10,3,5,4,0,3,16,0,6,23,3,0,4,3,6,0,5,10,5,11,1,0,7,6,3,1,12,7,6,0,3,5,9,2,4,1,8,3,8,13,4,4,5,2,9,8,4,6,1,12,3,2,3,7,1,0,1,0,6,0,0
destruction,13,6,0,34,4,12,1,16,1,5,6,2,3,57,12,8,1,4,1,5,3,19,11,13,22,4,7,1,5,12,15,99,58,3,33,23,15,5,8,0,9,12,6,2,6,9,5,3,130,14,30,4,7,36,8,4,16,9,0,12,6,0,3,3,30,3,44,2,1,4,3,3,1,3,46,10,14,1,43,24,7,0,4,7,80,4,5,1,19,0,2,0,0,11,19,2,7,2,15,12,4,13,18,2,12,11,1,13,6,2,5,3,1,7,0,40,3,1,17,81,28,11,3,44,15,2,2,2,3,2,14,1,9,18,10,28,4,8,4,0,3,50,12,3,7,55,30,24,10,6,21,2,4,3,2,4,40,4,4,8,1,11,15,1,1,3,8,10,24,5,4,60,9,4,0,7,70,4,3,12,37,6,3,5,2,11,16,20,14,18,8,3,5,1,3,2,4,1,3,14,15,1,2,6,2,2,5,14,7,13,36,2,19,3,0,0,0,4,3,1,0,16,3,4,10,26,44,33,5,3,10,7,10,8,17,2,18,9,4,1,35,30,12,4,17,3,2,7,13,3,2,9,10,3,7,7,5,2,1,6,2,23,6,4,0,28,1,3,4,1,51,0,10,4,1,2,23,1,2,1,26,5,5,5,6,0,2,12,7,1,2,3,4,3,0,3,13,7,0,13,16,7,0,1,11,3,11,1,2,10,2,5,6,1,9,2,3,32,5,7,16,5,39,1,21,5,3,29,5,6,0,7,5,2,0,3,9,3,1,2,6,13,7,8,2,7,23,35,10,8,4,5,1,30,27,3,3,5,7,12,2,3,7,23,0,4,9,10,3,10,1,11,3,11,6,5,2,6,4,4,18,1,9,5,5,30,2,20,25,3,8,3,3,1,12,1,9,1,17,2,8,14,2,4,6,9,13,1,1,6,3,11,0,11,5,4,1,12,1,6,5,8,11,4,1,3,1,6,9,13,0,0,0,1,5,3,3,1,9,3,9,8,3,9,12,3,3,9,27,4,12,7,8,4,25,14,1,4,7,14,7,1,21,27,3,2,7,6,14,2,19,3,0,7,0,10,4,1,3,8,32,2,0,4,4,1,5,2,2,0,45,12,1,1,5,4,4,6,8,10,8,2,0,0,2,5,5,10,2,6,2,2,9,7,10,6,4,6,1,3,4,34,2,10,0,1,32,6,7,21,4,3,13,3,8,2,3,5,32,11,1,3,5,6,6,6,4,10,5,3,23,2,0,23,1,1,6,3,3,3,8,2,6,3,5,13,9,9,16,24,6,3,2,2,1,2,0,8,3,11,3,4,3,4,3,1,2,5,6,8,17,15,5,17,12,21,0,3,8,9,4,1,9,0,1,9,0,8,2,10,17,3,0,0,14,2,10,4,3,5,9,0,0,4,0,0,3,6,7,9,1,14,20,17,2,1,6,5,1,2,7,2,3,2,5,11,6,2,2,65,13,3,4,3,5,2,12,6,8,2,2,11,4,14,4,1,3,7,2,5,18,2,3,13,8,5,2,1,6,3,1,12,4,1,5,6,4,2,1,0,3,5,7,0,0,2,23,0,4,4,24,1,0,14,6,5,4,2,2,0,4,3,7,5,10,4,0,2,2,1,2,2,5,5,1,5,9,1,0,8,8,8,2,3,0,1,8,1,18,7,20,0,11,3,15,1,5,4,2,2,10,0,0,1,0,7,1,5,1,4,4,18,1,1,10,6,9,5,9,6,13,20,1,10,0,9,1,1,7,2,5,1,3,2,6,2,2,1,1,8,3,1,0,3,3,5,4,6,0,0,1,2,6,2,5,2,5,5,5,5,4,9,0,7,5,2,0,3,0,7,6,1,5,4,5,4,6,0,3,2,5,2,1,0,3,2,5,15,2,3,2,1,0,4,10,0,9,5,1,5,2,11,3,0,1,2,2,3,4,0,2,6,2,1,1,5,1,0,4,3,7,1,0,1,2,2,2,3,1,2,1,2,1,0,2,2,0,6,3,2,7,26,0,5,3,1,6,0,2,5,1,3,2,5,0,0,3,3,2,5,1,0,2,3,4,3,0,1,0,2,2,2,2,4,2,3,2,5,1,1,2,1,6,0,1,1,2,1,1,2,2,2,0,0,3,4,1,1,3,4,1,6,2,0,3,0,5,1,10,2,2,3,10,5,1,7,11,0,2,1,7,4,8,2,0,4,0,3,3,7,0,7,3,0,6,0,7,2,3,0,0,1,1,0,0,1,0,1,3,5
approval,7,38,14,102,1,0,1,16,1,3,5,11,4,12,3,3,5,6,1,1,3,18,2,10,9,4,6,5,2,10,2,76,47,3,18,2,12,5,1,0,3,1,4,1,16,6,26,5,124,4,11,1,2,5,2,2,23,20,0,9,5,3,0,5,11,2,43,4,3,4,3,4,0,3,18,6,7,0,26,7,13,1,6,3,83,3,3,0,25,2,3,4,0,5,10,1,8,1,8,5,10,18,7,2,4,18,2,0,4,0,8,5,2,6,0,11,1,1,46,45,8,1,8,17,0,0,2,2,1,1,0,0,2,18,2,23,2,3,4,0,0,12,8,2,0,29,0,6,1,5,26,0,14,2,1,12,5,3,3,1,3,4,0,1,1,1,1,12,6,6,7,38,5,0,0,3,70,0,2,14,4,7,2,2,1,3,10,9,14,43,0,2,1,0,0,1,25,0,9,1,8,2,0,11,7,2,1,14,2,7,29,2,28,1,0,0,1,0,12,10,0,10,1,4,24,49,4,10,1,3,4,4,5,8,7,4,10,5,4,1,25,17,0,2,4,2,3,6,32,3,13,3,11,2,1,9,6,0,2,6,3,6,35,6,2,18,2,1,3,0,64,1,7,3,4,0,4,6,7,5,15,1,2,5,4,0,0,3,5,1,4,8,46,2,4,5,30,9,2,6,5,20,0,7,5,0,10,2,1,0,0,4,18,0,5,5,1,12,3,1,11,2,14,2,23,2,1,9,3,12,9,7,4,2,2,6,2,3,3,5,6,4,5,4,0,4,21,21,7,1,2,4,2,9,8,5,9,0,7,4,13,6,6,9,3,0,11,3,3,2,4,10,2,0,5,8,8,3,2,0,64,2,13,1,1,4,2,4,6,7,6,0,34,47,8,4,38,4,29,3,10,1,2,1,1,4,2,0,11,8,1,3,0,1,2,3,5,3,1,1,1,3,12,6,0,0,0,2,5,6,10,2,3,7,1,1,1,7,2,2,5,2,6,0,0,1,2,2,11,3,4,0,1,2,21,12,0,9,1,10,5,4,7,3,3,3,4,3,3,0,3,1,3,0,1,1,1,29,5,2,0,4,3,3,0,4,6,1,2,3,12,28,0,0,2,2,2,8,2,2,5,1,1,0,7,5,2,6,1,3,1,3,6,2,10,6,2,0,2,1,2,4,2,15,2,6,7,7,6,11,4,1,3,4,7,3,4,3,24,8,0,4,1,2,2,10,3,9,8,7,58,2,4,20,5,13,14,1,3,6,21,4,15,4,3,10,4,1,21,24,3,4,13,3,4,5,0,2,3,6,2,7,3,10,4,2,4,1,0,5,13,16,15,5,3,0,0,0,33,5,14,3,3,8,5,4,2,20,11,1,8,26,5,1,17,6,6,1,4,2,7,2,4,10,1,5,2,6,5,11,6,8,8,7,5,1,2,1,2,1,2,0,1,9,9,18,1,3,5,42,10,2,3,5,4,8,19,4,0,9,3,2,22,10,6,5,14,12,2,9,4,0,9,7,21,1,6,6,2,6,5,9,3,7,6,5,9,2,2,6,14,3,9,11,4,5,1,5,6,11,2,8,4,4,5,8,9,3,0,3,5,9,1,19,2,8,2,1,2,5,10,6,2,17,1,1,3,0,3,4,3,6,1,0,1,0,11,2,11,2,1,0,7,6,4,2,9,9,2,5,1,1,0,3,2,8,2,12,3,6,1,5,5,1,5,4,6,1,2,9,2,4,0,1,5,7,1,3,5,3,2,5,3,6,11,2,4,3,2,3,2,10,3,3,7,9,1,5,1,5,5,0,4,13,0,2,2,1,6,4,0,4,1,3,2,2,1,6,3,10,2,2,9,13,9,0,3,24,3,1,3,4,5,3,4,4,4,9,0,4,1,7,1,6,1,1,1,14,7,2,5,18,5,0,6,2,2,1,1,0,6,2,2,3,6,2,0,1,0,7,2,2,3,4,1,0,4,3,10,2,6,4,4,1,7,3,1,4,3,7,3,7,0,3,1,5,0,18,1,0,1,6,5,2,21,6,1,5,2,7,6,1,0,2,3,7,2,5,1,1,3,4,4,9,0,1,1,2,2,5,2,4,5,2,1,1,3,1,1,6,0,1,0,0,0,2,0,5,11,2,1,4,0,2,2,2,3,3,17,3,0,5,4,1,2,4,5,2,7,3,1,4,0,1,3,5,2,4,3,1,3,2,1,3,1,5,2,0,0,0,0,1,2,0,0,4,0,1,3,0
conflict,9,14,5,93,6,8,1,35,2,0,9,11,10,65,4,13,7,14,8,7,3,29,17,29,15,4,13,11,8,17,17,73,70,12,36,52,85,4,14,5,4,10,5,3,13,21,15,14,260,31,44,13,8,57,1,8,34,19,9,15,25,19,5,10,15,11,61,2,17,10,4,4,2,2,70,9,7,6,59,18,20,0,7,7,162,4,5,0,21,1,5,4,6,37,60,4,26,2,20,6,4,21,22,8,7,20,3,1,16,4,14,4,4,18,2,29,3,3,73,151,31,17,2,40,7,4,6,3,0,1,9,3,4,30,27,36,6,0,8,9,3,23,23,3,5,52,8,8,8,3,47,1,7,10,1,15,27,4,11,15,3,5,4,4,1,4,1,10,8,5,9,67,11,3,7,10,138,5,9,19,14,9,4,10,1,8,15,19,50,34,1,6,4,4,3,2,11,3,10,8,7,2,1,9,28,15,1,14,10,28,45,10,16,4,9,3,0,1,12,3,1,17,3,18,37,71,10,19,4,3,5,11,10,26,17,9,32,4,4,11,66,27,4,12,19,8,6,22,15,7,6,5,18,3,11,13,11,2,3,9,2,33,12,5,2,16,5,13,14,3,119,1,12,4,4,4,17,3,14,1,45,13,0,9,6,8,2,2,9,4,8,6,10,3,2,10,21,0,7,24,25,13,0,3,23,1,27,3,3,1,4,14,20,10,9,11,4,34,4,9,30,3,35,1,101,19,11,30,3,28,6,5,8,5,3,8,30,5,1,7,22,13,21,16,3,4,35,34,18,6,8,4,1,15,24,0,7,2,6,18,9,5,8,6,3,3,39,5,4,16,3,21,6,10,7,9,5,1,18,4,51,5,38,17,3,34,3,12,16,5,27,3,11,3,36,14,48,5,20,4,14,9,2,6,3,0,0,5,9,13,4,8,0,12,31,10,6,12,5,10,2,9,13,8,1,5,7,5,10,20,10,6,0,10,2,2,8,14,12,3,8,18,4,8,3,7,17,12,24,1,20,6,8,4,27,18,4,13,4,15,15,14,16,7,2,2,12,10,11,1,14,6,2,2,7,7,0,10,19,6,6,10,3,13,7,6,8,6,3,2,111,27,1,8,7,8,3,11,7,11,10,1,2,7,7,13,0,5,2,1,4,4,3,7,22,36,2,8,1,9,1,13,6,34,9,5,23,8,16,20,10,9,7,4,8,9,5,6,19,11,5,4,4,2,3,4,21,6,22,8,33,6,5,39,8,5,17,3,0,5,18,3,12,4,10,18,8,10,20,19,7,6,7,2,4,4,7,4,9,14,3,9,9,18,11,0,9,5,3,13,18,42,4,4,11,8,2,11,23,16,23,4,4,0,13,26,5,20,1,2,17,10,5,5,26,7,11,1,8,0,10,2,1,11,2,5,11,9,7,21,5,14,13,22,4,3,11,7,3,3,1,1,9,22,6,10,2,2,7,143,28,4,6,3,4,13,37,23,2,8,9,5,11,12,3,1,1,5,9,5,16,6,14,27,16,13,2,2,5,11,2,22,11,3,8,2,12,4,5,11,7,12,12,20,5,3,6,0,7,6,1,9,4,5,4,6,9,9,8,3,2,12,6,41,14,8,11,12,7,2,4,2,2,11,3,7,6,1,4,8,13,7,2,6,4,2,20,5,34,5,9,8,2,6,11,5,8,0,1,2,14,2,0,8,0,4,6,1,4,4,3,10,4,3,7,13,3,6,4,16,9,7,1,17,6,18,4,1,7,4,1,5,13,4,6,9,8,4,9,3,6,6,2,5,1,6,3,5,1,4,8,0,18,1,7,1,9,5,5,4,2,4,6,4,2,6,3,8,1,10,2,1,14,4,4,4,4,2,7,2,1,2,7,9,7,7,13,21,23,3,5,13,4,5,1,8,10,6,6,7,59,30,2,4,1,2,6,4,4,1,5,7,3,5,6,12,4,0,1,7,4,3,0,5,4,7,2,2,7,2,0,1,6,1,3,2,5,2,1,3,4,10,0,3,10,16,4,4,5,17,4,3,3,12,5,9,9,5,4,27,9,3,4,2,6,3,3,3,3,2,3,7,6,6,2,10,7,9,10,3,5,1,5,4,1,4,4,6,6,3,4,7,1,0,5,2,7,9,12,1,0,4,1,7,3,2,10,10,9,2,3,5,5,1,1,30,1,0,2,11,5,4,17,4,2,2,4,5,7,7,3,2,5,4,8,4,9,3,45,6,2,3,5,3,0,0,0,3,0,5
recommendation,7,37,7,404,13,7,5,20,9,5,13,8,11,39,2,8,4,21,4,6,3,35,4,12,31,25,6,14,9,8,15,313,125,15,49,12,27,10,16,5,7,5,2,21,45,9,28,38,227,13,37,4,12,18,13,3,59,140,4,15,23,3,2,19,39,5,59,3,10,18,9,10,7,1,77,16,13,7,82,11,100,2,14,6,222,21,17,5,79,5,6,4,4,34,51,26,25,16,27,16,33,32,39,7,10,64,26,7,12,5,16,18,22,19,1,36,20,3,94,175,22,20,29,90,14,4,3,1,6,6,16,2,2,81,2,51,3,6,8,4,1,30,23,8,1,79,5,18,17,16,40,3,17,8,8,66,14,2,1,10,32,3,5,7,12,4,7,23,17,4,23,106,19,1,1,8,220,7,4,67,27,10,23,23,7,17,37,22,27,40,2,3,5,0,1,6,43,12,21,16,33,12,2,19,16,19,2,64,18,25,108,8,21,8,3,4,6,28,31,3,10,12,7,21,57,150,35,29,1,15,14,25,36,29,23,31,23,17,11,7,72,22,6,2,13,8,8,29,85,6,35,12,33,11,17,13,18,8,5,33,10,26,61,10,6,114,14,3,6,6,131,12,34,10,8,2,19,28,27,14,35,12,2,19,12,4,26,18,9,4,5,2,19,8,11,11,70,45,3,20,9,100,3,6,15,5,8,11,13,2,2,15,60,13,42,28,30,54,10,14,27,8,9,2,32,9,14,17,3,13,3,14,6,6,2,21,16,7,5,6,7,9,19,5,17,9,55,51,22,7,16,14,5,45,16,10,5,8,20,26,55,17,15,22,4,0,23,5,19,5,10,18,13,7,4,70,13,10,9,6,86,1,44,15,2,65,11,21,16,5,26,8,19,16,51,14,92,16,47,9,26,1,0,1,4,7,4,0,16,19,1,12,5,44,9,9,3,14,6,2,2,9,36,1,1,4,8,12,7,18,28,15,2,26,11,3,0,12,12,5,24,27,6,3,2,2,11,6,34,7,15,2,5,6,39,9,0,5,5,37,20,11,27,22,9,11,19,11,3,1,15,3,9,1,4,11,0,20,21,5,6,14,0,1,5,3,21,2,3,7,69,68,0,0,9,13,1,15,3,9,8,9,7,4,9,15,10,35,15,6,4,7,6,9,27,31,2,13,2,5,1,16,6,14,1,4,20,16,22,31,9,6,2,7,20,6,14,12,19,38,5,6,2,5,10,12,0,21,16,16,11,4,17,41,16,10,25,4,7,30,42,16,32,9,26,28,14,11,48,46,9,19,49,11,9,7,15,5,2,28,10,21,11,9,6,6,6,13,2,16,19,38,10,15,20,1,4,7,43,23,57,2,8,5,8,36,5,39,25,4,20,98,35,2,28,4,24,4,19,7,24,5,5,31,9,14,12,26,14,39,22,92,17,21,8,5,17,7,8,13,14,0,9,30,6,138,8,16,21,126,22,4,11,18,7,9,25,5,2,8,22,8,3,15,11,5,2,7,7,9,22,11,14,57,28,4,26,18,3,9,7,44,5,24,41,5,7,11,7,36,17,9,17,30,10,28,6,3,10,21,16,8,50,7,14,7,24,3,14,21,5,11,1,53,28,55,9,8,9,22,5,8,3,55,6,10,8,3,11,19,14,33,5,9,13,16,62,4,32,12,20,5,9,18,12,10,17,14,7,8,6,11,10,15,10,28,14,33,12,24,27,14,1,13,25,12,16,10,17,26,4,8,5,25,5,22,4,9,44,5,7,8,6,4,5,11,8,4,10,16,86,23,14,12,25,16,13,52,3,18,13,7,9,5,2,3,13,3,29,11,11,3,9,11,7,6,13,9,2,15,3,5,24,28,15,2,6,24,7,6,11,7,15,1,6,7,5,20,3,13,2,6,9,7,11,17,5,8,24,11,5,29,13,7,23,12,6,17,6,3,10,4,9,3,4,17,3,7,7,1,19,2,6,15,6,4,3,6,19,4,8,9,11,2,36,8,11,14,4,10,3,16,2,5,7,11,5,11,6,2,13,3,9,11,4,6,2,13,17,39,9,1,7,12,7,7,10,4,2,12,3,4,5,8,3,8,1,10,3,10,12,11,3,8,8,5,11,1,12,27,7,6,10,5,9,22,6,19,52,4,22,6,1,11,19,5,16,14,43,3,4,12,5,20,4,29,29,5,3,5,1,6,2,7,2,4,11,6,12,4,33,6,6,12,47,4,4,10,19,1,5,5,13,1,1,2,4,2,3,0
bureau,3,7,10,94,2,3,2,7,0,2,8,9,4,33,5,1,2,6,0,0,1,6,0,9,27,9,0,8,0,10,3,102,52,5,38,4,3,6,3,4,2,2,1,7,11,1,9,13,126,4,17,0,4,7,20,1,24,50,0,8,10,0,1,5,14,1,13,3,1,5,8,4,1,4,31,3,5,2,29,6,33,0,0,0,111,2,25,1,16,3,1,1,1,7,30,4,8,4,13,16,11,18,13,4,3,16,8,5,2,1,9,2,12,16,0,6,0,1,25,44,19,19,9,53,12,0,6,1,3,0,5,2,2,33,8,72,2,6,2,3,0,24,11,3,1,27,4,8,11,18,17,1,3,6,1,51,10,2,1,0,18,2,6,1,3,2,1,7,18,0,3,43,11,0,1,3,67,2,2,30,29,2,5,7,3,12,22,5,25,19,0,2,4,1,1,4,11,1,5,6,32,0,1,3,9,7,10,10,10,11,43,0,7,2,1,0,2,13,40,10,0,12,5,4,21,62,32,23,1,10,8,10,18,17,19,6,8,3,4,4,28,15,1,2,2,10,6,11,44,1,7,7,4,2,6,3,2,3,0,19,9,5,6,1,1,155,41,1,2,3,35,13,18,1,2,1,6,18,5,2,20,4,3,11,3,4,20,8,3,1,4,0,3,5,1,2,9,1,0,3,4,30,1,2,11,0,12,22,2,0,0,22,18,4,6,17,6,28,7,12,10,3,6,0,2,9,12,9,1,8,1,8,0,17,1,11,6,2,0,3,1,0,4,5,4,0,23,14,26,6,6,10,8,18,3,7,1,0,11,19,12,8,7,4,1,0,10,0,4,4,4,11,0,4,3,43,4,1,2,4,30,0,22,7,5,32,3,4,7,1,6,4,3,2,8,7,37,3,13,5,17,2,4,0,2,1,0,3,11,11,0,1,2,21,0,3,0,3,0,0,1,4,5,0,2,0,5,8,0,9,1,1,0,3,1,0,0,1,2,0,9,9,9,2,2,0,4,1,39,0,0,3,1,0,13,10,0,6,13,11,5,3,20,13,7,0,4,4,13,5,3,0,3,1,1,4,0,5,6,2,4,6,2,2,3,2,14,0,3,2,35,26,0,2,4,5,2,10,0,3,1,6,3,9,6,2,5,8,5,2,4,4,5,12,6,5,3,6,5,3,1,1,7,25,2,2,10,28,6,10,2,0,3,10,12,2,3,4,17,19,0,18,8,0,0,3,0,9,3,1,3,1,8,21,16,5,29,0,1,3,8,2,13,2,7,8,7,9,25,36,3,2,23,11,12,0,6,3,1,10,3,2,5,4,8,4,3,3,0,3,1,12,12,8,68,12,2,6,1,2,5,8,2,0,3,8,13,14,18,10,16,30,8,2,17,2,9,1,1,1,5,0,4,6,2,4,1,4,3,22,0,15,15,5,7,2,10,4,8,4,9,1,1,21,2,35,7,3,6,61,0,3,1,0,2,6,19,7,0,8,0,2,3,0,0,1,2,6,1,1,19,6,8,14,24,0,5,2,1,1,0,17,1,3,4,7,7,3,1,7,8,17,2,5,5,16,2,0,3,5,4,3,2,6,10,1,7,1,5,1,2,11,1,5,8,22,3,0,0,22,0,3,0,11,0,7,4,0,19,7,4,13,1,4,3,2,26,2,10,8,9,1,2,3,2,5,4,10,4,8,6,4,13,9,5,10,6,23,4,8,7,11,0,7,15,13,5,5,40,5,3,4,0,2,7,13,3,7,10,2,1,0,6,8,3,3,2,2,3,20,2,8,7,5,4,15,1,9,2,5,4,0,0,1,6,0,4,4,13,0,2,0,4,2,4,4,3,2,0,9,1,1,12,23,27,4,1,4,2,0,11,0,8,1,2,2,0,4,1,18,0,4,1,3,0,5,4,3,1,6,0,6,3,3,10,14,12,2,5,3,3,4,3,6,0,2,7,2,4,19,1,4,3,1,2,3,0,0,2,2,0,2,15,1,17,2,1,5,1,0,3,9,7,0,0,2,3,0,4,1,1,2,2,6,0,3,0,1,2,12,8,2,3,2,6,0,0,3,4,5,0,3,1,3,1,3,0,0,1,0,7,3,0,1,1,5,4,1,2,19,1,1,24,1,5,13,2,42,17,3,8,0,0,2,8,2,0,0,18,0,2,3,4,6,1,0,23,57,0,1,1,3,1,2,3,0,20,5,6,4,0,5,6,0,2,1,1,4,0,1,2,5,8,0,2,1,2,1,0,0
section,0,19,4,77,3,0,5,60,2,1,14,0,6,17,6,4,0,6,3,15,3,17,1,18,11,0,2,14,7,12,8,92,94,8,28,14,15,7,4,1,7,3,1,4,24,7,19,6,186,1,14,2,7,13,3,0,16,9,1,9,8,1,4,4,6,12,70,3,7,30,1,2,4,2,44,14,26,1,28,11,23,0,8,2,66,6,7,0,9,0,4,2,0,17,43,12,8,5,21,7,15,14,11,4,3,14,3,0,13,0,8,1,2,10,0,8,2,4,73,70,20,3,5,17,3,0,3,4,1,2,2,1,0,30,7,37,8,2,2,2,0,9,9,2,2,28,4,7,8,11,20,0,8,3,3,10,20,1,0,2,9,2,2,20,0,0,3,6,7,10,2,71,4,0,12,3,94,1,8,18,7,3,6,9,5,10,14,6,14,27,0,4,9,0,3,2,11,2,6,2,7,0,2,13,10,4,5,20,8,11,35,7,20,3,0,0,1,0,9,3,3,24,2,9,20,100,9,6,4,1,7,6,11,2,9,21,11,7,6,7,37,13,0,4,7,4,0,2,31,1,2,8,8,1,4,7,2,9,0,6,2,7,13,1,7,23,5,2,7,4,59,7,12,2,2,0,11,6,5,3,35,2,0,7,5,5,1,1,5,1,5,1,5,1,14,1,12,2,4,7,6,16,0,9,5,0,4,1,0,5,0,4,11,6,9,13,13,20,5,2,10,1,20,7,20,6,4,8,0,13,2,0,1,0,6,18,6,1,4,1,1,2,4,5,3,7,21,41,13,0,11,6,5,7,19,2,5,4,6,8,21,8,7,5,2,0,9,4,2,5,2,14,2,12,5,13,2,2,15,5,33,3,22,5,1,34,16,6,9,3,9,4,8,3,23,5,19,2,9,3,17,0,2,0,9,3,0,2,13,8,1,7,6,6,2,1,3,14,0,0,7,5,12,8,1,2,3,9,5,14,3,3,3,19,0,5,0,20,2,6,8,9,4,2,0,13,7,1,10,1,2,2,0,2,15,3,3,6,1,27,7,18,17,13,3,0,14,4,2,0,2,0,1,3,2,8,1,13,17,5,3,3,2,5,4,1,7,4,4,6,38,15,1,0,11,3,4,3,7,6,9,0,0,1,8,15,3,6,1,6,4,10,1,4,6,5,0,7,4,3,0,5,3,7,2,2,6,4,14,21,4,2,0,10,5,1,4,0,14,10,1,0,0,2,4,5,0,6,3,6,41,2,19,26,3,4,19,2,2,5,9,3,35,0,14,5,10,9,16,20,16,9,5,0,1,3,42,1,3,10,11,10,11,11,8,1,6,5,3,3,16,10,1,0,15,4,0,2,28,11,14,1,1,3,7,7,9,7,7,3,19,16,6,4,20,8,6,7,1,2,7,0,3,8,1,5,2,4,10,13,2,14,10,11,3,0,13,2,0,4,5,6,1,7,4,17,2,4,7,74,8,1,0,3,2,8,18,5,3,10,3,7,5,1,5,2,0,2,2,4,6,5,3,25,10,2,2,10,0,2,3,5,4,5,3,0,2,6,1,1,24,3,4,3,3,7,5,4,9,5,1,4,5,15,12,4,12,3,8,3,3,5,9,13,7,5,0,3,6,4,1,1,2,11,1,17,5,2,4,5,1,8,2,2,2,0,7,2,13,8,4,8,2,3,0,2,7,6,1,7,11,4,0,11,6,6,1,1,4,8,6,7,4,2,20,6,2,7,13,3,3,2,1,6,1,3,3,1,9,10,5,4,4,2,4,2,2,18,13,12,2,5,1,6,5,23,9,5,0,4,4,2,6,2,4,0,5,4,13,0,1,1,1,5,5,2,5,1,6,2,3,0,2,10,6,7,0,11,6,2,0,5,2,0,5,7,4,9,3,3,2,3,4,0,0,3,5,3,9,7,7,10,17,0,0,3,4,3,2,3,2,5,1,4,1,3,1,2,3,2,4,1,4,4,0,7,1,3,2,1,0,2,3,3,4,7,4,0,2,8,0,10,0,4,0,5,0,6,3,13,7,4,0,3,8,1,1,1,1,7,2,3,2,1,8,4,0,2,7,2,5,1,1,5,3,3,1,0,9,1,8,0,8,3,4,4,6,2,1,6,7,7,3,0,10,4,2,5,12,2,2,0,1,3,4,3,4,0,9,4,11,1,0,2,6,4,3,0,3,3,3,2,2,3,0,19,0,0,2,1,0,4,1,0,7,2,5,3,7,0,3,2,1,1,3,1,0,4,1,0
bond,0,6,4,77,0,4,0,25,2,1,4,4,5,30,1,3,3,24,1,1,3,21,5,30,10,8,4,10,3,44,2,146,62,1,29,46,8,55,11,1,27,3,0,2,33,6,25,8,203,6,34,1,15,17,3,0,41,15,0,9,4,7,0,2,16,10,70,6,6,9,15,0,2,0,31,6,19,9,122,6,89,2,6,3,328,102,28,0,29,38,29,2,4,22,215,67,10,7,39,9,19,34,41,8,14,39,26,4,15,4,12,4,6,16,0,32,10,20,55,178,33,5,30,92,4,5,4,11,16,2,9,1,0,50,10,41,0,1,13,1,1,12,46,4,1,38,2,11,19,28,37,4,34,1,1,13,23,1,1,3,22,0,15,16,11,14,0,12,22,8,7,56,8,0,11,5,178,2,9,35,34,9,2,9,0,17,32,6,28,30,1,3,9,1,4,5,29,4,15,9,32,21,20,13,28,1,51,25,19,19,46,4,26,4,2,1,11,3,10,0,17,12,8,10,62,74,23,55,6,45,6,28,51,11,43,49,26,2,9,1,41,15,8,2,8,15,7,17,42,7,4,12,6,17,11,17,4,23,14,12,0,9,12,21,11,27,1,1,10,3,115,65,190,6,0,2,17,39,2,1,36,4,1,2,3,0,0,1,6,1,1,2,17,12,48,13,63,2,5,7,22,28,11,59,16,0,13,2,0,0,1,21,35,12,211,30,16,43,22,1,29,3,10,0,12,1,6,11,2,35,3,10,4,3,2,4,14,8,16,24,6,3,7,12,21,1,50,42,19,6,32,7,6,54,26,5,0,0,22,30,10,3,8,28,2,1,29,5,1,8,2,14,0,4,7,12,4,1,3,2,54,0,42,4,0,20,0,18,18,0,3,1,16,4,20,2,38,6,12,0,12,3,5,0,16,3,11,0,20,9,0,4,2,7,3,8,2,3,9,1,1,1,3,8,0,1,2,8,7,13,78,16,0,25,4,0,1,7,0,10,5,5,8,12,0,0,11,3,26,19,61,2,1,23,30,6,2,0,9,21,10,12,16,3,2,0,7,9,2,1,7,0,6,1,2,6,7,6,23,1,3,4,2,6,4,0,16,1,3,0,37,32,1,2,8,2,1,40,5,2,12,2,6,5,17,72,4,18,13,3,6,4,2,5,4,8,3,6,10,7,0,3,10,11,12,2,11,9,15,16,6,3,0,2,6,13,4,3,42,6,2,0,4,6,32,4,1,9,14,5,10,1,7,48,2,3,19,4,5,5,34,5,18,6,16,13,7,2,44,47,12,6,10,1,5,7,4,4,12,31,5,7,9,2,7,1,2,5,10,14,4,26,12,4,9,3,8,0,15,12,7,4,5,4,2,36,7,12,10,13,17,9,1,8,5,12,7,0,10,4,15,77,2,216,9,6,3,24,0,8,156,10,25,11,0,9,2,17,2,7,11,0,2,3,5,81,2,2,4,151,4,3,3,0,2,6,55,6,3,19,5,5,4,8,6,4,1,1,13,6,5,7,5,3,8,3,2,2,18,2,30,8,12,5,11,4,26,2,0,8,7,5,16,24,11,10,5,2,9,10,1,4,5,5,2,9,26,2,4,1,0,22,1,16,9,5,1,1,9,0,3,1,2,7,1,0,12,0,0,6,4,19,63,6,5,2,5,6,13,6,9,0,0,2,6,5,11,3,14,7,10,27,12,32,29,14,7,4,1,257,235,7,41,39,15,54,1,4,6,8,2,0,2,3,2,17,29,2,0,2,0,2,8,29,32,4,6,4,38,15,4,2,0,1,13,23,14,1,5,2,9,0,5,1,6,1,4,0,13,2,5,7,3,13,2,5,9,13,21,24,0,4,3,1,0,4,5,18,13,12,16,4,13,4,3,4,4,20,5,3,0,6,0,0,8,22,10,13,5,0,12,44,2,9,0,2,5,36,12,5,12,8,2,2,5,1,0,3,0,6,3,4,1,65,4,1,2,2,2,0,1,19,1,1,1,9,6,7,2,16,2,4,0,0,4,9,0,0,14,1,6,1,0,2,0,2,4,27,4,23,4,14,7,46,3,5,3,1,1,4,3,6,5,4,1,4,1,1,0,61,6,4,3,7,2,14,2,13,0,6,1,58,19,40,54,71,40,20,207,0,1,2,0,19,0,21,3,3,53,12,1,0,0,2,26,6,3,3,0,1,1,0,2,5,2,2,0,13,3,1,2,1,4,20,3,20,2,3,0,0,0,0,2,0,0,4,1,10,1,1
currency,0,4,3,104,2,1,2,30,1,2,4,0,3,54,2,1,2,27,3,4,7,44,7,17,24,6,6,6,3,16,0,180,196,7,54,56,8,28,32,2,21,0,3,1,35,14,36,6,217,0,52,0,31,34,1,0,46,23,1,5,5,4,3,4,17,6,124,6,6,2,14,0,15,2,114,16,17,3,100,27,56,8,11,6,246,92,42,0,49,14,12,4,1,13,104,26,12,15,26,32,6,29,53,20,10,29,14,1,26,12,21,19,10,30,0,31,3,6,40,239,28,9,11,66,5,6,2,0,10,4,4,0,2,36,14,21,1,5,5,15,3,24,23,4,4,50,8,10,18,14,69,6,51,8,1,13,15,2,0,4,0,2,21,11,0,5,7,4,33,11,19,90,20,1,7,15,181,4,21,57,16,14,0,13,0,29,47,30,34,54,0,13,19,0,0,14,43,16,13,21,99,9,7,12,39,5,29,114,5,24,87,7,18,6,0,0,0,1,6,2,6,15,0,12,91,94,27,50,15,41,10,21,22,39,46,37,36,20,18,0,66,35,7,2,21,15,10,58,34,3,19,54,21,14,38,33,13,10,4,11,0,15,12,2,7,17,0,2,19,4,153,20,83,11,0,0,19,5,7,6,66,11,0,15,24,0,0,5,16,2,2,0,22,1,6,17,73,5,8,23,22,26,0,10,21,1,23,1,0,3,3,31,48,19,101,35,23,39,52,8,28,8,28,0,10,0,7,17,5,46,1,19,4,7,17,4,35,10,13,19,10,3,26,4,11,1,65,26,20,0,16,9,3,69,16,2,1,3,32,30,29,4,4,23,7,0,47,10,27,9,9,13,19,29,8,9,5,16,13,5,51,1,53,6,1,12,0,40,31,11,1,1,5,2,27,21,66,12,21,2,13,1,5,0,16,7,13,1,74,7,0,2,12,12,0,4,4,3,2,1,7,1,16,6,4,0,1,25,6,29,135,15,1,2,4,0,0,3,0,4,2,8,2,14,0,3,7,6,33,19,42,3,3,25,54,4,0,4,13,38,7,28,35,14,12,1,22,9,0,0,9,3,3,0,2,15,3,6,11,12,6,12,4,1,4,4,24,4,4,0,28,40,0,1,23,7,1,28,10,32,14,5,24,0,4,284,2,19,22,10,7,14,6,5,40,12,9,2,3,13,0,17,33,18,8,0,43,20,25,27,5,8,0,4,5,11,1,2,53,13,2,1,6,24,30,8,5,22,12,10,37,0,8,33,5,8,30,14,10,11,30,3,33,5,26,36,28,12,38,59,11,10,3,1,1,16,10,2,17,6,8,6,9,19,15,0,4,7,12,14,16,36,15,1,27,10,35,11,5,20,25,1,14,0,5,39,0,12,11,11,37,20,7,5,11,16,22,5,6,3,41,131,3,133,4,4,0,21,4,32,212,24,28,22,5,7,8,15,0,12,42,0,4,6,5,29,7,3,4,97,3,4,18,5,4,10,57,16,7,12,8,0,5,10,1,0,0,5,7,10,19,11,3,1,10,5,6,3,0,1,0,25,12,3,18,2,41,1,9,0,4,7,17,0,6,2,10,0,3,9,21,1,5,1,5,7,17,0,14,0,3,6,6,37,11,6,0,7,6,4,5,2,0,7,1,5,8,5,3,23,21,10,10,7,7,1,7,11,3,5,15,0,1,1,6,20,23,5,8,1,17,9,3,3,4,8,8,10,5,77,77,14,9,15,11,105,5,6,4,5,7,2,0,6,0,23,83,5,0,8,2,7,20,17,10,4,19,0,50,13,8,3,3,11,3,23,2,5,6,0,13,5,15,5,7,2,15,9,13,1,11,1,0,3,11,4,4,12,3,27,0,7,3,6,1,8,2,6,119,5,4,6,28,6,10,22,8,26,21,1,3,4,0,2,16,52,14,4,10,4,5,18,2,16,1,15,12,16,2,7,10,5,7,1,17,20,1,4,5,15,1,4,65,1,13,10,1,0,5,1,0,21,3,0,1,8,8,0,1,9,2,1,0,1,5,0,0,4,8,0,9,3,0,2,0,2,1,66,2,13,5,47,5,2,11,0,12,1,8,3,14,2,9,4,1,2,0,0,0,52,6,0,4,7,4,13,7,8,0,8,6,33,7,7,9,91,56,6,127,4,0,2,0,10,0,9,1,2,31,4,1,0,0,0,7,6,1,0,0,4,0,8,4,5,0,1,0,17,20,1,1,6,4,145,7,19,20,19,0,0,0,2,6,0,0,6,1,18,0,0
failure,3,16,2,80,4,4,3,16,0,2,10,3,6,42,1,5,4,5,4,4,3,15,15,12,15,7,8,8,5,15,4,91,62,6,15,54,33,1,12,3,4,15,1,0,21,20,11,5,103,7,21,5,6,23,8,6,22,15,4,10,9,3,0,5,9,5,62,2,8,6,10,3,1,5,54,9,7,5,35,10,23,6,10,9,103,11,7,1,13,0,1,2,0,11,24,4,13,4,21,7,4,9,16,3,8,28,4,1,5,7,10,4,2,6,1,11,3,1,34,91,10,8,7,29,4,6,0,1,1,3,12,8,4,19,9,22,9,3,4,9,7,18,13,2,1,38,8,8,9,7,17,1,13,4,5,11,19,10,3,5,12,0,5,0,0,2,5,13,21,7,10,49,14,1,1,12,72,2,7,20,8,6,6,17,1,17,21,13,22,30,2,5,3,3,0,3,3,1,5,8,18,3,3,8,12,17,2,13,1,9,39,3,17,5,2,2,0,3,8,2,0,6,1,6,18,60,14,15,2,2,7,8,7,10,18,12,28,6,3,1,35,17,14,9,10,6,2,13,32,5,10,14,9,3,2,3,14,1,3,10,2,16,10,1,8,21,4,6,5,2,44,8,18,1,4,3,4,7,6,0,28,6,1,10,10,5,1,1,11,3,3,3,13,2,5,3,17,1,4,10,14,16,0,1,8,5,14,1,6,2,0,5,24,1,13,6,6,26,8,2,17,1,16,4,36,3,11,22,3,18,3,5,3,0,5,6,12,5,1,4,4,5,5,7,1,0,17,38,15,3,4,5,1,14,11,4,5,1,6,27,6,8,5,9,4,1,17,7,17,5,4,16,5,4,10,14,8,5,6,4,21,1,19,5,5,13,6,15,13,2,21,2,8,8,15,8,24,1,21,2,11,2,2,1,4,13,11,1,13,8,0,6,0,9,6,6,2,4,2,1,0,1,17,4,0,3,1,4,9,14,7,6,2,4,3,1,0,6,2,4,4,7,4,14,0,5,9,2,16,6,16,5,1,4,36,0,0,3,5,17,9,5,14,18,3,0,10,9,1,1,12,2,1,3,1,11,0,15,8,5,3,6,1,4,20,2,11,2,3,2,38,17,0,2,7,0,1,11,8,10,9,3,5,0,3,52,14,4,2,4,8,6,3,6,9,5,8,8,5,9,3,5,2,7,5,2,11,13,18,12,3,2,2,10,6,2,6,4,18,8,0,1,2,19,6,11,9,6,7,8,23,3,1,17,3,4,4,5,5,2,12,4,11,3,11,10,9,4,11,23,4,4,9,6,3,6,2,5,1,8,1,8,9,7,2,6,1,4,1,9,6,13,1,0,19,2,2,2,30,7,9,2,6,5,1,12,4,15,6,4,21,6,13,2,14,1,5,3,9,4,3,6,3,8,2,0,4,2,6,10,1,11,19,10,2,0,5,2,3,7,3,1,7,6,4,10,8,5,10,49,14,9,4,5,5,7,9,7,11,4,3,5,6,10,6,6,1,11,10,12,8,5,15,7,24,9,1,3,2,3,5,16,2,4,1,3,12,4,4,1,2,4,4,8,4,3,5,2,1,9,1,0,1,6,5,7,6,2,2,2,4,2,6,16,8,15,4,9,7,3,10,5,4,14,0,3,5,6,4,5,1,14,0,7,0,2,10,1,12,6,6,2,3,8,4,3,8,1,6,2,5,7,6,10,5,5,2,3,4,16,12,3,0,7,11,13,2,1,10,6,3,5,3,7,2,10,21,2,4,6,0,3,5,4,9,6,7,1,1,11,1,7,3,1,3,13,4,1,1,1,4,3,10,3,6,2,5,3,16,3,3,0,3,6,2,4,7,2,7,5,4,1,4,4,0,3,6,4,4,1,5,3,11,3,1,0,8,44,2,1,3,6,2,0,17,9,6,5,2,2,5,6,5,1,0,0,7,1,4,0,7,5,2,0,8,2,2,1,4,6,2,0,4,13,1,2,2,9,10,12,2,4,3,2,5,3,8,2,1,6,4,5,2,3,8,2,3,3,1,6,2,2,1,4,10,3,7,7,3,4,4,14,1,6,9,1,1,1,1,6,5,2,1,6,0,2,1,4,3,9,3,0,2,4,1,1,0,2,3,2,1,4,4,2,3,8,8,8,18,2,0,4,4,3,6,1,0,3,8,2,4,2,2,4,7,4,3,6,1,5,3,6,11,3,1,1,1,5,2,5,3,3,3,1,2,4,9,3,9,1,2,4,3,3,1,0,2,1,2,3
prevail,1,9,10,54,6,5,4,32,2,4,12,3,7,37,0,7,5,12,4,5,6,27,5,12,17,4,4,4,2,6,6,72,75,5,18,40,53,8,12,5,5,10,5,0,22,5,4,4,160,20,24,2,18,33,1,3,36,10,0,10,8,3,5,7,10,4,74,10,7,4,9,5,0,4,43,6,7,3,63,8,28,1,6,7,105,8,7,1,20,0,5,6,1,15,32,13,3,3,28,7,5,17,21,4,8,18,4,1,8,2,7,7,6,5,2,19,7,3,34,76,15,9,7,38,4,13,1,1,4,0,12,1,16,13,13,12,4,1,2,6,1,19,21,2,0,32,9,7,10,5,30,1,13,6,2,10,15,1,10,4,7,0,2,1,0,2,3,13,16,6,4,48,7,1,1,9,91,4,5,12,10,14,2,10,5,8,26,9,19,21,0,7,6,2,1,2,7,3,9,12,20,1,1,8,16,5,4,31,8,17,34,3,6,3,1,0,1,3,7,3,2,6,4,4,13,46,9,20,3,7,5,5,11,22,12,10,28,2,7,3,51,25,4,1,7,1,8,15,18,3,5,14,11,6,10,6,10,0,5,9,3,17,5,3,7,11,3,3,5,3,69,8,25,2,2,2,13,5,8,3,32,4,1,12,12,5,6,7,8,3,4,1,5,2,4,7,9,2,2,19,29,9,0,1,8,0,15,1,3,1,0,1,15,3,9,11,15,24,9,2,34,0,9,1,38,4,2,16,5,17,5,3,8,1,7,6,7,4,2,7,6,1,8,9,3,2,29,37,15,4,10,8,2,7,8,1,4,0,10,18,11,0,3,6,4,1,32,8,2,6,2,8,3,6,5,6,5,2,20,5,39,2,19,7,2,22,3,14,20,4,14,1,8,7,28,11,27,2,23,3,20,0,0,0,4,8,6,3,15,7,2,6,2,6,6,5,2,5,1,3,2,2,5,11,3,1,2,8,6,8,12,7,2,2,1,4,0,3,4,0,12,8,3,13,2,3,4,2,26,4,13,3,4,6,32,12,1,4,5,19,4,27,35,10,5,1,16,4,3,0,3,2,1,3,4,5,6,12,9,3,5,14,3,3,4,3,5,5,1,2,54,23,4,4,5,1,1,7,8,3,13,6,4,0,5,36,3,11,3,0,5,2,4,6,10,10,1,8,4,7,3,7,6,21,2,5,13,3,11,11,3,3,1,3,4,8,3,6,15,15,1,2,1,3,8,6,6,6,8,4,35,5,4,32,5,6,14,3,2,1,7,1,8,2,7,5,12,4,21,11,14,9,9,4,7,4,8,5,6,5,5,7,2,13,6,3,5,8,5,9,14,17,1,2,13,7,3,7,13,15,13,0,6,0,1,17,4,10,2,3,15,8,3,13,4,6,7,1,0,0,5,21,1,8,1,2,0,6,8,20,12,10,7,15,4,2,4,5,2,4,4,4,1,7,9,4,6,0,1,73,11,5,10,6,3,6,28,6,3,8,8,2,10,11,3,4,2,6,9,6,9,7,14,8,19,4,0,3,0,2,0,4,5,2,5,5,4,3,3,1,8,7,8,7,3,3,7,0,5,11,0,2,3,3,9,2,8,2,3,0,4,3,6,11,7,10,3,5,2,3,3,2,4,9,3,2,6,5,2,16,6,7,5,2,4,1,7,3,14,12,5,2,0,3,4,1,9,5,4,3,6,5,0,3,2,6,5,3,1,1,1,3,0,1,9,11,5,7,3,3,5,5,4,6,2,7,9,2,7,19,2,0,9,5,3,7,5,0,9,3,4,7,2,10,4,17,1,3,4,4,4,5,7,3,5,0,5,4,9,5,7,3,3,6,2,0,2,5,2,2,3,6,3,3,2,3,2,2,11,3,2,4,8,1,3,9,9,22,3,1,4,8,7,4,2,2,4,0,0,5,18,16,3,5,0,2,1,3,7,1,4,5,4,3,4,10,2,0,7,4,3,7,1,10,2,1,2,5,8,0,2,8,5,3,5,2,1,5,3,1,1,1,0,5,3,3,2,1,5,3,3,3,1,6,15,0,5,6,7,8,1,4,8,2,3,1,1,1,2,2,4,6,6,8,1,2,2,9,4,10,5,3,9,6,1,1,1,2,2,14,1,8,6,1,4,12,5,8,13,0,0,5,2,5,2,5,4,4,6,1,4,0,7,0,0,8,1,3,6,5,6,3,4,4,3,1,2,5,2,7,1,6,1,8,1,4,6,4,19,0,1,3,7,0,0,1,4,3,2,12
majesty,11,6,4,33,15,0,8,2,2,0,13,19,3,29,1,1,3,3,3,0,1,15,1,16,7,3,2,4,0,6,2,86,40,1,14,11,17,6,0,0,2,0,5,1,10,4,13,1,251,8,6,0,2,5,3,1,11,5,0,8,17,0,1,7,2,0,19,1,12,9,0,2,0,2,10,2,1,1,24,6,2,0,13,2,195,1,4,0,31,3,3,0,0,7,18,1,14,0,11,1,7,6,14,0,5,8,0,0,4,1,3,2,0,0,0,8,1,8,23,39,15,5,0,8,2,1,1,8,0,0,1,4,0,17,2,4,2,0,0,2,0,13,18,1,1,31,0,8,5,1,19,0,3,0,0,0,7,0,2,0,1,0,2,0,0,0,1,4,2,0,12,23,2,0,0,3,62,1,7,1,8,4,0,3,0,2,4,9,34,55,0,1,0,2,0,0,1,1,2,4,6,0,0,12,12,6,0,0,8,2,37,2,8,3,0,0,0,0,6,3,0,4,0,5,15,19,8,7,3,0,4,3,0,2,6,1,11,1,0,0,23,15,2,1,3,3,2,3,7,1,1,8,9,0,3,10,1,3,1,0,0,3,22,8,1,5,0,2,2,1,52,0,9,2,1,0,12,0,15,0,19,3,0,12,1,0,0,6,8,0,6,8,2,1,4,3,31,4,3,3,11,12,0,0,4,0,15,0,1,0,1,7,11,0,14,7,0,17,3,1,36,5,5,3,33,5,1,6,3,3,0,0,3,0,3,7,8,10,0,5,7,10,1,11,0,1,17,40,7,0,2,5,2,4,7,0,1,0,6,7,2,0,0,8,0,1,14,2,3,5,2,2,1,2,1,6,1,0,5,1,42,1,16,7,0,6,0,12,8,0,9,0,2,22,20,3,51,0,17,1,18,0,4,2,0,0,2,8,10,1,1,6,0,5,11,0,4,5,6,0,0,0,6,6,0,1,0,12,6,7,2,1,1,8,3,12,0,24,3,1,9,13,4,6,0,8,0,2,5,6,2,2,2,3,57,3,1,3,1,21,5,2,7,1,0,0,0,1,5,0,2,0,0,0,0,1,1,14,5,0,2,1,2,2,3,3,2,0,4,0,18,13,0,1,1,9,1,16,8,2,2,0,1,0,7,0,0,0,1,0,1,0,5,2,1,3,4,2,0,5,2,9,2,5,3,10,9,0,13,14,2,0,3,0,7,5,8,6,12,4,1,3,1,0,0,9,1,13,14,0,0,6,4,22,0,2,16,2,3,1,12,1,22,1,8,5,5,3,20,12,1,6,5,2,3,9,0,1,1,3,0,9,2,1,3,4,3,2,3,0,13,22,8,1,2,0,0,0,101,18,11,0,0,10,10,9,2,3,2,0,7,24,20,2,24,3,6,1,6,0,4,0,0,4,1,2,7,2,5,8,4,9,6,8,6,1,1,2,0,2,4,0,2,3,10,17,0,13,0,210,12,0,1,4,3,6,7,5,1,14,1,8,28,51,21,20,15,6,8,4,2,2,3,6,45,0,0,1,0,2,0,20,9,3,10,4,3,7,3,13,9,3,9,1,8,4,7,8,2,4,11,8,3,2,1,3,11,1,1,9,1,6,4,10,13,2,12,6,8,0,2,0,2,9,2,6,1,0,1,3,2,6,0,1,6,9,2,0,19,2,9,6,2,3,7,1,5,0,7,3,5,0,0,12,0,3,4,5,0,1,1,6,0,1,5,1,7,2,0,23,3,3,2,6,3,6,0,1,6,1,0,5,1,0,3,3,2,1,0,12,6,0,3,2,1,4,0,3,5,14,3,5,9,7,1,0,2,4,15,2,0,0,4,8,1,8,5,14,12,6,13,2,9,14,7,4,0,3,3,0,1,2,1,1,7,1,9,23,0,4,18,4,1,18,3,7,0,11,2,8,15,21,3,1,1,0,1,1,2,2,14,2,5,0,0,3,2,4,2,3,0,1,2,1,2,2,1,9,18,3,22,10,0,4,27,6,2,3,0,3,1,5,0,4,11,15,1,0,0,0,1,7,3,0,0,7,6,15,0,5,0,3,5,6,4,8,1,9,1,2,15,12,1,19,5,6,15,46,10,0,11,4,7,3,0,1,2,0,3,0,2,2,0,1,0,1,0,0,2,5,0,0,1,0,0,1,0,1,7,3,0,0,5,0,0,24,0,0,0,4,2,0,5,2,7,2,0,3,0,1,1,2,2,1,2,0,4,0,37,0,2,2,0,0,0,0,1,6,0,0
france,13,29,1,111,23,1,5,25,5,2,25,14,3,94,1,13,8,9,8,4,6,40,4,21,10,3,10,13,5,22,6,163,130,13,54,66,33,6,2,3,4,9,5,1,13,12,50,7,497,11,39,5,4,41,0,6,61,10,0,11,48,13,3,42,18,5,80,2,16,22,18,5,1,7,40,5,21,5,59,13,26,0,37,2,229,17,8,0,32,3,19,7,0,45,56,13,18,3,60,5,12,22,48,8,15,16,3,8,13,5,17,11,0,6,0,39,9,2,57,139,29,17,23,55,6,2,4,5,18,0,15,9,0,47,13,8,19,3,2,6,3,27,48,4,9,55,3,10,12,5,66,0,17,3,2,4,18,4,26,2,6,4,1,5,0,0,0,15,7,20,23,81,23,2,1,10,156,1,9,6,10,6,0,14,1,10,16,31,38,103,2,9,4,0,0,6,4,3,3,11,5,0,0,11,36,3,1,14,16,20,82,2,30,8,4,0,0,0,6,4,2,25,10,21,25,59,12,26,7,5,9,16,23,26,24,12,26,3,9,1,62,28,12,10,5,3,4,8,30,3,8,13,37,11,18,20,20,1,9,6,0,40,24,17,5,14,0,0,9,4,80,2,13,1,2,1,6,2,20,4,47,1,0,19,11,0,3,5,25,0,2,8,16,10,4,5,64,18,12,2,47,19,0,5,7,8,24,0,2,1,4,7,31,3,51,21,7,52,7,3,67,3,19,0,72,2,2,42,6,24,1,8,15,3,6,19,19,22,7,22,4,8,3,12,1,4,72,81,9,2,9,8,8,26,31,2,0,3,12,21,13,3,5,16,4,2,57,7,0,13,3,8,3,2,1,3,6,0,18,3,71,0,19,11,0,29,1,33,25,1,41,2,7,17,28,11,119,3,26,2,34,0,6,0,6,2,7,12,29,5,1,4,4,13,15,9,16,8,4,11,10,13,8,16,1,4,7,12,16,17,10,19,6,18,6,25,2,47,3,8,14,20,1,64,2,6,3,1,38,4,13,13,0,18,122,12,0,25,3,47,11,20,27,12,4,1,5,10,4,2,8,0,1,2,0,10,7,19,10,4,6,11,18,3,15,8,8,5,5,0,62,55,5,10,3,14,0,30,7,0,11,2,3,0,22,4,0,17,5,5,6,5,13,3,10,11,8,5,0,7,5,27,4,12,2,2,17,0,26,35,18,6,4,8,7,4,17,7,36,6,10,9,5,0,2,15,9,10,18,12,19,7,2,33,5,0,63,3,8,5,25,5,18,1,15,5,6,7,37,45,3,8,18,1,6,22,12,2,5,4,8,16,9,13,6,5,1,1,13,5,48,28,19,3,2,1,5,0,112,12,46,2,2,18,6,17,6,15,1,3,21,12,12,11,45,6,17,13,5,7,4,0,1,8,2,5,32,7,16,30,2,20,8,28,6,5,1,12,0,13,4,1,1,14,15,11,1,8,5,417,23,1,9,2,18,8,35,23,11,28,4,8,50,96,29,31,6,12,15,21,26,13,40,25,74,9,2,11,1,9,0,27,18,8,14,7,11,11,2,14,17,5,39,14,6,5,9,14,27,17,27,5,4,7,5,2,24,4,7,1,6,18,9,44,11,13,3,3,16,1,3,2,13,2,1,18,2,0,3,6,3,15,5,5,5,2,4,6,29,0,4,12,2,9,13,2,9,2,1,9,6,5,1,20,0,11,6,18,3,6,22,11,10,2,32,5,11,8,3,20,1,0,1,13,0,13,3,4,0,9,0,9,11,1,8,17,8,16,5,21,14,5,0,5,0,12,2,11,4,2,8,3,15,13,7,0,1,4,16,12,6,2,39,20,7,13,5,17,12,19,22,5,14,7,1,8,1,7,4,4,9,15,7,1,2,7,14,27,9,6,19,5,3,18,4,2,0,18,3,12,36,25,6,3,0,8,3,2,11,1,8,22,5,3,7,7,3,3,2,6,0,3,2,0,9,5,9,1,14,13,4,13,4,15,6,12,16,3,2,5,2,17,0,13,15,3,0,0,9,1,3,14,4,10,2,5,1,25,5,11,3,10,14,16,26,4,4,17,3,6,14,9,2,28,37,14,42,93,6,1,4,14,14,10,2,3,8,12,12,3,2,10,2,1,2,17,6,3,7,14,0,5,1,1,4,11,2,5,17,21,3,5,3,0,0,39,0,0,0,9,13,11,3,4,11,16,0,6,15,5,1,1,11,2,11,6,13,3,79,3,7,1,7,0,0,4,0,6,7,0
express,16,41,18,179,14,6,8,41,14,2,34,22,7,75,5,8,15,12,10,5,11,31,17,37,32,15,15,12,12,22,9,167,123,23,49,58,44,4,4,8,7,12,15,4,34,19,24,8,338,38,61,7,15,48,7,9,58,55,5,16,29,8,4,15,24,10,145,8,12,14,6,7,5,9,55,11,11,2,71,30,29,1,19,7,252,13,9,0,56,4,5,6,1,30,46,2,15,4,34,10,15,33,35,12,6,34,2,3,7,2,15,3,7,4,3,26,10,3,76,163,38,34,11,53,7,14,4,8,3,5,11,4,9,53,23,44,6,2,6,4,2,32,35,2,3,70,8,14,12,9,73,1,14,6,3,17,26,8,14,16,9,4,9,2,2,6,4,17,20,3,16,74,23,0,7,14,175,7,11,28,20,18,9,18,7,12,32,26,49,65,1,0,8,1,1,5,17,10,4,4,21,2,2,11,25,12,5,24,17,29,70,5,36,8,2,2,2,2,13,2,3,10,14,9,38,98,18,27,4,2,13,14,10,26,27,20,33,4,3,8,94,36,5,4,15,3,9,19,33,5,18,11,52,4,3,20,15,1,8,11,3,39,35,10,9,39,3,13,19,8,149,5,18,4,5,2,21,10,21,8,62,6,0,16,7,4,5,9,13,4,6,13,16,6,5,15,54,15,11,19,25,41,2,3,14,2,24,4,4,0,3,12,25,9,15,20,10,40,13,5,35,21,22,1,71,1,9,26,3,29,13,7,7,9,7,19,19,12,2,10,10,14,15,14,6,7,38,72,9,7,10,14,8,42,23,5,14,4,13,34,24,3,8,26,6,2,43,12,6,19,11,30,9,10,17,29,10,2,20,6,97,4,39,19,3,27,5,26,29,1,23,5,38,33,57,22,88,8,30,9,23,8,4,5,2,5,0,6,27,16,3,14,3,13,11,9,7,14,6,7,4,13,18,20,1,9,3,16,15,18,13,7,5,17,9,8,3,27,11,7,12,14,6,13,3,4,12,7,21,6,14,3,8,3,56,7,5,16,12,35,18,22,21,14,1,5,14,8,2,1,17,3,8,2,3,7,3,36,11,2,10,23,3,22,5,4,9,5,8,3,63,34,7,8,9,6,3,19,12,13,8,1,1,1,7,17,7,27,3,1,5,4,7,4,19,68,7,7,0,12,2,8,12,31,14,10,19,3,15,30,15,10,8,6,6,7,20,23,33,8,5,9,1,1,2,10,6,21,15,7,61,7,5,31,3,11,27,4,7,17,37,5,34,2,16,8,16,5,37,24,7,19,18,3,10,22,9,8,2,14,6,14,6,12,10,8,9,7,6,16,25,41,14,3,30,3,3,2,80,36,22,0,5,9,11,18,8,43,5,5,25,28,15,8,31,4,20,3,13,5,7,1,1,18,1,3,14,4,15,23,6,37,19,19,11,2,11,4,6,8,6,5,20,18,7,39,9,12,6,196,20,4,15,3,11,13,43,20,9,13,3,5,33,30,15,14,18,13,9,11,20,6,55,34,25,5,15,11,4,7,10,31,13,7,16,10,13,11,3,7,19,15,20,17,6,8,14,9,10,22,7,7,20,7,12,8,15,5,5,12,1,10,6,28,15,12,10,11,22,7,8,9,14,26,2,4,3,2,1,10,5,14,2,5,6,3,21,2,40,4,9,6,5,13,13,0,15,8,3,9,9,7,3,16,6,22,15,15,3,12,10,10,3,4,21,15,13,3,7,15,5,3,0,12,7,18,6,0,20,12,1,4,8,1,24,5,3,27,5,15,8,15,8,6,6,22,1,16,4,5,7,2,18,7,8,1,14,6,27,8,4,3,13,10,6,8,4,14,4,9,8,5,33,14,5,5,5,9,3,6,9,3,15,3,8,15,16,27,12,3,10,21,9,12,9,14,4,5,9,14,24,25,13,7,1,2,6,5,4,2,3,8,19,3,4,13,1,10,7,19,2,2,2,5,10,8,18,14,1,9,1,5,8,13,15,5,12,9,7,13,12,7,0,7,8,13,1,12,1,4,5,9,4,16,22,2,8,7,3,21,7,4,10,13,12,11,3,5,2,3,15,10,1,7,3,6,7,22,8,6,7,5,13,8,7,5,9,2,10,6,4,14,6,2,1,11,3,12,28,7,0,3,3,3,9,2,8,3,20,5,0,6,4,3,3,12,8,2,13,5,3,6,5,12,5,6,3,14,11,11,9,8,5,11,12,4,13,5,18,2,5,3,4,6,0,1,0,7,8,4
japan,2,9,2,27,3,7,34,19,4,17,4,2,5,115,2,2,1,2,1,1,1,12,1,18,16,4,30,9,1,5,2,96,108,15,33,60,33,7,0,0,1,9,14,0,8,6,7,7,192,43,4,5,2,45,2,14,8,6,0,19,29,1,1,6,8,3,101,3,0,16,4,2,1,1,24,14,3,0,27,20,41,1,8,4,115,4,6,1,12,3,7,0,4,8,16,5,7,2,33,1,5,19,19,1,6,7,1,4,4,17,33,2,8,3,6,24,5,1,21,42,14,38,0,60,29,0,0,0,0,2,3,40,0,45,5,13,5,2,2,28,4,31,52,1,16,36,2,16,1,2,32,5,21,1,12,0,28,4,4,10,0,0,2,2,6,3,1,9,13,3,14,41,15,2,1,3,43,2,5,11,3,3,1,6,7,7,35,14,21,35,1,0,14,1,2,1,3,3,6,1,6,0,0,2,19,3,0,2,4,15,44,7,6,2,0,1,0,0,3,2,7,6,4,1,13,14,64,18,1,6,4,6,3,6,7,1,7,3,6,1,12,9,4,1,26,2,0,5,13,1,4,23,17,0,4,4,3,0,0,26,4,11,13,1,3,4,4,7,0,4,59,15,15,0,1,1,5,7,7,2,49,1,2,16,19,5,0,0,26,3,6,7,3,0,3,18,37,2,6,2,11,16,1,3,4,1,43,0,2,0,1,2,8,7,1,6,4,22,3,4,11,1,17,0,32,2,3,13,1,33,0,7,2,2,1,5,11,8,1,5,0,16,2,14,5,3,22,57,11,3,6,5,3,11,4,2,1,14,1,26,1,0,9,11,3,0,11,1,1,6,4,17,1,9,2,9,2,1,4,1,25,1,14,1,1,47,0,6,2,2,7,2,6,8,10,1,17,0,8,7,21,3,12,1,0,3,0,19,39,3,4,18,12,3,1,11,6,2,13,3,0,2,14,5,3,0,3,9,3,9,13,1,0,3,11,2,3,26,2,3,6,10,3,43,28,11,6,3,6,2,12,2,2,2,85,3,0,1,15,14,5,13,18,16,0,17,19,28,4,2,20,0,1,1,1,2,0,25,5,0,2,21,3,1,14,2,0,0,4,0,45,14,1,4,2,6,2,15,4,0,5,1,1,0,4,2,0,8,0,0,2,0,2,2,2,4,3,3,0,6,27,5,0,3,0,4,6,0,8,4,13,1,4,4,4,2,2,6,32,0,3,6,1,1,2,4,0,5,6,8,1,0,1,8,4,1,27,2,0,6,26,1,12,1,2,3,10,0,22,22,0,10,6,2,6,2,3,2,1,21,2,14,5,5,1,67,5,6,3,0,3,29,5,0,3,0,1,2,65,17,6,1,1,1,4,8,5,2,2,0,21,0,0,2,6,1,5,3,1,1,6,0,1,4,0,7,1,5,3,14,0,11,6,4,8,1,5,5,25,4,1,0,0,1,13,9,1,7,0,170,33,4,1,1,2,8,6,7,0,6,1,10,24,28,12,5,3,1,7,3,4,3,7,6,9,0,2,6,0,3,0,12,0,13,10,1,12,5,13,16,5,11,2,64,5,3,3,5,5,2,110,3,2,0,4,3,11,3,0,5,5,9,0,6,12,1,1,15,22,29,7,1,29,1,1,6,5,0,0,18,1,0,1,6,7,0,4,0,4,3,2,4,8,7,14,9,7,18,0,4,1,0,4,9,10,6,0,10,3,23,20,10,2,3,7,3,0,2,1,13,7,2,2,0,4,7,13,0,0,5,0,1,3,0,5,3,0,0,16,5,4,0,4,0,3,0,7,1,6,0,16,0,4,1,3,3,6,4,17,4,4,2,11,2,0,3,18,4,0,3,0,4,10,2,2,0,1,4,1,1,0,14,12,1,4,5,13,10,15,0,1,0,0,2,1,5,2,8,5,3,8,6,1,2,3,2,1,3,0,2,6,0,3,5,0,3,2,2,2,4,2,1,0,1,12,0,3,13,9,1,1,5,5,8,1,1,0,3,2,2,7,1,24,4,0,5,0,0,3,18,2,0,14,2,0,8,0,8,4,6,1,4,4,2,1,2,0,11,2,2,0,7,1,2,26,1,23,15,0,1,2,2,1,1,3,4,1,2,5,3,0,2,3,0,2,3,1,7,0,1,0,3,17,0,3,0,0,7,0,3,0,0,4,0,0,3,1,0,0,6,1,1,3,6,3,10,0,0,5,0,1,0,2,0,0,1,3,2,4,1,0,1,4,0,3,4,14,0,15,1
award,4,11,4,64,7,0,5,1,3,1,31,10,1,11,1,10,13,6,0,0,3,2,0,11,17,6,0,1,0,5,3,112,28,4,13,10,3,0,0,2,0,0,0,2,0,9,5,1,172,6,17,0,2,2,0,0,22,14,0,6,15,0,0,10,1,3,6,2,4,3,4,0,0,0,5,3,1,1,28,5,1,0,3,0,123,10,3,0,36,2,7,0,0,17,18,0,8,0,15,2,3,16,11,0,3,4,0,1,3,0,1,0,0,7,0,10,10,2,41,22,9,8,0,22,1,0,0,3,1,5,3,0,0,20,3,8,6,1,0,1,0,18,20,0,2,15,0,4,3,2,18,0,16,0,0,4,7,0,2,1,4,0,0,2,2,0,0,9,2,4,1,11,3,0,0,2,64,2,0,3,2,4,1,2,0,0,5,4,34,43,0,1,0,1,0,1,1,0,2,0,3,0,0,5,3,0,0,3,4,3,27,0,3,1,0,0,0,0,4,0,6,6,0,9,10,6,8,2,0,1,0,9,0,3,2,1,12,3,2,0,14,13,4,1,6,1,2,1,35,2,1,3,2,1,3,3,4,5,2,7,1,2,26,5,0,9,2,0,0,0,36,6,65,3,1,0,3,1,24,3,10,0,0,12,4,0,1,3,1,0,10,11,1,0,9,3,36,0,0,6,13,20,1,3,2,0,8,2,1,0,0,0,8,1,71,2,1,21,2,0,50,4,1,0,6,4,0,3,1,7,1,0,1,2,2,4,3,2,0,2,1,1,8,6,0,2,7,25,3,2,1,2,7,8,12,1,2,0,2,5,1,4,1,1,0,0,2,1,0,3,0,0,2,1,0,10,3,0,7,1,16,0,7,3,0,2,0,8,17,1,10,0,1,11,18,1,21,0,3,2,14,1,1,0,1,1,2,1,1,1,0,4,3,2,7,4,1,1,1,0,2,1,5,1,0,1,1,2,2,9,0,12,16,14,3,7,0,14,2,2,2,4,3,0,0,0,1,2,6,0,0,5,0,1,39,13,0,4,0,12,6,6,7,7,0,2,1,3,5,0,4,0,0,0,0,2,0,5,1,0,1,5,2,1,5,18,0,0,0,0,9,12,1,0,0,0,2,31,7,0,0,2,0,1,8,1,0,26,9,1,0,3,2,6,2,6,0,1,0,0,2,7,1,13,3,7,2,0,11,7,1,0,0,4,20,5,3,0,5,2,0,4,2,0,1,8,0,3,17,3,0,5,0,21,1,0,1,0,0,6,9,0,29,6,4,0,7,1,14,8,0,2,7,1,6,2,0,2,1,3,0,3,3,1,4,1,0,3,3,2,10,21,5,0,11,0,1,0,79,0,10,0,2,7,15,3,2,17,15,1,11,37,17,1,31,3,6,2,11,4,4,0,0,6,1,7,3,3,0,6,11,9,1,2,8,0,0,1,2,2,5,0,1,7,4,11,0,13,0,163,8,3,1,1,6,10,23,5,5,9,1,4,66,35,14,5,38,7,0,11,21,3,69,27,121,0,1,3,1,0,4,9,2,1,3,5,9,0,0,16,37,2,7,1,9,7,0,2,8,11,9,15,5,0,3,2,10,0,0,4,0,13,3,4,6,14,5,1,4,2,3,2,2,13,1,0,2,0,3,0,0,3,0,0,12,0,10,0,6,0,0,2,0,4,4,1,1,1,1,9,0,3,0,10,0,4,1,3,4,8,7,5,6,1,2,0,1,1,0,17,0,0,1,8,2,3,0,1,3,2,2,0,3,1,3,3,4,1,6,1,2,4,0,6,0,3,1,3,6,1,2,0,22,1,0,1,0,4,11,4,3,3,10,3,0,1,3,8,2,2,2,0,1,19,0,0,0,6,3,1,5,0,0,1,0,0,1,6,4,2,9,0,6,24,9,7,0,16,0,6,19,6,4,0,0,1,0,1,0,0,6,1,8,0,2,2,1,6,0,8,0,0,1,0,2,2,22,4,1,1,1,9,3,8,34,13,1,6,3,2,0,2,0,1,4,42,1,0,9,4,5,4,2,0,0,9,2,5,3,9,1,4,0,59,4,10,0,3,0,1,1,13,0,8,5,5,2,17,10,4,3,0,2,0,0,0,0,0,2,0,1,1,0,2,5,35,3,1,11,15,0,1,0,0,4,1,4,4,16,7,0,1,4,7,1,10,1,3,4,0,1,7,1,3,2,0,1,0,4,0,2,1,2,5,1,0,7,1,9,0,0,1,9,0,0,0,1,3,0,0
date,5,14,6,75,4,3,9,13,11,3,13,6,9,19,1,2,7,17,2,2,2,26,2,24,6,4,4,9,0,51,6,126,50,9,20,12,11,13,12,0,7,1,4,4,13,5,9,7,217,15,15,3,3,22,2,0,32,33,0,11,2,0,3,2,6,3,27,1,5,11,11,3,1,5,42,4,16,2,67,9,29,0,8,4,113,12,8,0,59,1,29,4,2,18,27,11,14,5,26,3,25,17,31,5,6,23,6,1,9,9,17,2,5,7,0,22,18,1,74,76,10,12,2,64,3,0,2,0,8,1,5,4,3,35,9,26,3,3,7,2,2,25,46,2,1,52,3,5,14,11,21,1,13,2,1,6,7,0,8,5,15,0,2,12,0,5,5,3,15,3,14,38,12,0,0,3,96,5,1,19,7,5,2,10,3,12,20,8,17,39,1,6,6,0,0,8,7,4,10,4,26,0,2,10,12,2,3,8,2,10,42,6,22,1,3,1,0,1,5,0,3,8,0,4,27,68,15,30,4,12,4,11,17,5,9,15,10,1,6,4,36,18,6,5,4,3,5,15,41,1,2,10,9,5,5,12,6,3,4,25,1,14,18,14,5,29,1,1,3,0,63,15,60,3,3,0,12,13,10,4,16,2,1,12,4,3,0,3,12,2,14,8,7,7,10,15,45,13,9,7,13,21,4,11,4,3,5,0,0,0,0,4,13,0,33,14,3,28,19,3,26,2,8,0,23,1,5,13,5,20,0,6,3,4,8,19,5,5,1,19,4,13,5,6,3,4,27,38,6,3,9,2,2,20,16,1,2,1,9,30,14,1,4,4,1,0,20,3,2,5,2,5,3,2,1,20,4,7,5,3,32,2,30,8,1,14,3,12,13,0,6,1,5,17,17,2,31,4,35,2,13,2,3,1,6,3,6,4,21,3,0,3,4,5,8,3,4,4,1,2,1,11,11,2,1,2,1,11,9,11,33,31,13,27,1,11,0,19,4,4,9,12,4,5,4,6,5,6,20,11,6,4,0,2,26,5,0,7,5,36,8,12,10,11,3,10,4,12,2,0,5,1,4,2,1,6,1,7,11,2,2,4,3,2,3,11,6,1,3,5,25,28,1,4,5,5,2,18,4,9,5,4,6,0,17,26,1,8,21,5,4,0,5,0,4,8,6,4,0,4,2,10,8,6,2,5,9,4,11,16,15,0,1,4,6,4,6,4,22,11,5,4,3,1,4,15,4,2,5,3,10,1,5,41,3,1,14,2,1,5,5,11,29,2,8,7,8,4,21,13,14,4,15,1,4,3,15,5,1,21,4,12,3,8,4,7,2,5,2,4,6,14,13,4,13,1,1,1,65,7,7,1,4,8,24,17,7,12,11,2,20,30,13,5,34,1,7,1,3,7,6,16,1,47,2,1,9,6,6,14,37,10,10,8,9,1,5,7,0,10,8,0,1,17,9,39,3,9,6,145,17,5,0,2,5,8,13,8,3,9,3,5,29,22,8,12,3,5,11,10,10,4,33,28,44,3,3,4,13,5,15,25,6,5,7,3,3,2,5,3,18,7,20,11,4,9,7,2,6,18,6,3,7,3,1,8,9,3,13,11,5,37,9,8,10,14,10,5,6,3,5,2,7,14,2,8,5,0,2,6,4,9,4,2,20,8,8,3,22,1,3,9,4,9,8,7,17,2,1,10,3,14,6,27,18,10,7,5,3,30,26,6,27,29,16,15,8,1,3,3,3,0,1,9,5,3,6,0,4,6,0,2,6,6,6,5,4,11,10,15,5,4,2,5,8,7,5,14,3,3,3,8,10,2,0,2,0,5,10,4,10,15,13,13,7,7,1,8,11,9,5,4,6,7,4,4,1,2,6,2,12,7,1,0,1,2,6,11,5,6,12,1,0,7,3,17,3,17,1,7,18,18,4,2,4,5,1,5,6,0,7,3,12,0,3,3,2,4,1,9,2,2,19,21,4,8,10,13,5,5,9,1,6,11,15,5,5,3,2,2,0,10,1,2,2,19,3,8,14,1,3,8,3,7,4,24,7,26,4,14,0,4,3,25,6,18,0,6,3,2,6,4,4,9,3,3,1,26,5,9,3,3,2,3,2,8,3,4,3,1,2,14,13,6,13,29,4,17,46,10,0,0,1,1,2,30,3,2,16,3,5,3,1,6,8,16,2,11,2,4,0,4,1,2,6,1,1,2,0,7,5,5,7,20,3,2,1,0,18,1,2,0,5,0,0,2,0,6,0,1
chief,4,21,13,51,3,3,5,14,4,0,7,2,2,20,3,0,3,8,2,5,3,19,3,6,14,7,6,3,4,5,8,71,40,7,31,9,27,0,1,4,3,3,4,4,8,8,5,8,98,11,24,0,6,9,2,0,27,32,4,5,6,2,0,5,8,3,28,2,6,4,3,2,1,4,13,7,7,5,29,9,9,2,4,4,67,3,3,0,17,6,6,3,0,16,7,4,10,3,17,2,4,7,10,8,5,22,1,2,2,3,9,2,3,5,1,11,2,3,20,36,21,15,1,37,3,0,2,0,5,1,6,0,2,14,6,16,0,3,2,2,1,16,15,2,2,29,0,2,9,3,18,0,5,3,1,7,18,5,2,3,8,0,5,8,0,8,0,11,14,8,3,26,11,0,1,0,58,1,6,11,10,4,3,8,0,6,10,10,22,22,1,3,3,0,0,5,13,3,6,6,6,0,1,8,12,5,4,11,2,5,33,0,11,2,3,0,2,2,19,5,0,3,2,8,12,44,11,10,1,2,3,17,2,15,4,4,10,7,6,5,28,13,9,3,3,1,2,11,20,2,5,5,9,5,5,5,6,3,1,10,0,8,13,4,0,30,2,4,2,2,60,2,11,1,3,0,7,0,4,1,29,3,2,6,5,2,1,3,3,0,4,4,2,1,7,4,7,1,2,5,7,11,0,4,4,1,11,12,2,0,0,11,16,5,6,16,2,25,4,1,9,4,9,6,16,2,5,6,4,22,2,3,6,1,3,3,5,5,2,5,5,7,3,9,3,7,22,19,6,2,7,5,2,14,7,2,7,3,8,10,8,2,3,2,5,2,15,3,8,3,1,11,1,1,5,20,4,1,4,2,21,0,21,4,1,20,1,8,12,0,18,4,8,7,12,10,18,9,23,2,8,3,2,0,0,0,3,2,3,2,3,1,2,13,13,2,3,6,0,2,0,12,10,6,0,1,4,5,7,9,3,3,0,11,4,2,0,7,3,1,4,10,2,2,3,2,10,2,8,3,5,3,4,0,18,6,1,7,1,14,7,5,14,11,9,2,12,3,4,1,6,0,1,1,2,11,1,11,10,1,2,4,0,1,1,5,3,1,2,2,39,21,0,2,3,4,2,4,1,4,4,1,0,0,2,13,3,6,5,3,1,1,3,7,7,10,1,3,0,3,1,10,0,6,3,8,14,2,5,5,9,0,7,9,6,5,5,2,17,16,3,1,0,2,5,6,2,9,8,4,10,5,0,18,12,6,5,1,3,2,11,1,11,1,6,7,4,4,11,16,7,1,7,2,2,1,2,2,2,4,4,14,5,10,5,2,5,1,0,3,2,6,4,1,3,2,0,2,22,5,10,0,7,0,2,22,2,25,3,0,12,12,12,4,6,2,9,4,6,1,5,6,0,15,5,1,1,4,5,9,0,7,5,6,10,2,3,4,0,4,2,1,8,39,2,20,3,2,1,55,11,3,4,4,1,6,15,4,0,8,0,0,4,5,2,4,5,5,7,3,7,2,16,14,7,2,3,1,6,3,16,12,3,1,2,2,4,2,0,7,11,5,8,2,7,4,0,4,0,5,8,5,2,1,6,2,4,0,4,0,2,3,4,5,2,27,13,6,1,8,9,1,2,27,4,0,2,1,0,4,3,5,0,2,3,3,13,0,6,3,5,0,2,6,2,1,3,7,2,4,2,0,0,3,2,7,2,8,1,3,2,8,1,6,6,2,10,4,12,6,3,1,2,5,4,5,1,0,10,2,8,1,4,2,8,3,4,6,4,6,4,5,0,1,2,9,1,4,3,9,2,7,4,2,2,2,11,3,4,1,3,5,0,8,1,1,7,4,4,3,1,0,1,5,3,2,2,6,4,3,3,4,6,1,3,4,1,3,3,2,3,0,6,7,1,2,3,5,3,1,10,13,0,4,5,3,4,5,0,4,3,3,3,5,2,7,1,4,6,11,15,3,1,3,3,5,0,4,8,5,3,6,1,3,8,2,5,3,7,1,2,12,0,3,0,5,3,4,2,2,3,5,5,4,6,2,1,8,3,9,2,7,2,7,2,3,1,3,6,1,4,2,3,2,1,7,0,1,0,1,2,1,4,2,2,2,3,3,2,10,1,1,1,0,2,5,1,9,13,1,14,8,5,4,1,1,3,1,4,3,1,5,3,1,0,2,6,0,7,0,5,3,0,3,4,0,2,2,5,2,0,1,2,0,4,0,1,0,8,0,0,0,6,0,1,0,0,0,2,0
terminate,3,11,7,54,6,0,4,29,3,2,22,7,3,21,1,3,4,2,2,1,2,12,4,8,6,5,3,8,2,10,7,64,66,5,11,13,30,0,0,2,1,2,0,2,13,9,13,5,194,6,24,1,3,9,0,5,24,7,0,8,23,1,0,6,11,3,29,2,11,18,3,0,0,1,17,4,6,6,31,3,9,0,9,2,122,1,3,0,17,1,11,1,0,17,26,0,9,0,23,2,6,18,31,5,3,9,7,1,8,6,7,1,3,3,0,23,2,1,35,68,12,11,5,26,3,3,1,3,5,0,3,0,2,19,6,10,3,1,0,2,2,14,27,1,2,34,2,2,6,5,32,0,9,3,2,5,6,2,12,1,2,0,1,1,9,1,1,9,4,9,6,32,6,0,1,4,87,3,3,6,8,10,4,5,1,7,8,10,28,44,0,6,2,0,1,4,3,1,2,4,4,0,1,6,15,5,4,3,2,5,51,3,14,4,0,0,2,5,5,0,4,12,2,6,17,17,5,6,0,10,6,6,7,5,6,2,15,2,0,0,28,13,2,3,4,5,4,7,17,1,7,4,18,2,1,6,6,0,1,6,0,26,13,3,0,23,2,2,1,4,67,2,13,3,2,0,5,6,9,2,21,2,0,13,7,0,2,6,8,0,8,5,2,6,2,4,21,3,3,9,23,9,5,1,3,0,7,3,1,0,0,4,14,0,5,10,4,17,6,1,23,4,10,0,33,1,4,7,6,18,0,2,6,2,1,6,9,2,3,11,6,5,2,10,2,2,38,25,2,3,2,14,2,6,25,1,5,1,4,24,1,1,2,6,3,0,12,5,0,6,1,4,5,2,4,9,1,0,8,0,26,0,16,6,0,5,0,17,19,0,10,2,3,5,11,6,41,3,11,4,11,0,2,0,0,1,1,5,12,5,1,10,2,2,15,4,5,7,0,0,0,2,6,9,0,3,1,6,9,10,5,6,5,22,1,3,0,36,1,0,4,7,1,2,0,0,1,2,17,1,4,5,2,1,27,4,0,10,2,11,6,15,10,4,2,0,2,8,1,0,5,2,1,1,0,0,2,6,2,0,5,4,5,1,6,10,3,4,3,0,58,18,4,4,0,1,3,9,6,4,2,2,0,0,9,6,0,5,1,0,1,2,7,0,4,11,2,5,1,2,3,6,1,9,4,1,8,1,8,9,7,2,5,6,4,2,10,2,19,8,3,2,3,0,2,8,3,10,7,1,17,2,4,12,3,2,31,2,3,6,17,2,21,0,4,1,11,2,16,16,0,4,7,0,1,7,7,1,0,5,0,8,3,6,6,2,2,0,0,2,9,10,5,3,5,2,0,1,76,18,11,0,6,3,8,3,1,11,1,1,10,16,10,5,5,4,11,0,3,3,3,0,2,8,0,2,3,3,5,14,0,13,3,9,3,2,2,0,2,7,0,1,2,15,7,14,1,4,5,128,10,0,4,1,4,4,17,6,5,11,2,4,39,18,14,5,3,8,12,5,5,2,47,2,24,5,1,2,1,3,1,7,6,1,10,4,5,6,0,5,14,4,12,6,2,8,6,5,6,6,3,2,0,2,2,1,10,1,2,1,1,14,13,9,6,8,6,5,6,0,4,1,5,5,2,3,6,1,1,9,1,7,0,2,4,7,3,2,21,0,11,5,0,1,2,0,2,2,1,2,13,1,6,19,5,3,6,3,1,2,3,3,5,2,16,5,4,5,4,13,2,0,0,3,7,9,3,1,6,9,2,3,1,2,2,2,2,18,4,6,6,1,0,1,1,8,2,5,2,4,8,3,13,6,1,1,4,2,7,4,0,2,10,5,1,6,1,7,6,5,4,1,11,6,0,1,0,2,0,1,0,5,6,4,1,1,5,15,1,3,5,1,1,8,0,11,3,9,4,2,23,10,2,1,0,3,7,4,5,0,10,4,1,1,1,5,0,1,1,2,1,3,1,0,2,3,4,15,13,8,8,11,3,1,10,8,6,2,6,0,1,6,0,6,3,9,4,0,0,1,6,6,0,12,2,9,1,7,5,14,1,1,10,4,7,8,2,17,0,2,10,8,2,2,6,3,2,15,6,0,1,2,9,2,2,0,0,4,3,0,1,7,3,1,3,9,7,4,7,4,0,1,2,3,1,10,0,0,4,8,0,2,2,1,3,17,5,1,1,3,11,6,2,1,8,8,0,6,3,2,0,5,8,0,3,2,5,0,20,0,1,0,3,4,0,1,0,7,1,0
commissioner,7,24,11,163,2,1,29,14,2,2,27,29,4,29,4,0,13,16,0,3,9,49,0,13,20,16,0,13,0,13,7,226,60,9,27,18,33,9,5,0,7,1,3,2,30,12,22,9,392,3,34,3,4,4,6,5,53,152,0,26,25,2,4,26,16,0,28,3,10,23,1,2,5,4,28,8,6,3,82,15,36,0,24,2,193,9,13,0,74,5,35,2,0,28,32,4,22,12,23,4,11,18,35,5,6,33,6,4,14,1,13,5,7,15,0,24,10,25,83,65,34,8,7,75,5,0,3,6,9,5,5,0,5,50,7,74,3,7,2,3,1,33,18,5,2,63,4,12,17,24,30,1,19,2,1,19,22,7,2,1,12,1,7,1,0,1,5,21,15,0,35,63,12,0,1,10,198,2,4,21,19,1,0,5,9,7,18,14,39,71,0,1,7,0,1,1,13,6,17,7,17,1,0,16,10,7,1,25,7,16,85,3,14,7,0,0,0,0,58,5,5,12,6,27,46,102,26,13,4,4,9,45,14,16,23,12,29,6,3,8,53,31,3,9,5,2,4,5,47,16,12,12,9,10,12,10,7,2,6,24,5,7,61,11,7,45,12,2,5,1,109,17,53,2,5,0,11,7,28,1,15,0,3,14,6,5,12,12,2,0,28,15,18,12,6,9,79,2,6,21,10,44,1,1,1,0,10,7,1,1,1,7,57,1,38,27,9,61,14,3,44,4,8,21,26,3,2,23,2,39,1,10,7,2,4,16,8,19,2,16,7,13,15,9,8,8,31,94,6,2,4,13,5,28,18,6,2,6,14,28,15,11,7,6,2,0,35,0,9,6,4,12,2,4,1,24,12,4,4,8,45,0,64,17,1,76,3,11,19,4,17,3,7,26,44,9,92,11,37,6,13,1,3,0,5,0,5,4,12,4,3,5,2,18,1,6,10,4,2,0,0,7,16,5,0,4,3,12,15,24,6,15,13,40,5,9,0,26,7,7,14,13,6,8,1,8,2,8,28,8,2,5,0,2,65,5,0,1,2,35,14,3,24,17,6,5,16,9,17,0,14,4,2,0,1,7,1,9,8,2,3,10,1,1,6,27,6,2,4,10,44,38,0,2,2,13,4,20,10,4,9,13,0,0,11,3,4,5,12,2,2,1,31,12,12,25,4,1,0,1,7,12,7,9,9,9,12,5,18,25,4,4,3,2,22,7,10,7,38,15,4,8,4,0,3,18,1,12,13,9,1,9,12,74,10,10,18,3,1,12,30,10,44,1,16,10,16,5,34,35,7,5,30,4,9,6,1,8,4,19,1,26,10,2,6,6,9,2,4,3,8,25,27,5,32,12,0,5,168,13,16,3,2,11,14,8,3,14,11,3,25,83,135,4,40,15,27,0,5,10,15,4,1,18,3,9,7,15,11,33,7,42,8,15,19,4,10,9,0,16,6,2,10,50,16,79,6,4,2,277,30,3,4,1,2,25,25,7,3,23,6,6,61,42,34,21,10,17,14,8,20,8,90,43,92,0,14,15,3,5,7,25,5,8,22,4,8,2,12,14,28,6,19,23,9,32,13,9,4,23,30,8,8,4,7,9,24,3,1,30,3,24,5,14,25,48,12,7,7,7,27,6,16,32,2,9,12,1,1,6,4,20,11,0,12,8,4,3,56,2,10,14,9,5,11,7,7,3,3,14,6,2,8,44,14,14,5,18,4,20,12,16,9,4,21,6,22,7,33,16,7,2,5,15,3,10,2,10,91,11,25,8,12,5,11,0,8,13,6,34,6,92,29,9,12,12,3,15,7,33,5,9,25,13,2,1,4,8,19,7,3,2,11,11,3,6,4,30,9,11,4,0,16,66,31,7,2,16,11,4,9,9,6,1,6,3,7,31,10,17,16,9,3,29,9,12,2,6,16,7,34,26,5,3,10,5,5,8,2,1,7,0,21,4,4,13,2,7,3,36,17,4,1,1,5,5,27,6,15,1,34,15,8,10,1,9,14,12,2,4,5,35,0,2,1,22,12,3,12,0,2,24,1,25,0,17,0,31,8,19,8,8,4,23,3,11,8,9,0,3,10,20,10,30,5,17,7,31,19,6,16,2,11,10,3,1,5,8,5,12,7,3,8,5,7,25,7,23,25,14,7,0,3,0,6,13,17,4,33,6,9,10,10,18,2,18,36,41,5,4,0,2,0,5,9,4,1,9,9,2,2,4,12,7,3,1,0,0,29,1,4,4,12,0,3,8,1,21,1,0
satisfactory,2,8,6,55,2,0,1,6,3,1,17,5,3,21,0,2,7,2,0,4,3,21,2,3,11,2,1,0,2,3,0,90,49,4,24,15,8,3,8,4,4,0,1,8,15,5,10,10,107,6,22,1,5,3,0,0,17,18,0,16,15,2,2,9,10,2,22,3,6,9,0,1,1,1,7,1,6,2,25,6,26,0,5,1,109,4,6,0,28,2,8,0,0,13,20,4,10,4,12,8,13,12,17,1,10,3,1,0,6,1,10,5,2,6,0,14,2,1,22,65,18,2,1,35,4,2,3,5,0,1,3,3,1,12,4,16,1,1,1,2,0,22,17,4,3,25,2,6,3,8,23,0,5,1,0,8,9,1,3,0,5,0,1,2,0,1,2,4,7,3,10,17,5,0,3,4,74,2,1,8,10,3,0,5,1,7,7,6,16,43,0,0,4,0,2,7,4,0,2,2,5,0,0,7,12,4,4,20,8,12,28,4,14,4,1,0,1,0,7,2,3,7,11,5,18,35,8,12,1,1,4,7,8,6,11,10,15,2,3,4,29,27,1,1,3,3,2,1,11,1,4,8,17,4,3,7,5,0,5,8,8,3,13,4,1,28,0,1,5,3,57,3,22,2,4,0,4,10,5,2,13,4,2,5,4,1,0,0,6,1,1,3,3,2,6,5,30,1,3,6,13,10,1,4,7,1,9,3,0,0,3,3,14,4,22,13,6,26,2,2,15,3,8,1,9,1,5,16,0,10,2,0,8,1,2,3,7,4,5,12,4,5,2,3,1,3,27,17,6,1,6,2,2,8,18,3,0,0,10,10,8,4,1,4,0,0,14,3,2,0,0,4,2,4,2,20,1,1,4,3,25,0,11,4,0,10,0,8,14,3,9,4,4,15,17,2,31,0,15,2,12,0,3,0,4,1,4,2,9,5,2,3,1,4,1,7,4,10,0,0,4,6,4,6,0,1,1,7,6,15,7,2,0,9,0,2,0,21,0,2,3,5,1,4,1,3,5,4,26,0,4,5,0,1,22,11,0,2,0,13,3,13,12,6,6,1,2,6,3,0,6,1,1,0,3,0,0,1,6,0,0,7,4,3,7,5,5,1,2,4,26,20,0,3,2,2,3,13,3,4,6,1,2,0,4,0,0,10,4,4,0,2,1,2,6,12,1,1,1,0,2,7,4,9,2,0,5,0,7,13,1,1,0,4,6,3,11,2,9,5,1,2,2,6,4,6,1,7,9,1,5,3,4,21,2,1,14,2,4,5,13,0,9,7,6,8,12,4,18,12,3,9,9,7,4,1,3,3,3,12,3,4,6,9,5,1,5,11,5,0,13,7,1,0,10,0,3,1,51,11,14,0,1,2,5,6,2,9,8,3,10,13,13,1,10,4,12,0,2,5,6,2,0,8,1,4,3,3,7,15,5,7,7,9,2,1,4,2,2,4,8,1,1,5,11,18,2,6,5,82,6,5,1,2,3,6,11,10,1,4,3,9,17,18,13,8,7,7,6,10,9,3,15,3,25,1,2,5,3,1,7,10,3,2,6,5,3,3,0,8,8,4,8,8,4,9,1,0,2,8,5,6,6,1,4,3,13,0,1,2,3,8,3,10,5,11,3,3,13,5,2,2,1,9,0,8,2,2,1,1,2,8,1,3,4,3,17,1,22,2,6,2,2,3,8,1,8,1,2,1,1,6,1,10,3,5,5,8,7,14,13,4,1,0,9,4,6,6,9,15,3,3,2,2,1,5,4,2,12,2,7,2,3,1,1,1,0,2,5,3,4,3,0,3,3,7,1,4,7,8,6,2,5,2,1,0,5,1,10,6,1,4,7,6,0,8,1,8,2,8,3,8,1,8,4,4,0,3,4,4,2,1,2,2,4,6,5,9,3,3,5,3,0,3,3,8,2,10,3,0,17,8,5,3,0,3,6,2,1,3,10,1,7,3,1,4,2,3,2,8,2,7,9,8,3,2,6,12,5,1,13,5,2,8,9,1,2,4,3,3,0,10,0,4,3,5,4,1,2,2,3,7,0,4,3,4,4,4,2,7,2,2,2,11,1,7,1,3,1,1,5,10,0,5,2,2,6,15,7,0,6,2,11,5,1,1,2,1,1,5,5,7,2,6,7,16,7,8,19,5,0,1,2,0,5,4,3,4,4,5,3,2,1,2,3,7,4,0,2,1,0,1,0,0,3,14,1,6,3,0,9,3,4,4,6,2,6,1,16,0,0,3,4,0,0,0,0,1,0,0
early,9,8,7,135,9,8,4,12,2,5,12,7,11,36,5,2,5,8,4,2,7,14,5,13,19,8,5,13,2,9,5,132,73,9,24,27,28,9,7,1,1,2,2,9,14,6,22,11,162,13,28,4,5,20,5,2,23,25,1,13,20,7,3,11,14,5,48,2,16,13,10,3,2,0,31,3,8,8,41,10,26,1,13,5,116,14,8,0,34,1,19,3,3,16,38,3,20,5,22,7,18,20,27,10,4,30,4,1,13,5,11,6,6,9,2,11,8,2,35,79,21,12,7,32,5,1,4,5,6,0,5,1,1,23,12,34,6,4,5,7,5,33,18,4,4,53,2,15,10,4,31,4,17,5,2,11,18,1,12,10,9,1,8,0,0,10,4,5,11,8,16,47,10,0,1,15,100,2,2,32,9,7,4,11,5,9,16,12,26,43,1,6,3,0,4,2,10,7,5,2,14,0,1,10,17,1,3,7,7,25,42,8,16,5,4,2,2,1,6,2,1,2,4,8,31,55,16,9,17,5,19,23,9,9,11,14,22,10,2,4,34,14,5,2,7,4,3,7,36,2,19,6,26,2,4,10,5,0,5,8,1,17,15,2,7,27,5,2,6,3,57,4,21,2,1,1,9,11,4,3,25,2,3,11,6,4,5,3,3,5,12,5,7,10,4,1,36,4,1,14,17,29,0,2,3,5,9,4,5,2,3,6,19,3,16,8,6,27,9,4,36,5,9,10,26,5,12,19,2,10,0,4,2,2,2,7,15,5,4,14,9,5,9,8,7,1,20,29,10,9,5,9,1,17,12,3,2,0,10,16,17,8,8,14,1,0,31,3,6,9,4,12,6,8,4,15,7,1,10,6,21,1,36,10,1,29,5,14,20,0,10,1,8,9,31,8,52,4,27,2,15,1,1,1,4,0,4,5,10,6,2,2,4,7,7,2,4,3,4,4,2,11,10,13,3,6,1,5,4,14,13,7,5,17,1,5,0,25,5,6,9,12,4,9,1,2,6,3,21,5,14,3,1,4,27,1,0,8,8,13,11,13,21,13,7,2,13,4,2,0,9,0,1,1,0,9,4,10,25,7,4,5,3,4,8,5,6,3,4,3,47,27,0,3,6,10,6,7,3,4,8,5,7,1,8,11,4,5,4,4,2,3,17,4,4,11,6,6,3,4,0,11,5,9,1,2,9,2,14,13,11,6,1,6,17,5,11,4,31,14,1,2,3,3,5,10,1,5,4,1,10,4,0,26,6,2,11,1,0,7,9,4,14,1,8,8,13,7,25,17,5,5,14,2,3,6,5,3,2,6,0,13,5,4,0,3,1,3,2,6,13,19,2,4,8,3,2,1,33,15,16,1,3,4,14,10,9,13,8,5,11,13,16,2,10,0,11,2,5,6,12,13,4,21,6,6,6,6,12,17,8,20,23,9,10,0,7,4,4,3,10,0,0,11,6,20,3,6,7,114,11,1,8,1,6,10,14,16,8,13,3,2,9,13,7,4,8,12,2,10,11,6,58,13,30,0,3,12,6,2,6,15,12,7,9,6,7,3,6,13,12,4,9,6,11,15,5,4,7,16,11,1,7,3,6,12,15,1,1,6,0,12,3,20,9,27,6,9,6,4,8,2,7,14,1,4,9,2,1,4,1,13,2,2,7,4,15,3,23,5,10,6,4,8,5,2,5,6,4,6,4,1,5,7,1,12,3,8,3,7,5,13,9,1,10,13,5,3,11,12,8,0,0,7,4,8,5,1,14,11,2,1,10,3,11,7,3,30,4,8,7,7,2,2,9,6,13,5,4,3,6,6,7,12,2,3,3,2,16,4,5,4,1,6,1,6,6,7,6,5,5,2,9,6,8,0,3,10,15,1,6,6,2,4,4,6,6,12,5,5,13,4,1,8,6,12,7,8,7,11,10,18,10,3,4,4,3,2,5,2,5,5,0,1,3,5,0,1,5,11,1,4,6,8,8,1,2,16,12,0,1,5,5,6,14,2,1,6,3,10,0,5,3,6,8,7,8,5,3,2,3,9,4,14,3,7,10,5,2,11,2,5,4,6,12,6,3,4,1,3,7,9,3,1,5,9,4,34,7,1,2,5,6,4,4,2,2,4,5,7,4,7,7,4,3,17,5,11,18,1,3,1,2,5,1,4,8,4,12,7,2,2,0,6,1,6,3,0,0,1,7,3,1,1,7,1,0,2,7,6,12,1,9,11,0,1,5,5,10,0,2,1,2,1,2,2,0,9,1,0
accompany,2,11,4,73,10,1,5,10,4,2,8,3,3,28,0,0,4,13,0,1,2,17,5,15,8,3,7,8,2,13,3,110,51,6,21,18,21,0,7,4,7,1,3,0,18,4,12,10,169,2,28,2,6,10,2,3,28,92,0,11,18,2,2,8,21,0,37,1,7,2,1,2,3,1,32,5,10,4,24,20,30,0,6,0,110,11,6,1,29,0,3,1,0,13,27,8,13,2,27,9,5,15,17,3,2,9,5,1,10,3,5,1,4,7,0,16,7,0,37,77,21,6,1,34,4,0,4,2,1,0,3,7,2,23,6,11,0,1,2,3,3,25,13,3,0,37,6,11,12,9,19,0,8,3,1,11,8,2,6,2,7,1,2,1,0,1,2,9,11,3,8,24,7,0,1,1,80,3,0,11,10,5,2,11,2,9,17,16,19,27,1,1,7,1,0,2,9,3,8,4,19,7,0,7,8,1,1,17,10,10,39,1,10,5,1,0,0,2,13,1,4,7,10,15,25,41,29,6,1,4,8,5,8,7,12,14,16,4,5,2,30,15,2,0,2,1,1,7,16,3,6,8,3,5,5,4,7,0,2,6,4,12,13,4,3,47,9,2,6,1,48,1,21,1,5,0,12,6,28,0,20,3,0,5,3,3,2,3,7,1,8,0,5,6,2,4,29,19,4,6,13,23,0,2,10,0,9,3,5,2,1,4,11,3,10,30,5,25,3,3,29,3,12,3,17,2,3,15,4,14,1,4,3,1,4,5,9,5,1,7,4,9,6,2,4,4,24,30,10,6,4,6,0,10,10,0,1,3,11,11,17,2,2,11,4,0,9,5,3,5,2,9,3,4,3,18,4,2,7,4,19,2,24,6,3,19,1,8,21,3,8,0,6,7,10,3,32,8,15,12,24,2,2,0,4,3,4,4,13,4,1,4,2,4,7,7,4,6,3,0,3,5,9,5,1,1,1,10,5,5,7,2,2,19,0,5,0,9,4,1,8,12,4,2,0,1,2,8,29,3,6,1,2,2,18,2,0,5,6,20,7,6,11,13,10,0,6,4,3,0,7,3,2,0,1,7,1,5,12,3,3,15,0,1,7,5,6,0,0,1,75,30,1,1,1,6,3,12,2,4,9,2,3,0,4,11,5,14,5,2,4,1,5,5,5,10,3,5,2,1,2,11,0,7,3,3,10,5,5,12,7,2,2,2,4,8,5,10,19,8,2,1,0,2,7,6,2,6,4,3,9,0,6,29,5,7,14,1,3,3,12,1,15,1,6,7,5,3,17,20,4,5,19,1,6,5,7,3,3,13,4,9,4,5,1,8,3,2,3,4,14,12,2,5,15,5,4,2,32,8,11,2,2,3,3,7,3,25,4,6,16,17,6,3,18,6,5,2,8,4,12,0,2,13,0,3,14,7,6,8,2,20,11,12,5,3,2,8,1,6,2,0,9,17,6,72,4,4,4,101,6,2,6,1,8,5,16,1,2,5,6,3,11,8,6,8,5,9,7,9,8,2,48,11,25,2,4,5,0,3,1,19,8,4,15,4,7,1,5,12,8,6,13,10,6,3,10,0,3,9,11,2,4,4,9,5,10,2,6,11,2,5,4,13,8,37,17,3,5,2,7,7,9,21,1,6,4,3,6,4,1,8,2,1,3,9,27,0,31,5,11,6,2,4,6,0,2,4,3,3,5,4,1,3,1,12,3,10,4,3,3,6,1,0,13,11,4,3,5,7,2,2,5,3,2,6,2,6,10,7,3,1,7,9,8,3,2,34,4,10,4,6,1,1,10,5,4,12,5,6,0,9,8,4,2,0,5,4,12,3,4,2,2,4,0,4,6,1,2,1,5,4,2,7,6,3,1,5,14,1,8,3,3,3,4,3,4,15,5,12,9,0,4,5,4,3,3,5,6,5,5,5,5,3,4,1,4,3,5,0,2,0,5,1,3,6,6,4,2,14,5,0,7,0,2,5,3,3,9,3,6,3,3,2,12,4,6,1,4,1,1,9,0,4,2,3,5,4,2,0,3,3,1,12,1,3,0,9,2,10,0,1,1,9,7,6,1,3,1,3,4,8,1,8,3,6,2,15,3,2,2,4,1,5,1,0,1,5,2,6,3,2,4,3,2,13,7,16,26,3,1,2,4,4,6,3,14,4,12,2,5,6,2,3,2,9,6,0,5,2,0,2,4,1,5,2,1,3,4,2,4,3,6,3,2,2,5,1,4,2,3,0,9,0,1,2,3,4,0,0
border,3,4,2,49,3,10,3,17,7,3,13,0,4,48,5,3,9,6,4,2,5,24,4,16,7,11,4,4,8,8,5,96,106,3,31,48,44,5,4,8,1,5,2,2,19,12,8,13,219,30,26,0,7,20,6,6,26,15,10,3,18,6,1,4,6,5,61,2,3,26,9,4,4,0,58,14,11,12,34,9,40,0,15,3,103,7,4,0,13,1,5,4,3,13,25,2,14,6,28,3,4,18,15,10,7,11,2,4,18,4,12,3,14,9,14,14,4,4,21,80,20,37,3,42,4,1,0,2,4,0,5,0,12,39,8,29,2,6,4,3,2,28,22,2,4,54,1,6,13,4,38,2,9,3,2,13,20,6,10,17,0,2,4,0,1,6,16,13,19,12,18,47,16,1,2,12,112,0,7,34,18,18,1,16,0,12,20,18,21,43,1,3,2,0,1,5,11,3,8,3,7,0,0,9,15,6,0,13,5,31,39,8,13,5,5,6,1,2,8,2,0,7,2,12,25,70,12,11,11,6,4,6,11,13,19,7,22,7,1,6,38,29,6,6,4,2,5,16,11,1,4,9,19,1,2,12,16,0,4,19,0,23,4,0,2,17,3,5,11,7,70,5,3,3,6,3,39,4,7,0,32,7,0,10,4,5,6,2,4,1,0,5,0,2,2,8,24,3,1,4,18,10,0,2,5,1,12,5,3,1,0,5,11,4,3,7,7,23,2,0,24,4,16,3,28,8,3,15,6,20,0,1,4,3,4,2,11,9,1,5,18,14,12,7,2,25,21,32,8,9,5,3,3,19,15,0,1,3,4,24,6,9,6,18,3,1,19,2,4,9,4,12,1,6,4,18,7,0,7,6,26,1,23,8,2,30,8,5,27,2,22,0,6,0,20,11,40,3,35,1,9,3,5,1,1,8,1,3,18,10,5,10,2,12,6,5,3,17,2,1,2,10,8,17,0,2,0,7,9,16,1,1,1,6,2,9,3,4,7,0,8,26,2,8,2,5,9,5,18,4,18,2,7,0,33,6,0,11,3,15,5,12,22,13,6,1,15,14,8,0,25,15,1,1,1,8,8,8,7,3,8,5,1,1,0,1,7,7,1,4,51,18,8,2,6,7,0,6,7,5,6,2,0,0,4,3,1,10,3,3,4,2,2,3,5,7,12,3,0,4,2,29,4,10,1,2,34,0,3,18,10,3,11,0,4,3,3,1,28,8,7,0,1,1,2,6,2,6,6,1,6,2,2,61,1,4,27,2,0,7,11,0,12,0,8,9,12,11,10,42,9,12,4,22,1,1,0,8,0,7,1,12,7,5,3,4,3,8,1,3,8,20,8,0,4,2,1,1,30,10,5,0,4,0,6,15,2,12,1,4,7,6,5,4,19,1,11,1,4,8,9,0,2,10,4,3,2,2,2,31,1,16,4,9,4,4,8,3,0,10,3,5,3,15,11,15,5,1,3,131,13,3,0,1,6,15,26,20,6,19,4,8,7,22,3,2,3,6,6,6,13,6,92,13,10,4,1,5,0,4,6,10,9,6,8,3,8,6,8,24,9,7,9,16,3,6,6,2,3,3,7,3,2,4,1,0,15,3,1,2,2,4,6,10,10,21,38,2,2,0,23,2,7,18,5,15,5,2,0,12,7,6,3,4,4,8,5,2,59,14,3,12,1,6,15,1,9,6,3,4,17,0,0,2,5,20,9,5,3,2,0,7,2,2,17,8,3,5,2,18,3,7,0,11,6,11,2,0,29,12,18,2,5,0,4,4,6,35,2,7,3,4,1,1,0,4,0,5,2,1,0,12,5,2,7,3,7,4,13,10,2,3,5,5,5,3,1,1,7,6,8,3,5,0,2,3,3,0,0,2,1,4,0,10,2,3,3,4,12,4,6,3,2,0,1,1,3,6,1,13,8,14,11,4,0,4,5,4,5,2,6,7,12,2,3,7,3,3,1,4,1,2,2,1,1,3,0,2,7,2,3,2,7,6,2,3,3,4,1,3,21,17,0,9,7,9,19,8,13,8,7,13,3,7,0,3,7,5,6,7,5,0,5,0,5,4,6,8,3,2,10,2,2,2,0,2,10,1,1,0,5,2,1,4,1,0,0,0,3,4,0,3,2,0,1,4,0,5,9,1,4,12,2,6,2,0,8,6,7,5,7,10,1,0,1,6,3,1,1,14,13,5,4,1,5,5,1,5,4,17,6,3,2,0,2,2,10,7,5,4,5,0,2,2,0,3,5,1,1,2
contemplate,4,9,1,99,2,13,6,12,4,0,12,9,7,26,6,3,1,4,4,1,7,24,2,18,16,7,7,7,2,6,6,107,69,6,19,23,18,5,7,3,3,6,3,3,22,7,31,2,150,8,34,2,3,19,3,2,21,12,1,16,11,4,2,12,10,2,44,3,2,3,23,5,2,3,17,5,13,2,59,11,33,1,7,1,100,23,11,0,14,2,6,5,0,16,27,8,4,2,20,7,29,19,13,8,6,14,10,0,17,2,8,8,7,7,0,12,1,5,44,72,24,6,1,34,4,1,3,4,1,1,8,2,1,22,12,39,1,0,4,1,1,5,17,2,4,35,1,8,4,8,27,2,9,3,2,16,6,1,5,0,13,1,1,0,0,3,7,7,9,6,9,48,10,0,3,4,78,7,7,22,10,5,5,7,7,18,17,9,9,37,0,4,4,1,0,2,29,4,10,1,8,2,3,3,18,6,9,10,7,16,37,1,9,2,1,0,0,2,3,2,2,11,7,4,23,39,7,18,13,15,6,9,6,13,16,18,21,11,6,0,32,13,1,1,9,6,3,10,36,1,6,16,15,9,6,11,7,2,9,11,4,13,15,3,10,24,1,2,5,3,84,12,19,8,1,0,13,22,8,2,15,4,2,4,4,1,2,2,3,0,3,2,7,6,6,12,20,0,18,18,13,12,2,1,5,0,12,0,1,0,1,4,14,2,33,16,9,29,7,4,10,4,15,5,20,3,9,13,3,11,2,3,1,1,7,23,7,4,8,16,2,4,10,6,6,4,27,45,21,4,4,6,1,20,11,9,1,3,10,12,16,7,5,8,1,1,22,2,3,5,0,5,7,2,3,20,5,0,5,4,40,4,28,5,1,17,1,17,10,5,5,5,9,6,20,7,33,4,20,1,10,2,3,0,4,7,1,0,12,2,0,4,6,8,2,4,3,1,5,1,1,5,12,5,0,0,4,6,9,4,31,4,2,8,2,0,0,3,11,6,4,6,3,9,0,1,9,4,28,5,6,2,3,4,26,5,1,2,1,23,3,8,16,10,6,5,7,10,2,0,4,1,4,0,0,3,1,10,5,8,0,6,3,4,2,1,7,2,0,2,28,26,0,3,6,9,3,8,6,12,3,3,3,1,3,19,1,13,6,7,3,1,5,4,14,6,3,8,3,5,1,3,13,10,4,4,12,5,17,11,1,4,0,5,9,5,6,4,9,9,0,3,1,0,7,3,5,11,9,4,31,8,5,22,7,6,15,1,5,2,25,3,17,4,12,8,9,4,21,24,11,8,23,0,1,9,5,3,3,11,1,8,12,2,3,0,1,2,1,9,12,20,6,3,8,1,4,13,26,14,6,5,0,2,4,14,13,13,1,2,19,11,8,6,19,3,27,1,4,2,15,10,2,27,2,7,7,5,11,19,16,9,9,10,2,2,2,5,1,11,6,0,2,13,3,16,5,6,1,86,17,1,2,5,1,8,17,5,1,2,1,2,9,12,5,3,4,6,8,9,16,3,22,3,9,1,3,14,3,7,3,20,6,5,5,12,6,5,0,6,14,5,7,5,3,17,3,6,6,7,4,0,5,0,10,9,10,5,0,6,1,5,2,16,16,17,7,4,7,5,3,4,0,7,1,1,4,0,2,12,3,18,4,0,2,3,6,2,21,11,7,5,6,19,6,2,6,2,1,3,8,4,9,3,2,7,5,18,5,7,7,5,1,4,7,17,13,3,6,4,2,0,0,4,4,13,4,2,3,6,3,0,4,3,5,3,7,2,10,5,0,3,3,7,8,12,7,2,4,1,1,3,5,1,0,1,1,3,6,3,3,1,1,8,5,5,12,4,3,6,5,2,4,5,14,3,0,8,8,0,5,5,8,2,3,14,9,8,4,3,6,5,0,4,4,2,3,5,13,3,9,14,1,3,1,2,5,2,5,2,10,1,3,6,2,8,2,7,3,10,0,8,16,9,6,1,3,5,13,2,2,2,1,0,4,3,10,1,3,1,3,9,0,4,4,2,2,9,4,0,5,9,5,4,1,0,1,13,1,7,6,12,1,13,7,3,3,7,2,3,9,6,0,3,0,7,0,5,1,7,5,6,7,0,4,10,3,5,2,4,6,2,5,2,1,12,10,11,45,6,5,0,0,2,9,6,13,2,17,0,8,4,1,1,5,5,1,0,0,5,1,4,0,1,4,1,0,6,3,5,8,4,4,15,1,1,2,3,4,0,4,3,1,2,3,1,0,11,4,0
across,12,21,7,65,7,19,4,11,1,4,15,7,12,56,1,5,10,6,11,5,5,24,17,29,10,22,14,26,11,19,3,100,81,20,33,59,15,7,2,6,5,22,6,11,15,8,23,4,190,114,24,6,11,72,29,1,15,13,27,11,14,3,0,8,18,10,54,5,4,26,21,3,4,3,59,10,33,7,32,21,15,1,16,6,94,12,5,1,25,2,9,4,8,21,18,6,18,1,21,4,17,20,6,3,4,18,0,10,15,3,21,2,11,13,11,15,4,6,29,70,12,52,6,59,19,6,3,5,4,3,13,7,7,31,14,60,0,9,5,9,7,20,14,4,7,57,8,18,6,2,26,9,4,3,5,12,30,6,4,34,5,1,13,3,6,17,15,14,11,5,45,67,25,7,5,1,51,1,6,31,17,5,11,16,7,16,19,14,21,33,7,2,5,3,7,4,6,2,8,2,17,2,2,6,11,8,2,9,9,11,39,24,19,6,4,17,1,5,8,8,1,9,2,7,18,18,18,8,9,6,12,6,13,15,14,1,14,8,0,5,18,21,6,6,3,0,3,17,20,7,2,6,23,0,2,4,7,3,2,11,0,28,8,1,2,11,8,17,11,2,42,3,2,5,4,2,31,0,7,1,51,6,3,12,8,1,6,10,5,6,6,3,6,2,9,2,27,5,5,4,19,12,0,4,3,1,7,4,2,4,0,4,11,4,12,8,7,7,2,0,38,3,18,15,59,3,4,32,2,14,10,2,4,0,3,5,16,5,0,3,8,20,17,6,0,7,12,15,10,19,3,7,4,13,13,9,4,2,5,12,4,7,5,5,8,8,21,2,13,30,1,27,4,26,5,17,1,1,10,5,23,10,15,5,11,22,5,12,10,2,12,6,3,10,16,6,13,0,15,8,5,8,0,10,5,2,2,2,19,7,3,16,5,11,2,7,7,10,4,10,2,12,8,12,6,2,4,3,9,15,2,5,2,18,10,5,4,13,11,2,11,18,8,12,7,11,28,4,9,5,22,3,14,0,19,5,6,4,3,9,7,19,8,23,5,2,16,14,10,1,26,10,2,5,3,10,2,7,12,6,7,4,13,7,6,4,2,16,1,1,36,6,4,5,6,1,6,0,0,1,2,1,1,4,14,8,2,6,1,2,1,2,5,1,5,7,6,3,0,6,1,30,1,15,4,5,25,0,3,11,4,3,8,7,2,6,3,1,19,4,1,0,4,3,8,0,18,7,7,7,2,1,3,17,3,3,15,3,3,3,6,7,7,1,6,5,5,6,15,24,2,2,2,3,2,5,1,4,2,9,7,10,5,11,1,1,3,0,0,3,3,15,8,4,4,1,1,5,54,4,5,1,3,6,7,8,3,6,0,0,6,9,4,1,12,1,4,2,5,4,1,0,0,10,2,2,16,3,4,15,1,9,6,5,7,5,4,2,4,10,4,6,1,3,3,11,2,4,3,126,3,2,2,1,4,11,12,6,2,12,0,13,7,8,6,2,1,1,3,2,6,2,34,3,5,5,3,5,50,5,34,13,5,3,3,2,16,3,8,11,4,15,2,38,2,14,7,3,4,9,10,1,6,4,2,5,11,8,0,0,0,7,2,3,4,5,24,1,0,0,1,2,2,6,5,10,6,4,0,5,3,4,2,1,2,3,8,3,32,3,2,10,10,15,10,1,5,8,2,3,9,0,0,14,2,4,4,5,2,2,2,5,3,6,8,5,12,0,1,2,9,12,2,11,0,6,2,0,4,3,0,2,5,1,4,2,1,1,1,4,4,4,6,2,16,4,8,3,0,0,1,6,3,2,7,2,2,5,13,2,4,16,9,5,3,0,2,6,1,0,1,0,6,7,15,1,11,3,1,4,3,2,0,2,2,0,4,8,6,5,0,1,0,3,2,10,2,4,0,4,16,12,0,1,2,4,3,1,1,4,3,7,2,3,0,2,7,3,4,3,3,0,2,2,4,1,1,2,12,7,0,0,2,1,5,0,0,1,21,3,1,26,7,3,2,19,2,9,7,11,3,3,7,1,4,9,19,2,1,7,4,5,4,2,1,6,9,7,3,0,5,3,0,2,2,0,1,5,0,1,0,6,3,2,2,0,3,0,3,5,1,6,0,0,0,3,2,1,1,2,5,5,5,2,2,0,10,25,11,1,1,2,0,5,2,5,0,1,3,20,11,9,5,8,2,8,3,5,17,3,12,1,2,0,6,0,4,11,6,14,2,5,2,1,2,1,5,1,6,8
river,22,14,0,191,2,3,6,31,9,9,38,22,19,69,6,6,4,13,0,2,1,46,6,27,17,11,4,10,6,21,6,328,142,5,44,39,24,14,7,4,4,7,6,0,24,10,32,32,474,10,53,0,10,11,11,6,28,42,3,23,16,0,1,23,28,5,40,1,12,38,21,87,6,5,28,14,23,3,65,16,77,0,27,6,143,19,24,0,36,7,5,5,4,20,39,13,35,3,27,4,57,31,33,9,19,24,2,7,22,5,20,9,10,10,0,28,13,5,106,164,28,6,1,91,8,0,1,2,6,9,13,4,3,58,9,112,4,2,11,4,3,38,24,6,6,94,14,32,18,9,60,2,12,28,3,27,39,0,1,7,20,7,10,2,3,6,5,24,14,3,48,94,26,6,7,9,167,9,6,22,54,8,5,7,21,9,27,43,58,104,3,13,9,0,2,8,21,2,9,4,7,1,4,13,34,4,8,31,35,23,61,4,58,7,2,0,1,0,13,45,5,22,3,42,26,56,42,26,10,11,21,26,5,54,32,23,27,3,6,21,59,43,10,2,9,4,3,9,44,4,10,22,11,5,20,20,4,1,3,21,0,17,43,12,1,35,2,3,33,5,111,5,56,5,5,0,24,32,13,0,36,4,4,14,18,10,3,11,8,3,17,2,11,12,2,8,34,5,20,14,18,49,8,3,16,0,9,8,4,9,1,19,26,2,22,12,21,30,14,2,47,5,28,0,54,17,9,28,1,17,0,14,2,24,4,6,20,5,1,9,6,17,11,15,6,38,34,100,12,4,14,7,11,52,40,12,4,12,24,16,14,19,11,8,14,0,25,10,2,8,3,12,8,6,11,36,3,6,8,21,35,2,55,7,2,55,1,13,39,3,12,4,13,14,42,6,68,2,47,4,14,6,5,0,9,6,11,1,23,15,1,48,2,23,4,9,10,31,1,0,3,14,10,18,0,4,6,12,6,15,10,4,18,11,2,8,0,47,14,4,17,20,15,12,5,18,18,0,20,9,14,5,3,4,135,3,0,15,14,26,8,14,32,16,5,0,3,50,103,1,12,1,4,5,1,8,2,7,10,7,17,13,13,0,11,8,2,3,7,6,49,25,5,4,3,13,13,15,2,1,14,9,5,0,20,15,13,11,5,5,2,4,24,10,3,15,3,10,1,19,8,23,12,17,2,19,17,4,10,22,1,1,14,4,15,2,12,10,45,14,4,2,4,6,7,12,5,19,6,4,20,6,7,52,2,7,61,4,4,4,39,16,34,3,12,6,13,3,30,48,13,8,47,1,11,54,3,16,4,47,2,16,15,11,3,3,5,9,9,11,17,29,4,11,13,16,0,2,102,13,32,5,5,6,8,31,4,8,7,22,33,30,25,11,20,16,34,0,7,5,6,1,5,13,3,11,11,16,12,51,2,25,21,24,23,1,1,18,3,17,8,3,3,17,18,32,5,12,1,245,33,11,6,0,16,20,32,12,6,20,9,38,22,56,10,4,0,31,21,10,21,7,67,6,37,5,7,18,9,5,83,56,10,17,7,6,2,2,10,42,14,0,15,40,7,56,11,5,12,18,16,9,1,10,4,10,31,8,0,3,2,10,5,17,25,19,14,9,11,5,12,5,6,26,3,67,10,2,3,11,9,16,9,5,3,12,20,7,120,15,13,19,5,22,35,2,21,37,1,11,4,1,15,22,11,18,11,15,12,13,9,10,6,4,54,10,40,10,8,28,16,25,2,13,4,11,3,1,18,19,20,9,23,1,15,14,6,65,4,11,8,31,53,5,21,22,3,8,2,0,6,10,8,11,9,0,8,4,9,16,2,12,45,4,9,8,4,18,9,17,2,16,2,20,115,19,0,4,2,22,5,11,3,5,4,4,5,16,11,8,6,16,0,5,3,11,10,12,4,3,25,47,3,7,6,9,2,2,3,3,8,7,4,4,1,4,26,7,10,16,9,10,4,1,5,1,5,17,7,1,2,10,12,6,35,10,5,9,17,9,26,1,0,3,6,20,16,7,3,2,1,11,1,1,3,20,14,8,9,22,6,1,4,16,11,3,16,89,2,5,18,18,4,7,0,9,10,11,14,0,4,8,1,19,4,6,1,6,5,114,1,5,5,1,4,6,2,36,14,11,24,5,1,3,11,5,22,23,22,2,9,117,11,4,2,41,12,1,0,32,0,1,8,1,5,7,6,5,41,19,5,12,25,2,8,0,6,5,32,0,2,1,4,3,0,0,0,14,3,0
college,0,11,4,37,1,15,5,2,1,6,0,2,4,21,0,0,8,2,2,3,0,4,32,17,0,24,6,3,5,6,0,90,31,11,9,28,7,2,4,2,5,1,0,5,3,2,17,7,39,56,11,3,4,16,64,4,2,0,22,4,0,1,3,6,13,5,27,5,0,4,40,0,0,5,35,7,86,0,27,8,23,1,2,1,13,21,1,1,8,0,5,0,21,1,4,7,16,1,14,3,6,21,3,2,2,4,2,24,7,10,11,3,14,7,40,16,0,5,14,10,2,54,45,99,15,1,1,1,2,7,9,15,6,24,7,64,0,2,0,10,1,5,11,0,2,29,2,7,2,1,0,20,5,3,3,10,12,0,0,61,29,0,15,1,3,62,9,3,10,1,11,45,15,3,5,0,7,0,3,39,5,0,14,10,5,3,8,9,2,27,1,2,2,5,3,1,10,6,15,0,11,8,1,0,3,13,1,12,11,0,51,19,12,7,26,44,4,6,3,1,0,9,0,3,15,6,11,8,7,9,2,8,10,0,10,3,10,5,0,0,6,6,3,5,3,0,2,26,27,3,6,4,10,0,1,5,0,3,0,8,1,5,0,0,1,4,52,4,3,2,11,4,1,0,0,7,2,4,0,0,72,0,1,1,9,0,8,14,6,12,0,0,24,6,1,5,9,0,1,2,1,5,0,0,1,4,10,5,1,2,1,10,12,5,33,0,7,1,0,2,12,3,10,30,13,0,5,33,1,2,1,8,0,0,1,24,11,3,2,1,1,17,16,3,1,0,1,22,7,52,1,0,2,23,3,1,13,2,1,14,2,6,7,1,0,8,3,0,12,13,0,15,1,35,0,6,2,1,0,3,4,7,13,3,1,14,1,6,4,0,0,1,7,5,0,6,3,0,2,0,2,3,3,0,1,1,8,2,0,1,4,0,0,1,2,2,0,0,3,0,0,0,11,0,6,0,0,0,0,8,2,0,0,2,5,1,0,0,1,0,2,2,1,4,0,0,10,0,1,4,4,1,8,2,9,1,1,0,3,2,7,12,0,5,0,0,15,13,1,10,16,8,0,11,4,1,2,2,8,6,0,4,0,1,3,0,1,6,1,0,13,0,0,8,2,0,0,0,0,0,0,1,4,2,7,7,1,0,0,0,0,0,0,0,1,2,4,1,0,1,4,0,0,1,1,2,1,2,1,1,3,2,0,0,5,0,0,3,6,3,0,0,0,0,6,1,1,16,0,0,0,0,0,7,3,0,1,2,4,0,2,1,1,0,0,1,0,0,3,3,5,0,0,0,1,0,0,0,0,9,0,2,0,0,3,10,1,0,0,3,0,6,3,2,0,1,2,0,0,0,2,0,9,0,0,2,3,0,0,4,4,0,1,0,2,1,1,2,0,0,1,0,0,3,5,1,0,0,2,1,0,0,1,4,2,2,2,0,7,1,6,5,0,9,1,4,0,0,1,21,2,1,0,1,0,3,3,2,0,1,0,3,0,0,1,0,0,0,0,2,2,0,1,0,2,1,0,1,0,1,0,1,0,1,1,0,0,0,2,1,2,13,2,0,0,7,1,0,0,0,0,1,0,0,1,8,2,5,1,0,0,2,0,3,4,11,6,2,2,9,0,1,4,3,10,0,2,4,3,5,6,2,1,0,1,3,11,1,2,0,0,0,4,4,1,1,2,4,4,2,1,0,1,0,0,0,1,2,3,3,0,22,0,3,5,11,4,0,1,1,2,0,0,0,3,0,28,1,0,1,0,0,1,2,2,1,1,1,2,0,5,2,1,0,2,0,1,1,1,0,3,1,1,1,1,1,0,3,0,1,0,2,0,0,0,0,2,2,1,0,0,0,0,6,7,0,13,1,0,0,4,3,6,0,0,0,0,0,2,1,0,2,0,0,0,0,0,0,0,7,3,3,0,0,5,0,0,2,0,3,0,0,0,0,0,3,0,0,0,2,7,0,0,0,2,0,0,0,0,24,0,1,0,0,0,0,3,0,0,0,7,0,1,0,0,0,0,3,9,5,1,1,2,0,0,0,0,0,0,1,0,34,0,0,0,0,4,1,2,0,0,0,0,0,1,0,0,0,0,2,0,1,0,3,1,0,3,1,0,1,0,1,1,0,4,4,15,0,2,1,5,2,5,1,0,0,0,0,2,0,4,0,0,0,1,0,1,1,0,0,0,0,6,3,0,0,7,0,4,0,2,0,1,0,1,0,1,18,0,20,2,0,0,1,5,12,17,0,10,1
assurance,0,8,3,63,3,1,6,10,1,5,17,4,2,21,2,1,1,3,1,4,5,9,3,15,6,5,4,8,2,11,7,80,50,0,19,26,32,2,6,4,3,2,3,2,17,7,16,2,134,10,11,3,10,20,5,3,21,11,0,8,13,2,2,9,6,2,26,2,5,8,5,0,1,2,17,4,3,3,20,7,24,0,17,2,92,5,4,0,11,0,5,1,0,12,17,7,10,3,18,6,12,18,17,3,5,4,3,2,4,1,8,2,1,3,0,11,2,1,26,83,12,5,7,26,2,6,0,4,0,1,8,4,3,21,3,19,3,3,2,2,4,8,20,0,2,23,2,3,9,2,29,0,9,2,0,5,20,1,5,1,6,2,5,1,0,0,5,6,4,7,8,27,8,1,2,4,88,2,5,14,12,11,5,7,7,10,8,5,15,26,0,3,4,0,0,1,5,3,2,4,14,0,1,6,15,3,2,9,7,11,85,0,8,2,0,0,0,1,10,4,0,8,2,7,18,27,8,9,3,1,4,3,8,6,8,6,21,4,6,5,33,12,4,2,4,4,8,7,19,1,6,16,14,2,3,6,12,0,2,8,1,5,5,1,4,8,0,1,8,4,45,5,6,0,3,1,12,1,1,1,17,3,1,9,7,0,3,1,6,3,2,1,3,5,1,4,50,2,5,2,7,4,0,3,5,1,9,1,5,0,4,3,18,2,10,3,5,16,6,2,15,5,9,0,30,1,2,10,5,8,3,0,1,2,4,11,6,5,2,9,5,5,8,3,0,0,19,31,5,5,6,1,1,15,2,4,4,1,3,15,11,4,1,12,5,2,18,3,2,2,6,4,0,2,1,7,3,4,14,1,21,0,13,4,5,15,1,16,15,0,6,3,7,2,13,3,33,1,12,2,8,0,1,1,1,2,6,9,2,7,2,12,4,2,5,4,1,6,1,0,3,0,7,8,2,1,5,13,10,7,7,4,0,12,4,5,0,5,0,3,12,8,5,8,1,2,5,2,8,0,3,9,1,3,21,3,0,5,2,15,4,7,11,7,2,0,11,5,2,0,8,1,2,0,3,1,1,3,6,6,1,4,4,1,13,1,4,2,1,3,37,12,1,2,1,4,5,2,4,6,3,2,0,1,8,1,2,6,1,2,0,0,8,1,3,7,1,8,1,5,2,9,2,2,0,3,16,0,11,7,1,1,1,2,2,2,6,7,18,5,4,5,0,2,1,8,4,12,4,1,3,3,1,8,5,1,22,2,1,3,6,4,11,1,10,6,8,1,7,14,3,6,18,1,1,3,2,2,2,8,4,6,2,5,3,1,4,3,0,4,11,13,5,0,9,0,2,6,26,11,9,1,0,1,2,10,6,9,2,0,8,5,5,2,6,2,7,2,0,1,10,0,2,10,3,3,11,1,10,7,4,5,13,5,5,5,5,3,0,2,3,2,0,9,2,9,8,1,2,95,8,1,1,0,5,9,11,5,1,13,1,5,7,8,4,1,0,1,3,7,4,5,41,1,13,0,3,9,1,2,2,15,7,1,2,3,8,6,1,2,5,7,14,7,6,7,2,1,11,4,5,2,3,2,4,1,8,3,2,3,1,9,7,22,7,5,3,6,1,1,3,5,3,5,3,2,4,0,4,6,3,5,0,3,3,1,5,2,6,8,3,4,3,5,2,1,6,3,2,1,3,1,1,4,2,5,4,4,0,1,0,5,3,1,13,4,1,5,4,3,3,4,1,3,3,0,1,3,5,3,2,3,6,0,2,5,1,12,2,7,5,3,0,3,2,2,4,4,7,1,3,1,3,4,0,3,10,4,13,3,1,2,7,9,2,0,5,5,4,2,7,1,3,4,0,1,3,3,1,4,2,4,1,2,1,3,5,15,2,3,12,0,0,5,1,1,2,4,6,7,9,11,4,1,0,0,3,1,4,1,4,2,3,1,1,5,5,3,3,5,0,4,0,1,3,5,4,13,7,4,1,2,3,6,2,4,6,4,9,4,3,3,0,1,3,4,3,0,3,2,3,5,1,2,1,1,2,2,8,8,3,2,2,1,2,2,2,3,1,0,6,4,0,3,8,4,7,19,3,2,2,2,4,4,1,2,4,4,0,1,5,1,2,0,1,3,5,5,7,7,0,2,0,2,0,0,4,7,2,8,3,1,3,2,0,14,1,0,0,2,2,8,3,2,10,8,2,0,6,3,1,1,4,5,4,5,1,0,11,1,2,1,3,2,0,0,0,5,2,0
injury,1,8,3,63,10,1,1,10,1,4,31,7,4,38,1,11,0,6,4,5,4,27,0,13,7,4,2,5,1,7,5,101,84,0,30,24,28,6,10,3,5,0,7,1,23,15,14,2,197,2,34,3,6,12,1,8,49,6,0,4,22,14,2,8,8,4,48,2,12,4,7,4,4,4,37,2,7,5,55,12,20,0,11,2,184,4,9,0,29,0,4,3,0,22,31,5,13,0,26,10,2,12,30,7,9,15,6,2,13,3,7,5,0,2,0,26,4,1,25,104,24,21,4,29,1,3,1,5,1,3,6,0,2,19,13,10,26,5,1,4,2,25,25,3,1,45,5,6,6,9,32,0,7,2,0,7,11,2,15,0,4,0,3,1,0,3,2,6,20,6,5,42,11,0,2,38,140,1,1,13,22,12,1,9,1,11,10,17,22,48,1,3,0,0,0,0,2,0,4,9,15,1,2,9,14,8,2,22,11,18,50,0,7,4,0,0,1,0,2,1,0,9,2,9,31,62,18,16,0,3,11,9,17,10,25,16,13,5,2,6,79,21,9,6,8,6,6,9,23,3,7,14,17,1,9,4,14,0,1,8,5,13,18,4,6,12,1,1,2,1,88,2,21,1,5,0,17,4,8,1,28,7,0,14,4,0,0,3,11,0,3,3,4,1,0,7,50,5,1,21,31,19,0,0,11,2,14,1,0,2,0,4,17,0,17,6,9,43,11,1,112,7,34,2,57,10,1,11,7,19,0,6,12,4,5,8,14,10,1,13,18,10,11,6,2,0,30,37,8,3,10,3,3,16,16,1,1,0,7,19,6,1,2,14,3,1,36,2,1,9,3,9,4,7,9,9,4,2,8,4,44,1,23,6,0,19,3,42,18,2,37,2,5,7,25,7,31,0,35,3,15,0,1,1,3,1,10,2,21,5,1,1,3,8,25,8,2,4,6,0,0,4,9,11,2,0,0,7,6,8,3,5,4,3,1,8,0,17,9,6,14,23,3,12,1,2,1,5,15,7,4,8,1,4,30,4,0,8,4,16,7,10,15,1,3,0,7,10,2,0,17,5,3,0,1,2,3,5,13,4,2,7,4,9,8,13,7,6,1,1,71,27,2,6,4,8,3,15,21,5,3,2,3,3,4,16,1,9,1,2,2,8,3,2,5,14,6,5,21,3,3,47,1,10,4,5,20,1,23,19,13,2,2,7,4,3,13,1,26,10,2,1,2,1,5,11,6,29,26,5,7,5,7,28,3,5,32,7,1,9,18,0,12,1,7,9,10,10,24,38,4,4,4,1,2,5,12,6,2,10,4,3,11,13,4,5,8,7,3,7,24,27,4,2,7,5,2,0,63,15,16,4,7,6,16,21,1,10,2,3,19,10,8,5,35,7,11,1,5,2,4,4,3,16,0,7,7,3,21,14,5,15,21,16,6,4,2,6,5,11,9,1,8,13,10,7,0,3,2,149,27,3,5,2,4,10,18,14,9,10,6,3,10,15,11,3,1,10,14,9,13,4,97,31,77,5,1,3,0,2,0,17,11,1,7,1,11,2,2,14,6,10,10,10,8,3,8,9,3,15,2,3,5,6,3,5,14,3,4,2,1,1,6,20,9,13,7,9,4,0,4,3,11,10,3,14,11,0,4,8,4,12,3,6,11,1,11,12,17,1,5,5,2,7,14,1,12,0,5,6,8,3,0,4,1,5,12,8,0,5,4,7,7,2,12,8,4,3,1,16,2,4,0,31,4,15,2,1,1,4,0,2,17,0,4,7,0,21,2,9,9,2,0,6,5,11,7,7,2,1,0,4,10,1,2,0,3,4,12,9,5,2,13,6,7,4,3,7,5,7,6,3,3,2,1,7,1,2,4,2,8,5,7,4,4,4,5,34,9,1,7,5,2,7,17,4,3,9,2,29,34,29,10,3,0,2,6,2,8,0,7,6,4,0,5,8,3,1,10,7,0,0,4,5,8,3,11,15,8,0,4,2,0,3,1,3,8,2,7,4,2,6,0,3,1,15,4,2,3,2,5,5,5,6,0,3,10,3,0,8,2,2,4,9,10,4,1,7,0,1,4,21,5,5,3,2,8,28,11,5,3,1,4,4,2,2,5,6,3,3,5,14,0,3,4,14,4,4,11,13,0,9,0,2,4,3,1,8,8,3,1,0,1,6,3,15,4,4,4,6,8,4,12,2,3,2,8,12,9,5,0,7,8,5,4,3,6,0,39,2,4,1,3,0,0,1,0,4,1,0
april,8,38,10,143,8,2,11,6,9,2,40,31,6,44,2,4,8,4,4,1,1,34,1,32,9,23,1,13,12,20,5,158,55,3,20,32,21,3,3,5,4,0,3,2,9,13,17,3,399,19,17,8,1,17,2,6,44,48,2,15,36,1,3,9,6,11,49,4,4,16,7,10,2,1,25,4,11,16,72,12,13,0,11,1,212,4,8,0,111,5,23,2,4,24,53,2,14,3,27,3,10,16,25,4,3,24,2,6,38,18,15,1,1,13,0,29,40,13,107,76,10,50,8,89,11,1,1,3,5,3,5,1,4,32,7,22,17,6,0,6,0,26,40,2,13,50,2,3,6,5,43,1,8,0,0,8,10,0,28,2,2,0,1,29,4,0,3,7,8,6,35,38,8,0,0,4,107,0,3,6,11,11,0,4,6,3,18,10,47,100,11,3,3,3,2,4,9,0,19,2,1,0,0,14,30,1,6,10,9,12,43,0,18,4,0,2,5,4,7,0,3,19,5,12,30,33,22,9,1,4,7,35,9,13,18,6,24,1,6,0,40,23,5,2,5,7,5,26,34,1,5,7,10,2,2,5,15,12,2,18,3,52,34,30,2,20,1,3,4,1,120,8,41,0,1,0,31,2,21,9,18,0,2,15,4,0,0,1,1,0,58,11,9,10,18,7,45,13,2,9,30,30,2,35,2,0,16,5,0,2,1,2,25,1,47,14,7,29,8,2,65,1,9,5,25,6,2,10,3,22,7,7,6,2,1,11,6,4,3,38,11,14,8,14,0,1,13,36,7,6,8,2,3,22,14,2,4,4,12,16,6,7,3,5,1,0,28,1,3,0,0,5,3,1,8,14,4,1,15,2,21,2,17,5,0,57,3,59,29,0,5,2,12,18,31,4,33,0,73,4,13,2,0,0,6,2,2,4,12,3,0,6,3,5,37,8,3,7,1,0,0,12,11,28,1,2,3,7,16,39,13,64,40,88,2,6,0,23,4,1,12,13,3,5,1,3,5,2,11,8,3,3,1,6,49,9,0,27,0,38,3,17,16,7,1,6,2,25,12,0,21,6,2,0,3,4,2,11,17,0,1,7,2,1,4,26,4,1,3,16,113,25,2,7,3,12,1,47,5,1,3,0,0,0,11,1,0,21,4,4,0,5,8,2,15,8,4,0,0,3,3,35,8,23,5,6,21,1,11,12,5,0,3,2,9,2,9,7,22,8,3,11,1,0,4,8,171,7,24,14,9,10,6,33,4,1,12,3,3,2,20,6,35,3,10,5,9,13,40,30,3,0,14,3,9,13,2,2,4,24,2,24,0,6,4,0,11,3,3,2,6,16,5,2,4,2,0,4,98,5,12,0,2,11,12,9,3,28,2,2,17,34,17,2,24,6,8,0,2,4,4,1,0,32,2,5,9,3,5,13,8,8,7,7,15,0,2,3,2,6,0,1,3,27,11,20,1,41,4,343,37,1,3,1,3,8,34,5,19,34,3,8,76,31,27,14,20,12,6,14,9,2,117,8,76,19,1,12,62,5,36,21,8,3,11,18,11,8,2,21,33,5,16,7,14,14,15,7,5,19,4,4,3,2,2,6,6,0,2,7,4,95,6,16,10,30,39,5,9,3,3,6,8,16,2,4,3,0,1,4,0,12,2,1,10,6,11,5,26,6,4,4,1,14,3,3,7,4,1,4,6,3,4,81,10,10,4,4,2,12,10,5,33,22,9,5,19,2,0,14,3,1,0,19,2,10,0,0,16,5,2,4,6,1,5,2,7,38,0,1,5,6,4,4,12,8,1,7,2,8,4,9,19,12,2,1,1,3,4,7,10,11,38,5,5,2,2,13,9,8,3,3,11,25,31,8,1,21,1,2,5,9,0,4,3,5,6,21,1,5,15,0,0,2,1,6,4,19,0,21,18,36,9,2,1,4,0,5,6,1,13,6,6,3,1,9,1,5,16,11,2,5,9,0,2,3,15,3,13,5,42,19,5,9,22,5,7,3,9,2,19,20,0,4,15,1,4,8,17,4,11,6,4,1,5,80,18,14,2,16,1,1,5,24,3,38,2,10,2,4,4,12,7,8,2,7,5,27,5,4,4,0,5,4,3,1,2,7,5,4,4,4,0,3,3,34,6,9,17,2,13,4,4,2,6,13,0,7,28,6,1,3,1,0,7,61,3,0,1,6,6,7,0,1,9,5,1,6,12,4,2,3,5,2,4,0,3,1,42,0,2,2,3,0,0,2,0,12,0,0
frontier,5,3,2,51,8,3,3,9,3,1,25,0,4,32,4,2,3,2,0,3,1,9,4,15,6,3,4,9,0,1,7,102,57,2,20,41,39,3,0,0,2,6,1,1,12,6,8,5,136,11,12,2,9,12,3,8,20,31,0,12,8,2,1,6,8,0,20,4,5,13,3,4,2,2,27,5,4,2,22,9,25,0,10,2,79,1,10,0,14,0,2,1,0,18,6,1,9,0,13,6,9,15,11,6,3,16,1,0,7,1,8,5,6,2,0,10,6,1,23,54,20,5,0,19,3,0,2,1,2,0,7,6,3,22,5,20,6,1,1,3,2,23,10,2,0,26,1,4,8,12,16,0,7,3,3,0,15,6,6,3,1,1,4,1,0,0,1,17,12,6,13,24,8,3,0,9,87,0,3,6,10,14,1,5,4,3,8,9,19,23,0,5,0,0,1,3,9,0,1,2,4,1,1,1,15,9,2,4,5,18,30,4,5,7,1,0,0,0,3,0,0,9,3,12,25,34,5,8,0,2,14,5,4,4,25,3,18,9,3,10,33,16,5,4,4,2,4,6,22,2,6,2,17,3,12,7,6,0,3,13,0,18,8,1,1,14,3,4,8,2,60,2,4,6,2,0,15,4,6,0,24,1,0,7,4,2,1,3,4,2,2,4,0,1,3,3,17,4,2,7,10,21,0,0,1,0,19,5,4,0,0,2,12,2,2,11,3,18,2,5,38,4,13,1,29,7,0,19,1,8,0,5,4,4,0,4,13,11,0,3,6,7,4,3,3,14,17,33,9,4,2,6,2,6,16,1,0,1,5,10,4,3,6,8,4,2,8,4,1,3,3,6,1,3,3,22,1,1,7,3,22,2,33,4,1,19,1,1,12,3,14,4,1,2,14,0,38,2,22,3,12,5,1,0,2,8,3,5,3,6,4,3,0,4,0,8,1,8,2,0,1,10,4,8,2,1,2,11,13,6,1,1,1,9,1,3,0,1,27,0,13,34,4,7,0,3,5,2,14,2,12,2,2,6,31,1,1,9,1,18,6,6,11,13,1,0,3,12,6,0,12,1,3,1,0,1,4,2,9,1,5,9,2,1,7,9,8,8,6,3,67,17,0,1,0,10,2,6,2,1,5,6,1,1,4,2,1,2,5,10,2,2,4,0,6,5,5,2,1,6,6,13,2,5,2,2,14,0,4,14,7,1,9,1,6,6,6,5,15,2,4,2,1,6,2,5,6,16,5,1,7,3,0,24,6,1,9,1,0,2,21,0,6,1,11,10,12,2,15,14,7,8,9,2,1,1,0,5,1,9,1,7,5,9,5,1,3,6,2,2,6,15,7,2,8,5,0,0,49,9,11,4,2,1,4,15,1,4,2,3,8,9,7,0,14,3,10,2,0,5,17,0,1,7,1,2,3,4,9,13,0,12,20,10,8,0,2,10,3,11,1,3,1,18,14,29,5,0,1,92,6,3,3,0,7,4,16,10,2,9,3,5,12,14,7,2,1,11,7,4,9,5,61,2,13,4,2,5,1,7,5,13,4,3,6,4,8,6,11,17,7,5,12,14,1,9,3,2,4,12,2,5,2,6,3,11,5,7,3,1,2,0,2,22,13,34,28,1,2,4,16,3,7,18,1,8,6,0,2,5,11,10,1,1,6,8,17,7,43,8,4,7,2,4,9,3,6,1,0,5,11,4,1,1,0,8,4,10,4,0,0,5,4,1,12,1,4,3,3,11,2,4,2,6,7,6,0,3,37,10,18,5,10,0,5,7,4,26,2,5,3,4,1,2,0,4,2,6,2,3,2,8,5,2,4,0,3,2,9,7,0,1,5,0,5,2,1,0,4,10,8,2,3,3,6,9,2,1,2,0,2,15,2,9,3,6,8,11,13,4,6,0,1,2,2,2,2,3,2,12,8,7,5,6,0,1,1,3,6,1,5,7,5,4,3,6,6,0,4,5,3,0,0,0,3,2,1,0,1,0,1,3,3,4,12,4,8,5,19,2,2,16,0,3,4,4,1,4,2,4,5,7,3,1,0,1,2,2,3,9,0,0,1,4,3,3,4,8,0,1,2,7,2,1,0,2,1,8,5,0,1,0,3,1,1,0,1,6,6,2,2,2,2,3,1,6,1,9,5,3,1,1,1,4,4,0,14,10,8,8,4,12,1,1,1,6,6,1,1,3,10,3,6,1,6,4,0,2,8,10,1,3,3,0,5,0,9,3,4,0,3,3,1,0,0,0,0,5,3,1
governor,22,29,34,106,7,4,0,23,7,1,12,15,9,18,0,0,7,0,4,3,1,32,11,38,15,32,6,6,4,15,8,92,44,3,22,12,10,2,0,3,0,3,8,4,14,5,13,8,238,24,14,3,4,5,7,1,25,23,21,13,3,0,0,7,10,3,65,1,4,6,2,4,1,9,31,10,8,9,22,8,11,0,11,16,93,6,9,2,30,0,5,5,0,13,9,6,13,5,12,4,1,12,14,4,1,54,0,1,3,2,4,0,3,5,4,9,3,0,73,53,22,21,3,27,8,1,1,4,1,0,12,4,7,27,13,37,3,2,1,1,2,21,12,0,0,49,1,7,5,5,37,3,8,1,1,21,13,1,2,16,4,4,5,1,4,11,4,9,13,18,16,55,13,2,3,9,71,1,6,39,20,6,7,9,5,10,12,12,17,28,2,1,1,1,13,2,13,0,9,3,10,2,8,12,11,5,10,17,4,3,70,5,25,6,4,6,0,8,20,1,0,4,0,5,27,59,10,7,2,3,6,11,10,15,19,7,16,3,2,1,25,12,3,4,1,3,0,6,60,2,2,3,15,0,1,9,10,0,0,5,1,24,31,8,2,11,20,1,4,8,56,6,3,0,0,13,16,6,5,13,25,1,1,5,4,3,5,2,5,4,10,1,8,3,0,7,29,1,3,5,8,26,1,4,2,0,3,6,6,2,6,8,21,2,10,4,3,18,6,8,20,4,4,19,26,3,8,19,4,28,15,4,2,5,1,11,12,5,1,5,8,20,5,11,3,2,26,26,11,7,2,2,5,12,11,1,21,4,3,5,6,8,9,7,0,1,35,3,5,12,1,5,3,1,1,12,6,3,4,1,42,0,9,3,2,11,11,4,18,0,7,2,17,14,10,2,21,9,51,0,9,2,0,2,2,0,3,0,3,3,1,3,4,6,12,4,0,7,1,0,1,6,8,11,0,0,0,3,5,6,8,5,5,14,2,8,0,3,6,3,2,6,4,5,0,5,5,5,11,3,1,2,2,1,7,12,1,11,3,22,7,7,13,11,7,22,10,2,2,2,11,9,1,0,2,5,1,21,8,1,2,2,0,0,5,5,3,4,1,7,23,12,2,1,0,1,2,4,2,2,5,5,1,0,3,22,7,3,4,1,0,4,8,3,5,2,7,5,1,3,0,12,0,36,3,2,20,0,5,19,4,1,3,4,1,0,8,2,13,5,1,0,1,6,2,6,0,10,8,3,60,2,2,20,10,3,1,0,1,5,11,2,20,2,1,10,4,7,14,15,3,3,8,2,7,2,0,1,1,16,0,10,3,3,1,3,2,2,3,7,7,7,1,4,2,0,2,4,8,2,12,2,1,16,5,10,1,15,2,7,10,25,47,0,13,4,3,0,3,6,9,0,6,21,1,0,10,2,5,26,2,7,6,13,6,1,1,3,3,7,0,7,22,36,4,33,7,8,5,67,82,0,2,5,8,3,18,6,6,2,1,7,25,4,0,3,0,11,4,4,5,3,10,19,9,0,1,4,1,3,2,19,8,2,4,0,0,5,6,2,21,5,11,2,4,6,4,4,2,4,0,2,0,0,4,5,10,1,1,9,9,12,1,13,8,13,22,1,5,6,19,3,10,48,3,6,0,0,1,15,1,9,0,0,7,2,3,2,74,4,7,8,6,1,2,1,2,7,4,2,8,5,0,9,2,9,5,22,3,0,0,7,6,2,15,1,6,5,3,2,2,0,5,9,2,3,3,3,8,3,1,1,3,6,8,0,5,19,2,7,5,26,5,2,1,12,3,1,4,10,5,5,7,1,4,1,1,0,8,3,0,0,2,18,0,6,2,6,1,7,2,1,10,23,2,2,3,17,3,2,1,0,2,1,5,1,10,9,4,3,10,32,0,1,1,0,3,7,3,7,22,41,2,0,6,5,3,0,5,0,5,1,5,7,1,4,0,18,4,11,0,6,0,4,3,1,0,0,12,0,0,8,4,0,3,1,5,4,8,9,9,7,3,0,2,8,4,1,10,2,8,16,31,3,36,9,1,0,3,6,5,4,3,0,17,16,7,3,1,2,2,0,1,13,0,6,0,3,0,1,1,2,8,3,5,0,4,4,3,8,1,0,0,0,0,0,0,1,8,1,3,4,0,1,2,4,1,0,17,3,0,13,0,2,2,5,4,0,9,1,7,3,0,2,5,1,2,1,1,15,0,2,8,0,2,0,0,5,3,9,1,5,2,1,1,1,1,2,2,1
five,1,23,7,88,6,11,6,18,1,2,11,14,6,39,3,3,3,12,4,1,6,18,10,29,7,16,6,6,4,36,8,137,49,11,20,26,17,11,11,7,6,4,1,3,22,6,18,11,157,30,17,3,8,21,10,1,38,30,13,15,9,0,0,14,12,6,55,8,0,15,60,0,1,0,47,8,18,5,65,11,66,0,12,4,95,11,9,1,49,4,31,1,9,11,34,24,14,1,23,9,18,15,14,3,20,27,9,7,32,9,17,5,5,23,16,12,8,2,50,67,25,30,33,207,25,1,1,2,20,4,2,7,10,39,8,46,2,5,2,5,0,13,25,7,3,52,6,14,8,13,23,5,7,1,1,13,11,5,0,17,13,2,8,1,17,9,16,13,14,1,18,111,20,4,4,4,97,3,5,32,16,10,14,15,5,8,23,10,9,93,2,1,5,4,6,8,9,7,37,5,21,3,4,4,7,2,11,12,13,8,42,4,16,8,6,13,2,2,15,1,0,12,1,8,31,67,23,21,30,20,5,52,13,14,16,23,22,1,2,2,29,14,8,6,6,3,1,17,44,4,9,10,6,14,4,9,8,5,2,39,4,16,5,10,1,44,13,4,4,4,62,7,35,1,5,7,10,16,6,2,36,3,5,8,15,2,3,5,5,2,5,5,15,22,6,6,35,4,6,4,10,18,6,3,1,1,12,3,6,2,0,11,17,3,37,10,2,27,6,2,21,3,12,12,22,3,3,16,5,30,2,11,2,2,5,7,9,4,2,17,7,11,10,6,5,4,9,23,9,5,2,3,2,11,10,7,6,8,8,23,13,7,7,6,0,3,16,0,8,11,2,18,5,9,4,29,4,1,3,5,37,1,27,4,4,30,7,10,6,0,5,5,11,4,14,4,30,1,10,5,5,5,2,4,7,0,7,0,10,6,0,6,7,9,0,1,4,7,1,4,3,2,13,5,5,4,4,5,5,15,14,9,13,14,2,4,4,6,13,2,12,7,2,4,1,4,16,1,19,5,8,7,5,4,19,4,0,8,2,23,8,13,11,20,5,4,14,7,6,4,13,5,6,3,3,8,2,6,12,5,5,13,3,2,5,7,7,5,2,3,41,31,1,0,1,8,4,12,4,0,9,3,6,2,2,28,6,4,7,4,4,2,5,4,9,4,9,4,2,11,1,13,3,12,3,6,8,6,13,11,11,1,3,6,6,4,1,2,9,13,5,3,9,9,11,4,0,4,4,5,7,4,5,49,5,5,8,5,5,4,11,7,26,5,2,9,7,12,17,15,4,8,17,2,11,2,5,1,5,11,2,6,7,10,2,1,9,0,3,9,9,7,1,3,3,4,7,2,25,3,10,4,1,5,2,5,1,7,4,0,9,18,20,1,17,2,5,0,4,3,4,15,1,24,3,5,4,3,3,13,14,10,6,8,3,1,8,12,2,16,8,2,3,18,1,27,1,3,3,78,12,4,3,1,1,12,18,12,4,12,1,1,12,5,2,6,1,2,0,8,15,4,22,14,6,2,4,5,4,5,4,28,3,3,4,4,5,0,5,12,13,10,11,7,4,21,9,6,11,7,13,0,3,6,2,17,4,6,3,1,5,20,0,8,4,6,2,0,2,6,9,2,2,14,5,2,7,2,6,9,8,7,13,4,3,10,40,1,22,9,0,1,7,54,11,2,14,6,3,2,6,11,3,14,7,5,6,4,6,24,24,6,4,13,12,9,14,1,8,4,4,1,3,7,3,6,10,1,15,5,21,2,6,14,4,4,4,14,15,10,5,18,10,2,7,10,2,13,1,3,3,3,11,9,3,0,8,3,7,9,4,11,19,12,3,4,0,2,6,4,0,8,12,21,2,5,2,13,6,6,11,5,6,2,2,3,3,17,1,6,3,4,4,4,0,18,5,9,2,8,7,18,9,3,3,3,1,11,3,4,7,2,1,3,2,2,2,1,5,6,4,3,14,8,1,5,0,9,1,3,9,14,2,0,12,2,3,2,13,4,7,3,9,3,3,17,2,10,1,4,3,3,2,7,7,9,7,9,6,12,5,7,4,15,5,8,9,0,4,4,1,1,6,1,0,4,2,4,2,14,6,4,2,6,2,2,7,7,3,4,3,12,11,5,5,16,11,19,39,2,7,4,9,5,2,9,6,6,16,2,17,2,0,2,5,19,9,3,3,2,1,4,6,4,6,0,4,3,6,3,9,5,2,11,4,10,2,7,18,3,4,3,5,0,5,5,6,8,1,2
fight,5,11,8,57,20,29,4,13,3,11,6,7,21,112,1,7,8,10,14,22,0,18,29,34,11,31,42,44,20,36,14,105,88,31,44,123,92,1,9,16,6,58,4,9,28,6,15,7,68,93,46,14,11,119,17,8,23,10,34,16,0,10,4,10,18,19,88,7,8,21,35,5,10,2,132,13,39,4,44,30,23,15,4,17,63,5,10,1,15,1,14,4,5,31,10,6,15,2,43,8,2,22,9,17,8,24,2,12,10,10,17,2,5,14,7,33,1,3,24,85,26,64,4,91,9,6,3,2,2,4,29,11,19,57,51,67,4,5,13,14,13,28,19,0,4,60,10,10,2,0,34,3,13,4,2,17,39,5,13,67,16,0,17,5,14,31,9,25,19,4,17,92,29,8,15,4,77,7,6,68,13,15,16,25,0,17,23,11,5,35,5,4,4,6,4,9,11,11,14,14,4,1,1,6,15,10,2,6,9,5,61,28,7,3,18,29,3,14,6,0,2,18,2,9,8,33,36,27,6,9,9,15,14,6,21,1,35,5,4,13,33,26,11,12,23,10,10,58,29,7,6,5,16,0,0,23,2,9,0,23,0,65,2,0,1,4,6,29,15,5,46,12,2,3,4,7,37,7,0,0,59,8,4,13,10,3,9,11,22,6,2,5,2,9,10,2,18,1,6,13,31,6,5,2,0,0,18,3,2,5,2,9,22,14,14,9,4,10,6,6,14,1,32,8,66,0,5,65,1,32,16,3,5,1,3,2,32,1,1,5,8,22,22,2,1,7,9,24,19,16,1,7,3,25,15,1,15,5,6,33,8,8,7,4,2,17,12,14,10,41,2,60,0,22,4,17,5,2,15,4,21,2,23,7,23,21,11,15,17,3,20,8,7,2,3,14,2,2,16,3,10,15,2,18,3,2,4,5,8,12,6,12,3,14,5,12,6,29,10,32,0,7,11,6,13,4,5,3,3,17,1,1,0,8,10,1,5,7,21,2,10,3,3,10,7,16,44,11,7,7,36,0,14,4,37,2,11,2,9,3,16,28,15,108,6,5,46,9,6,7,44,16,1,12,6,27,4,2,16,7,15,10,2,8,10,3,1,13,0,3,203,4,10,10,20,4,1,5,4,5,6,8,4,3,5,3,5,2,2,3,0,3,1,0,2,2,6,2,0,19,4,7,0,9,2,8,17,0,8,9,13,12,20,8,9,5,4,11,14,2,10,1,6,4,1,3,3,3,2,1,12,3,2,13,9,5,8,1,4,1,3,0,3,5,3,4,6,6,12,16,4,0,0,1,0,0,1,0,3,15,0,10,8,25,5,9,4,2,0,9,19,6,15,2,1,3,4,4,6,5,5,3,4,2,1,4,3,2,3,0,16,5,6,0,13,0,0,1,1,2,4,0,0,8,2,1,1,0,4,10,2,2,11,5,6,1,2,8,17,3,6,3,0,13,1,10,1,1,0,59,8,9,1,3,1,8,5,5,6,7,1,9,3,8,0,0,0,3,0,2,12,3,9,4,8,6,0,0,0,1,2,14,4,3,4,0,5,2,4,2,3,13,4,3,0,9,4,2,5,3,6,0,1,5,3,5,8,15,0,0,3,5,7,4,7,32,28,3,9,13,11,1,8,21,19,7,3,1,2,9,0,3,2,5,1,1,41,4,5,2,5,1,3,37,23,4,9,7,12,5,14,1,0,3,4,7,2,1,0,0,0,10,2,1,10,8,9,1,0,6,9,5,6,10,0,4,7,3,3,2,2,0,9,1,4,1,1,3,9,5,3,3,1,0,2,7,0,2,0,1,1,2,1,0,20,9,8,6,5,4,0,4,4,3,0,0,3,9,1,3,0,1,5,0,1,4,6,2,4,4,6,3,3,24,6,3,4,25,7,0,0,1,0,2,1,0,3,10,0,3,7,5,4,0,2,2,3,0,1,4,0,11,3,0,1,0,5,0,17,2,1,13,1,0,6,3,0,1,4,18,4,1,2,1,0,2,2,0,8,0,11,2,5,2,2,4,4,2,4,1,2,2,17,3,6,1,5,0,0,5,1,2,5,0,0,2,4,0,12,3,0,0,2,0,4,2,6,4,1,0,0,1,5,3,1,3,0,1,0,2,3,8,3,0,0,1,3,3,0,0,2,14,6,7,5,0,4,3,2,1,0,0,2,1,3,8,1,5,2,0,30,6,10,10,1,6,9,0,0,1,0,1,0,4,2,0,1,15,2,6,4,3,1,4,3,2,3,1,4,22
relieve,3,13,9,65,3,2,2,19,2,5,14,4,5,27,1,5,2,12,5,5,2,26,8,9,9,8,7,8,0,10,7,117,79,7,35,19,20,7,11,2,26,0,2,5,17,15,24,6,124,4,29,2,9,15,7,3,38,13,1,11,9,4,0,6,8,5,64,2,1,21,7,0,4,1,49,8,14,9,34,9,47,0,10,5,168,17,9,0,17,3,4,3,1,9,37,9,6,9,23,26,9,23,13,6,8,18,15,1,5,1,14,6,5,22,1,16,2,3,48,157,34,16,32,20,4,1,3,3,1,1,5,1,4,41,5,25,6,1,6,4,0,12,13,4,1,31,6,9,17,11,32,3,7,4,1,35,18,2,3,6,8,4,8,3,0,2,5,18,11,7,15,45,17,3,2,3,112,5,5,21,15,4,2,9,1,14,20,7,18,14,1,2,7,0,1,2,15,0,4,13,28,6,3,10,19,10,9,23,8,22,37,2,14,10,0,2,2,4,14,5,5,9,5,7,28,60,11,16,1,3,9,5,26,10,11,26,15,5,8,4,53,18,4,3,6,14,2,10,29,5,12,10,10,11,3,18,11,4,4,18,6,17,16,1,4,30,8,2,12,6,93,9,20,3,4,0,16,10,8,2,41,2,2,14,4,3,3,11,8,2,1,1,12,3,1,7,24,2,5,5,15,23,0,1,6,1,14,3,7,0,3,13,24,4,33,13,19,29,9,2,37,6,13,2,19,5,3,12,1,21,3,8,4,8,4,8,7,1,9,3,9,7,10,11,7,7,32,35,14,14,9,4,4,24,17,1,1,4,11,14,13,8,10,17,5,0,28,1,6,4,1,13,3,10,5,12,5,5,11,6,37,1,23,9,3,24,5,12,20,4,7,2,2,14,20,9,33,6,18,5,12,1,2,1,1,5,7,1,24,10,1,5,6,6,9,7,0,14,2,2,3,4,13,8,2,3,2,7,5,15,9,2,6,3,0,3,0,10,5,4,13,15,6,7,0,3,13,4,29,6,10,4,2,2,30,8,0,2,4,21,6,5,12,13,6,2,24,12,9,0,11,3,2,0,1,5,1,9,14,4,6,6,0,2,5,8,20,1,2,0,48,20,4,2,10,6,6,12,6,8,8,2,1,3,4,38,11,10,4,2,9,4,3,4,6,12,5,8,1,4,4,13,7,5,5,3,23,6,7,11,5,1,8,3,3,4,2,7,23,15,7,0,2,12,7,3,1,16,6,4,21,2,6,20,4,6,12,7,10,6,26,4,14,1,12,24,4,6,18,20,6,4,10,1,3,5,16,6,3,13,11,10,15,12,7,2,4,9,1,3,14,19,4,5,18,0,1,2,23,12,12,2,4,0,8,12,5,17,11,6,13,15,4,5,19,6,15,7,6,3,8,4,6,11,3,3,0,8,6,16,17,17,10,13,8,4,6,6,3,7,3,0,6,19,3,15,8,6,7,50,9,4,7,4,2,7,41,7,4,12,5,5,11,9,4,2,0,5,9,5,11,6,19,16,14,6,2,4,6,1,13,21,6,9,6,5,12,5,2,4,9,5,10,3,9,4,7,4,24,13,3,6,4,2,7,2,14,5,12,1,4,3,5,18,10,14,5,4,3,8,3,4,3,12,0,3,2,6,2,5,4,12,2,6,12,4,6,5,12,8,8,2,9,2,3,7,8,12,3,9,12,4,4,9,3,13,8,7,2,8,11,12,0,2,10,18,7,6,16,10,0,1,0,5,1,8,12,5,19,14,1,7,10,2,2,4,10,0,8,7,5,4,3,2,6,15,4,2,3,9,3,3,7,1,5,1,10,5,10,5,8,5,1,4,4,1,2,8,5,6,2,2,3,2,3,4,3,3,6,4,5,2,12,3,4,7,9,17,4,0,0,0,7,11,12,3,6,6,6,8,12,19,6,2,4,4,6,6,1,2,12,3,2,3,5,10,1,1,4,13,1,7,6,9,2,3,1,3,5,2,5,3,3,6,2,3,3,3,7,5,3,1,1,3,5,11,5,8,3,2,1,1,2,8,3,1,6,11,5,11,4,12,7,9,9,2,4,12,4,4,8,2,2,10,4,4,4,1,4,6,5,1,1,1,2,3,7,1,1,9,1,6,3,7,9,23,14,3,36,0,1,2,2,6,5,3,0,2,12,7,3,6,7,4,1,10,9,1,2,2,17,4,5,3,4,3,4,4,4,4,1,2,3,5,2,15,4,7,15,0,1,1,6,0,9,4,1,1,2,0
instruction,16,17,1,83,15,4,5,16,9,3,12,11,1,24,3,1,6,6,3,1,8,17,1,11,9,8,9,11,1,10,15,102,52,1,23,19,22,4,3,2,3,4,8,1,9,13,14,3,226,10,56,1,4,2,4,9,54,14,0,5,12,2,1,11,6,2,46,1,8,6,1,2,0,0,16,5,3,3,31,9,7,0,13,1,123,10,16,0,22,1,10,4,0,13,27,0,18,0,11,9,6,12,24,10,7,13,6,1,5,2,8,4,2,2,0,11,5,3,56,65,23,5,3,17,0,2,0,1,3,0,5,0,2,26,9,14,5,2,2,0,0,20,15,0,1,42,2,2,5,6,27,0,14,1,2,2,4,7,4,0,2,1,2,0,0,4,1,11,13,9,3,32,13,0,0,8,85,1,8,3,15,7,0,9,5,4,14,22,26,35,2,3,6,0,0,0,8,1,9,3,3,2,0,9,15,1,8,9,8,15,101,0,18,3,0,0,0,0,2,1,0,2,5,12,42,41,4,13,0,0,5,2,2,6,1,2,17,10,3,1,41,19,4,2,2,0,4,9,14,1,7,8,15,2,8,9,5,0,2,7,0,16,24,4,4,18,5,1,5,2,66,1,7,2,2,0,7,0,12,0,21,0,0,7,5,0,2,8,5,0,2,4,11,1,2,12,44,10,9,8,15,10,0,1,2,0,10,2,1,0,0,3,17,0,16,11,5,25,2,7,22,2,11,8,30,4,2,23,4,9,4,5,1,1,2,13,7,9,2,10,9,16,10,13,0,0,19,36,11,0,4,5,2,15,16,0,1,3,11,7,4,4,4,10,0,0,29,2,0,2,2,6,2,4,3,16,8,0,9,3,31,1,17,4,0,7,0,19,18,1,7,1,10,11,30,2,56,2,26,1,16,0,0,0,2,0,2,2,20,3,0,3,5,8,6,7,15,4,1,0,0,4,11,9,1,2,1,14,17,8,8,4,2,13,0,4,0,19,2,2,8,15,2,6,0,2,1,4,7,1,6,9,2,9,35,6,1,14,2,26,8,4,9,7,9,0,6,7,5,0,5,4,0,0,1,4,2,11,5,8,0,5,2,2,1,7,6,3,4,1,45,32,2,6,3,3,1,7,9,2,1,3,2,0,1,3,0,8,1,4,3,4,9,3,10,12,4,3,1,3,1,11,2,12,1,5,16,0,17,27,5,6,2,5,9,10,15,5,15,8,4,0,0,0,1,11,3,10,6,2,24,10,1,31,7,4,18,1,1,6,22,5,17,0,15,5,12,4,19,13,2,4,9,5,6,4,5,5,1,2,2,22,5,9,4,1,0,5,4,10,12,18,2,1,3,4,4,0,68,7,13,0,1,11,4,11,3,15,7,2,17,8,8,3,11,0,21,2,5,12,11,5,1,20,0,2,11,4,9,11,3,11,5,15,4,1,0,1,1,6,4,0,1,32,9,42,2,5,4,140,15,3,11,1,8,13,28,2,2,2,1,6,19,21,18,13,1,9,4,13,12,9,44,1,25,0,5,7,0,3,0,17,15,5,6,5,6,4,1,2,13,4,8,3,6,6,7,3,5,13,5,1,6,1,10,6,19,2,2,24,4,8,5,15,9,50,19,7,7,8,17,3,7,33,4,8,5,0,1,5,4,12,2,3,4,7,4,2,43,3,4,4,3,6,7,0,9,3,6,3,8,5,1,13,1,10,12,8,6,2,2,3,3,0,9,3,1,3,0,8,1,1,0,5,2,7,1,1,9,9,8,3,2,0,2,6,5,20,8,17,7,3,0,4,1,7,2,6,3,5,2,8,4,5,1,0,1,2,16,2,6,6,3,14,2,3,5,3,4,6,7,5,5,9,5,4,2,7,7,4,1,5,7,2,2,6,14,13,7,6,19,5,0,7,2,0,1,4,5,10,14,28,5,2,8,2,5,1,7,0,15,2,5,2,0,1,3,6,3,3,2,4,1,3,2,3,7,14,9,0,4,8,5,6,24,7,9,3,13,9,3,11,1,5,5,6,7,16,3,2,1,1,6,3,5,7,3,8,2,12,1,0,2,3,10,5,1,2,1,2,7,4,4,20,4,12,4,78,4,2,3,8,7,6,2,2,1,1,3,4,1,5,1,0,0,8,1,1,2,7,4,5,3,0,2,1,2,1,16,1,2,3,2,0,1,6,0,0,1,3,6,7,2,0,9,4,0,6,4,6,0,3,3,3,4,0,6,1,28,1,2,3,4,0,0,0,0,6,5,0
military,1,8,7,68,12,7,4,14,1,2,4,4,7,58,1,1,9,7,7,7,2,19,12,13,5,20,21,18,9,26,11,84,59,25,35,61,41,2,2,7,4,17,5,7,16,8,8,6,99,59,31,7,5,59,1,4,24,19,13,17,1,5,0,6,5,7,51,4,1,3,12,6,4,3,69,5,10,2,42,11,24,0,3,4,71,3,5,7,19,2,6,3,0,29,9,0,8,2,28,3,8,17,9,8,4,21,1,8,8,3,11,4,5,2,4,15,3,1,27,42,21,23,10,42,7,3,4,3,4,2,11,7,2,39,15,56,3,0,6,8,3,14,14,1,2,53,7,10,8,8,28,0,5,7,1,4,23,8,8,24,4,1,2,1,17,13,2,14,15,3,18,50,6,2,12,3,47,5,2,41,9,5,11,19,8,11,16,4,5,25,1,4,2,2,3,3,6,4,2,3,6,0,1,2,19,5,4,10,7,5,46,11,8,5,6,4,2,13,15,4,5,5,3,10,17,50,15,19,9,8,8,5,9,15,12,10,13,3,1,11,27,8,3,3,7,4,1,35,40,5,1,1,4,2,3,3,5,2,1,8,1,41,8,2,1,20,7,23,8,4,44,4,7,1,2,4,21,7,1,1,35,0,0,4,4,2,8,14,8,4,3,6,2,9,4,4,8,4,4,6,12,16,1,2,1,3,15,2,1,2,3,4,19,10,19,9,8,5,3,3,17,0,14,5,39,4,9,16,2,15,7,5,6,1,2,4,12,5,3,8,4,12,16,5,2,6,14,20,9,11,8,2,1,24,11,1,1,4,4,23,4,5,6,9,5,11,19,2,8,23,4,35,0,13,7,20,8,2,11,4,30,0,13,1,24,8,8,9,11,0,5,3,2,3,12,6,20,2,49,0,6,14,3,6,1,0,4,2,7,12,2,3,2,6,12,13,7,3,3,21,4,6,12,5,2,1,0,4,5,3,3,6,4,8,3,3,2,6,32,3,18,3,0,11,2,5,24,8,18,10,25,2,11,9,17,9,6,5,4,15,8,6,11,29,4,12,17,7,1,2,16,6,0,1,0,4,5,4,5,0,2,8,3,4,7,1,2,6,1,18,79,13,1,4,11,2,1,6,1,0,4,4,0,2,1,2,0,6,4,3,1,2,4,5,5,3,3,3,0,5,4,2,0,26,3,5,10,0,8,6,12,2,5,5,4,7,6,3,15,0,2,2,4,1,1,1,3,12,3,1,9,5,3,19,10,4,11,6,1,3,10,1,4,1,3,9,6,0,12,24,5,2,10,3,4,0,0,0,0,21,3,14,12,11,1,6,0,6,3,10,5,10,9,3,7,1,0,0,14,5,3,1,7,1,4,8,4,8,2,6,12,19,9,4,3,8,6,1,7,6,5,0,3,11,1,2,4,4,3,18,2,9,3,5,5,1,2,2,13,8,6,3,1,11,1,17,1,8,4,77,44,7,1,0,2,11,13,2,2,3,1,3,6,4,3,2,0,1,3,4,5,3,39,7,4,1,1,1,2,7,5,13,3,8,2,4,4,2,7,9,6,13,4,7,4,9,3,3,7,4,1,2,2,3,5,6,3,12,2,3,3,3,4,12,10,42,24,4,4,5,4,1,9,27,7,14,0,2,1,7,2,5,0,5,2,2,31,1,15,2,3,7,5,8,6,5,10,7,4,4,8,3,3,5,1,8,3,27,0,1,1,4,0,5,7,6,12,2,1,3,7,0,3,1,10,5,1,0,2,3,0,2,6,0,4,1,1,16,4,5,2,1,0,2,1,2,2,2,6,1,5,3,1,1,6,3,0,2,4,1,7,2,6,4,0,4,3,10,1,2,3,1,4,14,2,3,10,0,3,1,4,2,10,10,6,5,1,9,9,3,3,0,0,1,0,0,3,6,3,6,3,15,6,8,4,10,3,4,5,3,0,4,1,2,2,3,2,5,3,9,2,0,0,0,1,1,3,4,4,14,2,3,5,0,1,0,4,1,3,5,7,1,2,1,5,4,3,31,2,17,2,6,1,3,1,5,0,2,5,3,2,0,1,6,4,7,3,1,2,3,2,0,2,1,5,12,2,0,2,2,1,0,3,4,6,0,3,1,2,6,5,4,8,5,0,8,5,9,10,0,18,0,4,3,3,4,3,8,6,0,1,3,2,1,3,3,1,3,1,4,16,2,4,8,0,1,11,1,1,6,1,1,0,0,2,0,3,7,11,3,6,4,3,7,1,0,2,5,10,8
affair,9,18,9,103,7,4,7,28,11,4,24,7,7,67,4,12,2,17,4,6,5,29,8,26,18,4,9,12,5,6,12,139,89,11,37,48,49,4,4,3,4,5,10,2,21,16,9,20,289,33,33,4,17,53,8,7,42,40,1,16,39,15,4,14,30,0,92,3,4,16,6,2,6,6,62,14,7,13,66,32,30,2,16,4,220,16,3,0,47,2,4,5,1,31,64,3,18,5,33,6,3,16,24,10,8,25,6,2,13,7,8,2,6,16,0,24,5,2,50,155,43,9,8,45,3,16,4,6,3,0,2,5,8,28,11,22,5,0,6,3,2,31,22,4,3,47,6,17,9,4,52,0,10,5,6,19,23,6,9,4,3,0,4,2,1,2,6,17,25,6,11,63,29,1,3,10,140,9,14,19,16,6,3,8,3,13,18,15,32,52,0,5,3,2,0,3,10,2,5,6,20,4,0,12,25,14,1,20,3,24,61,4,14,4,3,2,0,0,14,4,2,15,3,14,42,49,22,13,4,5,11,7,14,22,20,9,18,10,4,10,45,38,4,5,8,3,3,24,25,6,11,9,35,2,6,9,19,0,1,11,3,31,15,8,6,36,6,4,13,3,89,3,14,3,2,0,16,6,13,10,45,5,3,18,11,3,6,5,11,3,2,2,7,8,0,10,42,5,3,14,27,23,0,5,20,2,20,3,8,2,1,9,14,3,25,5,4,35,14,5,42,15,26,11,72,5,5,27,4,28,2,14,5,3,10,7,21,15,2,16,20,14,12,16,4,6,49,36,18,3,7,19,7,19,28,1,3,4,9,34,18,5,10,14,4,0,48,9,3,5,3,17,2,9,3,9,10,2,13,7,59,1,41,22,4,20,8,19,19,5,24,5,12,8,35,12,51,6,18,6,15,1,3,4,6,1,3,11,17,11,6,10,8,10,28,11,7,13,1,1,7,8,11,13,1,10,4,28,18,10,12,5,4,19,1,4,0,10,8,3,5,20,5,15,3,3,3,9,54,4,7,7,1,6,30,11,1,7,0,26,18,17,25,29,2,7,15,7,10,0,13,0,9,0,6,4,8,16,15,1,5,8,1,9,11,4,8,5,3,6,63,48,2,6,14,6,1,15,6,7,10,8,2,0,4,27,4,9,6,2,5,0,7,1,15,15,5,8,1,5,10,23,8,22,13,4,18,9,10,18,7,6,8,6,5,8,7,16,47,12,5,4,2,3,7,5,10,15,14,9,27,5,4,37,6,7,22,3,11,7,15,3,11,2,13,14,11,8,35,19,6,8,12,0,11,4,3,4,6,5,1,12,13,19,7,5,10,9,1,5,18,37,10,2,15,5,8,1,25,32,23,1,7,4,11,21,4,20,0,2,20,15,20,4,13,10,17,1,6,3,4,4,1,4,6,6,8,14,16,19,8,23,16,19,9,0,6,3,5,8,5,1,7,27,7,29,5,9,2,168,35,1,5,3,2,9,32,20,7,8,4,4,4,12,8,3,1,5,15,12,14,4,42,31,14,12,6,9,3,6,2,15,26,4,8,14,23,1,3,7,10,9,14,11,9,3,10,3,12,8,7,9,13,4,5,7,17,4,1,4,2,7,11,22,15,17,5,9,4,9,6,2,9,15,2,3,7,4,4,13,3,12,4,4,5,5,20,7,36,13,7,10,2,3,10,3,10,2,1,6,4,4,2,7,2,13,7,11,3,4,3,16,5,2,18,15,13,9,5,10,4,1,1,7,1,19,6,9,54,12,10,4,6,7,4,9,3,5,6,13,6,22,10,2,4,9,1,4,7,4,3,7,23,7,4,7,15,7,7,7,7,5,4,8,0,5,6,5,10,14,9,2,3,6,1,4,3,5,3,3,4,5,20,5,5,9,14,21,15,9,7,8,9,2,4,4,5,1,6,7,39,27,8,2,2,6,9,9,6,2,4,7,8,3,5,3,5,2,12,11,6,3,2,2,4,6,0,10,16,2,0,7,4,12,25,4,14,12,7,4,1,1,0,2,6,1,1,3,7,3,8,3,3,1,1,9,6,4,1,22,14,5,17,5,8,2,0,1,6,5,10,7,1,3,5,5,2,24,10,2,9,0,14,8,5,0,2,3,3,8,4,12,2,1,6,9,18,4,11,3,1,3,1,2,2,8,1,8,3,16,1,4,4,3,2,22,13,0,1,4,11,6,8,2,5,6,2,7,13,9,1,4,5,2,4,5,15,3,32,3,1,4,4,2,2,1,1,6,1,1
election,3,79,62,184,3,1,1,94,3,0,11,4,9,24,3,17,9,9,10,7,12,44,6,24,18,4,9,11,2,40,8,96,76,4,30,43,16,0,2,7,1,43,0,2,15,10,26,7,382,7,45,2,8,12,1,0,55,13,2,23,15,3,6,4,16,4,153,18,2,6,13,2,0,2,55,7,25,1,77,17,6,1,5,6,143,17,4,3,28,1,7,3,0,22,32,3,2,0,22,2,1,24,28,4,8,57,2,1,13,6,12,2,1,4,1,10,0,4,76,118,36,7,6,77,12,0,0,5,4,2,11,3,28,31,13,23,6,17,6,4,3,20,18,5,1,78,7,6,9,5,67,2,30,0,1,44,19,2,5,6,10,0,5,0,3,4,5,12,2,15,20,57,10,1,2,3,140,0,8,23,4,26,2,17,1,12,16,8,52,32,8,2,4,1,5,9,6,2,34,4,1,0,0,12,17,8,0,19,24,5,60,4,50,2,7,6,2,3,39,1,0,21,8,5,36,182,33,24,6,2,11,18,7,29,25,1,28,1,0,2,100,34,5,1,12,4,5,3,71,9,11,6,6,2,4,12,16,0,6,24,0,9,39,8,3,12,0,5,19,3,129,6,1,2,4,0,14,20,18,3,51,7,1,18,10,0,1,2,23,2,8,2,19,7,1,4,35,1,14,20,8,30,0,7,20,1,4,0,2,1,2,20,28,0,7,0,14,61,4,3,40,2,15,0,67,0,2,27,0,55,82,5,2,0,3,12,3,5,1,4,8,11,9,10,1,0,38,45,5,10,6,5,2,9,27,0,26,0,7,23,25,3,2,12,0,6,39,23,14,13,1,21,3,9,7,8,9,1,25,2,104,3,22,4,1,8,6,6,24,2,11,8,41,15,31,6,35,7,38,8,22,2,10,2,1,6,2,1,0,6,0,23,0,7,16,5,0,3,0,1,3,0,26,7,4,3,4,23,14,14,1,5,10,16,5,7,1,0,2,10,7,18,4,0,1,6,1,5,8,6,10,6,2,3,41,4,0,22,8,15,6,16,22,16,4,1,8,7,0,3,12,7,4,0,1,3,1,69,13,4,2,20,0,2,2,13,4,1,3,7,30,37,0,0,1,1,6,11,3,21,5,0,5,1,0,6,0,23,10,2,2,10,12,1,7,28,6,18,2,11,6,18,14,45,12,9,18,4,19,17,5,6,0,4,12,1,5,11,28,1,4,0,0,0,2,10,1,10,7,10,186,0,8,30,0,6,1,1,7,14,23,7,32,0,8,11,13,7,25,37,14,12,1,0,10,5,1,1,3,14,1,22,6,24,9,0,2,7,4,13,13,18,5,1,2,0,6,3,7,13,24,1,8,10,2,24,0,32,17,1,22,18,21,15,15,4,9,0,8,0,2,0,2,17,1,3,0,9,15,17,0,26,34,26,4,5,6,0,0,4,5,9,22,23,7,5,2,10,8,80,33,2,12,30,4,9,53,34,18,6,4,11,46,2,2,3,1,7,0,9,12,6,6,40,20,9,1,4,1,6,1,16,8,5,8,11,9,1,8,0,34,8,10,6,6,12,10,4,3,12,2,3,10,1,4,2,12,2,0,15,10,9,7,37,12,8,4,13,11,0,10,6,1,45,1,6,7,2,10,14,1,15,0,4,1,1,3,1,29,8,4,4,0,1,0,0,12,13,7,5,10,2,0,7,0,11,7,2,2,0,0,3,14,0,15,6,2,8,0,1,5,1,1,33,5,12,5,3,1,2,0,3,4,1,5,2,4,29,5,9,4,12,3,8,1,8,2,1,4,20,2,4,16,6,8,1,3,8,7,6,0,1,0,11,0,7,14,6,2,13,3,4,1,2,0,6,0,20,0,4,4,0,24,10,20,32,4,16,13,3,2,43,29,11,0,3,2,2,2,8,19,25,14,3,5,3,1,0,10,3,0,5,7,2,10,13,0,21,5,4,0,8,0,0,10,15,0,2,22,0,0,4,6,2,0,3,3,1,0,1,4,3,0,1,0,5,0,36,7,6,3,5,1,1,1,9,6,0,2,15,3,3,15,3,21,9,4,0,5,0,2,1,0,15,1,4,0,2,0,1,8,2,9,7,3,0,0,4,4,7,3,5,0,0,0,0,1,0,7,0,5,3,10,5,4,0,2,7,14,1,0,17,2,3,2,0,0,0,48,7,7,8,4,2,1,0,0,7,8,6,0,7,10,0,7,2,2,0,1,1,1,7,13,1,0,1,0,5,0,7
october,9,19,5,48,1,0,5,6,5,0,7,10,7,12,0,4,6,14,1,0,0,8,4,9,8,8,1,3,7,44,3,67,39,3,11,22,25,1,8,0,1,1,3,3,6,4,10,6,228,2,19,1,3,10,1,1,23,37,0,5,8,0,1,5,9,1,12,1,1,12,12,1,3,2,12,3,15,1,35,9,63,0,9,4,103,8,8,1,103,9,17,1,5,16,31,3,13,8,27,1,0,8,21,2,4,18,6,1,22,10,12,2,4,4,0,10,31,8,26,43,8,22,7,94,10,1,1,1,3,6,4,1,0,9,2,9,1,4,0,2,1,16,27,5,8,25,4,2,7,9,20,0,10,1,0,3,3,1,14,3,0,0,2,16,1,3,0,7,4,3,37,31,5,0,0,6,48,1,1,4,2,9,1,9,4,4,19,5,31,51,7,0,8,0,0,3,3,3,14,1,14,0,0,5,10,0,8,8,5,7,33,0,9,1,0,0,0,1,6,0,15,14,2,7,19,19,40,24,4,1,2,18,17,7,14,11,18,1,4,0,18,12,0,1,0,4,3,15,29,5,2,1,4,6,6,3,13,10,5,25,1,41,8,13,0,16,1,0,1,0,73,7,44,3,1,1,17,19,2,0,4,2,0,9,2,2,4,1,7,0,45,5,4,6,18,11,33,7,5,1,13,17,5,27,5,0,7,4,1,0,2,1,26,1,23,4,4,26,24,1,17,3,3,0,10,2,0,9,2,21,1,2,1,2,0,3,9,1,7,28,1,8,1,3,2,2,18,30,3,1,3,5,0,7,10,3,5,2,6,40,6,2,3,4,2,0,15,1,0,2,0,6,0,1,0,10,3,0,0,6,18,0,11,3,1,31,0,29,17,0,3,2,2,5,13,1,14,2,33,3,2,2,2,0,1,1,2,1,14,2,0,3,11,1,11,3,1,7,1,1,0,1,10,17,0,5,2,8,11,27,30,37,16,62,1,3,0,22,0,2,3,7,1,5,1,5,0,1,8,3,0,0,1,1,27,6,0,9,5,25,5,5,6,8,0,0,0,13,4,0,8,0,0,0,0,0,1,11,11,0,0,5,0,0,4,6,2,1,2,8,72,11,1,1,2,0,2,11,1,2,4,2,4,0,4,31,2,8,3,5,6,1,9,2,9,7,1,0,2,5,0,9,3,14,4,7,10,1,3,3,6,0,3,0,6,4,3,1,7,1,1,7,1,3,2,3,121,3,5,9,7,1,3,16,2,1,13,2,5,3,8,7,12,1,3,2,5,0,17,6,2,1,10,0,7,2,4,0,0,16,0,11,2,1,2,4,8,4,0,4,6,8,2,1,1,0,0,1,45,4,12,0,2,4,10,0,3,5,4,1,12,13,19,2,12,2,4,0,2,0,6,10,3,12,0,5,3,3,3,12,3,6,1,12,10,3,1,1,3,3,0,0,1,19,3,22,0,19,1,179,7,3,2,2,3,9,19,4,9,10,0,3,33,17,7,7,2,2,3,6,5,2,25,3,14,7,0,3,37,0,16,13,9,2,6,4,8,3,4,9,11,1,11,7,7,12,11,1,1,7,13,6,3,1,3,4,7,1,0,5,1,58,5,12,1,25,23,3,5,2,4,1,3,15,1,5,4,0,1,11,1,9,0,0,7,2,4,1,5,5,4,0,4,10,6,0,3,5,1,3,4,12,12,70,13,8,4,2,6,20,34,3,26,18,13,7,19,4,0,6,1,1,0,4,0,4,1,1,2,5,0,0,2,8,1,3,0,5,0,7,2,0,3,2,7,4,3,4,7,3,0,2,6,6,1,2,0,2,2,4,7,3,22,13,0,2,2,4,3,2,4,10,14,6,3,3,0,10,2,1,4,10,3,1,2,0,6,8,1,3,5,1,1,5,1,8,3,8,4,2,18,9,3,2,0,8,1,2,0,1,9,0,5,0,2,4,0,6,9,6,3,1,2,2,3,0,7,5,2,8,9,24,2,9,17,4,7,3,3,0,9,20,0,1,3,80,1,9,9,1,1,7,5,9,9,1,3,8,3,11,1,12,7,7,1,38,14,6,2,6,6,3,5,7,1,3,1,18,4,3,2,3,2,2,1,2,1,2,3,1,3,6,10,10,9,9,7,19,34,2,3,2,0,2,1,34,4,2,7,4,8,3,3,3,2,30,1,0,3,3,4,2,2,2,5,1,0,0,5,5,5,1,9,4,4,0,3,1,24,0,1,1,2,0,0,1,0,5,1,0
nicaragua,10,15,1,45,3,1,0,2,4,3,87,8,4,22,0,0,9,1,0,0,5,22,2,7,10,8,6,6,1,9,5,66,51,0,10,15,38,0,0,0,0,19,2,4,10,16,6,3,211,67,20,2,7,18,1,0,13,11,2,8,6,16,0,11,7,0,21,0,4,8,0,2,0,0,21,0,0,7,41,3,4,0,26,14,172,0,10,0,29,0,2,0,1,22,25,0,2,9,18,0,26,15,7,0,10,10,0,2,13,0,11,0,0,1,0,23,3,2,26,43,2,17,0,23,1,1,0,0,1,0,7,2,1,20,7,33,3,6,0,0,0,16,28,1,0,41,0,7,4,1,16,0,6,1,0,1,1,4,0,6,8,0,0,4,3,1,1,9,2,10,7,31,15,0,0,0,83,1,3,5,5,1,0,0,5,3,8,2,32,60,3,3,2,0,1,0,16,1,2,4,1,0,0,5,16,1,3,0,3,4,26,0,19,0,0,1,0,0,5,3,0,4,1,1,13,11,12,7,0,0,9,8,4,11,8,1,11,3,0,0,18,7,3,0,13,1,7,4,15,1,2,0,14,0,4,1,6,1,1,6,0,22,7,8,2,7,0,0,7,1,29,5,4,4,2,0,26,1,5,0,10,0,6,5,2,0,0,1,0,0,2,7,0,3,5,5,32,3,6,0,8,10,0,2,1,0,12,0,2,0,16,4,3,0,4,2,6,12,4,4,33,0,11,0,43,19,0,21,0,29,0,1,3,4,2,11,11,6,1,1,5,23,1,12,0,1,18,31,9,1,2,1,0,9,6,5,1,0,10,2,1,0,3,7,6,4,19,1,2,1,5,15,0,0,2,5,3,0,7,1,45,6,24,9,1,9,0,25,8,0,4,0,0,24,20,12,30,1,19,6,15,1,2,2,0,0,7,2,12,7,1,5,1,5,4,6,12,1,5,0,1,4,10,7,0,5,3,2,6,10,0,3,0,7,1,2,1,16,1,0,15,30,5,6,1,0,2,7,10,1,11,3,0,4,55,2,0,6,0,11,6,4,12,12,2,1,1,13,0,0,11,0,0,0,0,0,4,3,9,0,7,7,6,1,7,7,3,3,5,0,15,25,0,3,7,5,0,11,3,0,3,1,4,0,42,2,1,5,0,0,0,0,10,6,1,3,0,0,0,3,1,16,0,12,0,3,7,0,8,10,4,0,1,2,2,0,3,15,28,2,7,0,0,0,1,1,14,3,22,6,4,0,3,19,2,0,20,0,1,5,11,9,8,4,11,3,12,3,27,26,7,2,11,0,1,15,2,9,1,7,0,11,9,4,0,4,0,3,0,1,2,22,1,1,6,0,0,1,75,8,12,0,1,3,17,8,0,1,0,4,11,28,11,4,16,3,7,2,1,3,5,0,6,3,1,0,18,1,5,24,0,7,1,5,7,8,1,1,4,10,0,0,0,15,9,19,1,14,0,123,7,1,0,2,9,15,17,12,3,29,3,2,38,43,21,13,5,1,6,9,16,5,7,0,31,0,2,5,18,3,57,10,5,9,7,1,1,1,7,17,8,2,11,35,5,20,2,9,0,6,5,2,6,0,0,0,11,7,0,2,3,7,4,8,9,1,3,0,3,0,1,7,2,13,4,0,4,0,2,12,0,6,0,1,1,0,7,0,29,1,4,16,5,4,7,3,0,0,0,0,1,0,0,13,0,3,0,3,4,1,1,2,6,1,15,3,2,1,0,15,0,7,0,5,4,11,0,0,30,2,1,0,6,0,7,0,0,0,0,3,1,2,0,5,2,8,1,2,2,1,0,6,12,3,0,4,0,5,19,5,1,78,8,4,1,3,4,7,12,2,1,0,3,2,9,4,0,7,3,0,3,5,0,0,0,2,15,14,3,1,6,0,0,0,1,22,0,3,1,3,27,13,4,8,2,1,0,0,0,0,16,1,2,0,0,0,3,1,9,2,0,1,4,1,7,5,6,1,8,0,2,7,1,1,0,4,10,0,7,1,19,14,0,2,10,18,2,1,7,5,6,3,0,6,6,3,1,6,10,10,0,7,7,5,14,2,0,8,0,0,8,8,0,2,1,1,5,34,9,3,3,0,1,10,0,0,1,1,2,1,2,1,0,0,1,9,5,0,5,2,5,12,0,0,0,0,2,31,9,1,0,0,0,0,0,5,0,0,2,33,0,0,1,0,2,2,0,4,16,0,3,5,0,0,4,0,8,1,7,0,6,1,1,0,0,1,0,4,0,10
exchange,9,15,4,125,2,3,9,14,1,1,27,14,9,24,2,2,2,16,2,0,9,65,4,16,7,8,3,7,6,21,1,138,139,11,42,36,18,29,14,2,13,1,4,2,29,14,51,4,360,19,40,3,21,24,0,1,78,14,0,7,16,6,3,15,6,5,77,5,5,5,9,4,8,2,38,14,7,2,102,19,43,4,18,3,248,26,28,0,56,6,11,6,2,21,53,16,25,6,20,28,3,25,25,20,9,18,11,2,9,2,26,4,4,18,2,16,15,14,62,135,38,19,1,51,1,6,2,2,17,1,3,1,1,42,17,10,1,0,3,2,1,17,34,0,0,47,5,5,15,23,69,3,33,9,0,3,12,4,3,3,5,0,9,9,1,6,5,16,11,12,24,69,17,0,3,8,133,4,8,14,16,9,0,6,2,22,22,11,18,89,1,4,24,0,0,10,29,8,8,23,38,5,3,12,24,9,8,35,11,20,62,7,19,4,3,1,0,0,10,0,3,12,7,15,48,63,6,27,1,19,12,28,9,32,23,27,26,6,11,2,76,31,6,0,20,9,14,26,44,18,23,33,21,32,10,27,20,13,4,6,0,11,39,15,16,25,0,0,15,3,108,16,44,5,2,2,11,4,8,1,40,1,3,15,14,1,5,2,13,1,10,16,52,4,5,12,80,7,9,22,16,17,1,9,10,0,13,2,1,0,4,6,37,10,85,31,15,23,15,5,33,4,11,1,21,1,5,21,7,26,3,13,7,8,5,23,12,10,8,19,10,11,25,6,11,6,46,44,22,0,9,16,5,31,22,3,1,5,18,15,11,7,7,17,7,1,42,2,5,8,1,7,11,18,5,13,8,12,12,4,63,2,69,12,0,25,0,24,25,8,7,1,11,40,36,35,47,13,57,5,23,5,6,0,17,11,5,5,68,9,0,15,13,3,4,8,24,5,1,1,4,1,18,3,1,1,1,22,7,38,96,10,4,14,1,7,0,18,1,1,10,15,2,13,0,7,4,3,19,19,10,13,1,14,55,3,0,5,2,38,15,12,16,5,2,1,7,13,8,1,5,2,4,0,1,15,7,12,2,2,3,8,2,2,6,1,19,8,1,0,20,41,1,1,12,5,3,21,6,16,8,13,0,1,3,77,4,6,19,5,8,0,14,5,14,16,6,3,1,3,4,15,17,24,7,6,7,5,20,27,12,5,0,6,3,10,10,9,53,14,7,14,0,5,18,19,4,19,9,5,14,8,1,37,7,9,51,5,16,7,23,2,17,4,24,24,13,5,30,41,9,13,11,0,9,9,13,8,9,12,8,17,18,12,17,2,7,6,3,8,15,25,12,7,24,6,6,2,150,13,24,1,6,38,11,24,6,16,10,7,19,24,11,5,22,12,8,6,6,10,45,33,5,81,6,3,3,6,5,36,117,10,16,21,8,8,11,6,1,7,8,0,6,10,7,27,7,8,3,240,9,9,10,7,2,12,54,13,5,24,8,6,62,30,37,121,12,4,12,7,19,7,26,6,43,3,0,8,10,2,10,35,9,2,9,4,14,4,3,11,16,5,19,11,7,9,14,5,6,15,21,3,8,3,5,4,8,5,7,7,1,18,3,28,20,1,4,9,15,0,2,2,1,4,1,6,4,2,6,8,9,11,20,5,1,4,0,1,10,6,8,3,3,3,8,16,22,5,3,8,9,10,5,13,5,18,5,9,13,16,19,7,9,5,18,48,9,5,6,6,5,3,2,5,1,14,27,5,6,7,3,8,5,14,10,4,28,3,9,20,10,0,0,10,3,10,3,11,2,4,7,4,10,13,5,3,13,11,18,5,12,9,7,8,13,4,5,14,6,17,3,2,19,20,2,5,3,13,42,8,3,0,21,0,4,7,11,34,9,6,10,4,3,9,7,15,4,16,7,2,22,34,0,9,1,11,2,17,2,1,12,3,9,2,6,10,3,5,5,13,1,1,27,66,7,6,15,25,7,8,5,26,8,7,31,4,5,9,5,13,2,8,0,2,3,14,2,0,9,0,11,8,2,4,0,8,6,1,4,19,18,15,3,18,12,8,4,14,2,2,19,3,9,21,8,13,3,30,9,33,2,1,11,2,3,10,11,8,4,7,6,14,0,2,7,59,23,4,89,5,0,2,6,3,5,6,6,2,36,10,2,8,12,4,1,7,0,0,1,8,0,17,1,4,10,11,0,9,9,7,11,2,3,56,3,4,6,1,24,0,2,1,2,2,0,1,1,9,1,0
custom,2,12,3,66,0,1,2,6,1,2,21,2,2,14,2,2,1,7,1,4,0,15,1,5,8,4,1,9,1,4,6,95,60,1,22,19,9,7,7,1,11,1,1,4,14,2,7,25,129,4,14,0,5,6,0,1,83,19,0,3,16,3,0,4,12,5,25,0,1,7,30,8,0,4,18,5,10,6,26,10,32,0,5,7,109,8,5,0,39,0,15,0,1,12,25,6,6,3,13,6,1,21,18,3,7,10,9,2,6,4,7,3,4,5,0,11,10,2,49,55,13,26,14,80,5,1,2,1,3,3,0,0,3,18,18,21,2,1,1,3,2,19,17,4,1,49,5,12,10,7,19,0,4,1,0,2,6,0,2,3,13,0,1,1,1,11,2,8,8,3,8,19,9,1,1,5,98,1,3,11,10,0,1,7,0,27,17,12,12,17,1,0,9,1,0,1,3,2,6,1,15,0,1,6,9,4,0,20,16,8,40,1,5,7,1,1,2,0,12,0,23,4,4,3,11,65,10,32,3,11,2,21,27,7,7,78,5,1,14,2,27,21,3,2,10,2,0,4,35,3,4,10,1,18,3,5,7,2,7,6,8,16,6,4,5,27,1,2,12,1,44,16,84,1,3,0,7,39,7,1,18,12,3,14,4,1,1,2,2,0,5,2,4,9,9,6,32,1,7,10,13,15,2,1,9,0,9,1,0,0,4,2,17,1,41,18,8,25,5,4,15,1,9,0,12,7,1,19,1,4,0,5,1,4,4,8,3,2,9,6,4,6,6,4,1,1,14,18,1,0,13,3,2,21,8,2,3,2,2,41,5,1,3,7,1,0,8,1,5,3,2,4,0,1,8,19,7,0,5,26,23,2,19,3,0,30,3,6,20,1,10,0,15,14,19,3,21,3,26,1,9,0,1,0,3,0,4,1,17,6,0,3,12,7,9,7,2,6,1,0,2,11,6,7,0,3,4,5,1,21,5,15,8,5,1,0,0,16,4,2,2,8,13,5,1,2,2,1,7,14,4,3,3,2,19,8,0,1,4,24,9,7,9,5,3,4,12,7,5,2,6,0,0,4,1,1,0,2,10,1,2,0,2,3,4,3,10,0,5,3,12,16,0,1,2,2,2,9,1,3,5,2,3,1,2,5,3,4,3,4,8,3,6,8,6,2,1,5,0,8,4,2,2,18,2,5,20,4,8,7,1,3,0,6,10,2,1,6,13,13,1,2,0,0,13,3,4,6,6,6,3,3,6,23,6,14,21,4,2,4,13,3,18,4,1,10,8,3,21,20,6,6,14,2,2,0,48,5,4,33,4,8,3,6,2,2,5,3,2,3,12,12,3,3,12,1,2,6,36,4,7,0,2,1,7,9,1,16,8,21,15,14,15,2,15,3,9,0,7,3,4,2,3,4,3,2,2,1,6,14,6,21,6,7,3,0,2,3,0,3,3,2,0,14,7,30,2,5,3,94,36,3,3,5,6,4,14,3,1,13,2,2,26,8,3,2,1,1,3,4,7,6,9,11,28,0,0,3,2,0,1,12,7,8,8,10,8,1,1,5,9,10,7,4,5,2,6,2,18,10,7,10,2,3,11,5,14,0,2,0,3,17,0,12,8,2,3,3,2,8,4,2,1,17,0,2,5,0,0,10,7,14,3,3,0,2,1,1,10,3,16,2,0,2,0,5,5,1,7,7,5,80,32,32,25,5,2,9,5,21,22,5,3,2,10,20,1,2,2,7,0,2,3,8,3,8,2,1,4,3,4,0,7,0,4,2,2,3,7,4,3,0,0,2,5,7,1,4,3,1,8,1,18,1,1,1,2,7,14,1,32,3,23,2,5,0,1,6,1,6,4,15,4,8,2,1,2,4,0,5,12,5,4,3,4,1,1,11,2,10,4,2,0,2,2,1,5,6,4,1,17,17,10,20,2,4,8,18,14,0,5,3,6,3,0,1,2,2,4,17,2,1,4,2,3,7,0,5,3,4,3,4,3,5,8,2,2,2,6,1,1,9,0,8,0,2,3,3,6,0,5,2,5,1,2,3,10,4,1,7,1,20,2,26,9,3,7,6,5,3,0,7,5,19,15,4,0,3,5,5,0,1,1,6,3,5,4,5,1,5,2,9,24,22,21,25,11,43,85,4,0,2,0,2,1,27,2,2,7,3,0,1,4,3,1,20,2,2,2,2,0,1,2,9,1,1,0,1,2,6,1,1,4,8,3,2,0,3,4,0,4,5,3,0,0,8,0,1,0,0
consider,14,44,19,306,8,8,9,60,9,6,32,22,13,112,14,10,12,13,10,8,11,56,16,33,35,32,17,14,6,23,19,269,167,7,105,95,75,18,20,5,12,6,4,4,46,44,58,30,528,20,76,15,16,65,18,12,102,78,2,26,43,28,3,30,36,8,136,9,12,18,13,9,7,8,139,21,18,12,151,21,67,3,23,7,340,29,21,2,54,8,11,15,3,46,110,15,43,7,49,20,24,52,66,15,18,51,24,7,14,0,28,16,11,30,6,58,8,3,135,290,71,17,25,98,6,4,6,12,6,2,17,8,3,93,36,68,10,6,10,14,9,50,44,4,5,110,12,20,26,29,92,1,24,12,3,60,40,10,20,22,33,9,13,5,1,6,8,37,44,12,27,140,23,6,14,13,288,8,22,66,40,21,32,17,11,29,55,50,104,86,6,8,9,4,5,8,32,12,12,18,32,4,7,28,44,25,10,57,22,57,122,8,52,10,5,6,3,6,28,12,6,35,7,38,85,151,32,36,6,12,28,14,17,33,70,32,42,14,18,18,89,64,9,5,22,8,12,39,100,13,22,33,43,8,13,31,13,2,5,26,13,50,34,7,8,47,5,6,32,11,271,13,33,13,9,4,24,18,24,10,78,18,7,26,13,4,15,17,18,7,12,7,21,12,5,25,66,15,14,34,27,60,4,4,35,3,56,8,16,7,8,32,61,8,53,15,35,72,24,7,68,12,55,7,138,14,30,29,15,47,9,21,8,12,12,19,31,14,7,26,21,29,25,27,6,20,66,107,24,18,27,17,14,56,35,13,12,5,24,49,54,13,22,20,6,4,78,17,12,17,3,21,14,10,16,46,17,7,33,17,127,8,77,30,3,62,6,29,36,8,34,10,24,29,78,15,123,6,43,5,43,6,11,3,11,8,21,14,45,27,3,9,10,28,41,15,19,15,10,3,5,12,32,22,2,6,9,17,24,24,13,14,3,28,5,10,0,26,17,10,29,37,16,26,3,6,16,4,50,9,23,12,5,6,78,23,2,21,13,43,11,33,50,26,14,5,20,22,32,2,24,8,12,8,13,28,7,22,39,8,9,13,10,17,22,36,11,8,15,8,145,77,3,11,19,9,4,26,9,23,26,3,5,21,11,20,5,37,13,6,8,17,14,15,18,51,17,20,5,19,15,24,15,42,18,6,35,14,22,51,17,16,10,16,22,18,25,23,64,29,7,4,6,5,4,22,8,30,19,19,68,10,11,75,15,20,50,7,13,11,49,12,38,6,19,35,19,22,61,60,13,15,32,8,12,16,30,11,19,30,9,20,21,31,21,9,17,14,11,27,32,80,9,9,34,7,10,9,100,48,47,6,11,10,15,45,11,57,17,11,46,54,28,10,36,23,29,8,25,9,11,3,7,30,9,16,18,22,36,46,10,30,95,37,14,8,16,8,4,19,12,1,25,19,14,59,11,15,14,280,48,15,11,16,10,17,54,39,11,15,11,7,40,24,17,13,5,14,26,16,17,16,77,53,39,22,9,12,9,17,14,49,40,24,38,16,27,12,6,19,25,25,29,27,15,17,23,4,26,24,8,20,12,12,15,11,37,14,7,9,16,13,7,85,27,35,6,26,17,14,10,5,7,40,8,17,17,7,12,14,20,32,9,13,23,7,33,14,78,21,19,12,9,18,39,10,23,20,6,16,17,11,2,14,5,24,19,13,11,23,26,29,7,7,37,23,18,15,15,16,17,5,9,26,12,27,8,5,29,27,17,8,18,8,18,15,9,41,18,20,7,17,7,9,16,40,2,11,13,13,5,5,40,14,3,6,12,16,34,11,14,8,14,17,7,21,7,16,7,25,9,4,50,29,9,7,5,15,10,8,13,9,17,6,10,15,33,33,32,12,20,15,10,14,7,12,12,13,19,19,84,27,9,4,10,9,13,10,11,3,16,9,13,9,9,19,5,7,27,39,12,7,23,13,4,8,5,11,21,6,9,14,9,14,19,7,11,10,7,7,7,22,1,8,8,16,9,6,12,5,11,12,3,22,15,11,10,19,7,1,21,9,6,18,19,10,11,11,7,12,23,14,4,15,4,13,4,39,12,10,15,12,17,9,8,1,9,9,9,20,13,21,7,8,11,26,17,22,46,15,4,8,14,7,5,7,8,14,39,8,10,14,17,10,5,58,14,0,12,16,5,18,15,6,14,10,7,12,7,12,4,16,9,7,16,8,14,5,44,10,4,3,8,2,2,8,4,7,5,3
agency,0,17,4,79,2,1,0,4,1,2,2,0,6,23,0,2,3,5,0,4,3,23,2,10,13,11,5,7,5,7,3,79,46,11,25,8,11,6,7,1,6,1,5,2,19,7,26,38,153,5,17,4,7,18,5,5,19,18,3,15,19,6,1,7,8,4,45,1,2,7,16,1,4,1,47,6,3,1,47,8,22,3,9,5,159,9,9,1,12,5,4,3,8,11,20,9,10,8,24,20,12,13,14,3,6,24,2,10,6,2,12,6,7,29,5,10,0,8,38,72,28,6,0,25,2,2,3,7,2,4,4,1,5,25,8,50,1,3,5,2,0,20,17,4,0,28,1,5,7,7,30,4,5,7,5,65,5,17,2,11,12,1,3,0,12,3,5,15,14,9,10,36,11,4,2,6,57,2,2,28,11,1,30,4,0,10,18,6,16,18,2,2,2,0,1,2,21,4,8,8,18,10,2,10,11,20,4,16,3,23,38,1,13,8,1,1,0,12,10,6,1,7,3,7,36,59,9,11,2,18,5,7,13,37,13,6,10,12,7,7,28,21,3,4,13,9,6,15,29,6,8,7,7,9,6,2,11,6,1,8,8,12,17,0,6,51,6,1,4,7,64,9,15,3,1,4,9,6,6,7,31,12,3,5,8,3,10,10,7,0,3,3,14,5,0,13,21,5,3,11,11,16,2,1,8,1,10,4,7,2,5,20,14,15,9,14,6,21,3,3,13,6,9,5,40,2,5,11,2,7,1,6,1,8,2,10,8,5,8,2,9,8,10,10,1,4,31,20,16,7,10,7,2,25,11,7,2,3,6,9,22,12,11,11,3,2,22,1,13,9,5,10,1,7,2,26,5,1,7,2,37,2,33,12,6,21,1,9,10,2,16,0,14,0,21,12,26,8,32,2,9,5,0,3,5,8,10,2,16,6,0,3,1,8,10,9,3,0,0,0,2,6,10,6,1,6,5,4,11,5,25,2,0,3,2,3,0,1,5,10,7,12,5,4,0,0,4,0,10,10,10,4,2,7,21,6,1,2,1,12,3,8,16,8,3,0,6,3,7,1,2,6,2,0,3,3,1,9,14,0,1,4,3,5,6,0,6,1,0,1,27,11,0,5,4,4,0,16,1,11,8,3,2,3,7,34,9,1,0,1,2,1,4,8,9,12,7,3,6,4,5,7,4,16,3,6,8,10,3,9,4,2,1,2,5,4,2,5,21,21,2,10,0,4,2,2,0,12,2,3,19,7,5,18,9,7,16,1,12,3,10,0,5,3,3,8,8,5,16,24,2,5,12,22,7,1,3,4,2,11,1,18,4,5,7,3,6,2,0,0,9,18,8,7,9,2,5,2,6,12,15,13,2,0,4,12,1,24,3,8,12,8,17,2,12,7,5,7,2,1,10,7,1,27,6,3,6,4,5,39,9,11,4,16,8,3,9,5,2,3,0,1,6,8,1,15,7,5,6,79,7,2,3,2,2,2,23,6,3,4,4,1,2,5,0,0,0,1,2,3,5,2,5,8,2,6,1,3,0,2,0,17,4,3,4,8,8,9,1,2,4,12,13,2,5,3,2,0,3,5,2,5,0,1,2,2,15,7,3,5,1,2,3,24,12,8,0,3,1,3,1,2,2,12,3,8,1,2,1,8,3,9,5,2,2,2,0,1,2,1,3,1,2,1,0,3,14,10,5,1,5,5,6,3,1,15,2,5,3,4,4,9,3,5,8,2,1,2,12,1,1,0,3,3,3,8,18,13,30,2,4,2,3,5,4,10,6,0,1,9,3,6,1,1,4,8,4,0,1,2,5,1,7,3,3,3,7,1,0,4,1,0,2,3,3,5,3,2,3,9,1,2,6,15,0,0,4,2,3,4,2,1,13,1,1,3,4,10,8,16,2,6,1,1,2,1,5,0,3,1,21,20,6,1,4,9,1,8,0,3,0,5,14,4,2,3,1,6,9,9,8,2,4,5,4,1,0,3,7,1,1,0,2,1,8,2,2,0,5,6,4,6,0,3,2,1,0,5,5,1,4,1,2,14,3,1,0,18,1,21,1,12,6,3,2,5,0,0,3,2,9,1,5,1,1,5,0,1,3,16,3,6,2,1,2,1,16,2,2,7,3,4,2,1,8,11,3,2,34,0,1,4,2,8,0,2,4,2,16,2,3,2,4,0,2,6,4,1,1,2,3,2,6,2,1,5,4,3,5,4,5,0,2,9,4,0,4,6,12,2,2,7,1,1,8,1,3,2,0,0
loan,0,5,5,90,1,4,1,2,2,0,7,2,6,23,1,0,10,13,5,4,1,29,9,10,16,26,0,12,1,31,3,182,103,5,30,23,19,18,34,2,7,1,2,8,20,8,38,24,154,21,31,2,9,12,10,0,31,9,3,3,10,2,1,1,13,2,49,4,0,8,156,1,4,0,55,7,28,4,61,11,58,4,12,7,187,53,14,0,64,22,16,4,16,35,83,21,13,7,45,11,20,51,33,9,8,19,5,9,13,24,18,6,25,28,12,17,8,4,70,137,24,29,15,117,12,2,1,2,1,4,11,1,1,43,14,28,1,4,0,6,3,19,32,2,0,40,3,5,15,13,29,6,12,15,4,55,16,11,0,21,12,0,15,5,18,17,6,11,21,6,9,47,10,3,6,7,90,1,8,26,14,4,20,6,3,14,29,17,17,30,2,2,4,1,6,2,5,8,14,13,29,20,11,5,17,4,18,39,13,28,51,9,16,13,4,6,6,11,6,4,50,7,2,6,74,27,17,17,2,66,11,26,55,11,20,30,23,11,8,0,45,32,7,0,17,9,2,19,56,4,16,27,11,45,8,8,12,21,11,8,1,6,4,4,5,25,12,6,3,4,130,55,127,4,1,0,11,66,9,2,22,1,2,14,19,3,3,2,5,5,8,2,14,33,10,12,35,0,6,6,13,30,15,8,4,0,20,2,5,2,21,21,50,14,60,17,6,33,26,3,15,4,9,8,12,0,7,17,6,23,0,10,2,2,1,34,6,4,38,25,6,11,13,3,5,5,37,13,33,13,9,3,2,32,10,1,6,0,20,58,21,9,4,10,6,3,24,2,42,11,1,18,3,13,7,16,4,1,5,26,30,16,58,7,3,39,1,25,41,2,2,3,3,4,18,6,25,3,30,0,11,1,0,0,16,3,10,0,17,10,2,1,14,2,0,3,33,3,1,0,6,6,15,2,0,1,1,4,8,13,47,26,45,7,8,3,0,21,8,6,8,10,11,13,1,4,7,1,19,24,20,3,0,9,34,2,0,3,2,39,6,12,13,11,1,0,28,3,5,5,6,2,1,2,2,1,1,5,15,1,1,18,0,0,9,0,18,2,4,0,66,69,1,4,17,1,5,17,6,2,12,5,6,14,10,191,38,2,3,4,3,1,3,5,12,7,2,3,0,2,0,14,1,1,2,0,12,31,23,16,8,1,0,7,4,3,5,6,19,35,0,6,1,9,23,1,2,11,11,16,19,1,2,31,1,2,16,5,10,8,5,0,29,1,7,12,19,1,33,36,13,5,15,0,0,0,8,6,4,49,3,7,3,2,2,1,2,10,3,7,14,15,6,17,5,2,2,0,14,18,21,2,5,1,6,8,6,13,0,15,13,8,3,0,14,8,8,1,0,6,10,18,9,38,9,4,0,19,2,23,16,7,7,13,2,3,6,14,2,18,2,1,2,4,4,23,14,24,3,89,0,4,5,3,0,17,38,5,2,6,3,1,1,13,10,1,0,2,8,12,10,7,32,0,2,4,0,8,1,1,3,25,4,1,3,17,9,4,1,1,18,16,8,4,8,3,8,0,21,7,71,0,1,4,11,4,24,0,2,2,0,41,7,30,16,1,1,4,2,1,7,1,3,6,1,0,21,1,1,8,9,22,6,3,0,0,9,15,2,2,15,2,12,1,1,8,9,16,6,0,1,53,58,58,12,7,3,14,8,23,18,9,4,8,11,22,4,1,19,12,5,1,0,1,1,9,73,4,2,9,0,3,4,37,11,1,11,0,5,13,3,5,3,3,5,8,24,5,10,1,7,12,5,7,5,1,6,5,5,7,6,3,0,6,5,2,3,8,3,4,1,3,1,19,0,7,2,17,18,1,21,7,4,1,5,4,4,6,3,1,6,2,0,0,15,31,6,7,0,13,1,46,1,27,1,4,4,17,0,2,4,0,5,10,6,4,0,1,3,1,2,3,14,47,14,4,3,10,4,4,4,4,7,1,8,2,5,1,0,12,5,1,34,2,2,1,0,4,7,2,12,0,0,5,3,12,7,15,20,9,12,1,2,58,7,15,0,0,4,2,2,7,8,3,9,2,5,0,0,13,2,5,6,8,1,5,11,20,1,5,1,10,69,28,17,40,48,82,200,1,1,0,0,16,0,44,1,2,59,1,3,1,0,1,4,9,1,3,0,2,0,1,4,9,1,1,6,15,3,2,0,2,0,6,2,8,0,25,0,2,2,10,6,0,9,6,5,7,2,0
privilege,3,11,6,77,6,3,4,23,5,4,10,7,10,42,2,12,1,11,1,5,2,25,8,16,21,9,15,10,8,10,3,88,75,17,38,44,12,4,1,4,4,13,2,3,19,9,21,5,215,18,16,0,7,37,6,2,29,19,2,13,13,3,4,8,10,6,84,7,3,11,4,5,3,1,49,13,10,2,50,11,45,0,8,3,123,5,7,0,31,1,3,2,0,9,27,12,10,4,13,6,12,15,21,5,8,11,5,2,7,4,9,9,0,29,1,8,1,3,53,63,17,12,1,31,3,3,3,3,2,2,6,5,10,22,12,21,11,4,3,7,3,19,20,1,1,34,4,13,12,8,43,1,10,1,1,15,23,2,6,2,11,0,4,2,0,1,1,9,12,8,14,46,16,1,2,10,109,4,14,10,7,8,1,8,5,17,21,9,20,27,0,3,4,3,0,1,8,2,1,9,15,0,1,8,8,15,8,11,7,13,60,2,10,2,1,1,0,2,8,2,1,8,5,3,26,85,21,9,3,0,5,6,9,26,27,14,20,6,7,2,32,27,10,2,18,2,4,8,22,3,6,8,15,5,6,8,7,5,3,10,3,7,13,2,4,37,6,6,9,0,84,2,20,0,3,0,16,10,9,2,35,17,0,14,5,1,1,6,10,1,1,3,15,0,2,6,18,1,5,10,15,11,1,3,5,5,18,4,6,0,1,12,11,1,23,7,14,25,8,4,52,10,14,2,86,8,3,19,2,20,4,4,5,8,4,30,12,6,2,7,6,5,9,13,3,2,27,25,6,3,9,16,5,21,19,7,9,3,15,15,15,7,1,20,7,2,22,6,13,11,3,7,2,5,3,13,7,2,14,4,49,4,28,9,2,24,7,14,14,2,18,5,8,8,17,8,40,2,8,2,17,3,1,1,1,7,7,1,12,4,0,8,0,10,2,0,2,6,4,3,9,5,13,6,1,1,4,6,3,7,10,3,0,19,1,2,0,13,1,5,10,15,4,7,1,0,9,1,28,4,10,4,1,2,34,7,1,2,5,18,11,14,20,21,4,4,9,8,7,1,7,2,4,4,5,7,2,10,10,4,5,6,4,6,1,5,11,1,3,4,22,18,2,6,6,3,5,7,4,10,6,2,1,0,11,26,0,9,4,1,3,10,2,9,2,11,1,6,1,3,4,22,10,21,13,3,17,13,10,16,1,3,6,6,1,2,3,7,17,10,5,2,1,0,2,3,4,9,8,5,34,8,5,32,6,7,17,4,5,3,12,1,10,4,11,11,11,3,25,35,8,5,0,4,6,6,0,5,2,7,0,5,6,14,9,6,6,5,7,3,14,20,15,3,15,3,1,2,40,18,11,1,5,4,2,12,1,9,3,1,8,8,4,28,17,6,17,5,4,0,7,3,1,13,2,4,8,7,6,26,3,17,14,19,4,2,5,3,6,0,14,7,9,7,2,5,1,2,6,124,16,5,5,3,3,5,27,8,4,7,8,7,11,13,2,4,2,3,4,5,6,5,7,24,13,5,6,3,6,6,9,21,7,3,8,5,15,6,2,6,14,9,5,4,3,3,1,2,8,12,8,3,3,4,6,2,11,4,3,2,5,6,5,15,13,7,0,6,5,3,4,5,2,13,1,4,5,4,2,12,4,11,0,8,3,4,3,2,31,7,4,8,0,4,5,3,3,14,4,11,8,3,0,5,6,10,7,8,9,16,19,4,1,7,21,10,6,2,1,10,2,0,1,16,3,12,6,2,7,7,1,3,6,5,12,5,6,1,5,5,5,11,3,2,1,9,2,4,1,0,3,3,13,5,3,2,6,3,9,2,2,2,16,7,0,2,7,4,5,9,6,6,6,7,1,7,4,5,0,4,0,4,16,3,3,13,7,15,7,2,2,6,7,5,1,7,6,7,3,10,5,27,8,0,1,7,1,9,4,0,5,8,3,1,2,3,2,0,4,7,3,2,7,5,1,8,5,14,10,4,0,3,2,10,4,2,4,1,5,1,4,4,0,2,4,5,1,3,4,5,7,2,1,17,15,7,7,3,2,6,6,2,1,3,12,3,1,13,3,0,3,0,4,10,5,1,7,8,4,2,4,1,4,9,1,2,11,5,2,6,8,8,4,3,2,6,6,7,15,2,0,2,5,4,1,5,0,3,7,6,2,1,2,3,0,25,2,0,4,4,8,7,6,7,3,0,0,2,9,3,21,4,1,3,2,3,8,1,4,1,2,2,3,0,1,2,0,0,0,9
sum,8,11,4,170,5,2,4,27,2,1,9,7,6,30,1,3,7,19,2,1,3,22,9,25,12,16,4,20,3,45,11,277,75,3,29,37,19,25,16,3,11,2,3,2,25,17,27,10,284,5,32,3,7,6,3,2,73,72,0,12,8,1,1,12,15,3,57,3,6,14,160,10,3,3,37,7,13,4,77,17,91,0,23,2,242,55,16,1,132,11,27,1,0,64,141,18,23,8,42,5,10,56,44,6,12,42,27,3,33,7,42,5,13,9,2,46,28,10,112,133,29,4,39,294,3,4,1,2,30,6,11,0,0,54,10,28,8,6,0,0,0,16,65,14,1,42,7,11,31,59,25,0,17,11,5,12,13,2,3,1,24,2,14,12,5,0,13,9,21,7,33,54,14,1,12,4,160,1,8,15,24,6,2,8,11,8,24,21,27,49,4,3,2,0,1,3,11,3,24,9,23,3,3,9,28,3,6,31,15,9,37,3,21,14,0,0,10,3,18,1,66,10,7,15,73,73,40,38,22,18,3,44,57,9,34,107,30,3,5,3,68,28,10,1,6,10,9,20,56,4,12,24,13,91,13,13,7,16,9,21,1,6,28,16,10,104,3,3,1,1,153,53,336,4,3,0,6,112,26,6,38,1,0,13,3,1,3,9,6,4,10,4,14,40,28,6,81,5,7,12,13,35,20,17,12,0,18,8,5,2,2,7,43,3,257,48,12,30,13,2,47,2,21,0,18,4,3,11,2,12,2,15,2,2,6,16,6,2,14,29,10,8,18,11,15,2,29,36,14,8,45,6,7,27,13,7,1,2,13,151,7,4,2,13,1,0,36,1,5,4,2,16,6,3,6,36,5,4,10,28,78,0,50,3,0,50,5,20,81,5,13,1,5,8,30,9,54,10,29,10,16,2,3,0,20,6,9,1,10,6,0,4,9,2,10,8,10,4,2,0,1,4,13,5,1,1,1,8,16,21,53,66,72,37,0,3,0,8,13,3,13,17,9,14,0,1,6,4,27,13,7,7,0,6,38,2,1,13,2,37,5,16,25,8,3,1,6,8,5,0,2,2,1,1,2,6,1,5,17,3,2,16,0,3,2,11,14,3,0,9,66,71,0,2,2,6,6,65,12,6,16,6,8,1,22,30,3,16,15,3,16,4,7,0,15,20,1,10,2,8,3,18,3,7,1,13,2,8,28,40,8,1,1,4,8,3,15,3,30,27,2,1,1,5,12,7,5,10,23,7,5,5,0,57,1,6,16,5,6,4,27,8,24,2,11,14,15,0,59,27,21,10,70,0,10,4,15,7,9,109,9,21,7,5,6,1,5,12,15,5,14,19,14,14,13,1,2,0,62,12,8,0,0,3,14,27,7,16,0,16,34,14,11,3,37,12,32,2,10,8,21,10,5,46,15,5,4,8,4,15,14,16,19,20,3,4,3,19,5,16,5,0,5,12,7,80,4,10,4,175,10,11,8,3,5,26,54,8,3,27,2,3,45,16,16,9,10,11,11,17,20,6,56,27,93,5,3,20,9,9,10,31,15,6,6,32,15,3,3,8,27,3,24,18,11,22,15,1,19,23,20,7,11,5,10,11,28,4,8,9,1,51,6,25,19,13,4,6,12,9,2,3,1,18,0,1,21,0,1,8,3,25,21,1,6,13,18,7,24,17,5,3,2,8,4,4,49,3,1,23,3,113,64,159,111,11,5,12,7,74,75,23,23,35,10,10,10,3,6,20,3,1,2,16,3,8,12,4,5,18,7,3,12,21,13,1,11,8,27,19,6,7,3,8,14,10,2,11,8,0,3,14,21,3,4,6,10,4,21,8,30,4,10,18,1,3,14,20,7,15,3,27,0,16,8,2,2,16,5,12,52,17,6,0,0,4,10,28,3,5,12,1,5,13,7,26,15,11,6,5,9,30,2,20,1,4,3,56,0,2,10,0,12,4,5,3,3,2,2,12,2,1,46,2,6,2,6,16,13,2,59,25,7,4,23,11,6,9,0,13,2,16,0,1,9,24,4,0,15,0,9,3,6,5,3,7,5,18,26,18,3,58,3,1,8,44,16,6,1,6,6,13,13,9,3,5,6,11,8,43,5,3,9,7,3,33,6,19,3,17,3,13,85,77,36,121,61,169,318,12,0,2,4,8,48,82,16,2,34,5,17,9,2,12,9,28,14,19,0,3,0,6,7,5,9,2,1,7,11,5,33,2,23,10,4,11,6,4,25,0,0,2,5,0,0,6,0,15,4,0
admit,2,20,28,194,7,5,1,104,3,3,39,6,4,56,3,10,6,24,3,2,5,54,7,33,23,7,5,12,6,27,10,167,131,7,56,50,33,5,3,6,6,3,4,3,24,23,35,9,415,14,45,4,8,31,7,6,114,26,1,13,15,9,1,10,16,11,125,4,9,8,1,8,4,7,97,14,11,5,79,34,27,0,21,7,215,9,12,0,22,0,5,3,1,30,40,7,11,2,23,9,16,30,35,10,6,12,10,0,10,2,20,7,5,17,2,26,15,2,124,151,30,22,5,57,7,3,7,4,5,0,3,2,6,43,33,36,5,12,4,9,3,35,34,2,5,67,4,13,11,15,71,3,20,4,7,23,28,4,9,1,10,1,2,2,0,5,3,20,16,9,19,96,16,0,5,4,202,7,9,27,31,13,1,7,8,35,29,12,73,63,4,8,9,0,1,2,13,3,10,7,16,1,1,8,21,13,5,33,22,26,73,4,31,10,2,5,1,0,15,1,2,16,10,16,48,115,29,20,3,0,11,4,11,26,23,22,35,11,20,9,67,36,4,10,16,6,1,22,30,4,6,23,15,12,9,22,8,2,6,24,2,26,26,5,3,28,6,7,39,7,132,3,16,4,7,0,16,9,14,1,47,9,3,23,3,0,8,10,20,7,4,1,6,7,1,7,23,5,14,30,21,26,0,3,14,3,13,2,0,2,3,8,20,8,28,16,14,29,5,1,47,7,27,1,82,8,10,32,7,37,9,13,9,4,8,24,25,6,4,20,13,7,25,19,11,5,65,42,12,5,10,17,10,29,29,18,12,6,18,23,17,7,14,12,1,2,40,9,7,15,3,15,6,3,5,20,7,0,14,14,72,4,27,14,0,36,2,30,25,3,27,4,22,19,35,17,52,4,32,3,21,0,2,3,7,4,7,3,26,12,4,6,9,11,10,6,4,7,2,0,5,10,8,7,1,9,2,13,9,13,8,7,3,29,2,4,0,15,5,6,14,13,6,20,1,0,7,2,47,1,7,9,2,9,60,12,0,20,7,29,22,20,16,31,9,3,8,21,6,3,10,4,1,3,2,14,3,27,12,9,7,13,5,7,3,13,11,2,3,5,57,49,0,2,11,13,5,15,9,9,11,4,2,3,5,11,4,15,2,5,4,1,6,9,11,17,4,16,5,7,4,16,12,30,12,4,22,7,10,46,8,5,2,14,8,4,18,18,45,18,12,2,3,1,12,12,9,19,18,8,106,10,10,57,3,12,29,4,6,9,19,4,22,2,24,10,11,9,23,29,8,15,15,1,2,18,11,7,5,9,17,12,15,16,8,8,8,7,17,12,47,40,22,4,14,4,8,0,55,17,24,3,5,13,6,23,14,32,9,8,27,8,13,7,54,8,19,7,20,8,7,0,5,14,3,7,7,7,20,29,6,20,43,40,19,6,10,6,1,11,23,3,7,17,11,17,2,5,9,201,19,8,6,6,15,16,49,19,13,21,6,5,24,30,3,10,1,8,18,10,13,11,40,37,53,6,4,9,2,5,4,26,12,8,17,12,18,5,3,11,34,9,9,13,8,6,9,10,21,20,13,6,6,10,14,2,23,1,11,7,9,9,4,26,26,21,8,9,19,4,5,7,5,21,2,20,7,3,7,7,11,9,4,3,6,1,10,8,80,18,10,6,3,9,9,8,10,2,1,13,5,7,1,4,7,14,12,10,8,14,17,6,1,4,27,32,3,14,3,12,11,1,5,31,1,12,2,7,13,15,3,2,13,2,11,7,6,99,17,19,7,17,3,5,11,35,8,6,2,3,7,5,13,9,8,4,14,4,19,12,20,4,39,13,5,7,5,8,5,20,4,8,1,3,3,9,7,9,4,8,8,13,10,6,10,14,9,16,14,4,11,31,5,9,5,5,7,3,8,9,38,23,12,4,2,3,7,6,9,1,15,14,7,3,7,7,4,3,6,7,6,8,3,11,9,3,4,26,12,1,4,6,2,7,3,1,12,7,5,7,1,11,0,2,10,3,3,17,5,0,9,10,4,8,21,1,14,12,9,19,2,7,12,8,1,5,3,5,4,2,9,6,8,34,6,6,3,19,4,3,2,2,8,8,6,2,0,8,4,6,4,10,6,1,3,17,12,15,18,7,1,5,2,5,4,8,4,6,20,6,2,6,6,2,2,46,2,4,12,3,9,7,2,3,11,4,0,7,5,14,7,15,7,5,6,2,8,2,17,6,7,1,3,1,0,2,0,10,1,2
september,11,19,4,62,3,1,3,9,7,0,17,7,9,15,1,2,7,4,3,3,2,17,1,9,8,8,2,9,3,35,10,85,54,3,10,41,13,3,7,5,2,2,2,1,13,6,9,1,223,20,23,5,2,11,2,1,29,29,2,8,11,2,0,2,9,2,28,2,6,12,98,0,2,1,11,3,11,1,36,6,46,0,4,2,117,14,12,0,142,20,24,3,3,26,36,0,20,2,23,2,6,12,18,4,6,21,8,2,25,8,25,7,0,9,1,13,18,7,71,42,9,15,4,131,8,0,0,4,14,6,5,3,0,17,5,14,5,6,5,9,0,25,31,6,3,46,3,2,10,13,20,2,9,3,0,9,12,7,12,5,5,0,2,18,2,4,14,6,12,4,21,28,5,0,0,5,59,1,1,5,3,8,9,7,2,10,14,10,24,50,4,2,2,0,0,3,13,3,9,4,5,2,2,10,8,3,2,8,1,11,37,4,14,2,4,1,1,2,8,0,20,8,5,8,20,30,15,12,16,2,4,29,16,8,8,16,15,1,9,4,24,14,2,6,4,3,3,12,35,1,0,8,10,33,3,4,8,10,5,14,3,20,13,10,4,40,0,0,8,2,65,4,81,3,1,2,16,23,16,0,9,0,2,10,5,1,1,4,8,1,28,12,1,12,12,2,47,4,4,8,10,32,5,22,6,1,13,6,0,1,2,2,32,3,30,12,2,26,11,2,26,2,4,1,13,0,5,19,2,15,3,4,3,1,1,8,5,5,4,23,2,11,4,8,2,2,14,22,7,1,7,4,1,10,8,1,5,1,3,69,15,6,1,5,2,0,9,2,3,3,2,10,0,1,2,12,0,1,6,6,19,0,17,6,1,25,1,17,26,5,14,1,4,15,19,2,22,2,32,4,7,2,1,3,4,1,1,0,10,5,1,6,12,5,5,2,1,1,1,6,3,5,6,7,1,3,6,5,10,21,9,37,60,41,3,3,1,13,3,2,2,5,3,5,1,3,7,2,11,7,5,4,3,5,20,6,0,6,2,22,4,13,13,20,1,1,7,7,3,1,5,3,1,0,2,2,1,6,11,1,1,7,1,1,3,3,4,5,1,6,62,12,1,3,6,3,1,8,5,3,4,2,2,1,14,6,0,6,5,0,6,2,10,5,4,9,4,2,0,2,1,8,0,7,1,6,14,3,11,10,6,1,14,3,10,10,5,4,12,7,2,7,0,0,2,3,36,3,8,6,17,3,7,29,3,0,8,2,1,2,10,4,23,3,7,3,9,3,19,11,6,6,7,3,4,0,6,1,1,34,4,8,5,2,1,4,4,2,2,4,2,14,3,2,4,1,0,3,38,3,14,0,5,7,7,2,7,11,5,1,14,16,14,0,10,3,5,0,2,2,10,1,1,34,1,2,1,3,4,14,3,7,5,10,5,0,1,6,3,7,3,1,4,22,5,35,2,10,3,149,21,3,3,2,3,10,15,9,6,7,3,5,34,13,8,8,2,14,6,8,6,2,35,13,33,2,0,11,18,1,13,17,8,6,4,9,2,5,2,12,8,4,16,2,3,2,5,5,2,6,15,8,3,1,3,2,14,2,2,9,1,28,1,7,8,33,16,4,5,5,7,2,1,15,5,4,10,0,1,6,4,21,2,0,7,7,13,1,17,0,4,2,2,7,9,2,10,3,2,3,9,53,10,35,46,8,2,7,5,23,16,4,20,16,8,22,13,3,2,15,1,0,0,12,0,2,4,1,3,4,1,1,3,10,5,1,4,20,2,6,7,4,1,4,5,4,3,8,5,13,3,18,4,4,1,2,0,6,5,3,23,4,9,5,1,3,1,11,6,5,9,12,13,10,0,3,2,11,1,2,17,14,0,1,4,0,3,19,2,6,6,1,1,2,2,12,4,13,2,14,13,25,7,1,1,5,1,6,1,0,4,0,11,0,0,5,3,7,3,7,0,4,5,0,1,1,8,4,11,2,10,18,3,8,11,7,6,6,4,3,6,3,0,2,4,38,3,16,8,2,2,5,7,2,9,38,2,8,3,10,5,15,3,44,5,1,5,0,1,2,6,5,0,3,4,8,3,22,4,6,5,1,5,1,4,6,1,4,3,1,2,5,12,18,8,20,8,44,92,2,6,2,1,2,4,23,5,4,16,3,22,5,1,4,8,27,2,0,3,1,11,1,2,0,4,1,3,4,3,2,2,2,11,0,3,0,4,1,10,0,1,1,3,0,0,1,0,9,0,1
york,6,5,5,43,2,4,2,17,2,4,5,10,12,14,2,3,1,5,3,2,0,18,8,13,7,8,3,3,3,11,1,82,58,4,15,15,10,4,4,2,4,3,5,0,16,8,7,1,151,13,15,0,3,12,7,0,27,18,3,10,1,3,0,3,3,1,34,11,6,16,4,16,5,4,30,3,10,2,27,7,47,0,11,6,42,7,9,0,29,7,9,3,5,5,30,12,6,6,11,1,12,15,4,1,4,13,1,3,7,4,13,1,1,1,3,5,3,2,23,53,19,6,2,61,4,1,1,0,11,7,1,1,5,31,11,29,1,0,1,2,0,10,14,1,0,20,5,4,21,6,14,1,4,1,1,3,14,1,1,3,4,1,5,12,0,0,6,2,6,2,199,40,8,0,8,3,51,1,2,25,11,6,2,11,2,7,20,18,20,25,2,0,2,0,0,1,15,2,8,1,22,2,0,2,8,2,4,19,1,5,25,5,7,2,0,4,0,0,4,2,4,5,3,13,24,36,30,23,3,3,8,10,6,4,8,10,11,3,2,1,17,12,3,2,0,3,5,18,12,1,1,8,3,6,3,2,2,0,2,19,3,6,9,5,1,17,1,0,4,5,41,8,14,2,2,0,8,1,5,3,16,4,1,3,5,2,0,4,5,3,7,0,1,4,1,3,26,0,1,8,1,11,1,6,3,1,3,2,0,3,0,9,11,1,34,8,5,15,1,0,11,3,15,7,8,2,2,15,0,7,6,9,0,5,0,2,3,5,1,7,6,3,3,3,4,1,12,22,10,2,5,2,2,14,6,7,0,2,5,7,9,7,1,11,2,0,10,9,3,10,1,5,0,8,3,27,7,1,1,0,23,1,14,9,2,9,8,3,9,0,3,2,10,7,11,3,19,0,6,1,2,1,2,2,1,4,4,1,13,4,3,23,5,19,4,3,2,1,1,0,0,5,4,2,0,2,0,7,5,12,1,1,0,5,1,1,0,0,8,2,4,5,3,16,3,12,7,1,14,5,10,1,8,2,32,3,0,3,4,6,4,10,13,26,6,4,5,9,3,0,6,7,1,2,3,8,2,8,9,2,4,9,1,2,4,6,11,1,0,2,34,28,0,0,6,1,11,5,10,1,1,1,5,1,5,13,1,7,1,2,3,0,6,0,5,6,4,2,0,7,0,10,1,5,2,1,17,0,15,7,3,2,3,3,3,8,3,2,16,4,4,3,2,13,9,3,0,11,5,4,3,2,3,21,5,6,12,3,1,3,3,4,11,1,1,1,4,1,13,8,5,2,8,1,5,1,2,0,9,10,3,4,2,4,2,2,3,3,2,4,6,9,9,1,9,0,2,2,10,4,8,0,1,0,4,3,5,5,3,12,11,9,5,2,16,2,6,0,2,0,6,6,2,4,4,2,3,5,5,17,8,14,7,6,3,0,5,5,1,14,5,3,5,13,1,19,4,3,2,71,10,0,7,2,1,7,11,2,0,7,6,4,0,8,3,1,0,0,4,1,14,0,8,10,4,2,0,7,6,0,5,12,3,6,4,4,2,1,13,17,2,3,7,10,4,16,2,0,3,6,1,0,3,1,8,2,12,5,0,2,2,4,1,11,2,7,3,2,4,1,10,10,0,18,1,23,8,1,2,10,18,3,1,1,1,5,19,0,10,18,3,0,0,11,12,3,10,4,1,2,3,0,1,2,6,7,2,8,0,38,33,6,2,5,13,8,52,8,0,3,8,4,1,9,1,7,6,0,5,5,6,2,4,0,6,4,1,3,4,8,1,10,4,0,2,4,0,7,2,2,0,3,7,3,4,0,4,2,4,10,5,6,19,5,7,0,3,4,3,6,3,5,4,9,6,2,2,4,0,2,3,1,4,0,8,2,4,6,4,1,1,2,1,3,8,17,8,2,0,0,4,7,3,5,1,3,6,1,1,0,2,2,7,1,5,4,0,2,3,10,0,0,3,12,1,1,1,4,3,0,0,0,1,2,8,1,3,1,6,3,9,16,4,2,1,2,4,7,9,4,4,1,3,0,4,14,0,4,7,11,0,0,1,16,3,5,1,8,2,3,0,0,3,3,4,5,0,4,0,1,0,2,2,1,1,0,3,1,2,4,1,6,3,1,4,5,2,2,8,0,2,2,3,2,0,0,7,4,11,0,0,7,4,1,1,13,2,0,2,8,2,1,2,3,1,0,1,1,7,2,21,2,5,7,2,0,0,2,4,1,0,0,1,0,1,1,1,0,1,0
navigation,14,6,3,90,5,1,1,14,3,3,12,7,6,67,2,2,4,32,2,2,3,33,2,13,5,10,8,9,1,2,3,152,109,0,22,20,23,4,3,1,18,5,3,5,19,14,26,4,249,14,23,1,7,12,1,2,53,14,0,11,16,10,0,26,10,3,19,2,9,16,11,22,9,0,42,8,20,6,39,14,43,0,7,3,156,12,12,0,20,0,7,1,0,18,38,2,6,3,25,11,29,18,23,4,3,10,1,0,8,2,14,1,6,60,0,24,7,4,62,72,18,19,6,24,3,4,5,5,3,3,7,0,1,51,5,35,2,1,15,2,1,26,27,3,4,54,8,9,7,15,85,0,11,12,2,23,14,0,10,0,10,5,10,1,1,2,3,7,12,3,24,58,13,3,2,8,128,0,14,15,9,19,2,3,4,7,32,15,18,56,0,2,6,0,2,3,19,3,2,3,2,0,2,10,13,0,3,15,11,12,55,1,11,7,1,0,0,0,1,10,2,8,14,11,41,29,12,20,8,7,24,6,14,16,18,23,14,4,7,10,33,20,5,0,16,5,8,7,33,8,17,16,8,3,2,7,6,0,4,9,0,12,11,3,2,9,0,0,23,8,138,1,7,12,4,0,15,8,12,1,29,2,4,19,5,3,1,7,2,1,8,5,19,1,2,4,27,2,8,8,25,18,0,2,13,1,14,1,0,7,0,6,18,6,8,12,17,20,12,4,52,3,24,1,51,8,1,13,4,5,0,4,3,3,3,35,10,5,1,6,4,4,9,2,7,12,26,56,15,2,13,2,5,22,16,6,1,0,11,5,11,32,7,52,7,0,15,1,0,4,1,4,11,0,1,15,3,12,4,8,35,0,37,12,0,13,0,6,13,1,11,2,6,22,20,10,51,0,20,1,22,3,3,0,1,11,4,8,45,9,1,8,7,14,3,10,6,5,0,1,4,7,12,4,0,5,3,11,5,6,1,4,2,8,2,3,0,29,8,0,11,42,6,25,4,3,27,3,21,5,12,5,1,1,74,8,1,20,2,28,2,7,11,8,1,1,2,41,89,0,11,0,7,1,0,4,4,5,11,2,5,8,3,2,2,4,8,4,3,1,28,20,0,1,9,8,4,6,3,4,13,2,2,1,6,6,3,6,0,2,7,0,5,21,14,27,2,7,0,3,3,21,6,12,1,5,11,4,10,10,7,3,2,1,9,2,3,2,21,8,8,2,2,1,7,10,1,21,6,6,15,9,4,41,3,10,157,6,8,2,16,3,23,0,7,3,11,3,44,28,12,6,19,2,9,8,5,3,3,22,40,11,25,8,7,2,4,3,9,1,25,26,13,8,10,1,0,2,114,11,18,2,6,6,13,19,1,5,11,10,12,5,7,16,9,6,19,3,4,5,8,0,8,4,13,4,7,6,5,19,1,13,18,13,3,4,9,8,4,17,8,0,0,7,11,15,3,5,8,177,6,17,3,0,11,15,53,13,2,8,9,4,44,44,36,20,1,3,9,12,14,16,67,1,24,1,1,9,6,5,7,45,21,10,9,8,2,2,5,27,13,4,13,27,7,20,3,8,22,22,6,7,3,4,6,8,19,7,0,5,0,7,5,20,10,16,1,15,8,3,4,5,5,12,3,13,2,1,1,8,3,5,4,1,2,1,21,5,23,14,4,4,12,27,41,4,13,58,3,9,7,1,2,9,1,13,2,7,6,4,2,5,1,2,24,23,13,2,22,6,5,3,0,7,4,4,2,1,0,5,2,2,18,0,11,7,3,21,2,11,4,2,4,2,4,12,4,4,9,0,7,8,8,2,0,0,1,3,12,9,14,5,40,5,11,7,2,8,3,7,6,0,2,9,18,4,2,0,0,5,5,7,1,4,12,2,4,12,22,4,7,7,1,5,4,12,6,4,2,4,32,17,2,18,1,4,3,1,3,1,9,14,1,1,3,4,1,5,3,4,3,2,1,1,1,1,9,17,5,11,3,6,3,17,9,3,4,3,8,7,7,89,1,3,7,10,8,3,0,0,12,2,1,1,0,6,8,14,6,11,0,0,13,6,5,0,8,1,1,4,8,4,10,16,1,4,9,14,1,0,6,2,1,3,5,1,12,2,8,54,4,14,0,2,1,4,3,7,7,8,6,2,2,2,4,2,4,17,12,3,0,34,2,3,3,59,4,0,0,21,3,3,7,4,7,17,1,2,10,10,3,9,4,1,3,4,21,3,14,0,2,2,2,0,0,0,0,11,4,0
gain,5,6,6,29,4,7,5,11,2,5,3,2,10,38,1,2,2,12,5,7,0,21,8,13,15,10,10,8,6,17,4,81,60,5,24,43,16,2,9,20,5,7,1,0,19,5,13,6,88,22,23,10,10,31,6,1,21,15,6,17,4,3,2,5,13,4,56,3,11,11,12,1,2,3,55,7,20,3,32,16,36,2,7,4,76,8,11,2,18,0,3,4,3,6,17,14,10,5,31,10,2,9,16,2,7,6,3,16,6,3,12,2,9,19,13,23,2,0,16,59,21,14,24,46,9,2,4,3,3,1,4,4,4,24,9,30,13,3,5,7,5,15,10,5,4,41,1,14,7,9,28,6,9,4,6,12,13,2,2,16,4,4,8,1,4,5,4,7,12,3,10,40,16,4,6,2,60,1,4,26,6,6,5,10,0,12,23,12,9,25,0,6,3,4,0,3,6,3,13,3,20,3,2,6,18,6,2,21,2,16,43,11,7,3,7,11,1,1,10,1,2,12,4,2,21,32,24,18,2,6,12,10,7,17,12,18,13,5,3,3,30,23,9,5,14,4,2,19,27,3,3,10,11,5,3,13,2,4,3,13,11,12,11,4,6,22,8,3,9,4,45,1,10,3,2,5,5,3,0,0,27,8,3,11,7,1,4,9,14,1,3,4,7,2,4,3,12,2,1,15,8,8,3,3,2,1,12,6,4,2,1,8,10,9,15,11,19,22,22,3,13,2,14,2,23,2,7,20,4,17,5,10,1,4,9,2,11,3,1,3,6,4,9,3,8,7,18,21,3,7,6,3,0,12,10,2,2,2,7,15,14,7,5,10,4,3,5,4,6,7,3,18,2,8,6,24,5,5,8,4,21,0,15,4,6,6,1,6,12,1,4,1,4,2,11,4,14,2,9,2,6,2,5,0,3,0,5,4,13,4,3,4,9,6,5,6,0,11,2,2,5,9,14,5,3,2,5,10,5,11,3,2,0,3,4,2,1,9,9,5,3,4,3,9,2,7,8,2,12,10,15,1,2,2,16,3,2,1,5,8,10,12,20,21,5,0,10,6,4,3,11,4,4,3,5,3,3,2,14,2,3,14,2,3,6,0,6,4,2,0,27,9,4,2,8,2,5,6,7,4,5,3,3,0,2,26,2,6,6,8,4,6,1,1,21,4,9,5,3,5,1,1,3,8,5,2,9,1,4,10,12,1,2,6,9,3,1,1,18,11,4,0,0,4,5,1,1,5,4,1,9,1,5,15,5,4,6,3,1,3,7,2,2,1,8,5,9,1,16,15,6,1,7,4,2,0,1,5,4,5,8,4,14,8,3,3,5,1,0,5,13,15,5,1,16,1,1,13,9,13,12,3,2,2,2,7,4,5,3,2,14,11,4,1,12,2,11,1,2,3,7,6,3,6,1,1,0,1,11,10,18,5,11,9,3,3,3,6,1,4,5,1,3,7,5,15,8,3,2,45,8,2,2,2,9,6,21,4,0,6,3,2,6,1,1,0,1,2,4,1,5,6,1,2,1,2,2,2,2,4,2,7,5,2,2,6,4,2,3,5,6,7,5,3,4,6,4,0,3,2,4,2,2,3,1,5,9,3,0,1,0,5,2,8,4,7,2,4,5,9,9,2,0,11,1,3,2,1,3,8,4,6,1,3,3,2,7,7,7,5,6,3,3,7,2,2,6,9,2,2,4,3,6,9,4,5,4,2,2,4,2,8,2,2,11,10,4,6,4,2,4,4,5,4,0,4,8,4,4,4,4,0,6,6,3,3,1,0,2,4,1,2,2,2,11,6,3,2,1,6,1,4,4,3,5,1,7,2,3,0,2,4,3,3,1,0,1,4,2,3,2,4,3,8,1,7,5,0,9,4,4,7,5,2,1,12,4,13,3,3,0,1,0,2,8,3,7,4,0,3,6,7,6,4,6,1,1,0,0,4,3,5,2,7,3,3,0,1,3,2,4,7,1,8,1,2,1,3,2,2,0,3,6,0,0,1,1,1,3,2,3,2,2,1,0,2,0,1,4,12,4,1,2,6,5,2,0,2,5,7,3,4,3,1,4,1,2,1,1,5,5,3,0,5,0,1,2,3,2,7,2,0,2,2,3,4,2,0,1,7,3,3,7,0,1,4,2,5,4,1,1,1,5,3,2,0,2,4,7,6,0,7,5,1,1,1,1,2,2,3,17,2,5,2,2,4,3,1,5,3,1,2,3,16,1,3,8,3,15,3,4,2,7,4,0,6,6,3,2,2
indicate,0,2,1,69,5,0,2,7,3,0,4,2,8,20,1,2,0,2,1,2,0,13,1,9,11,3,3,6,2,3,2,66,54,2,17,11,14,1,6,6,0,2,1,1,14,8,5,13,87,2,12,1,2,9,4,4,7,18,0,4,5,1,2,4,5,2,24,1,4,9,9,3,1,0,23,6,9,5,43,9,34,0,4,3,77,4,5,1,14,2,2,3,1,9,10,11,12,4,12,5,8,19,17,1,3,11,10,2,6,0,2,1,6,7,2,10,1,0,22,71,10,4,10,46,4,4,3,5,0,4,1,1,0,16,2,24,1,2,4,2,2,7,11,3,1,21,2,4,5,7,17,0,6,1,3,9,6,2,4,1,2,1,4,3,21,5,4,11,8,2,8,23,8,3,1,6,51,0,4,9,13,4,4,5,1,6,9,11,15,25,1,1,4,0,4,3,6,3,1,4,11,0,3,3,9,1,3,8,4,8,33,1,9,3,0,2,8,15,14,5,3,11,1,8,18,41,18,17,4,19,5,11,13,6,12,11,8,2,5,2,26,11,2,0,5,9,0,4,23,2,6,10,7,3,6,5,3,4,4,13,1,1,13,4,4,34,2,0,3,2,38,2,20,2,1,0,2,38,3,3,15,3,3,5,1,2,3,2,6,0,4,3,4,6,6,5,15,4,5,4,2,13,5,1,6,0,9,1,1,0,0,7,9,1,7,4,7,11,5,4,17,1,8,2,12,0,10,7,1,6,1,3,4,2,0,3,8,5,4,3,2,3,4,3,2,5,17,20,4,10,5,3,0,18,8,0,1,0,6,19,13,5,7,4,3,0,13,2,1,2,3,5,5,4,1,12,3,2,4,3,23,0,26,5,0,12,4,10,9,2,6,2,7,5,20,1,22,1,13,1,8,0,0,1,4,1,6,1,7,3,0,3,1,5,2,6,1,3,1,0,2,3,11,8,0,3,2,11,2,2,3,1,3,6,0,1,0,3,2,1,2,6,9,5,2,4,6,2,14,3,9,1,1,0,26,5,0,0,1,10,8,3,12,9,3,1,6,8,3,0,4,1,1,1,1,0,0,3,6,1,6,0,1,1,5,2,3,2,4,2,34,18,0,0,5,1,6,14,2,1,8,0,7,0,1,6,3,5,4,1,1,1,3,2,9,8,4,5,2,4,2,9,6,1,2,6,4,4,10,20,3,2,0,2,8,1,2,4,13,5,1,4,2,2,2,0,1,6,4,2,9,0,3,8,7,1,12,1,1,2,5,1,7,2,10,10,4,2,22,9,3,5,8,0,10,3,2,7,2,16,2,9,1,5,2,4,4,2,3,7,5,8,6,1,5,0,0,1,14,7,11,5,3,2,3,16,2,6,6,0,11,14,3,3,4,5,4,0,8,1,6,3,2,4,3,3,4,6,1,13,9,11,7,2,1,2,7,6,1,3,8,2,1,9,3,11,8,4,5,68,10,2,4,1,3,8,9,3,2,4,3,1,5,10,6,1,2,2,3,7,6,0,1,14,5,3,4,5,2,2,2,12,11,6,5,2,5,1,1,4,7,2,5,11,3,3,2,3,2,9,5,2,4,4,4,3,10,2,4,5,1,6,4,9,5,16,6,1,4,2,2,2,2,12,2,2,2,1,1,2,1,6,3,3,6,1,16,2,3,5,4,2,2,7,8,1,6,6,2,2,4,10,15,16,9,7,2,6,2,8,7,3,0,10,8,5,4,4,7,6,0,2,2,6,0,8,6,0,2,1,0,2,1,2,12,3,3,0,1,6,5,3,1,1,4,6,1,4,1,2,4,3,3,4,2,0,2,6,5,6,3,1,5,4,0,1,1,9,5,1,1,3,6,8,5,3,1,5,1,1,8,2,4,0,0,7,4,6,2,1,2,2,0,6,1,4,5,3,2,0,11,5,4,4,2,0,6,2,3,0,2,6,5,0,1,2,2,1,2,12,5,2,4,3,6,2,2,6,3,2,1,2,1,2,3,1,3,3,2,3,0,5,0,0,1,4,1,2,4,3,4,2,3,5,0,6,0,2,3,12,2,2,0,6,2,2,3,4,5,1,4,2,0,1,3,2,0,9,2,1,7,5,3,1,2,2,2,3,2,3,6,1,13,1,12,6,4,46,14,3,2,0,2,1,3,2,6,1,9,3,1,5,0,2,1,9,2,6,1,3,2,1,2,2,3,5,3,2,2,5,7,2,3,4,3,1,4,3,4,0,1,1,2,2,0,6,0,1,0,0
entertain,4,14,2,105,13,0,4,40,8,3,16,7,3,40,8,5,7,6,1,5,5,27,2,14,14,2,9,8,2,8,5,108,94,5,48,28,33,5,5,9,2,7,5,2,23,18,38,10,293,9,46,2,9,10,3,2,40,9,0,12,19,4,2,10,9,1,62,1,13,21,7,5,5,1,26,13,11,2,56,17,11,1,17,2,191,14,5,0,30,0,5,4,0,23,37,1,9,5,19,5,20,7,24,6,3,20,1,1,15,1,13,8,4,7,0,21,7,6,44,149,29,2,1,22,2,2,3,5,2,1,3,1,2,28,16,28,4,1,6,6,0,24,35,0,3,35,3,2,10,7,63,1,15,5,1,9,9,4,8,1,5,0,3,1,0,1,0,11,3,8,6,39,6,0,2,6,124,2,10,8,15,9,0,9,5,11,23,14,36,53,1,9,2,0,0,1,10,2,1,8,8,2,1,17,20,5,8,21,10,23,61,2,18,3,0,0,0,0,8,5,1,8,5,7,34,55,15,23,0,1,10,6,5,19,13,10,17,9,2,1,56,21,7,4,11,7,4,11,11,4,10,23,30,8,16,18,7,2,3,8,0,14,26,4,13,21,0,1,9,2,113,6,19,6,6,0,16,11,8,0,36,10,1,14,4,0,2,4,13,1,3,1,19,2,0,8,41,7,6,11,22,19,0,1,11,1,21,5,3,0,2,4,17,3,19,9,11,26,4,5,25,8,15,1,38,6,2,15,3,20,5,10,3,9,4,14,17,10,4,7,4,4,11,9,2,9,38,47,18,1,6,10,3,16,8,4,1,2,11,12,10,4,1,12,6,0,38,8,4,10,2,6,6,4,4,10,5,2,14,9,41,0,35,5,1,15,1,11,24,9,17,4,8,6,43,13,67,8,25,1,17,3,4,1,5,2,6,3,19,10,3,10,2,10,12,7,4,4,3,1,1,10,13,15,0,2,2,12,9,7,19,3,4,8,3,5,0,22,2,4,15,18,8,9,1,4,0,6,16,11,12,7,1,9,45,4,0,5,4,15,7,12,25,15,6,0,7,7,5,0,3,0,2,1,1,3,4,13,8,4,4,10,6,4,7,5,8,5,5,0,50,28,4,8,7,8,2,15,7,9,8,4,3,0,8,30,0,18,4,5,5,4,10,4,13,29,4,9,4,6,5,7,12,10,5,5,15,3,9,22,4,4,7,8,5,5,13,5,39,8,4,1,1,1,7,6,5,20,10,4,37,11,2,28,2,6,22,11,5,1,23,4,9,1,44,12,16,3,34,17,9,14,13,4,3,23,4,7,3,4,5,14,15,10,10,7,3,3,6,5,17,38,8,1,8,3,3,1,56,23,17,1,6,12,10,17,10,20,2,5,10,6,9,6,21,5,21,0,3,2,19,6,2,29,1,5,11,5,13,24,12,11,22,17,9,3,3,6,1,6,5,0,6,33,8,10,1,5,1,160,17,2,9,8,7,16,27,4,5,12,5,9,9,22,6,7,0,9,13,9,14,5,52,3,26,5,1,15,0,2,5,19,23,3,7,8,10,9,4,10,5,1,19,9,5,10,9,2,5,19,6,0,6,2,5,3,20,7,2,7,2,5,8,27,15,22,7,10,7,2,11,3,13,15,1,4,8,4,1,13,4,8,4,0,4,6,3,3,30,5,8,10,1,6,5,4,11,0,2,5,16,8,2,1,0,4,6,7,3,1,0,7,4,0,16,13,5,4,3,11,2,4,0,8,1,8,7,5,17,7,5,9,13,3,6,1,8,21,12,7,6,2,6,5,5,10,4,3,3,2,4,8,6,6,9,2,8,2,17,5,3,4,10,9,6,4,7,10,10,5,13,6,2,12,1,6,3,0,10,9,2,9,15,4,4,6,11,24,6,6,15,6,1,3,0,6,4,7,12,5,18,20,5,12,1,2,2,6,6,1,9,1,12,4,2,6,2,3,3,3,0,5,3,14,5,4,15,14,15,0,1,6,4,10,10,5,7,4,10,9,5,18,0,6,4,4,2,2,1,0,8,7,2,10,2,6,8,19,0,23,9,2,3,6,9,6,0,8,5,4,1,14,2,6,2,9,4,30,4,9,5,3,8,8,7,7,5,5,2,4,3,5,2,4,3,14,8,4,26,4,0,9,4,4,2,0,7,4,14,8,4,6,6,0,1,15,4,3,6,8,13,10,3,0,8,15,2,6,9,8,7,10,8,9,6,2,10,0,19,1,4,0,6,0,0,1,0,15,2,0
adjust,0,14,4,84,15,4,4,16,4,1,32,13,2,57,2,5,10,4,3,2,4,27,1,16,14,5,6,11,4,6,5,110,105,5,31,37,52,5,13,2,5,2,1,0,27,19,25,5,226,27,36,4,11,25,3,1,50,14,0,12,31,13,0,12,21,6,40,8,42,16,4,1,3,3,38,7,5,3,63,8,29,2,6,3,181,10,6,0,35,3,3,5,2,38,34,16,9,0,26,14,6,20,25,9,15,13,5,5,14,3,8,4,6,9,1,35,8,1,35,99,23,4,14,26,2,3,3,2,0,2,6,1,4,24,18,14,11,4,2,7,1,27,32,4,2,43,6,14,10,5,45,1,8,5,2,7,14,0,12,8,4,3,3,2,1,0,0,19,13,10,13,45,15,0,2,10,123,1,9,9,17,14,7,8,2,19,14,14,67,93,0,4,2,1,1,0,8,9,2,7,10,2,2,12,20,6,2,15,19,23,37,2,10,8,0,0,0,3,3,3,8,14,4,13,25,24,7,12,2,3,16,7,17,15,18,22,35,7,15,4,50,25,4,6,12,4,5,4,24,4,13,14,19,3,8,6,8,4,4,12,6,12,22,5,3,10,0,2,9,4,101,3,15,1,2,0,7,8,17,2,18,0,2,11,7,5,0,4,14,0,5,7,4,7,4,11,45,5,2,23,26,24,0,5,5,2,18,7,5,2,3,4,24,5,23,10,6,31,9,4,55,4,14,3,48,5,9,20,2,15,2,2,5,3,1,6,9,12,0,8,12,7,6,5,0,5,49,41,6,3,5,14,6,7,17,9,5,4,11,21,9,4,3,12,2,1,18,12,2,6,2,9,3,2,3,16,2,0,14,3,30,0,17,12,5,20,1,17,15,1,17,3,5,14,27,11,55,0,18,3,20,1,2,0,3,3,2,4,21,9,2,12,9,12,7,5,9,10,5,2,2,5,8,10,1,5,0,7,7,24,5,3,2,13,5,6,0,39,7,5,14,23,6,18,1,4,2,15,21,8,11,4,1,2,75,2,1,7,3,24,12,17,22,10,2,1,9,6,5,0,10,2,3,2,1,4,3,8,18,4,8,11,5,5,9,6,10,2,0,2,59,26,1,4,10,6,5,16,11,3,4,3,2,3,8,4,12,15,5,1,7,3,2,1,13,11,4,6,2,6,2,8,5,8,4,1,16,2,5,15,3,2,0,5,6,3,9,9,19,10,5,5,4,2,5,6,7,16,35,3,12,3,3,23,7,4,17,3,1,11,26,1,15,1,9,8,13,4,34,21,7,7,12,1,7,18,11,6,1,18,7,2,8,9,3,3,3,6,3,8,31,12,7,2,17,1,5,7,77,17,12,2,6,8,27,15,2,27,8,3,20,10,14,5,26,5,17,2,4,4,4,4,0,13,0,7,4,5,9,19,11,15,19,13,7,2,5,10,1,4,4,0,5,13,21,8,3,7,1,176,20,6,3,1,5,8,24,11,6,12,5,8,29,57,18,8,26,24,31,8,10,9,50,10,66,3,1,2,4,4,8,18,16,7,10,6,1,7,5,14,11,6,5,19,7,4,6,4,15,8,11,4,11,3,6,11,13,5,1,2,3,10,2,11,13,7,7,7,8,1,6,3,5,6,1,1,8,1,2,7,2,12,4,3,8,0,6,0,26,4,14,6,1,3,10,1,4,7,7,2,5,3,1,9,2,2,5,15,3,13,15,9,8,4,16,10,5,5,5,28,2,5,3,4,2,8,6,3,9,10,5,2,9,1,4,4,4,24,3,6,9,3,7,8,3,15,1,7,9,4,12,3,10,4,9,4,2,2,10,3,15,6,11,8,2,5,3,15,5,7,12,5,7,4,5,6,4,9,1,10,2,6,4,2,5,10,1,32,7,5,8,7,1,6,3,7,3,9,1,12,15,7,12,5,0,4,6,5,6,5,7,2,3,7,2,8,2,4,7,4,3,1,6,2,2,6,12,9,10,7,13,4,2,8,20,10,9,8,2,6,3,18,0,4,21,12,7,0,1,0,2,4,0,7,1,3,8,3,7,14,1,7,0,13,6,5,0,4,3,2,14,1,2,17,3,4,6,35,14,2,5,3,19,9,3,0,0,2,2,2,1,13,0,1,5,19,8,6,4,11,1,2,1,3,3,1,11,5,5,6,3,3,2,3,2,12,1,0,4,7,3,2,1,1,8,3,6,8,9,0,3,5,10,6,7,9,7,8,21,0,0,0,2,1,0,2,1,9,1,0
consist,2,8,9,66,3,3,5,23,1,3,10,6,3,25,1,3,5,11,5,1,2,32,8,9,11,3,2,8,4,13,5,63,48,7,31,23,16,11,1,3,2,1,3,0,15,7,8,9,156,1,18,0,6,16,3,4,32,18,0,7,2,2,4,5,4,1,49,1,1,2,8,5,2,2,31,6,9,0,53,10,25,1,11,2,117,18,10,0,29,3,1,3,0,12,28,11,6,5,11,4,8,15,8,8,7,3,0,0,12,3,7,4,4,19,0,16,5,1,36,65,12,8,3,32,3,0,3,1,2,0,8,0,2,19,12,8,4,1,2,4,1,10,23,3,0,34,6,7,8,9,43,3,9,2,3,19,12,2,5,2,11,3,4,2,1,3,1,6,20,5,11,46,7,0,2,8,90,4,10,12,12,7,3,4,1,6,14,11,16,35,6,0,3,1,1,1,12,3,3,9,12,1,2,5,7,4,3,9,7,17,24,2,23,6,0,0,0,0,6,1,2,6,1,11,18,48,7,7,5,3,10,11,22,9,16,14,14,2,5,2,23,12,3,3,5,7,2,10,25,3,7,7,4,8,7,4,6,1,1,21,1,18,9,3,2,27,2,5,13,3,72,4,41,6,6,0,7,10,7,1,20,6,4,10,7,1,1,9,4,1,1,0,19,1,1,5,14,0,5,8,12,17,2,2,5,0,4,1,5,0,1,7,18,1,11,6,6,17,3,2,18,5,13,1,17,3,3,11,0,12,3,6,4,2,3,12,7,3,8,8,6,5,7,5,3,3,28,25,10,2,9,7,2,11,9,9,2,8,7,13,10,3,7,7,0,0,28,3,4,5,2,3,0,4,3,20,4,3,4,3,27,2,26,4,1,25,3,9,27,4,11,2,22,11,17,11,24,2,18,2,11,1,2,0,7,4,6,2,4,4,1,4,12,11,0,6,2,4,1,0,3,4,10,10,0,1,2,6,9,8,9,2,6,4,2,1,0,4,4,3,7,17,3,5,1,1,9,1,22,2,8,4,1,3,23,2,1,7,6,17,2,5,8,28,2,4,6,6,9,0,3,2,1,4,1,5,5,6,8,2,3,9,4,2,4,8,3,2,0,1,52,16,0,2,3,4,1,15,3,3,4,5,0,1,6,4,1,7,2,2,4,5,3,5,9,9,2,4,0,3,3,12,1,12,4,2,9,1,12,18,8,5,2,7,4,5,7,3,16,7,2,2,1,2,4,2,1,8,5,1,33,3,2,12,4,4,15,1,4,5,12,3,11,1,11,8,5,1,20,8,6,5,7,1,2,1,3,0,1,9,8,7,9,4,6,1,2,5,3,6,11,12,2,6,7,2,1,1,18,7,12,2,0,1,3,13,5,16,3,0,12,9,7,2,14,10,11,0,5,7,5,2,3,12,3,4,0,5,2,17,9,6,7,18,1,2,7,7,3,13,11,1,2,14,1,22,1,0,3,90,7,3,7,3,1,5,24,5,3,14,4,2,8,8,3,4,4,8,2,4,8,3,41,18,10,1,1,1,5,2,6,23,4,7,11,5,8,2,1,10,11,2,8,9,4,5,8,4,1,9,1,3,3,3,9,1,7,1,1,2,4,12,6,9,4,20,4,4,7,4,7,1,6,14,2,2,1,1,0,5,9,5,7,2,5,6,33,4,20,6,4,3,3,12,4,3,5,6,1,3,5,3,4,8,0,8,3,5,4,13,13,7,4,10,16,20,7,4,4,7,5,0,0,9,3,8,7,5,8,11,1,3,3,2,3,3,5,16,4,5,0,9,6,2,0,13,2,2,1,5,0,3,4,2,2,2,1,2,9,6,10,0,6,1,3,1,1,4,2,5,2,1,2,11,7,0,2,5,6,2,3,4,6,1,5,3,5,9,0,0,3,4,2,9,3,11,3,2,7,5,8,16,6,6,1,6,2,7,2,1,4,0,3,3,1,7,2,4,6,5,1,1,5,9,1,6,1,2,1,1,0,4,3,2,10,0,3,1,2,0,0,4,0,0,5,7,2,1,6,2,2,4,2,1,0,5,0,9,5,4,5,8,4,13,8,0,3,10,0,0,2,2,1,8,3,9,1,2,1,2,2,0,3,2,11,0,0,4,2,7,6,7,6,1,7,14,7,10,25,2,5,4,3,3,5,14,3,0,9,4,6,4,8,6,2,21,7,4,5,2,3,4,1,0,3,2,2,4,2,2,16,5,4,11,2,2,7,3,2,1,1,1,2,0,3,1,0,1,0,0
article,5,9,11,133,2,1,6,31,1,3,9,7,3,31,5,4,12,10,0,5,1,46,0,27,13,9,6,9,1,5,7,155,138,3,45,39,29,21,49,1,15,2,1,1,21,11,21,4,316,20,42,0,12,10,0,0,299,16,0,14,10,4,3,45,13,1,70,19,14,7,5,6,3,14,43,10,24,1,46,22,98,1,11,3,193,44,33,0,30,0,6,4,0,16,39,48,9,16,22,22,8,16,36,13,1,24,19,5,25,5,13,2,4,21,0,26,11,1,85,212,30,4,46,40,3,2,1,11,5,9,4,0,4,45,17,17,0,1,2,5,0,41,15,2,1,46,1,7,19,15,40,1,17,0,5,12,23,1,7,1,34,2,3,2,0,4,2,19,33,6,9,82,17,0,3,5,200,1,8,24,15,1,0,9,1,30,50,9,34,58,4,4,33,0,1,2,5,0,7,3,19,3,7,14,12,0,1,37,14,20,91,3,18,58,0,0,1,0,9,2,4,19,8,29,53,74,18,26,3,1,16,6,31,9,26,186,31,8,32,3,75,39,10,1,3,1,1,11,55,7,3,143,10,22,15,17,7,1,4,15,3,10,37,6,5,19,2,0,30,15,146,14,65,4,2,0,27,10,20,0,51,3,6,13,11,1,0,7,6,3,9,8,12,10,3,6,35,7,16,22,23,40,4,7,16,0,14,2,0,1,2,4,17,3,93,34,22,36,30,6,48,4,15,0,42,8,3,17,3,15,8,19,6,9,6,23,15,8,0,8,3,5,26,12,1,0,40,77,5,2,15,11,14,55,26,16,7,4,14,15,19,4,4,9,3,0,34,4,7,8,2,43,5,3,9,6,6,15,15,4,76,2,56,20,1,12,4,23,22,2,17,4,15,28,33,4,69,1,22,1,35,1,5,0,4,8,7,4,40,10,0,8,34,7,8,1,11,4,0,0,2,3,7,8,0,0,0,4,8,28,2,11,3,7,2,3,0,22,2,7,19,48,4,26,1,2,1,3,18,12,5,18,0,2,67,15,0,15,6,55,3,12,23,7,1,0,71,16,5,0,13,0,1,2,2,5,3,10,12,3,14,18,3,2,4,4,10,1,2,0,53,29,0,1,23,1,6,10,7,4,10,6,9,0,0,7,7,23,10,1,31,2,5,6,22,16,3,9,9,6,1,13,6,10,3,0,20,6,16,33,5,1,1,20,8,11,13,8,36,6,8,9,0,11,25,9,0,46,20,8,58,3,1,44,2,8,39,6,10,4,30,3,32,3,11,17,2,5,53,38,18,5,8,1,9,18,61,16,5,16,100,11,32,15,2,0,6,8,10,10,37,28,14,3,30,7,25,12,134,6,35,0,6,17,1,18,2,16,7,30,16,13,13,7,23,12,28,20,4,16,8,5,4,4,1,15,6,11,10,30,5,19,25,38,9,3,2,5,2,13,20,1,2,10,8,13,9,3,2,199,22,1,14,10,5,8,47,10,2,44,8,7,39,44,16,17,10,7,9,8,21,17,8,22,31,7,1,9,4,2,4,24,8,5,18,4,11,3,1,18,17,3,16,6,3,11,11,7,77,15,1,12,10,11,12,3,18,4,2,11,1,8,20,22,7,12,5,2,9,3,6,1,4,14,0,7,11,4,3,5,1,18,19,2,2,1,4,7,17,0,6,6,1,14,7,4,29,4,5,12,2,7,11,12,19,6,14,16,3,65,70,11,2,22,10,30,9,12,7,8,5,5,3,10,2,10,2,1,5,14,1,8,11,6,8,8,27,1,18,12,13,1,0,8,3,22,2,9,0,3,5,5,20,5,0,0,5,0,20,6,80,1,29,10,10,4,1,20,7,21,10,6,9,24,0,5,1,8,5,5,6,4,5,1,14,4,6,14,5,2,10,17,0,11,12,5,10,12,2,5,30,8,3,26,1,7,5,19,11,2,11,1,3,3,9,4,4,9,6,8,3,5,4,4,6,8,19,28,7,2,8,9,2,2,30,5,1,8,2,3,2,7,0,3,5,8,1,13,1,0,10,20,1,3,15,7,2,21,19,15,1,3,10,9,34,3,3,16,5,1,6,17,8,1,4,10,18,21,5,2,15,3,15,11,6,1,2,5,1,4,2,35,5,5,17,16,7,10,31,3,0,4,2,2,3,2,1,6,11,5,0,3,4,4,1,34,2,2,6,5,13,4,6,1,6,6,0,10,12,5,7,10,15,3,3,26,13,0,23,2,3,6,9,0,0,1,2,0,1,0
germany,6,13,3,23,4,2,6,10,1,1,4,5,4,41,0,0,0,1,2,0,1,6,4,8,9,7,12,6,1,2,2,57,69,2,14,22,29,1,0,1,0,5,1,1,7,4,12,8,135,7,8,1,0,32,1,3,12,16,2,16,25,8,0,0,8,5,29,2,3,8,3,1,1,4,25,6,9,5,22,10,17,0,9,4,88,2,2,0,13,0,6,4,0,11,11,2,15,2,21,6,5,8,16,5,2,8,1,0,1,3,6,0,2,2,3,9,3,2,30,23,10,6,0,29,6,5,0,2,3,1,2,1,4,20,8,6,6,2,2,6,7,15,11,2,3,12,4,9,5,3,26,0,7,3,0,0,19,3,3,0,6,2,2,4,0,0,1,8,7,6,12,23,13,1,1,1,60,1,3,11,2,3,0,7,0,16,6,9,13,31,1,1,9,1,0,1,3,9,5,1,3,0,0,4,15,2,1,11,4,9,21,4,3,5,2,4,0,0,3,0,0,5,2,1,7,25,10,9,5,2,0,11,3,8,10,5,8,3,8,2,19,12,1,1,8,6,6,3,21,0,5,8,5,2,2,3,5,0,3,6,2,16,11,13,4,17,0,0,10,2,12,1,9,0,0,4,2,6,0,2,16,5,7,12,1,3,2,1,9,0,4,6,3,0,2,2,13,0,6,3,6,5,2,1,8,2,9,0,2,0,6,4,11,3,6,15,4,12,2,4,13,0,3,2,21,2,1,10,3,13,0,4,1,3,3,5,8,6,2,0,0,10,4,4,5,1,25,18,3,1,9,4,0,10,11,3,5,0,1,18,2,1,6,11,1,0,8,3,2,6,0,3,2,4,5,6,3,0,4,1,29,4,17,7,2,5,0,5,5,0,10,0,0,7,12,1,13,0,7,4,21,0,0,0,2,2,2,3,14,8,4,8,13,4,2,4,4,1,2,6,2,8,7,7,5,1,0,5,3,13,1,3,6,6,3,3,1,12,0,2,6,7,3,32,1,7,6,5,9,2,7,7,2,2,44,7,1,3,5,13,6,7,10,9,7,1,5,13,1,1,3,0,0,1,0,5,0,12,4,1,0,3,3,2,6,2,3,2,1,2,35,6,3,0,3,8,4,5,2,0,6,2,3,0,3,1,0,7,2,0,0,1,2,6,2,4,4,0,0,2,5,2,0,4,4,4,6,0,7,12,0,1,6,4,11,5,0,2,18,4,3,10,0,0,8,0,0,3,11,2,3,2,1,10,5,6,22,1,0,3,7,0,15,0,0,7,3,6,12,15,1,2,2,1,3,3,12,4,2,4,4,2,2,3,0,4,1,1,4,2,3,13,0,1,8,0,1,2,32,8,9,0,1,2,2,6,3,3,4,2,9,20,12,4,13,2,3,0,7,4,1,0,2,4,1,3,1,1,0,14,0,8,5,10,6,0,1,2,1,2,3,2,1,4,4,4,1,3,2,117,21,2,2,2,8,2,4,9,1,9,3,16,16,31,13,3,2,1,3,6,4,2,3,14,21,4,2,3,1,2,0,6,4,3,4,2,4,3,1,1,4,5,6,6,3,3,0,1,8,7,10,6,1,4,3,1,8,2,0,6,4,6,2,4,1,6,1,2,9,0,3,0,3,3,0,7,2,0,0,4,3,1,1,4,3,2,5,1,5,2,7,1,1,3,5,5,2,1,1,5,6,2,2,10,2,3,4,10,5,18,18,15,1,1,22,15,3,3,6,8,1,1,1,5,2,6,2,1,0,4,0,2,4,0,5,0,3,1,2,2,0,1,0,0,0,2,2,1,3,0,5,1,4,2,3,4,0,1,11,1,11,6,10,2,2,3,1,6,4,2,2,2,14,1,0,2,2,5,1,0,1,5,0,2,3,2,2,16,4,5,2,0,0,7,3,4,0,19,1,2,7,4,1,0,0,4,4,1,6,0,1,2,7,7,2,2,2,0,2,3,1,3,1,1,0,1,5,37,3,26,5,3,1,6,5,2,5,3,0,0,2,0,1,8,3,2,0,0,0,4,4,4,5,5,1,1,1,8,15,4,1,9,5,3,6,4,4,1,0,3,2,3,3,4,1,3,14,15,1,2,2,1,0,4,1,4,1,1,5,2,2,3,3,0,0,5,0,3,9,3,0,1,4,1,1,2,1,4,3,0,0,0,5,3,4,8,0,0,0,3,3,4,7,3,6,6,0,0,1,0,4,0,3,0,0,1,7,1,16,3,1,2,0,0,0,0,1,0,3,0
execution,9,14,1,119,15,1,3,29,3,1,17,11,3,46,5,2,0,7,3,3,4,26,5,6,6,2,1,8,2,8,7,107,64,3,41,26,27,5,4,3,1,1,2,0,17,14,10,11,227,4,35,1,6,9,6,10,47,22,0,13,10,2,0,21,7,5,52,1,5,4,1,8,1,1,24,4,3,2,37,12,14,1,9,2,141,5,9,0,20,0,1,2,0,19,23,0,11,2,15,4,12,16,27,8,4,22,3,2,7,4,5,4,5,11,0,21,4,2,83,83,24,4,5,20,2,8,5,0,1,2,4,1,0,28,10,24,3,1,3,3,2,17,21,3,2,35,7,4,7,12,55,0,5,3,1,23,10,3,3,0,5,0,3,0,2,1,2,10,12,5,18,52,9,0,0,6,114,2,7,8,13,9,1,11,6,3,19,18,25,30,3,6,1,0,1,4,20,4,3,10,7,2,1,18,15,6,5,21,5,16,42,0,14,8,0,0,1,0,8,2,2,9,3,13,31,153,4,13,4,0,3,11,7,15,17,15,24,2,0,6,59,24,1,7,3,2,5,6,27,5,6,12,11,3,7,12,6,1,2,8,0,18,22,8,4,36,0,2,4,3,103,4,12,4,4,0,11,9,9,4,26,4,3,5,4,1,1,8,6,0,8,4,8,4,0,8,22,1,4,15,17,12,0,1,1,1,14,3,2,1,0,2,14,1,18,12,11,19,4,2,35,4,12,5,33,8,2,10,2,9,4,4,6,4,3,8,4,6,5,12,5,9,8,8,5,3,37,39,14,4,10,14,7,15,17,1,3,2,13,4,7,4,4,12,2,0,40,3,1,9,1,13,2,4,8,25,6,2,3,3,41,5,42,8,0,22,12,6,19,10,19,3,4,8,28,5,46,6,31,2,22,2,3,1,2,3,3,2,20,10,0,13,1,7,2,12,4,2,0,0,2,2,7,11,1,4,4,8,11,16,5,3,3,8,0,6,0,4,7,8,13,21,6,3,0,4,1,7,20,5,12,7,0,7,31,8,3,12,4,26,6,15,17,10,3,1,11,12,9,1,3,0,3,1,3,6,5,8,12,1,3,7,1,2,6,12,5,3,3,9,45,22,1,3,5,9,3,13,9,7,9,3,0,0,8,3,1,4,8,0,7,4,12,6,11,16,5,5,2,7,3,11,6,14,7,4,17,1,15,18,5,5,4,5,8,8,18,3,32,10,2,2,0,3,3,14,3,8,24,5,52,16,5,20,8,3,15,1,6,3,18,5,27,1,13,9,6,12,20,21,6,7,14,5,1,0,2,5,3,5,1,20,5,11,6,2,3,3,4,5,20,22,3,1,7,2,1,0,65,10,22,3,4,9,7,11,8,22,1,4,12,13,20,0,19,6,21,2,7,5,8,2,4,11,3,1,11,7,12,15,2,18,17,27,7,1,5,3,1,13,1,0,10,25,9,35,2,4,2,111,5,4,6,3,5,11,28,7,5,15,2,7,18,13,8,8,3,7,10,8,24,7,18,38,27,3,2,15,8,4,6,45,17,7,8,13,8,6,0,15,17,3,15,5,6,12,10,2,8,14,9,2,1,3,13,7,16,6,6,7,2,5,1,33,14,28,14,7,8,5,10,4,6,32,6,9,1,1,0,10,4,5,6,4,4,3,28,4,35,6,7,2,4,1,15,4,13,1,3,3,6,5,1,2,1,12,4,8,3,3,1,9,2,0,14,1,11,6,2,4,6,3,0,10,6,12,2,2,21,12,8,8,5,1,2,3,4,8,2,18,3,14,3,3,8,11,5,5,5,7,2,3,10,6,2,2,6,2,11,6,3,1,6,12,7,6,3,8,8,8,7,2,2,20,7,9,1,15,2,1,4,7,10,2,8,4,5,16,8,7,8,16,11,14,3,9,2,12,5,14,23,23,11,8,3,6,5,5,9,2,4,2,9,2,7,9,3,1,10,8,3,3,4,2,2,2,6,14,6,1,5,3,7,3,17,2,9,6,2,7,0,9,0,4,2,7,2,6,4,2,4,12,12,5,4,3,1,13,4,13,5,2,1,5,6,8,5,4,1,2,9,4,9,10,3,1,2,20,4,7,9,2,5,5,7,1,4,6,4,19,0,6,3,3,1,16,5,10,19,5,7,2,2,3,4,6,3,1,24,6,4,8,8,0,1,18,6,4,3,3,4,6,3,0,6,6,0,2,8,3,0,4,11,2,1,3,6,1,18,0,5,2,4,0,0,0,0,7,4,0
russia,4,4,1,29,0,3,5,4,6,3,6,3,1,38,4,4,1,6,4,5,2,9,3,7,12,2,5,8,2,4,4,69,57,2,14,37,34,1,1,4,1,10,2,6,11,5,23,4,166,29,14,4,6,35,1,7,7,8,1,14,31,5,0,13,12,1,34,4,4,11,1,7,0,1,25,4,10,0,36,11,19,0,11,7,109,2,10,0,17,0,1,2,2,20,23,0,7,6,29,0,7,10,13,4,6,11,0,5,10,1,11,3,5,3,0,11,3,0,16,35,10,5,1,22,1,2,0,6,0,1,1,2,0,20,6,17,3,1,2,2,2,22,18,2,5,23,6,10,7,5,37,4,6,2,0,1,11,6,8,9,0,0,4,1,0,1,4,7,6,5,4,25,14,2,3,3,43,0,3,17,0,5,0,5,5,14,6,9,28,35,0,2,2,1,0,2,2,2,3,1,2,0,0,9,7,0,0,4,9,10,17,6,5,4,0,2,1,0,2,1,0,9,4,5,5,14,4,15,0,0,2,2,4,7,4,8,14,3,1,8,24,25,3,0,11,4,5,6,14,2,5,5,24,1,9,9,7,0,6,7,0,12,14,4,4,9,0,1,1,4,47,1,3,0,1,0,5,4,4,0,14,1,0,5,3,8,0,3,8,1,3,6,0,3,1,2,32,3,4,4,13,6,0,1,4,0,11,4,1,1,0,2,5,5,5,2,2,18,4,3,37,2,11,1,29,8,0,11,0,13,0,1,11,2,1,3,12,10,2,6,3,1,6,5,0,4,19,22,1,3,2,1,6,9,16,1,4,2,8,9,1,2,2,7,7,1,6,3,4,10,2,16,1,4,2,0,1,0,5,1,16,0,13,4,1,8,0,9,15,3,7,1,1,12,10,5,29,0,5,4,12,3,0,3,1,0,1,6,9,5,5,12,1,6,3,10,4,14,4,6,0,5,3,5,1,0,3,6,5,9,4,4,0,8,5,8,2,7,3,3,9,5,3,36,3,2,7,4,8,5,11,5,0,0,60,5,2,2,0,11,1,10,9,10,1,0,8,4,3,0,5,2,2,1,1,2,6,10,11,0,0,5,9,0,2,0,0,0,4,1,38,16,1,8,6,4,2,6,3,0,9,0,0,0,1,2,0,16,5,0,2,1,1,3,3,4,2,4,0,6,4,7,2,4,1,0,10,0,13,10,4,2,4,5,5,2,2,3,13,2,2,6,0,0,2,3,3,8,8,0,0,1,0,17,0,4,29,4,0,3,11,0,15,1,2,3,8,2,21,38,2,1,3,1,7,9,2,0,2,14,1,4,8,12,4,6,3,4,6,4,21,21,4,1,7,1,0,0,75,16,10,0,5,6,5,11,2,2,3,0,2,11,1,5,11,5,5,0,2,1,4,0,1,1,0,6,0,6,5,11,0,10,14,9,4,1,0,5,0,7,6,14,0,2,9,3,2,1,0,140,20,2,0,0,2,13,9,12,5,11,3,17,22,57,15,8,4,6,11,13,3,5,7,11,10,4,0,6,0,7,7,12,4,9,10,0,6,9,3,26,6,4,14,17,3,2,0,6,8,2,35,5,2,0,1,2,8,0,1,1,1,4,1,8,2,2,1,2,7,0,4,1,5,5,2,13,1,0,0,6,1,5,2,3,0,1,2,3,18,1,2,5,0,2,14,3,5,1,3,4,1,0,1,2,2,5,1,15,2,9,9,7,2,0,6,4,2,4,0,10,4,15,0,2,0,2,1,1,2,3,0,1,6,0,8,2,2,4,4,4,12,1,2,2,0,7,4,4,2,3,1,3,7,1,0,2,4,3,14,5,1,0,7,8,3,2,1,16,3,8,1,3,38,3,4,6,5,3,1,2,0,1,4,1,4,2,7,14,4,1,3,2,0,11,3,5,0,7,5,2,10,8,2,4,0,0,4,4,1,0,5,4,4,1,1,5,2,1,7,1,0,1,1,0,1,2,15,42,7,23,2,1,0,2,7,6,4,2,10,0,1,10,0,7,8,5,1,0,2,6,4,4,2,2,0,1,5,3,0,4,0,5,7,6,3,3,0,9,2,0,4,6,1,18,14,2,1,19,3,2,2,7,3,5,2,1,2,1,6,4,5,7,1,0,0,1,5,9,0,7,0,1,3,0,1,1,10,8,2,5,3,2,0,0,0,9,1,0,2,4,7,2,1,2,1,10,0,0,3,1,1,6,1,1,0,0,0,3,18,0,4,0,0,0,0,0,1,0,4,5
minister,49,52,8,185,32,1,2,24,18,2,124,32,11,80,1,7,13,12,1,5,19,48,1,18,28,20,8,22,2,18,12,264,166,15,59,34,66,3,2,0,3,4,15,3,44,22,37,14,725,28,60,5,8,11,0,11,74,8,0,14,73,12,3,33,20,1,57,1,31,8,2,6,1,2,19,9,13,3,87,24,15,1,41,5,446,5,1,0,79,0,19,4,0,62,63,0,31,2,38,9,6,26,53,10,10,22,7,1,5,2,17,11,1,8,0,46,31,0,93,181,43,14,0,28,1,8,1,12,1,0,11,7,2,64,16,10,33,0,3,2,0,37,50,5,1,97,11,18,3,3,74,1,28,2,0,1,13,5,17,5,3,0,4,0,0,0,2,27,21,23,34,84,24,0,0,28,211,1,8,10,18,14,0,17,1,11,19,31,78,144,1,4,5,0,0,0,2,4,7,6,12,1,0,35,36,6,2,13,25,23,139,8,31,11,0,0,0,0,16,2,2,14,15,22,53,53,19,14,1,0,22,17,8,13,27,0,56,5,1,3,78,42,5,6,9,4,13,11,43,12,23,29,51,4,10,19,31,0,9,5,2,27,36,9,4,39,3,0,10,1,115,4,23,7,0,2,29,0,31,0,34,4,2,19,3,0,1,11,28,0,21,15,5,4,3,22,202,29,12,17,57,28,0,0,13,2,45,7,6,0,1,0,31,5,23,9,7,65,18,2,124,12,22,1,93,8,3,62,22,17,2,7,11,3,10,9,33,35,2,16,15,56,11,20,0,4,71,100,13,10,5,13,6,18,18,0,10,4,16,21,3,2,4,23,1,0,82,5,7,5,5,15,1,6,4,21,4,0,13,2,64,1,34,8,1,10,1,57,34,1,39,2,12,43,72,8,112,2,78,3,47,1,7,1,1,0,11,14,26,10,3,12,11,7,29,19,17,11,10,5,3,18,15,18,0,2,2,30,22,27,29,11,14,28,2,20,2,81,3,6,22,45,4,23,2,5,6,14,17,9,17,15,3,23,81,5,0,25,5,59,13,10,24,7,0,0,4,25,2,2,10,0,4,0,2,2,2,50,16,3,5,11,9,10,18,12,5,6,6,2,84,62,1,12,3,15,1,46,16,4,4,2,0,0,4,2,0,16,2,2,2,3,37,3,10,17,10,3,0,12,0,37,8,15,9,11,33,0,40,51,15,4,8,2,10,2,41,10,39,5,7,1,2,0,2,35,19,27,28,12,17,20,4,34,3,6,63,3,3,8,29,6,28,6,26,12,22,6,73,40,1,9,28,3,10,16,3,5,1,16,1,44,15,11,7,14,3,12,7,8,34,57,7,1,3,1,2,2,208,33,38,2,6,27,31,18,11,32,3,2,36,30,85,8,40,11,19,3,11,13,14,0,2,21,1,1,33,3,22,30,2,21,18,35,12,4,2,5,0,20,3,0,4,84,32,71,3,23,1,546,39,3,10,8,16,15,52,28,36,32,6,10,70,66,55,47,4,22,31,40,23,9,215,23,89,4,0,20,17,6,3,35,32,14,21,15,14,12,2,22,26,19,34,17,23,7,16,19,9,29,32,4,22,5,2,11,40,3,7,29,2,24,5,37,12,53,8,25,22,5,30,12,20,18,2,14,12,1,5,5,12,20,2,4,24,10,10,4,46,2,22,8,3,19,15,1,10,0,8,10,21,11,0,21,0,15,16,18,4,4,4,4,29,2,17,0,24,7,2,26,5,2,4,18,4,11,0,0,9,9,1,15,13,0,34,12,5,85,3,42,22,3,7,11,1,18,1,16,7,15,5,23,12,11,4,0,4,6,35,20,9,17,19,24,8,9,3,18,26,6,34,2,9,21,6,15,2,6,5,15,3,7,2,5,7,5,25,54,19,10,52,0,0,21,7,2,1,13,1,39,42,42,13,2,0,11,7,0,26,1,23,8,19,5,4,17,5,2,9,10,0,0,1,0,4,9,46,93,22,15,17,26,1,15,31,15,34,15,1,5,5,11,0,19,28,27,8,3,4,4,1,78,0,24,2,18,34,30,3,39,1,0,8,11,19,22,4,14,3,9,30,35,2,21,15,20,19,1,21,1,7,14,21,13,9,0,2,3,6,2,3,11,1,0,2,21,3,0,3,24,2,5,1,1,2,5,0,7,40,22,0,0,3,2,0,29,3,0,1,7,3,9,8,4,43,14,0,10,12,4,5,10,18,0,12,1,8,0,105,0,5,1,3,0,0,2,0,17,0,2
adjustment,5,14,1,52,4,0,3,11,3,0,30,7,2,28,2,1,5,3,1,1,3,15,0,6,9,3,2,6,1,2,3,87,55,1,20,14,21,2,9,0,6,3,1,4,12,11,14,13,139,4,18,3,5,21,0,2,30,10,0,13,24,8,0,9,13,3,24,3,9,7,4,1,0,0,27,7,5,3,38,8,23,0,2,2,120,2,1,0,23,5,9,3,0,23,21,16,8,0,23,4,5,9,19,3,5,7,5,0,4,2,4,2,5,7,1,17,3,2,43,47,23,7,8,23,1,2,0,4,0,0,4,2,0,22,5,19,7,0,2,5,0,19,17,1,2,27,2,6,5,3,25,0,5,1,2,10,6,1,4,6,4,0,0,5,5,1,2,8,11,9,20,25,3,0,0,6,94,2,1,14,9,6,3,2,1,6,10,11,26,42,1,1,0,0,2,3,7,5,1,3,10,2,0,11,9,4,0,11,7,9,23,3,7,3,0,0,0,0,2,3,7,8,1,3,19,17,3,8,0,5,12,4,6,9,6,14,20,3,6,5,32,16,1,0,10,4,5,6,27,5,12,7,12,1,3,8,9,0,4,4,4,8,11,5,1,15,0,0,3,5,49,2,19,1,1,0,5,8,16,4,15,4,2,4,4,0,0,2,4,1,6,4,2,0,3,4,18,2,2,8,15,18,0,1,10,0,21,3,4,1,1,2,13,3,19,9,4,23,1,3,48,4,9,0,22,4,1,9,2,8,0,1,2,1,2,4,7,8,2,9,5,8,6,9,3,2,20,31,4,4,3,9,6,9,13,1,0,0,4,8,5,7,4,7,0,0,11,4,1,3,2,9,3,1,4,13,6,2,6,3,41,1,22,12,3,11,0,16,15,0,11,1,3,17,25,6,39,2,12,3,14,1,3,0,1,0,5,6,19,9,1,1,4,7,13,2,3,8,1,1,1,4,8,0,2,5,5,5,6,5,6,3,3,19,2,5,0,18,2,4,7,12,4,11,2,5,1,7,15,5,0,3,2,1,30,3,0,6,2,28,3,10,9,2,2,0,1,7,7,2,5,0,1,0,1,2,2,8,10,1,2,5,4,5,3,9,4,4,4,0,37,18,0,1,2,5,6,11,4,2,1,2,2,6,6,6,3,5,3,0,4,3,7,1,6,7,1,1,0,1,2,9,2,12,8,0,6,2,11,15,2,1,4,4,2,3,3,3,11,6,1,5,3,1,4,12,2,6,27,1,3,1,1,21,6,3,20,3,4,3,14,0,6,3,9,10,5,0,14,18,4,1,4,0,4,3,12,5,2,7,7,7,4,6,5,0,2,5,0,8,13,16,6,1,10,1,1,9,45,9,13,1,2,8,15,8,2,4,9,1,9,13,11,0,21,4,12,8,4,2,3,0,3,2,2,1,5,2,6,15,0,13,1,6,3,2,1,1,2,4,2,0,1,5,9,9,2,3,0,107,12,2,3,1,4,14,13,5,3,8,7,1,41,19,6,4,3,9,20,3,3,3,26,7,87,5,3,6,2,1,4,14,7,10,4,2,6,8,2,6,16,3,8,9,5,4,2,6,0,6,7,4,3,5,6,1,5,2,2,4,0,3,4,14,5,3,2,4,3,1,1,1,2,5,0,5,3,1,1,4,5,2,0,1,2,3,1,0,17,2,6,7,0,3,2,2,5,4,4,5,1,4,2,6,2,9,5,6,2,0,0,14,2,1,9,2,3,4,6,19,0,3,2,8,3,8,2,0,3,8,4,2,4,2,6,6,0,4,1,4,7,1,0,2,2,4,7,6,6,4,9,3,8,0,0,2,2,4,8,2,7,2,3,3,3,10,5,12,2,4,7,2,2,11,2,4,1,4,3,3,4,3,1,0,1,2,4,14,3,7,6,0,0,3,4,5,1,11,5,8,16,22,0,1,0,3,4,3,3,1,6,3,3,1,1,0,1,2,10,3,1,9,0,0,3,4,10,6,8,0,10,5,0,6,19,7,7,3,1,1,0,14,0,3,11,5,5,0,2,1,4,4,2,10,0,4,9,9,5,12,3,0,4,8,4,4,0,1,2,2,4,14,1,5,1,4,3,21,1,1,4,6,3,8,1,0,1,2,1,3,3,7,3,4,3,14,6,5,7,11,0,4,1,2,1,1,1,3,10,5,0,0,0,3,1,7,1,2,0,4,1,2,2,1,6,5,2,3,4,1,2,2,3,1,1,0,1,0,24,1,0,3,1,0,4,2,3,2,0,0
deposit,0,12,1,70,1,2,3,14,1,0,2,5,2,11,2,2,1,27,1,0,4,38,5,10,6,5,3,2,8,8,1,110,72,6,26,18,2,13,11,1,3,1,0,0,18,8,26,9,214,0,20,0,2,3,0,0,29,22,1,3,6,0,0,3,14,4,76,1,6,0,23,0,6,0,40,12,11,0,55,17,44,5,9,3,180,61,12,0,26,5,16,2,0,21,58,12,10,6,29,20,10,13,29,3,1,29,8,0,12,16,16,5,10,16,3,32,10,6,58,120,18,5,14,55,0,1,3,3,11,5,7,0,0,18,5,13,2,3,3,3,3,9,22,1,0,28,2,3,8,13,45,0,22,7,0,20,13,3,1,1,9,1,4,3,0,8,4,7,9,8,4,76,8,0,0,3,112,4,1,16,6,15,0,3,7,10,15,10,15,9,1,8,1,0,0,5,26,7,19,9,37,29,3,3,18,4,8,64,8,6,33,4,5,2,0,3,0,0,23,0,10,12,3,4,65,65,14,26,9,52,9,13,17,26,24,29,14,7,1,0,65,20,2,0,6,6,4,58,27,5,10,25,7,18,13,19,17,4,3,16,2,8,19,3,12,48,0,0,6,3,90,22,148,5,3,0,5,7,4,1,24,2,1,9,16,4,1,3,7,1,4,4,24,6,7,9,36,2,5,4,21,12,6,10,16,0,1,0,2,0,1,9,16,2,61,22,8,40,37,1,3,3,10,1,13,1,0,10,1,30,3,8,3,6,18,10,6,5,4,14,8,2,9,5,5,3,35,15,10,9,11,7,3,53,15,0,3,4,4,16,16,0,7,28,1,1,25,1,1,1,0,14,0,8,8,9,8,4,9,7,54,1,29,3,1,10,2,25,24,0,0,1,8,4,16,18,35,10,21,3,19,4,2,0,10,6,12,0,16,3,1,2,2,6,0,2,6,1,0,0,1,3,5,7,11,1,4,6,12,20,131,23,1,18,3,4,0,0,0,2,2,8,2,9,0,0,1,4,25,9,41,1,0,18,31,1,0,6,2,15,1,19,12,4,11,0,10,4,1,0,0,1,2,1,2,6,0,10,11,6,2,4,8,0,0,1,3,0,1,0,7,25,1,1,10,2,0,13,4,13,12,6,22,2,8,334,3,4,2,4,3,1,7,7,20,12,7,1,1,2,0,7,14,27,2,3,16,0,7,27,2,1,0,7,5,7,3,2,14,32,4,3,0,5,6,5,3,19,7,3,19,2,0,36,2,10,6,2,7,3,20,3,11,2,9,14,9,9,32,44,12,7,8,0,4,5,8,2,10,16,1,12,7,12,3,0,0,6,2,1,14,18,15,7,6,1,1,5,4,30,14,0,3,2,1,17,2,13,10,18,10,10,2,1,20,5,13,2,2,4,31,143,1,87,8,1,0,5,2,12,75,13,24,11,3,2,2,7,1,12,5,0,4,7,3,44,3,6,4,106,0,1,4,2,1,5,44,3,4,5,3,0,4,11,3,3,2,0,5,15,21,1,1,7,7,2,2,9,2,0,2,8,8,2,5,5,4,1,14,2,5,5,24,13,10,3,21,5,6,9,0,3,2,2,16,8,9,7,7,0,4,11,0,20,13,2,0,4,3,0,1,4,0,14,0,2,2,2,1,24,10,8,10,2,2,10,3,3,3,0,4,4,5,0,0,10,8,4,2,0,1,19,4,13,17,1,0,9,2,72,64,7,13,24,19,24,5,5,2,2,3,1,2,10,0,5,33,4,0,9,0,2,12,10,9,1,4,5,51,11,3,2,0,11,2,18,2,2,1,3,5,8,16,1,5,0,9,11,4,3,9,1,2,9,4,0,3,2,9,8,0,1,1,8,2,2,2,1,43,3,17,1,21,0,5,8,1,18,2,4,1,6,1,3,9,1,7,4,10,4,0,22,1,1,1,30,5,22,3,6,2,3,7,1,11,4,1,5,3,10,0,1,61,52,9,10,0,1,6,1,4,9,1,0,6,0,1,2,0,7,1,0,2,2,5,4,0,1,14,0,6,2,2,2,1,3,3,33,5,10,16,13,2,43,3,6,1,0,7,1,9,2,2,2,2,7,2,1,1,1,2,0,2,3,3,13,11,13,1,8,3,9,3,6,25,44,12,28,137,1,0,1,2,7,0,12,3,0,25,1,0,0,12,0,3,1,1,3,2,0,1,1,5,1,3,3,0,4,3,0,1,1,3,63,1,3,6,3,1,0,1,1,3,0,1,1,2,4,0,0
relate,0,11,6,115,6,2,3,14,1,0,11,17,2,26,3,2,3,6,1,4,0,16,4,14,17,8,5,10,5,6,2,107,43,3,28,14,14,7,4,0,4,3,1,1,7,15,13,14,176,8,11,1,8,17,8,2,41,31,1,11,13,5,3,9,10,1,49,5,5,5,8,3,0,2,35,8,5,3,30,8,27,0,5,3,138,11,7,1,25,4,1,0,0,12,35,2,12,7,17,9,13,12,20,3,5,23,1,0,9,1,6,2,8,3,2,13,5,1,39,33,18,18,7,25,2,0,1,1,2,3,6,4,4,37,6,32,2,4,4,2,2,17,16,3,0,28,8,15,7,4,29,2,7,1,1,29,10,0,4,10,3,4,5,5,2,0,12,8,13,2,7,43,7,0,4,2,98,0,6,19,10,7,12,10,6,8,20,9,32,30,1,1,4,0,1,4,5,8,3,7,11,1,0,6,12,5,3,16,7,11,44,1,12,4,0,1,0,9,12,0,0,9,3,8,22,111,12,9,4,6,13,13,10,11,14,16,14,5,8,4,32,19,6,0,3,4,5,10,30,3,13,10,13,3,6,12,4,3,2,7,4,7,22,6,1,68,7,2,4,0,92,6,11,2,4,1,10,14,12,5,18,4,4,9,5,2,4,8,5,0,3,8,6,1,7,8,14,8,8,10,10,37,0,3,14,1,6,4,6,2,2,12,17,4,10,12,8,23,10,5,20,3,6,4,30,4,12,11,1,10,1,6,4,8,5,7,8,4,2,6,7,4,7,3,1,6,32,37,16,5,2,5,8,16,6,4,2,2,8,18,28,8,6,12,3,0,28,3,5,7,2,10,3,5,5,16,6,0,4,5,36,1,29,7,7,19,4,9,12,0,20,3,7,13,33,5,64,7,14,1,17,1,2,0,2,3,3,1,18,8,0,1,0,16,6,0,5,9,0,4,3,3,11,3,3,3,3,19,4,4,5,2,1,9,3,1,0,10,5,3,4,15,2,8,0,1,5,4,30,5,9,4,0,1,24,1,1,4,3,18,0,8,23,3,2,0,9,6,4,0,8,2,0,0,1,3,0,11,11,1,4,3,1,3,2,2,5,1,3,7,31,15,1,0,7,7,6,6,4,10,3,4,2,1,2,2,3,14,2,0,1,2,5,9,6,12,1,2,6,3,1,7,6,10,0,1,9,4,8,19,5,4,3,6,10,3,8,2,22,10,0,3,0,6,3,3,0,6,9,8,16,5,8,20,4,7,18,5,7,6,19,3,23,3,6,13,7,3,23,15,2,4,18,7,17,1,6,5,3,15,5,18,9,7,3,0,5,8,4,5,7,15,2,2,14,7,2,6,49,7,16,5,3,5,2,6,3,19,6,2,19,25,10,4,14,3,10,1,4,3,9,1,0,6,6,4,6,5,11,14,2,31,16,14,8,1,10,4,5,9,3,0,2,17,5,34,9,9,7,107,9,2,1,14,3,6,20,8,1,7,3,7,18,14,7,5,2,3,7,7,13,6,19,14,22,5,4,7,0,5,1,12,6,11,12,8,4,0,1,12,5,4,7,2,11,3,3,1,5,17,6,3,13,0,9,9,7,2,1,7,2,4,2,8,8,6,6,3,8,6,4,1,2,18,0,6,0,2,1,3,6,4,1,3,0,0,11,4,19,6,8,7,6,5,7,5,13,1,4,0,6,2,2,3,6,8,6,6,12,9,9,3,4,4,19,8,6,9,15,9,7,4,0,4,5,10,1,4,11,9,2,3,5,2,5,9,1,2,1,9,5,16,6,9,3,9,1,7,3,5,4,4,5,7,3,2,1,0,11,0,3,0,7,4,2,6,2,4,5,11,2,1,22,11,5,3,4,5,4,0,8,4,5,0,5,4,4,7,2,4,12,4,1,8,7,4,4,7,4,8,9,9,13,2,4,7,4,5,0,6,9,5,7,1,1,2,2,2,5,12,7,8,6,6,3,5,11,4,7,2,3,3,2,1,16,6,2,2,5,5,0,4,0,2,3,4,1,1,6,0,5,3,1,9,8,2,3,2,0,15,3,2,4,5,2,5,0,6,2,7,5,5,2,15,2,9,2,7,4,2,1,3,4,6,5,1,8,2,1,11,1,6,2,3,4,2,8,7,21,2,3,1,1,3,18,2,1,2,11,5,5,2,4,1,2,15,8,6,4,4,1,3,2,3,6,9,1,4,11,3,2,5,3,3,2,1,3,3,9,1,2,3,7,0,2,4,2,4,4,1
proposal,0,12,6,98,2,9,4,7,4,2,1,8,6,48,0,0,7,3,5,4,5,17,15,8,5,20,4,10,2,6,4,134,37,8,18,22,15,7,4,1,7,7,1,8,27,3,36,17,112,34,21,14,1,19,21,6,16,10,8,5,6,3,2,13,8,3,37,5,2,4,16,2,4,2,44,3,17,4,29,9,33,2,6,3,90,10,2,5,11,3,13,6,9,11,18,17,10,1,21,6,5,12,13,5,4,15,5,7,10,1,12,2,3,25,18,15,5,3,31,83,8,16,55,59,8,0,0,8,2,1,10,2,1,37,4,33,1,5,5,0,1,14,11,2,1,24,2,8,4,2,30,6,3,4,2,36,22,16,5,27,12,5,7,6,11,19,2,19,18,8,10,36,13,6,5,1,54,5,4,35,8,1,16,7,2,9,9,9,18,43,3,1,3,0,4,6,23,3,8,13,21,6,6,5,5,7,2,20,27,16,42,1,21,9,1,5,7,12,11,6,0,10,2,9,14,26,6,14,1,6,9,4,12,19,12,6,14,5,3,3,24,16,2,4,11,1,3,5,41,2,18,6,17,2,2,9,2,6,0,2,1,7,17,3,4,12,19,1,7,4,34,11,9,1,1,5,13,9,7,8,26,1,1,9,5,4,12,11,4,1,3,4,16,6,2,10,37,3,3,10,13,23,3,2,4,10,12,1,18,8,7,13,25,8,25,3,13,16,3,7,11,5,12,12,20,1,18,18,1,11,13,7,5,2,1,14,10,3,9,2,2,11,11,10,3,3,18,19,6,9,2,2,2,23,7,7,3,1,6,7,18,13,9,11,4,3,13,1,27,8,2,12,3,12,2,6,1,0,10,0,23,4,13,6,2,3,4,2,6,0,13,5,10,11,11,3,21,2,7,1,9,2,3,2,1,5,3,1,13,9,1,5,6,15,6,5,1,5,4,2,1,1,14,3,1,8,2,7,3,4,2,1,0,3,8,5,4,16,4,2,4,4,4,4,0,2,8,3,8,2,12,0,8,2,30,5,0,10,2,12,8,6,9,10,5,2,9,7,2,0,5,3,1,2,2,6,3,7,3,3,0,4,2,0,4,2,1,0,2,0,27,19,2,0,0,0,1,5,2,2,1,2,3,6,4,4,2,10,4,0,1,1,2,8,1,6,2,1,1,3,0,5,8,10,3,2,9,7,7,7,7,1,5,9,5,2,8,7,9,9,6,8,0,6,6,6,0,6,5,1,5,1,7,23,2,4,15,1,4,4,15,3,5,4,3,6,3,5,14,10,2,1,8,2,4,12,0,3,2,24,0,3,2,5,3,1,0,1,1,3,19,8,3,8,2,0,3,4,12,11,11,4,2,2,12,4,3,4,2,2,6,20,3,1,6,0,4,3,6,1,3,0,3,11,4,5,2,14,3,15,0,6,4,14,3,4,11,8,5,3,4,1,4,4,5,12,8,7,12,80,11,0,3,8,2,3,3,14,1,7,6,3,5,19,3,3,3,6,2,5,5,1,1,21,9,0,7,1,3,1,5,17,0,2,9,2,5,2,0,1,4,12,5,1,5,6,4,4,13,3,5,3,1,1,8,9,6,3,0,4,1,1,0,8,1,5,0,5,12,4,1,2,0,11,0,4,5,0,1,3,1,5,2,4,5,2,4,0,5,1,3,3,4,4,8,1,7,15,3,5,3,2,0,2,4,5,1,8,2,8,15,5,3,3,11,5,5,4,2,5,2,1,0,4,0,5,5,1,0,3,0,1,5,0,12,1,4,0,1,2,4,5,7,3,8,6,9,4,0,2,6,2,6,6,2,4,6,4,9,1,0,2,12,8,1,2,1,12,4,4,1,2,23,9,1,0,7,7,0,2,2,3,2,0,1,1,1,5,0,4,4,2,5,6,0,2,3,10,4,4,14,15,3,0,3,1,1,1,0,1,5,0,1,2,1,1,1,4,1,11,3,0,4,0,0,3,4,14,5,2,0,3,1,2,2,2,5,4,2,6,6,8,1,2,1,0,0,2,4,1,1,8,0,0,2,3,0,1,1,12,6,5,1,3,2,1,2,2,0,5,3,3,0,3,1,2,7,14,6,0,3,1,2,3,1,1,3,0,1,7,0,7,1,1,3,2,4,3,5,3,1,7,0,4,2,1,1,0,5,2,2,2,4,1,5,4,0,12,2,3,2,2,5,4,7,2,6,2,0,1,1,1,2,0,2,6,2,14,14,6,0,6,0,1,2,11,11,1,2,3
manner,5,8,7,75,2,1,6,33,6,0,12,3,4,36,4,4,9,8,6,2,7,16,7,14,16,4,3,6,2,7,9,113,67,1,27,27,31,12,7,4,8,1,6,2,20,15,19,10,220,4,39,2,11,13,0,12,63,12,1,7,14,9,3,10,13,2,50,4,14,9,3,0,2,2,27,3,9,5,49,12,15,2,12,6,158,14,6,0,30,3,3,6,0,14,43,4,4,3,14,5,9,16,29,6,5,18,2,1,8,1,12,6,3,9,0,18,4,2,35,113,22,6,7,25,2,7,1,2,5,1,6,1,2,27,12,17,5,2,1,5,1,21,21,3,1,35,0,5,5,4,39,0,10,4,0,9,11,2,5,1,14,1,2,4,1,2,2,20,15,10,5,47,13,0,1,6,79,5,11,12,15,16,0,9,2,14,23,13,32,37,2,3,6,0,0,3,11,4,7,3,14,0,1,10,16,6,2,14,9,22,53,1,10,7,0,0,0,0,9,2,3,12,6,6,23,58,15,8,0,0,10,5,12,16,16,16,21,9,5,2,38,22,5,5,7,1,4,5,31,6,7,12,19,4,7,12,9,2,6,7,1,11,18,3,4,24,1,0,7,4,98,4,27,3,4,0,14,4,7,0,36,5,0,13,9,1,0,7,9,1,4,3,6,6,0,11,32,0,4,9,8,22,0,4,9,1,7,4,4,1,3,3,11,2,25,9,11,24,14,3,32,10,11,0,45,5,4,13,5,12,10,9,5,0,2,12,9,9,2,9,5,7,7,8,2,2,38,43,12,2,9,13,5,15,16,3,10,3,15,23,10,3,6,3,1,0,27,5,2,7,3,10,3,6,5,7,6,3,11,4,68,1,17,8,2,20,6,10,16,2,12,4,7,8,22,4,44,5,18,1,13,0,2,1,1,4,3,1,13,8,0,7,0,3,7,6,1,3,1,2,6,3,5,10,1,4,4,14,8,7,13,4,2,6,1,2,0,15,3,7,13,10,4,7,0,1,4,7,18,2,5,6,0,0,21,3,0,5,5,24,8,10,16,9,2,0,11,5,3,0,7,0,1,0,0,6,5,11,10,2,4,5,2,3,9,7,2,1,6,2,37,25,0,2,10,5,4,8,5,7,6,1,0,0,3,19,1,13,7,4,6,2,10,5,11,17,2,8,2,4,5,9,6,19,4,3,17,1,11,21,5,3,2,4,16,3,23,2,13,14,4,2,1,3,10,5,0,13,19,3,46,7,1,17,0,2,21,2,7,6,11,5,9,2,10,14,8,9,22,22,6,9,6,3,5,11,16,5,3,6,9,14,1,17,10,6,4,9,2,6,21,17,8,4,10,1,0,5,29,8,18,2,4,8,7,10,8,14,3,4,11,10,8,1,18,6,13,8,3,8,11,5,2,16,1,2,8,11,9,9,2,15,22,11,3,4,9,3,4,8,4,0,7,15,8,23,4,2,4,119,11,0,6,6,2,5,31,6,2,8,2,3,21,12,10,11,3,10,16,9,19,4,34,11,25,5,2,9,1,5,0,16,17,3,7,9,7,2,1,6,9,7,7,4,7,5,5,9,7,22,3,4,8,10,6,4,12,3,3,9,6,2,5,16,6,11,2,7,8,2,7,5,5,17,1,5,7,3,2,8,6,11,4,2,11,7,10,2,31,7,5,5,1,0,10,1,12,1,5,11,4,2,2,7,2,8,7,11,4,4,7,7,4,0,2,13,6,7,2,11,4,1,2,9,5,6,6,0,14,10,1,2,8,7,4,7,4,8,5,6,5,2,0,6,3,13,9,4,4,5,2,3,15,4,1,0,4,5,16,5,12,1,2,10,3,2,5,9,4,5,8,1,1,6,4,3,0,6,6,3,9,5,8,1,3,10,9,12,9,4,8,5,1,8,6,13,4,3,8,7,16,11,6,6,1,3,2,11,4,3,8,4,6,3,4,7,6,5,5,3,0,8,3,4,2,9,7,14,13,1,2,2,4,9,11,11,6,1,1,7,3,1,0,4,4,5,3,8,2,5,1,7,3,14,9,2,1,11,1,17,2,6,4,9,8,5,2,1,2,3,8,19,3,15,0,5,3,21,3,2,4,2,1,2,6,3,0,1,8,4,1,8,3,1,7,20,6,8,11,4,2,5,1,3,1,6,6,0,14,3,3,3,4,9,2,20,4,0,6,2,7,5,4,2,7,5,0,6,6,0,8,3,7,1,6,4,8,3,7,0,2,1,4,0,0,0,0,11,2,0
embrace,0,23,8,105,4,4,3,36,1,2,15,7,4,30,0,9,2,5,4,4,6,22,3,19,9,10,7,7,2,12,6,103,91,7,38,30,31,10,8,2,4,5,2,3,17,8,18,8,216,17,29,1,5,23,7,4,55,34,2,10,18,5,2,11,12,5,37,2,8,4,12,5,6,3,33,8,6,2,44,7,49,0,7,1,128,8,10,1,26,1,7,9,0,19,33,8,17,5,18,3,6,19,28,4,5,24,11,2,10,8,11,7,4,26,0,18,5,2,71,75,17,12,5,58,6,4,4,1,0,5,12,3,5,31,8,20,1,1,0,5,1,17,24,2,1,26,2,6,7,13,39,0,3,1,1,7,21,3,7,2,7,1,1,2,0,1,7,14,19,8,24,53,12,0,0,3,97,1,1,10,17,5,3,2,2,6,18,6,21,53,0,7,2,1,1,2,7,2,3,7,5,0,2,13,14,3,24,20,12,23,41,5,15,4,1,1,1,2,8,2,4,12,4,9,30,55,16,19,10,3,8,14,14,19,12,23,17,1,5,6,25,21,5,0,6,1,5,4,14,4,5,12,2,7,11,9,13,2,2,15,5,9,13,9,1,32,4,1,9,2,95,4,36,1,2,2,11,15,13,2,29,1,1,10,6,11,1,6,9,1,3,3,7,6,6,7,36,1,3,14,11,23,1,4,9,0,8,3,3,0,0,5,18,1,20,24,6,26,3,2,31,6,11,8,42,2,2,18,2,12,3,7,7,3,4,16,19,5,2,15,5,5,7,4,8,2,40,36,10,8,8,7,8,20,12,0,2,1,6,15,6,5,2,7,0,2,35,5,2,8,0,10,6,5,3,17,6,1,16,9,36,4,27,9,0,57,2,11,15,0,12,2,8,9,26,3,55,3,12,5,24,4,2,0,3,2,1,0,18,7,1,9,3,5,6,8,1,8,1,1,3,4,5,7,1,6,2,5,9,8,6,3,7,14,3,3,0,25,5,2,15,21,3,14,2,3,7,1,19,7,7,4,0,2,38,5,1,9,5,20,3,16,23,4,3,0,13,11,4,0,6,1,2,3,0,3,4,6,3,1,3,11,8,0,5,1,9,2,3,5,46,24,2,1,2,7,0,14,4,2,7,0,7,0,10,7,1,7,1,0,1,3,5,2,3,13,0,5,1,4,3,7,6,10,14,1,18,4,16,14,3,2,5,4,2,3,14,0,21,12,5,0,3,3,7,3,3,14,11,4,23,4,2,45,3,3,13,5,4,2,16,0,25,1,9,9,8,2,32,20,12,5,12,1,10,12,15,3,3,17,5,11,6,9,4,0,6,5,11,4,24,22,6,2,9,4,6,4,34,7,17,0,8,2,6,18,3,14,1,7,20,9,9,8,20,12,16,4,4,6,15,3,1,7,3,5,4,3,10,22,6,18,13,6,5,1,1,7,2,10,10,1,5,19,9,15,3,3,2,132,20,8,6,2,6,13,17,9,3,14,4,9,12,23,13,3,0,16,11,9,10,10,39,8,28,2,3,9,11,11,13,14,17,16,11,5,6,2,14,8,18,11,17,25,5,3,7,3,13,11,1,1,5,3,3,6,11,3,1,2,2,10,4,18,14,18,6,7,7,1,8,1,6,8,0,17,3,0,3,10,3,9,5,1,8,4,9,3,40,16,6,7,1,4,7,0,8,3,4,11,6,8,12,22,8,6,9,7,3,9,9,2,1,3,27,13,10,9,3,9,2,4,2,5,3,6,6,2,17,16,9,7,9,1,10,4,3,36,6,5,6,4,5,5,5,10,3,6,3,2,2,3,4,6,3,0,1,2,13,6,10,3,15,4,4,2,3,9,4,11,3,12,0,11,3,1,0,8,5,5,1,4,11,6,4,9,4,14,8,5,5,4,3,2,2,6,6,4,4,7,4,17,7,9,0,4,5,6,2,3,11,3,3,5,0,4,0,2,4,8,1,3,7,7,4,6,3,10,8,1,0,3,2,2,10,5,4,5,4,0,2,19,3,4,4,4,1,3,6,3,1,6,4,8,7,2,10,2,6,9,1,8,9,7,8,1,1,3,2,1,8,9,2,11,4,5,5,13,8,3,6,3,2,1,4,6,3,9,2,7,3,7,9,1,3,18,11,15,21,8,2,2,4,4,4,3,10,8,14,8,46,9,5,12,1,10,2,3,3,13,15,1,7,1,4,4,0,8,7,7,4,6,2,6,4,6,8,0,14,3,3,4,5,0,0,2,1,8,0,1
confine,3,20,7,81,1,2,3,34,5,0,8,2,2,23,3,5,1,3,3,0,3,14,6,5,6,0,1,5,6,7,3,63,52,3,16,22,11,5,8,2,3,1,1,1,17,6,9,6,156,5,21,0,8,6,4,7,37,12,0,7,7,2,2,4,5,0,48,2,0,1,3,5,1,5,27,4,7,1,42,7,24,0,2,4,106,9,5,0,13,1,1,4,0,12,16,5,4,9,14,1,11,11,15,4,4,10,3,2,11,1,6,4,3,5,0,12,7,2,42,90,14,11,6,32,5,0,3,2,3,0,2,0,3,17,9,20,2,2,2,6,1,14,10,2,4,23,2,8,4,12,36,0,4,6,1,27,12,3,6,0,5,0,2,3,3,1,1,6,12,4,5,44,4,0,0,4,72,2,6,8,10,7,1,6,3,7,18,16,10,27,2,3,6,0,1,4,1,1,4,10,12,0,1,11,10,3,9,16,1,16,30,1,5,1,0,0,2,0,6,1,3,8,4,3,18,30,3,8,10,0,9,10,6,11,15,4,3,3,8,3,34,17,1,1,5,2,1,6,18,3,5,7,11,2,9,6,5,2,1,12,1,15,6,0,3,17,0,5,7,2,66,11,2,7,1,0,1,11,4,3,28,0,2,8,5,0,1,6,5,0,1,1,10,3,1,7,13,4,5,4,11,27,0,2,6,0,3,2,1,0,1,3,12,1,11,10,12,12,2,2,14,5,10,0,22,3,3,7,0,11,3,6,6,2,5,11,14,1,3,4,7,4,6,7,3,1,19,23,8,2,13,1,5,8,7,2,0,0,11,15,19,3,3,9,3,0,25,3,3,4,3,8,1,7,4,18,8,3,5,5,30,1,22,3,0,21,1,11,15,2,8,2,6,2,15,4,37,2,17,0,10,0,2,0,0,2,3,0,9,10,5,7,4,5,3,6,0,3,2,2,0,1,12,9,0,8,0,9,6,6,7,1,3,2,0,1,0,3,2,2,5,11,2,1,4,2,4,2,18,5,5,6,1,1,21,9,1,4,0,17,2,6,8,12,3,2,6,4,5,0,5,1,1,1,1,2,0,7,6,3,2,8,0,2,6,3,5,3,5,3,36,19,0,2,5,1,1,7,1,6,6,6,1,0,3,8,1,4,2,4,1,6,8,3,8,7,2,3,5,6,1,3,3,11,10,3,10,2,9,17,4,1,2,5,1,2,14,2,19,7,2,0,0,0,9,5,3,6,9,3,42,5,2,45,3,11,16,2,8,2,9,4,11,0,12,5,5,8,13,12,7,1,10,0,6,2,3,4,7,12,5,11,10,9,3,2,2,4,2,4,8,16,5,4,7,3,1,1,18,9,8,0,3,2,3,12,9,15,4,2,7,5,5,7,17,6,20,1,6,2,9,1,2,7,1,6,3,3,15,14,7,8,13,15,1,1,5,2,2,4,6,2,6,13,2,11,5,1,3,67,2,2,5,6,3,6,22,1,6,7,4,2,3,10,3,1,0,2,5,3,11,3,13,26,16,5,4,6,3,2,2,15,8,4,1,6,9,0,0,6,6,2,10,5,3,3,5,1,8,11,2,3,6,3,4,0,7,1,0,2,0,5,1,11,18,12,3,4,1,1,9,1,1,13,1,2,5,0,0,7,4,4,5,7,6,2,6,1,21,3,4,1,2,2,7,2,3,4,0,9,6,4,3,7,4,9,4,2,5,6,4,5,1,1,15,6,5,6,0,6,0,1,3,2,5,5,3,2,11,8,3,1,4,1,3,3,1,6,5,2,2,3,0,4,4,11,2,3,2,1,2,2,5,2,2,2,2,3,8,2,10,4,9,6,1,3,1,1,3,7,3,1,0,7,3,2,1,3,2,3,2,6,5,3,1,4,4,9,2,3,3,3,8,3,0,6,2,2,3,2,10,15,3,4,2,4,3,7,6,0,8,1,2,3,0,2,1,1,1,8,1,4,2,4,1,1,0,2,7,3,0,2,2,2,3,1,4,1,1,4,2,4,1,1,2,3,1,5,2,1,2,2,6,5,3,1,0,3,3,8,2,1,1,3,6,4,1,5,3,2,7,3,11,6,1,7,2,9,1,3,5,1,6,4,1,5,2,2,1,10,1,1,6,1,1,7,2,6,13,8,1,1,4,3,4,3,5,2,14,3,12,6,4,1,0,11,5,0,0,4,8,5,3,3,3,3,1,5,2,5,6,6,1,3,5,2,5,3,15,0,3,0,4,1,0,0,0,7,1,0
excess,0,1,0,59,0,2,2,12,2,1,4,0,10,14,4,1,2,6,3,1,2,11,1,5,11,5,2,2,2,10,2,68,62,3,20,6,6,9,8,1,5,1,2,5,9,8,17,3,100,4,16,0,3,8,2,2,25,31,0,6,0,0,0,0,2,1,36,4,5,1,13,0,1,0,17,11,16,1,30,7,69,0,6,2,74,17,11,0,47,4,5,2,1,8,20,16,10,10,12,4,13,10,14,4,9,10,19,3,13,5,13,8,6,5,0,11,3,8,25,53,26,2,30,82,1,0,0,1,4,2,7,0,2,17,7,24,1,0,8,5,2,6,23,5,5,24,3,9,9,16,15,1,11,3,2,4,8,1,0,1,18,4,1,3,10,2,4,2,6,6,6,29,9,3,0,6,66,0,5,14,2,3,4,8,5,14,20,9,6,26,0,4,6,0,1,3,3,2,8,2,27,6,2,1,12,1,7,19,1,8,21,1,12,3,2,1,3,3,9,0,10,7,4,5,20,30,41,18,6,13,7,15,10,8,12,62,13,7,10,1,32,11,1,2,5,3,1,5,16,1,6,16,4,18,9,6,4,0,1,17,1,7,7,1,8,36,0,2,6,1,45,18,83,0,2,0,2,95,1,1,16,6,2,1,1,1,0,4,7,2,1,2,5,6,2,3,20,0,2,5,4,7,6,2,4,0,5,1,1,0,0,10,13,3,32,22,4,16,7,0,8,4,12,0,11,2,4,6,1,7,0,10,1,2,2,14,11,2,6,12,3,0,9,2,5,0,20,18,8,2,14,1,5,22,10,3,2,0,2,50,9,5,2,11,1,0,12,3,2,6,0,7,3,0,3,22,3,2,4,6,24,0,22,2,1,30,1,12,24,2,6,2,7,1,15,5,33,4,9,3,4,2,2,0,4,2,0,0,8,0,1,1,12,8,0,2,2,7,2,0,1,2,6,1,1,0,1,5,4,12,18,6,10,7,1,1,1,0,0,2,1,3,0,1,0,0,2,0,24,7,4,3,3,1,24,0,0,4,2,19,7,8,11,9,2,0,6,4,2,0,3,2,0,4,0,8,1,5,5,5,2,4,1,1,2,1,9,2,1,0,19,29,0,1,3,4,4,5,8,8,5,2,11,1,4,21,5,3,9,10,5,3,3,2,7,9,1,3,2,2,1,7,4,5,0,3,11,1,3,8,1,1,2,4,0,2,3,2,7,13,2,1,2,1,6,3,1,5,4,1,4,3,2,20,1,4,8,1,2,1,12,0,6,2,8,5,11,3,14,3,14,8,20,0,1,2,7,3,2,29,10,7,7,4,2,2,0,5,5,2,7,9,9,4,7,4,0,2,6,5,7,0,1,0,5,15,10,4,3,6,16,0,0,3,11,3,7,0,2,4,14,10,0,11,0,4,3,4,7,13,12,12,5,10,1,1,3,7,5,3,4,0,2,14,3,25,2,0,0,57,0,4,8,1,0,11,16,2,4,5,0,2,0,5,3,1,0,3,1,2,5,1,5,6,18,1,1,12,0,3,1,13,2,2,6,0,3,2,0,2,4,2,5,2,5,7,1,0,9,3,11,1,3,2,3,1,12,2,4,3,1,11,1,6,10,3,2,3,3,4,1,1,3,6,1,0,9,1,3,4,0,7,3,4,8,5,2,3,6,4,8,3,0,1,2,2,6,4,2,3,6,57,33,51,38,6,3,4,6,56,54,7,2,12,6,24,1,4,0,2,1,2,2,4,0,3,6,0,6,4,3,1,4,2,5,0,4,0,7,5,1,0,0,6,8,6,4,7,2,0,1,2,3,0,2,1,5,3,9,3,19,0,4,6,2,0,6,3,4,7,2,11,0,4,5,1,1,8,7,1,11,5,2,0,2,3,12,10,2,1,2,0,3,4,4,9,6,6,9,2,6,13,1,4,0,0,2,0,1,2,0,0,2,3,3,5,1,1,4,5,5,4,14,13,1,1,1,3,5,4,0,8,2,0,1,1,2,0,0,10,0,6,0,2,2,1,0,0,2,3,3,2,0,0,0,2,0,10,5,1,1,5,2,33,2,6,0,1,4,2,7,0,0,1,4,1,1,0,0,13,1,1,3,6,5,1,8,6,0,5,2,6,41,8,19,21,6,36,61,2,1,3,3,5,4,9,17,0,7,2,23,1,0,4,1,5,1,8,2,1,1,3,3,0,0,1,2,0,3,2,20,2,3,8,3,9,3,1,0,0,2,0,4,0,0,9,0,5,0,0
facility,0,7,5,71,3,2,1,13,1,2,6,9,6,24,2,2,0,6,1,1,2,25,0,7,9,0,2,13,4,7,3,73,64,9,22,25,8,6,12,3,2,6,3,1,11,9,22,16,122,7,10,0,8,20,3,1,26,23,0,15,8,2,1,9,7,2,50,2,0,19,26,4,3,2,38,11,7,2,41,4,62,3,17,7,90,13,14,0,20,0,3,3,2,3,17,13,12,10,27,17,11,15,13,8,10,29,3,1,11,6,10,4,8,10,0,9,0,5,23,52,20,11,2,50,6,0,3,1,2,3,6,1,4,31,5,28,1,3,1,1,0,25,13,3,0,23,3,13,10,14,28,0,5,14,6,16,7,12,3,16,12,1,2,2,3,2,3,9,8,11,19,20,6,1,3,5,64,3,8,31,6,4,16,4,6,19,15,12,13,20,1,4,12,0,1,3,19,7,7,7,19,6,3,7,16,4,6,29,13,18,36,0,9,6,0,0,1,1,14,5,0,7,2,6,26,54,13,15,2,15,4,13,16,26,17,23,10,12,20,2,25,20,6,0,8,7,3,15,30,3,9,16,6,12,6,6,3,0,3,11,2,20,14,1,7,45,19,2,6,3,72,4,22,2,4,0,8,23,9,3,39,11,2,6,4,7,6,6,5,1,3,2,5,5,1,7,20,3,2,10,9,23,2,0,2,3,8,3,1,0,5,7,20,9,16,11,21,28,18,5,18,1,8,11,14,1,2,8,3,10,3,6,3,5,0,18,7,2,8,8,3,4,12,2,10,6,24,17,15,3,10,1,2,24,11,24,2,1,4,16,14,12,9,6,4,0,17,2,0,4,1,7,6,13,3,28,3,2,2,2,22,0,36,5,2,30,3,12,12,3,1,3,7,3,14,10,28,7,22,4,7,3,1,1,5,5,4,0,31,10,2,1,12,11,6,2,1,2,1,1,4,2,8,0,1,1,5,3,3,4,14,3,1,3,0,2,0,2,8,3,8,12,3,6,2,3,6,1,17,9,17,2,4,4,28,2,0,3,3,14,2,5,20,9,4,4,10,6,6,0,3,1,4,1,4,5,2,8,3,1,2,5,9,0,4,1,13,1,0,0,16,14,4,0,9,3,6,7,6,6,9,2,2,7,15,30,5,9,1,2,3,2,3,3,16,8,4,5,0,6,3,4,3,11,3,2,12,8,6,15,4,3,0,3,7,7,4,4,20,19,3,1,1,8,9,3,0,33,7,6,4,1,2,31,6,7,24,8,7,3,11,2,16,1,4,8,8,1,16,19,6,7,10,0,1,1,0,2,2,17,3,15,7,5,6,0,3,3,5,5,10,14,3,3,15,4,1,2,8,12,8,8,1,0,2,12,4,5,4,5,9,12,7,11,9,4,6,5,4,4,22,4,6,19,4,5,22,6,8,35,5,16,4,12,7,0,6,5,2,4,5,3,2,8,2,15,3,2,7,66,10,6,3,4,4,6,17,3,1,6,2,3,3,10,3,0,0,3,4,5,12,6,4,4,13,2,3,6,1,6,7,18,3,7,8,7,4,2,0,8,2,10,16,3,6,6,4,0,6,5,3,3,3,2,10,4,8,7,6,0,2,4,2,14,11,3,0,2,0,3,4,2,1,12,2,10,2,1,2,5,5,10,4,0,1,10,4,4,10,7,3,5,5,3,4,3,16,18,2,2,2,6,11,6,8,9,3,15,13,12,9,5,1,3,22,4,7,2,10,6,4,2,3,9,4,14,17,3,7,8,9,5,5,1,2,9,6,1,5,9,6,5,2,1,10,6,11,2,4,1,1,5,1,2,2,6,9,0,3,5,6,5,19,7,5,3,6,3,6,2,1,7,13,12,2,1,2,2,9,3,4,1,15,3,5,6,3,9,7,3,4,6,1,1,7,5,8,1,7,5,3,13,2,9,3,4,3,11,0,1,6,7,7,5,2,8,2,3,4,11,4,6,2,7,0,1,2,8,9,1,0,3,3,0,5,2,2,1,0,3,3,1,3,4,5,2,1,4,7,0,7,1,3,2,0,1,1,11,4,9,16,11,11,6,0,1,3,12,2,2,5,0,0,2,1,4,2,2,1,11,8,3,0,3,2,8,1,2,2,18,2,2,7,1,5,11,2,6,33,0,2,3,2,6,0,5,12,5,21,2,1,3,5,3,3,9,2,3,0,2,4,2,4,2,4,7,4,2,13,1,34,4,1,5,3,1,4,13,4,0,5,7,2,0,5,2,0,0,1,1
sufficient,0,16,7,81,8,2,6,21,0,3,8,1,2,45,4,4,3,9,1,1,3,18,5,14,8,10,9,9,3,16,9,108,57,11,23,34,17,15,15,4,2,4,2,1,23,2,22,5,119,1,17,1,8,15,3,2,38,20,0,7,7,6,1,8,11,9,51,5,3,2,19,3,4,1,22,6,10,4,42,9,38,0,12,4,114,12,16,2,29,3,5,3,0,22,33,12,8,3,19,11,11,13,31,4,5,7,9,1,7,7,10,6,4,11,0,15,5,1,35,94,15,8,15,81,4,6,2,1,2,3,5,4,4,44,15,21,11,5,4,8,2,20,18,2,4,38,5,6,9,24,27,1,13,2,1,13,18,5,4,2,8,2,4,2,5,2,2,10,6,4,4,47,5,1,1,7,86,0,1,18,9,5,1,11,0,12,21,11,12,24,1,2,6,0,0,1,8,2,8,3,18,1,1,5,22,5,7,20,12,16,47,2,13,6,2,5,2,1,14,2,6,11,3,8,53,45,21,23,8,14,8,10,26,10,15,32,16,7,9,0,44,24,0,4,7,3,3,10,29,2,4,28,8,16,11,9,4,3,4,14,1,24,9,2,1,31,4,3,5,2,90,25,45,3,3,0,13,25,5,2,27,3,2,9,15,5,3,8,6,0,1,1,6,11,3,3,19,1,6,6,16,21,2,3,2,2,4,1,3,1,0,6,41,2,43,11,11,24,9,4,31,3,24,2,35,4,0,7,3,11,6,9,6,3,4,1,7,6,3,14,6,6,15,5,6,2,24,32,9,5,8,5,3,13,13,4,1,1,14,26,10,5,4,2,1,2,20,5,1,3,5,13,0,5,1,23,1,5,3,15,44,1,35,3,1,27,3,21,25,0,20,6,8,1,10,3,27,3,19,3,10,3,0,2,2,10,5,2,16,4,0,5,6,5,6,1,2,0,3,0,1,9,7,9,1,0,0,5,5,9,16,9,16,6,1,1,1,3,5,2,2,15,2,1,0,1,3,1,21,7,10,7,1,3,21,1,0,4,2,14,5,17,15,15,3,2,18,7,3,0,12,1,4,1,0,12,5,5,6,8,11,7,2,1,7,4,4,2,5,2,43,33,0,3,6,2,16,8,8,6,10,3,10,1,6,26,0,5,3,1,5,7,2,4,6,5,2,1,1,4,1,15,6,4,4,0,11,2,18,15,8,1,0,7,3,4,7,3,9,22,2,2,3,8,7,4,7,8,8,5,21,2,2,31,1,5,13,3,2,9,11,2,16,4,10,14,10,5,34,24,11,7,22,1,3,4,10,4,6,8,8,3,4,16,4,4,5,6,11,5,8,14,6,10,13,9,3,3,20,6,14,1,6,3,1,13,3,5,4,4,8,10,8,1,7,5,14,2,3,1,11,18,4,15,2,7,0,3,8,12,22,11,14,8,6,3,2,7,4,5,7,0,4,11,5,29,3,4,4,63,11,5,4,2,5,5,22,2,7,12,1,0,1,4,4,4,1,4,6,9,12,7,26,9,16,4,2,7,2,3,1,20,13,3,7,9,3,5,2,5,8,2,16,3,4,9,5,4,13,22,3,1,2,1,4,4,12,5,0,2,1,7,3,8,11,21,5,3,4,4,4,5,3,11,1,1,10,2,1,11,9,15,10,3,4,1,29,6,28,10,8,2,4,7,7,4,12,3,4,5,9,19,13,20,10,3,14,2,7,10,15,8,4,4,10,7,10,3,2,3,3,1,2,9,2,8,6,2,3,5,0,2,12,4,9,2,5,3,8,5,0,5,1,4,16,20,1,8,6,5,3,8,4,4,6,1,7,6,9,8,6,0,3,4,1,2,0,3,4,10,2,3,3,2,6,1,2,9,12,5,11,9,5,1,4,3,7,22,6,2,5,0,0,5,6,4,2,0,3,8,7,14,4,6,0,4,0,5,5,5,0,3,4,1,3,4,1,1,6,1,1,2,13,8,2,2,0,12,2,2,0,4,3,4,8,1,4,5,0,5,0,6,1,4,6,7,6,4,7,1,1,1,1,3,4,2,1,8,5,9,2,20,5,19,8,4,1,2,0,3,5,2,4,5,1,6,1,3,2,13,2,0,1,9,2,6,2,1,7,6,1,9,19,12,8,12,11,47,46,2,0,1,2,4,8,10,3,4,15,8,12,4,1,6,4,18,5,3,5,3,4,4,1,1,2,0,0,10,3,4,7,4,2,11,2,2,3,1,5,1,0,2,3,0,0,6,1,2,0,0
behalf,10,17,7,54,8,1,5,4,7,2,11,2,3,38,1,6,1,11,9,6,1,11,2,11,14,11,9,5,11,8,8,81,60,2,22,19,27,5,1,2,1,8,4,0,13,11,9,9,152,7,10,2,9,11,4,9,34,13,1,9,11,1,0,7,4,7,66,2,4,6,1,3,2,1,23,4,5,5,36,16,13,0,6,3,118,5,1,0,20,1,7,1,0,9,29,6,6,2,15,7,3,5,13,3,6,10,0,0,5,2,8,1,0,8,2,12,2,2,32,86,12,8,2,27,2,4,1,4,6,0,7,6,4,19,4,15,7,1,6,1,2,23,12,2,2,41,3,9,8,2,32,1,3,4,1,14,11,4,7,3,0,0,7,2,0,2,1,17,7,4,3,40,7,0,1,2,80,2,2,15,9,6,0,14,1,12,14,7,26,21,3,3,3,0,3,1,2,4,2,8,20,2,0,9,12,7,2,8,2,15,35,1,8,3,2,3,0,0,5,1,2,9,2,8,14,41,10,9,2,0,6,5,9,10,15,0,9,7,2,8,31,6,4,1,4,6,5,8,9,4,11,6,12,3,6,5,3,0,2,4,3,16,17,5,2,11,5,1,9,1,52,2,11,4,0,0,7,3,9,1,35,5,0,17,2,3,1,2,8,0,0,6,4,1,3,4,22,9,5,8,8,11,1,0,3,2,18,3,2,0,2,3,8,7,9,6,13,25,4,3,57,6,9,0,55,6,2,9,4,16,2,7,7,0,1,9,8,5,0,2,5,7,9,12,2,3,15,24,9,5,9,5,4,10,9,4,5,4,5,14,10,6,3,7,1,2,17,3,3,8,2,3,5,5,5,12,6,4,13,2,35,1,11,8,4,12,6,12,8,2,22,4,6,7,12,2,33,6,26,1,7,2,1,0,1,11,2,0,8,4,5,1,1,7,23,5,2,2,1,2,6,8,5,4,0,5,0,10,8,4,1,5,1,5,4,3,0,10,3,3,11,12,9,5,0,3,2,0,12,4,5,5,3,1,32,6,1,6,10,7,6,16,20,15,2,3,3,8,3,2,18,7,2,0,2,14,0,9,7,3,2,5,1,3,6,4,2,5,3,3,27,19,0,3,4,1,2,10,7,5,9,0,0,0,2,3,0,7,4,4,2,1,1,4,3,10,5,4,1,6,2,15,3,15,4,11,11,5,15,14,11,5,0,8,4,3,4,10,20,10,2,3,2,0,4,5,1,14,5,2,7,3,5,22,0,2,17,2,3,13,11,4,5,1,2,8,3,8,9,21,0,2,6,4,7,7,6,3,7,3,2,8,3,11,0,7,5,4,1,2,7,22,5,1,2,1,2,3,24,5,5,4,2,0,3,7,1,16,2,1,12,5,5,3,19,4,6,4,5,1,4,0,1,7,0,3,3,2,8,5,0,19,12,5,1,0,8,7,4,3,16,1,9,5,8,14,1,4,3,102,24,1,5,1,8,1,16,7,3,10,2,2,12,14,8,5,1,1,3,5,8,4,9,25,20,2,2,1,0,1,4,10,7,4,13,4,13,1,0,5,7,9,8,2,4,3,6,3,8,8,5,4,1,9,4,1,13,2,2,2,1,1,2,9,6,11,0,3,6,1,0,3,4,6,1,2,2,7,4,4,1,2,4,8,7,1,12,6,11,4,9,1,0,5,6,5,3,2,2,10,7,2,1,4,2,3,4,5,1,3,7,5,3,2,6,1,4,2,1,5,1,2,0,12,2,7,1,2,23,2,1,2,7,0,7,4,3,5,1,9,3,3,1,1,16,8,3,6,0,4,3,2,8,2,4,1,3,0,4,3,1,1,5,3,5,7,3,4,1,4,4,0,15,1,0,2,2,2,1,1,2,2,6,3,0,5,2,10,8,2,5,0,3,2,2,5,1,5,6,12,16,17,9,3,0,0,7,3,6,0,3,7,3,0,2,5,1,1,6,12,2,1,0,0,3,2,3,12,10,5,2,3,2,3,5,1,5,2,3,2,3,5,0,0,3,5,6,3,3,0,1,3,2,3,4,3,2,4,1,9,2,1,2,3,4,3,2,8,1,2,2,2,2,1,5,4,6,6,1,1,1,1,8,2,1,0,2,7,1,7,1,0,0,0,1,4,5,4,7,2,0,0,1,2,1,2,0,2,11,0,2,4,3,3,1,15,8,2,1,3,1,6,10,3,2,1,2,4,2,3,0,5,2,0,7,3,6,2,26,1,0,2,1,0,0,2,1,1,0,4
improvement,2,7,10,183,7,7,8,39,3,1,7,33,18,63,13,8,0,24,3,2,10,25,11,24,22,14,9,16,4,9,7,210,132,13,41,49,18,26,17,6,10,10,6,7,34,16,28,28,195,4,20,2,23,22,11,5,32,68,0,42,18,5,5,9,17,5,82,9,8,15,13,61,9,5,80,12,12,13,58,6,107,1,11,14,171,31,13,0,19,9,5,7,2,16,52,16,22,12,43,12,47,39,25,12,15,18,9,2,11,7,28,9,22,33,1,32,0,2,57,118,46,5,11,84,6,1,7,4,7,10,10,4,10,73,10,100,2,2,7,10,3,32,22,5,5,56,5,13,5,39,66,1,7,15,15,41,24,8,5,11,31,5,9,3,9,4,5,23,29,9,14,69,30,4,6,4,151,4,14,51,36,15,13,8,30,24,41,31,17,41,3,2,9,0,4,5,53,1,10,10,14,4,11,9,16,8,3,69,11,26,58,9,14,12,3,1,1,4,24,23,7,12,15,19,62,85,32,19,10,10,21,24,17,24,43,28,31,13,11,2,61,31,12,1,12,4,4,19,54,2,17,21,11,17,12,19,13,2,5,24,11,18,24,3,16,84,22,4,12,13,142,11,62,8,14,1,20,40,21,11,62,7,3,22,10,4,9,11,13,1,3,2,21,5,0,11,37,7,4,18,21,58,1,3,15,6,23,9,15,3,5,27,15,9,25,20,52,50,29,10,31,11,21,10,49,15,15,24,0,9,0,17,6,6,3,30,15,6,3,7,7,3,17,10,11,6,43,53,28,5,32,6,12,35,14,18,3,6,21,28,28,25,13,24,9,1,21,4,12,5,2,23,6,11,2,69,12,6,16,11,58,1,54,14,3,62,5,15,19,4,17,5,19,10,45,12,54,9,44,7,36,6,6,1,6,10,9,5,21,22,2,7,9,26,1,13,8,4,1,0,6,6,15,3,3,4,2,9,12,9,6,7,6,6,3,1,2,8,8,6,16,34,8,6,1,4,20,4,53,8,17,6,6,2,60,6,0,1,13,30,5,32,38,21,12,2,21,11,37,1,17,1,6,3,3,16,9,14,19,4,2,19,1,5,10,3,13,3,6,5,52,47,3,2,8,13,11,11,2,6,14,7,5,9,14,9,16,12,8,4,3,5,12,10,27,26,3,12,8,7,13,6,6,17,6,2,14,1,18,20,7,13,1,9,8,10,11,15,26,33,4,3,0,18,11,11,3,24,7,8,25,6,6,54,11,9,36,6,1,7,24,7,28,4,12,12,7,7,44,54,23,10,54,9,15,8,10,4,5,37,13,10,13,15,4,4,12,6,2,12,20,26,8,10,37,17,9,9,13,12,45,8,9,0,10,25,9,14,20,10,12,24,15,8,17,13,26,6,3,3,11,2,9,5,6,9,20,24,16,50,4,48,27,14,18,0,13,12,6,17,17,5,4,22,13,44,2,3,7,79,16,15,5,7,11,14,43,5,0,11,8,4,1,4,3,2,0,11,7,9,33,12,10,7,13,4,10,18,7,7,33,42,3,14,17,12,5,5,5,18,9,8,14,14,3,31,6,3,6,19,4,10,4,8,19,16,15,3,3,4,1,11,0,26,17,33,3,13,1,23,8,4,1,29,3,20,6,5,12,11,9,28,10,5,6,9,36,8,23,26,6,4,7,6,6,6,21,35,11,17,12,11,11,16,10,14,6,28,21,6,5,5,4,8,28,22,64,22,20,18,10,4,10,4,6,17,7,7,17,15,13,5,6,7,9,13,11,0,7,21,8,44,22,10,8,29,5,12,8,12,2,4,7,5,3,2,12,7,9,7,5,1,5,5,5,4,4,3,3,8,2,2,4,28,32,5,6,12,1,6,7,6,23,2,12,10,5,26,8,11,4,8,6,6,8,20,8,5,9,2,11,12,1,9,8,11,13,11,1,1,5,2,8,3,2,10,2,6,3,27,19,6,6,8,2,14,0,3,6,3,0,1,10,0,12,5,7,6,4,4,5,114,1,1,3,4,2,8,4,2,9,4,6,8,7,1,1,7,5,20,7,5,6,17,6,1,4,54,7,3,4,2,7,4,2,19,4,2,3,8,11,7,4,7,10,5,18,6,7,1,3,15,8,3,11,9,9,40,38,2,16,1,9,8,19,4,7,10,26,8,4,37,8,9,3,19,5,3,0,6,2,7,5,13,3,9,6,4,14,1,13,10,9,2,4,7,12,9,4,1,12,9,7,1,5,8,2,18,9,0
attain,0,11,5,51,3,4,1,14,2,6,11,3,5,28,3,6,1,3,2,4,4,14,2,14,8,5,4,5,2,6,4,61,46,4,34,21,22,2,5,7,4,3,1,7,15,12,13,8,83,8,14,2,5,20,5,4,19,19,0,13,4,3,1,3,7,1,50,4,2,8,4,3,1,4,32,6,14,2,34,9,33,2,2,1,52,7,8,0,17,0,7,2,2,10,24,5,13,1,11,7,12,19,11,4,3,10,3,1,4,3,6,3,8,2,1,8,0,3,18,49,24,4,8,48,5,2,7,0,8,2,8,0,0,17,13,23,0,1,1,3,0,12,6,1,1,26,1,5,9,5,18,0,3,2,1,8,13,1,4,4,3,1,3,2,2,2,1,12,9,1,7,33,9,2,0,4,53,5,3,18,9,4,3,9,0,10,9,14,10,12,1,2,8,1,3,0,11,0,5,8,9,0,0,5,15,2,4,10,5,11,19,7,11,3,2,0,1,0,3,1,6,9,6,11,22,33,12,13,1,4,5,4,10,9,10,21,13,4,8,4,24,15,2,1,8,4,1,14,22,3,5,8,5,4,3,6,1,3,1,10,2,10,9,2,4,27,4,1,2,1,49,1,12,0,1,4,7,21,4,0,30,2,2,2,6,0,0,7,1,3,4,2,11,3,1,1,8,1,2,10,7,13,2,0,3,0,13,2,6,3,0,3,14,6,9,8,17,32,4,3,11,5,14,4,15,1,3,10,2,9,0,15,5,1,9,7,7,3,0,7,1,3,5,1,1,1,23,18,5,0,8,2,1,11,7,4,1,8,6,24,9,8,6,1,2,1,13,5,4,3,1,1,1,5,6,27,4,4,4,4,31,0,17,3,0,4,0,5,9,3,11,8,3,8,11,7,22,1,22,4,4,0,1,0,5,0,2,1,12,5,0,2,2,5,11,7,0,3,1,1,2,2,8,3,0,4,6,10,7,7,4,2,0,2,0,4,0,2,6,5,4,6,1,6,0,0,12,2,16,3,6,2,1,2,23,4,0,1,3,13,2,10,9,23,2,4,7,2,0,0,5,4,2,1,4,3,1,6,12,2,0,5,4,0,9,2,8,3,3,6,41,21,1,2,4,0,3,7,3,7,8,5,3,0,1,6,2,4,2,4,1,4,2,5,10,9,2,5,0,7,8,8,2,11,1,3,5,1,3,8,6,9,0,6,3,0,0,4,16,7,0,0,0,3,2,0,2,6,1,1,16,1,2,13,6,5,10,0,1,7,14,5,4,2,4,2,5,5,12,27,3,6,4,0,4,2,5,3,7,9,6,6,8,4,9,3,4,5,2,8,14,17,5,0,6,1,4,7,10,12,10,0,3,2,5,14,0,9,8,1,9,5,6,4,9,4,21,0,10,2,6,2,0,8,1,7,1,5,1,11,2,11,14,9,6,2,4,5,0,3,6,3,3,5,1,20,3,3,2,49,20,0,7,1,2,5,17,2,1,8,7,3,1,7,5,0,4,1,3,10,5,4,4,8,5,2,4,2,1,5,0,5,6,2,3,0,3,2,1,5,3,6,1,4,2,5,0,1,1,7,1,2,3,7,9,3,4,4,0,1,1,5,2,13,3,28,3,4,3,7,6,3,2,25,2,7,4,0,2,7,4,7,2,1,3,2,25,1,3,3,2,2,3,12,8,4,6,3,4,0,5,5,5,7,3,8,4,10,3,10,9,8,5,2,8,1,2,0,5,3,5,0,1,3,3,8,4,2,10,7,3,0,9,4,4,5,3,0,10,4,3,1,0,1,1,6,1,2,5,2,2,2,2,1,2,2,6,4,7,2,1,4,2,9,2,2,4,5,0,3,0,4,5,11,1,3,2,1,6,2,4,2,3,0,2,5,5,12,7,3,0,2,1,2,2,5,7,5,5,4,5,6,2,7,2,3,0,0,1,2,2,1,3,2,2,3,2,0,4,7,1,7,1,6,1,1,2,2,4,0,1,2,1,1,7,5,4,3,0,6,1,1,0,5,5,4,2,1,3,3,1,1,5,4,3,3,2,6,2,13,3,1,8,3,4,2,1,4,3,6,3,1,6,2,2,0,5,3,3,3,1,0,1,3,1,2,2,1,1,3,1,2,7,1,7,2,5,8,7,1,0,3,9,2,1,4,0,2,4,2,0,1,4,1,0,9,4,2,3,1,2,5,1,0,1,1,2,2,2,1,6,1,1,2,2,0,9,0,6,0,2,2,4,1,0,4,1,3,1,0
bear,4,16,11,117,17,10,9,42,4,6,18,8,8,100,6,13,7,22,7,6,5,36,21,35,15,13,24,15,17,35,16,187,145,19,61,80,42,12,20,3,72,16,8,6,34,20,8,10,260,32,56,6,22,64,61,5,104,15,15,11,19,17,1,17,19,12,141,18,10,4,22,7,11,9,82,10,36,1,86,32,83,1,8,10,266,54,16,2,32,17,10,8,1,25,101,58,22,8,31,45,8,31,38,16,13,26,11,4,24,9,24,16,10,16,8,38,1,5,55,189,53,43,130,84,11,5,5,0,5,3,11,5,16,70,29,37,13,16,7,13,11,39,32,6,8,67,8,24,14,27,49,3,18,6,3,20,40,8,19,30,39,6,18,3,4,10,3,15,28,11,15,117,43,6,12,12,222,6,12,31,24,20,10,23,5,24,59,21,31,29,4,4,14,7,1,7,12,5,10,16,25,1,17,8,23,25,12,35,11,11,81,9,27,30,9,6,2,5,9,0,10,22,4,21,45,120,32,50,10,11,24,15,31,15,41,60,26,10,13,10,90,29,4,15,25,13,9,38,33,11,8,24,16,17,6,16,17,20,1,21,5,27,14,7,8,15,7,13,27,14,199,9,70,19,9,3,26,11,10,0,78,2,3,40,10,3,13,27,25,1,4,3,11,11,8,11,70,4,5,34,30,31,4,14,15,1,20,6,7,2,1,34,33,8,84,19,29,28,25,9,75,10,41,4,59,4,6,44,2,33,10,24,11,10,9,9,25,7,3,19,4,11,29,20,16,6,35,57,11,15,14,18,5,46,30,4,4,6,27,21,23,9,7,28,6,4,31,15,7,28,2,46,4,23,11,27,11,7,16,7,78,1,46,11,11,41,3,37,29,8,24,8,7,10,20,10,51,5,26,1,21,6,6,6,10,11,8,2,32,9,5,7,10,19,1,10,4,5,5,9,4,7,9,5,2,2,1,14,6,15,21,7,3,21,4,2,1,6,10,6,17,40,6,15,0,3,22,8,34,20,27,6,9,2,54,10,5,27,9,20,19,48,35,58,16,12,35,5,9,2,36,3,5,10,9,51,9,14,24,17,8,12,1,6,12,13,8,8,6,2,81,30,8,13,22,7,2,27,13,8,14,6,20,1,5,21,2,15,4,2,10,2,5,1,13,16,6,12,2,11,2,32,12,21,4,14,10,7,24,26,14,35,2,22,9,11,10,6,53,17,3,2,5,10,9,6,7,32,15,6,30,7,17,64,2,13,28,3,14,7,19,1,31,2,15,14,15,8,40,34,16,5,6,2,3,4,14,7,7,18,14,11,19,13,15,2,3,6,10,12,26,34,10,1,18,7,15,11,29,14,26,4,5,5,3,18,1,15,8,22,26,18,5,9,35,14,21,5,7,9,10,25,4,48,1,12,5,12,16,22,34,17,27,19,1,5,15,15,4,10,34,4,10,13,10,29,5,7,7,164,13,7,5,1,3,14,47,26,10,14,3,4,10,15,6,7,0,7,17,1,23,16,55,35,30,3,9,8,3,6,10,24,12,6,12,16,18,11,2,12,14,18,16,6,10,8,7,6,55,16,1,1,2,5,10,6,20,11,5,3,3,9,13,17,10,37,9,3,11,11,13,5,7,26,3,2,13,3,4,12,6,16,15,3,9,2,22,10,20,12,11,1,2,11,7,1,17,4,11,14,16,3,2,10,9,11,11,4,0,89,76,27,11,12,14,34,21,4,4,8,10,4,9,18,4,12,4,1,0,17,3,4,17,9,13,6,11,29,18,19,15,11,5,2,6,19,2,10,9,5,4,5,9,3,6,4,5,10,20,5,10,2,8,6,3,6,5,15,4,18,4,1,3,0,0,9,5,6,30,5,12,4,17,4,17,2,7,34,12,5,5,5,9,1,14,13,16,8,2,12,13,23,4,16,3,7,3,10,7,6,3,11,8,3,8,5,2,1,7,6,1,7,58,33,4,8,2,10,14,2,1,14,1,7,3,7,7,2,3,2,6,5,1,1,14,4,2,0,12,8,6,5,4,12,5,6,1,14,9,21,4,10,8,13,10,5,6,14,3,1,5,13,7,35,3,6,7,11,7,9,6,7,8,7,1,6,2,9,0,15,2,1,2,12,11,25,25,8,37,9,1,9,9,8,7,10,5,1,27,7,1,1,1,3,8,18,2,2,6,7,10,5,4,20,4,1,5,8,7,3,1,12,8,22,1,60,12,8,9,8,1,5,2,3,1,17,2,6,3,3
fiscal year,0,4,4,137,2,0,5,9,0,4,4,1,21,17,3,0,2,9,0,3,6,14,1,6,10,17,4,9,4,26,2,197,58,4,22,16,7,18,22,4,7,0,0,7,19,8,26,26,85,0,11,2,19,15,0,0,38,97,0,9,3,1,2,9,14,1,34,6,4,7,68,3,3,3,49,0,10,1,51,7,180,0,2,2,143,17,13,14,230,7,32,0,10,73,74,32,17,12,51,1,12,29,51,1,20,14,44,12,39,19,29,5,31,6,0,32,15,5,78,95,18,2,36,281,10,1,2,6,15,4,6,0,0,45,2,29,0,6,0,2,0,27,41,14,0,50,2,18,20,59,9,1,12,8,6,21,36,7,1,2,44,1,8,5,69,0,6,9,10,4,12,36,2,1,2,5,90,0,3,28,14,1,28,7,4,1,27,5,5,49,0,0,1,0,5,6,6,6,15,4,34,4,2,2,15,0,2,14,7,16,27,2,8,3,1,1,35,59,23,7,68,2,3,7,82,70,83,60,24,100,3,55,101,7,23,134,25,3,9,0,24,21,3,2,1,8,5,6,51,0,3,17,3,59,19,4,5,4,11,49,5,7,30,8,19,132,2,0,9,4,64,41,295,2,3,1,1,237,10,1,15,5,2,3,11,1,6,2,6,1,2,0,8,133,10,8,41,5,0,7,7,34,43,5,10,0,7,11,0,9,2,4,45,2,74,39,6,29,2,6,9,3,6,5,3,0,3,6,3,7,0,11,0,2,5,22,2,1,11,23,6,4,4,8,5,1,32,30,24,3,37,0,0,9,9,9,2,1,4,218,26,7,1,12,1,0,6,3,4,4,3,15,0,3,0,71,6,2,3,38,54,0,30,0,1,45,0,8,79,0,3,4,2,1,16,0,29,10,20,7,5,0,2,2,5,3,5,0,12,2,0,0,43,5,0,1,8,1,0,0,0,4,6,0,2,1,5,5,7,27,34,11,67,16,1,0,0,0,7,5,7,5,5,1,2,0,7,0,27,23,10,7,4,1,9,1,1,2,3,29,3,9,10,7,1,0,4,7,2,1,8,0,3,0,0,2,2,3,8,2,0,3,0,0,4,0,18,1,2,1,78,180,0,0,3,0,1,30,5,2,3,4,45,0,5,18,7,8,1,2,14,2,2,1,1,26,1,4,1,5,0,0,1,3,4,16,6,5,7,25,7,3,0,1,6,3,3,1,14,22,1,0,0,3,14,3,0,8,5,9,1,0,3,38,5,3,7,2,7,2,5,11,18,1,1,10,5,3,21,12,7,9,82,0,4,2,11,9,4,78,2,17,2,5,5,0,3,3,8,0,4,12,15,18,5,3,0,1,2,1,15,2,2,0,3,11,11,9,5,27,28,3,0,6,10,0,8,2,4,4,5,5,3,30,9,1,1,4,0,17,15,16,11,12,1,0,0,24,4,6,12,0,0,9,4,109,6,11,6,34,0,4,4,2,0,52,34,3,0,10,0,1,2,0,2,0,0,7,1,11,8,5,21,0,11,3,4,7,12,2,14,25,5,9,9,6,11,2,1,4,8,5,18,3,1,16,10,0,26,4,0,2,3,5,17,5,22,5,3,4,0,80,5,16,13,18,3,4,3,8,7,0,2,16,1,0,11,1,0,12,4,8,15,3,10,3,27,7,6,6,10,2,4,4,6,0,33,9,0,7,1,140,125,244,161,11,2,4,8,91,81,21,23,57,7,45,5,1,4,7,0,0,2,4,5,7,12,3,2,12,0,1,7,0,5,1,2,1,11,7,0,2,2,6,17,6,5,13,8,1,5,2,9,8,2,3,2,8,13,3,39,1,1,16,2,3,6,4,0,14,0,45,0,7,12,0,3,10,3,5,44,52,4,0,0,3,5,8,2,7,2,0,0,3,8,26,5,0,5,3,2,12,2,13,0,2,0,11,0,3,1,0,2,5,1,4,0,0,1,10,24,3,19,7,4,6,0,2,6,3,0,13,1,3,8,2,7,4,2,5,0,5,1,2,0,0,2,0,11,3,3,1,8,2,0,10,0,0,24,7,2,69,4,85,6,12,3,0,7,13,2,0,6,5,3,3,1,1,3,3,2,1,3,9,6,41,7,19,0,8,7,2,1,59,72,58,24,304,217,1,8,0,2,6,14,44,18,0,36,0,60,1,6,8,4,10,9,43,0,1,0,0,10,2,2,1,5,2,7,0,33,1,10,30,1,12,4,5,0,0,0,4,17,5,7,10,1,30,0,0
the public debt,0,4,5,76,0,0,1,14,1,0,3,0,2,18,3,5,2,5,1,2,1,21,3,4,4,3,1,4,0,15,2,82,34,1,21,21,16,18,14,0,15,2,0,3,20,2,17,11,67,0,15,0,3,4,0,0,43,22,0,8,9,2,0,8,9,1,31,6,0,0,79,1,3,0,19,3,5,4,44,7,51,0,7,1,123,24,11,0,70,15,7,0,2,44,148,15,4,5,27,5,5,16,29,2,2,11,32,0,15,7,25,0,10,7,2,18,3,2,44,40,22,2,19,157,4,1,1,2,8,3,5,1,1,19,5,7,0,1,1,1,0,3,37,6,0,21,1,7,8,31,10,0,7,7,1,7,5,1,3,0,4,2,7,6,8,0,0,4,5,5,2,20,2,0,0,2,84,0,2,9,9,2,3,2,2,2,17,9,6,18,1,0,0,1,1,3,2,1,9,1,2,5,4,2,5,0,2,10,4,8,10,0,8,8,1,0,4,10,5,0,59,3,4,1,27,27,20,27,9,20,3,26,58,4,25,88,18,1,1,0,34,7,2,0,0,4,3,4,30,4,4,14,7,51,8,9,1,13,8,5,0,0,3,4,4,17,2,0,5,2,97,37,197,2,0,0,1,89,9,0,14,2,0,1,5,0,1,1,4,2,1,0,6,22,10,3,27,6,0,1,8,27,2,19,3,2,5,3,2,0,1,1,24,2,90,6,3,13,10,1,20,1,7,0,3,0,1,6,2,9,0,6,1,2,2,5,3,0,22,22,2,0,12,4,8,3,16,18,11,0,56,13,1,11,2,0,1,0,9,84,5,1,2,8,3,0,10,1,8,1,1,9,1,2,1,6,1,2,2,27,58,0,26,0,0,16,0,12,55,1,3,1,0,2,17,1,27,3,6,0,6,0,4,0,6,1,0,0,5,3,0,1,8,4,0,0,4,0,0,0,2,2,2,0,0,3,1,1,0,7,40,44,35,35,0,1,0,2,6,5,1,3,2,2,0,0,0,0,7,19,13,1,0,6,10,1,0,1,1,21,4,10,15,4,0,0,0,4,2,0,2,1,0,0,0,2,1,1,3,6,1,4,0,2,2,1,12,0,0,1,39,54,0,0,4,1,2,24,3,5,12,0,8,0,0,17,2,7,1,0,10,1,0,0,9,5,1,9,0,3,0,3,3,3,3,2,3,0,5,23,5,0,0,1,7,3,1,2,15,13,2,0,0,0,8,2,3,11,11,1,5,2,0,49,0,4,12,1,3,1,15,4,11,3,5,9,8,0,19,16,11,4,13,0,0,0,9,3,3,75,5,9,1,3,0,0,3,6,4,4,2,16,2,0,7,1,1,0,9,2,4,0,2,2,0,10,8,8,1,6,11,3,0,2,1,5,36,0,2,4,5,5,6,18,3,10,0,6,4,3,4,4,11,12,0,2,0,13,0,8,9,0,2,1,4,45,0,2,2,33,0,1,1,0,1,15,10,0,0,9,7,1,2,0,6,0,1,4,2,9,8,7,18,0,4,1,0,4,4,1,5,6,2,0,1,32,9,0,1,2,2,8,15,1,1,5,10,0,8,9,0,1,3,0,6,1,17,1,2,3,0,31,7,14,16,7,0,2,4,0,4,0,0,11,1,1,9,1,2,2,3,15,8,2,3,0,9,0,6,4,6,1,0,0,1,1,14,0,3,1,0,63,38,86,64,12,4,6,1,37,33,9,11,15,0,12,2,0,6,2,2,0,0,2,3,1,4,0,7,11,0,0,4,23,3,2,4,5,9,8,2,2,1,3,0,9,0,0,6,1,0,11,7,3,0,3,5,2,5,4,13,0,0,2,3,4,2,1,1,10,1,1,0,2,0,0,0,5,4,6,48,13,6,1,3,0,1,8,2,1,3,0,0,0,1,19,2,0,1,0,0,7,1,13,0,1,2,14,2,1,3,3,0,3,0,0,0,0,0,5,1,0,40,7,2,1,1,1,2,0,2,6,0,1,5,6,4,3,0,2,0,1,0,0,3,3,3,0,5,0,7,0,5,1,0,10,0,2,22,8,1,28,3,77,1,18,1,2,0,1,4,1,1,5,0,3,0,0,4,6,3,1,1,1,1,8,1,12,0,3,1,12,59,1,26,81,42,87,221,1,0,0,0,0,8,58,0,0,25,1,0,3,3,0,8,1,1,12,0,1,0,0,5,0,5,0,2,3,5,1,0,2,5,2,2,12,2,1,0,1,2,0,9,0,0,3,0,6,0,0
surplus,0,4,0,65,0,5,3,15,0,1,0,1,14,16,1,3,1,23,1,0,4,27,10,10,6,8,5,2,5,10,4,143,77,4,36,57,8,40,39,0,7,3,1,15,18,5,24,14,98,10,27,6,16,17,4,0,46,26,6,8,7,2,3,6,17,9,86,6,3,9,72,1,5,1,69,7,12,1,59,16,79,1,10,4,177,46,29,3,51,4,9,1,10,36,71,18,25,10,46,18,4,38,27,8,12,33,43,8,24,6,20,4,25,18,11,30,6,9,36,125,28,4,43,155,11,3,2,2,4,5,7,1,7,31,8,17,1,8,3,1,3,26,22,10,1,43,2,13,22,23,14,3,16,9,1,22,14,3,2,7,19,4,16,9,59,5,6,7,13,8,15,34,11,1,2,6,109,2,9,39,17,2,16,15,7,17,41,14,7,31,0,7,30,4,9,3,10,7,13,7,51,7,5,8,18,6,10,21,10,16,30,3,16,14,3,3,21,42,15,3,31,10,3,14,44,39,46,40,7,69,6,25,64,9,38,161,20,8,26,4,47,30,6,0,10,12,5,18,42,7,4,44,6,15,17,16,11,7,7,16,0,6,13,1,12,60,5,0,8,6,87,59,95,1,3,4,11,120,5,5,41,4,9,15,6,2,2,8,8,4,1,2,9,20,13,11,17,3,4,12,18,22,11,16,22,21,16,3,0,0,6,3,43,8,85,36,9,39,27,7,14,5,18,7,9,0,21,11,1,6,3,9,3,4,12,9,10,1,20,13,10,5,18,13,3,1,38,16,16,9,46,8,6,46,6,10,2,0,5,68,19,6,7,18,5,0,18,0,3,10,2,13,7,7,7,22,2,4,8,32,59,1,55,1,1,25,2,14,63,0,4,7,4,2,21,7,34,1,21,6,5,0,3,0,5,9,15,0,22,9,2,8,14,8,1,4,3,5,1,0,0,2,6,3,0,8,3,4,4,19,11,7,10,17,1,0,0,0,4,9,8,5,2,12,0,3,2,3,22,13,33,3,9,5,9,4,0,9,2,30,8,4,16,8,8,0,24,8,2,0,9,3,1,2,0,3,2,2,17,7,0,11,1,0,2,4,13,2,1,0,38,44,1,1,16,3,3,23,1,6,3,8,4,2,0,43,35,19,6,5,15,2,7,4,5,11,6,9,6,12,1,35,2,11,4,2,14,12,2,27,10,1,0,10,2,9,4,0,28,12,0,1,1,28,36,0,1,20,10,10,11,1,2,18,7,7,13,4,12,1,10,0,9,5,5,17,4,6,31,20,19,8,28,0,10,0,19,3,11,37,14,9,7,12,3,1,5,7,11,4,12,17,10,7,20,6,4,5,10,6,7,2,5,0,1,22,13,6,5,33,21,7,3,3,15,6,18,7,5,1,10,14,2,9,2,4,1,14,6,28,10,12,14,8,7,1,7,9,3,12,2,0,1,12,2,38,6,1,9,32,0,4,2,3,0,23,40,4,2,15,3,0,7,2,2,0,0,5,6,7,12,1,3,1,15,7,1,6,5,1,9,23,10,1,1,7,10,4,3,0,4,3,15,1,4,9,3,3,3,10,7,4,5,2,7,5,12,3,1,1,1,25,8,15,12,1,0,5,1,2,4,0,0,2,1,3,11,0,1,12,4,13,17,10,13,14,5,2,2,4,5,6,0,7,1,0,13,10,4,6,5,94,64,82,64,9,5,12,3,42,45,22,18,28,17,7,7,2,28,3,6,7,2,1,3,5,19,0,9,5,6,2,9,8,4,5,3,0,13,5,4,3,1,4,8,16,1,2,3,1,11,4,13,4,5,0,4,4,17,0,27,1,8,9,5,1,4,7,5,7,1,6,0,14,1,3,3,5,2,11,12,20,7,1,4,9,3,9,1,5,0,2,0,1,13,17,14,2,3,1,4,17,1,4,3,8,4,26,0,3,5,1,2,1,0,3,3,0,5,9,5,10,54,9,3,4,0,2,1,2,5,13,2,3,7,7,3,2,1,1,0,4,4,1,4,3,1,0,5,0,9,0,0,6,0,9,1,7,21,11,8,17,2,36,3,8,4,1,1,12,3,5,7,17,0,1,0,2,3,25,4,3,7,3,1,19,5,8,1,11,7,11,72,26,1,49,44,113,145,4,0,3,2,2,6,7,7,1,18,11,2,1,2,3,4,8,2,5,2,1,0,0,2,0,0,0,2,1,1,1,13,2,4,3,10,24,4,6,0,0,1,5,10,1,0,23,2,10,1,0
payment,11,21,2,215,7,6,4,26,4,3,27,3,13,65,4,3,9,32,5,0,8,55,7,24,28,26,4,11,2,28,5,373,151,6,67,78,29,45,24,5,28,6,1,9,41,25,52,14,394,7,66,8,19,25,4,1,102,45,2,10,24,9,2,20,19,8,121,8,6,10,108,1,3,6,80,18,25,11,141,25,100,4,27,2,417,80,28,0,110,19,38,8,8,92,202,32,13,13,54,24,17,50,58,19,15,35,34,6,39,16,34,17,18,33,11,67,27,6,115,213,53,15,32,185,8,10,4,6,14,5,18,2,6,63,26,32,13,8,9,6,2,36,55,6,4,74,5,15,33,47,75,3,40,12,4,23,22,9,6,11,28,9,14,13,36,7,6,22,30,16,24,107,30,1,9,15,244,0,16,28,41,21,19,11,11,37,42,35,32,90,0,6,8,2,3,19,34,6,29,17,53,7,11,16,44,2,20,51,26,20,77,6,38,16,2,2,19,9,18,5,82,28,10,14,108,168,27,55,20,73,13,49,46,16,72,103,59,8,15,11,100,33,4,9,13,25,10,29,108,9,33,49,11,45,23,25,22,14,12,22,12,23,35,12,7,96,3,2,9,5,194,48,266,9,6,3,24,68,24,3,68,5,2,31,18,2,10,14,17,2,7,6,42,25,13,27,139,8,8,22,35,82,18,19,22,4,34,5,2,1,7,20,65,9,229,45,35,54,33,4,94,4,22,5,35,4,7,28,3,46,1,27,13,6,10,19,15,12,35,37,18,7,20,17,12,3,64,57,21,20,48,11,5,73,31,15,2,1,26,74,41,4,4,37,7,1,61,7,11,9,8,31,12,19,9,43,14,12,12,31,88,0,61,15,2,48,9,44,73,5,32,3,6,13,43,17,96,8,36,4,22,2,8,0,14,13,12,3,47,15,2,13,19,7,11,9,11,6,3,1,6,11,11,7,3,3,1,15,17,40,116,47,42,29,2,5,0,10,6,8,18,14,7,19,0,3,15,7,44,35,38,8,8,14,44,5,0,17,13,44,14,28,37,11,4,0,24,14,8,1,5,8,2,1,0,20,4,3,28,9,5,14,3,8,11,18,26,4,4,2,92,67,2,2,23,11,3,124,13,27,17,6,12,6,19,132,9,38,27,8,12,13,9,6,11,33,10,7,0,12,3,11,15,15,14,12,40,9,29,49,14,3,1,15,19,22,8,7,66,53,7,8,8,13,22,12,7,45,21,12,34,9,7,64,2,21,29,6,14,7,36,17,46,5,18,21,19,4,61,53,20,13,57,5,6,8,14,7,11,65,16,35,10,17,8,6,6,10,17,11,15,35,42,12,25,0,12,8,78,16,20,5,8,7,13,36,15,28,12,29,37,17,13,10,49,14,29,11,5,15,32,60,8,87,12,4,8,12,7,36,146,28,27,27,6,7,12,18,4,15,26,0,6,15,12,77,13,21,7,255,7,5,10,1,4,21,74,13,16,43,8,2,61,9,18,8,10,22,14,37,17,4,91,14,130,4,1,17,11,6,19,35,22,6,17,44,46,2,7,6,35,13,29,11,18,14,23,9,18,18,25,8,9,4,14,9,32,6,16,8,1,52,11,37,18,27,19,8,15,1,11,5,2,36,4,7,18,1,5,12,12,25,25,9,12,9,27,9,22,6,13,4,1,10,11,13,36,6,21,19,12,81,48,70,40,21,5,21,5,59,69,19,20,23,15,54,7,16,10,26,7,1,0,17,2,19,30,4,11,19,9,8,14,23,6,4,21,14,34,28,11,10,4,6,13,29,9,11,10,5,10,15,20,6,6,3,13,12,37,9,36,1,18,19,7,5,10,10,12,36,9,10,0,18,3,5,2,12,55,7,70,19,25,10,11,7,9,37,21,12,6,5,0,10,12,46,12,15,10,14,26,30,11,23,0,11,11,27,8,9,25,6,12,7,18,16,4,2,2,22,13,4,71,91,8,12,1,17,11,3,35,29,5,9,25,16,17,13,4,12,3,6,4,3,14,34,6,0,16,1,23,8,8,9,0,9,9,59,25,26,11,40,6,121,17,20,5,4,4,6,14,19,14,16,5,16,1,21,14,44,2,2,20,18,7,21,11,12,4,9,2,25,58,81,49,1,116,66,277,8,0,2,2,7,17,56,11,3,63,8,7,3,3,25,7,22,15,42,2,4,1,8,5,6,16,2,5,11,20,3,24,4,26,101,9,19,9,7,27,2,2,4,10,5,1,12,8,13,0,0
debt,0,9,1,151,12,12,1,23,2,6,26,4,14,85,5,6,9,22,3,0,13,25,19,38,14,18,7,6,1,18,7,198,138,7,51,115,29,21,21,5,37,5,0,5,49,21,26,15,222,22,37,3,35,29,17,0,26,27,6,9,8,12,4,13,21,11,132,11,5,3,78,3,10,2,91,26,34,8,110,24,83,5,19,9,295,55,16,3,63,18,10,4,8,52,167,17,24,13,44,21,5,56,53,15,9,17,68,21,27,11,25,4,41,37,9,49,13,20,70,186,33,21,77,209,13,8,3,7,6,6,21,3,5,43,27,32,1,4,7,7,2,28,34,5,5,46,6,10,30,28,54,14,47,20,8,41,30,11,7,23,25,4,23,12,35,7,2,12,22,5,10,91,16,2,20,9,177,9,20,37,11,11,6,8,5,19,40,22,24,53,2,10,14,4,5,5,17,3,12,34,31,21,12,11,21,7,12,43,12,42,63,3,15,9,3,12,24,28,9,1,34,24,9,12,76,65,28,58,8,55,11,23,66,20,62,40,35,9,8,7,99,36,10,9,25,27,3,37,56,13,14,24,17,25,23,35,5,15,8,15,0,18,17,4,8,24,5,14,24,8,185,47,133,7,2,0,15,53,7,4,58,2,1,8,21,2,6,8,17,3,0,1,17,36,10,12,50,5,8,26,27,31,9,16,11,10,35,1,3,5,1,10,39,6,191,24,39,37,25,3,66,10,29,1,16,5,15,29,1,44,2,22,3,4,10,16,11,6,21,29,20,6,29,14,6,0,44,32,18,9,42,11,4,34,20,3,4,0,19,76,30,8,6,21,6,3,64,6,9,19,3,12,7,11,7,15,4,4,11,19,63,1,57,6,0,23,10,21,34,8,16,3,4,3,38,7,47,1,17,4,13,1,9,0,11,16,8,3,24,9,2,3,10,4,10,12,9,0,4,3,4,6,10,3,1,2,5,16,6,32,36,28,14,27,1,3,0,8,8,5,11,3,14,16,0,2,10,7,39,25,47,3,3,24,64,2,0,12,4,31,10,11,29,18,3,0,14,4,4,2,26,10,1,1,0,11,5,3,26,8,9,17,4,1,9,10,18,3,2,10,107,50,0,8,22,4,1,69,5,12,23,11,20,5,4,64,10,24,11,4,14,7,9,2,17,8,5,13,1,19,1,23,11,10,11,2,23,19,13,29,17,6,4,9,9,6,11,5,75,45,0,2,4,10,17,14,11,20,12,11,31,2,7,65,3,14,16,12,14,4,20,4,37,5,18,41,14,10,24,39,14,5,27,3,5,9,5,11,19,27,3,11,13,15,15,6,4,11,4,7,15,31,11,4,30,12,11,3,21,13,30,0,5,2,6,18,10,15,10,15,18,10,6,7,27,3,36,2,10,7,13,22,5,29,5,6,1,13,14,22,62,15,27,22,0,2,15,11,9,9,23,2,5,15,8,28,2,3,4,113,4,8,4,4,1,15,30,13,8,14,8,0,18,10,6,2,5,4,10,10,14,7,10,9,17,4,2,7,1,2,12,22,12,7,13,47,54,6,2,2,8,7,11,12,4,3,14,1,12,13,13,5,2,3,12,7,24,4,7,2,5,13,22,20,17,12,2,3,6,3,5,4,0,11,0,3,8,0,1,7,5,17,13,12,4,7,8,7,11,12,8,6,1,1,6,13,25,6,8,10,12,39,21,31,25,15,14,7,5,40,48,19,10,11,21,49,2,5,8,15,7,2,4,12,7,30,50,13,2,13,0,0,17,22,12,6,8,6,19,22,16,5,4,13,20,25,4,1,6,3,8,3,12,11,9,1,19,32,8,2,19,3,2,8,5,2,7,17,5,26,5,4,1,1,0,8,4,7,18,12,19,15,19,4,5,6,2,23,20,3,3,6,0,8,1,67,14,7,1,9,9,24,13,10,1,5,6,34,5,7,13,5,5,3,2,0,1,0,7,6,2,2,40,56,8,5,0,6,3,1,3,4,1,7,7,7,5,7,0,10,2,2,15,5,4,6,1,0,11,3,14,1,5,18,1,7,5,23,11,17,3,48,6,61,12,8,2,3,2,4,8,8,7,7,0,5,5,3,6,12,8,4,6,11,2,6,2,11,5,9,5,25,24,42,44,116,1,68,139,0,0,5,2,5,6,26,0,3,26,4,0,1,1,2,8,10,1,3,0,2,0,5,9,5,6,0,11,11,3,5,1,3,6,39,6,37,7,6,7,1,0,1,9,3,0,38,1,19,1,2
estimate,1,11,1,259,6,5,1,21,0,4,12,3,23,49,9,3,0,15,4,3,3,28,3,28,17,28,4,25,9,41,15,361,118,8,55,35,22,27,37,11,11,0,0,14,39,5,29,46,245,6,41,2,12,22,7,2,82,129,2,20,6,4,2,25,28,1,57,10,22,26,238,28,2,6,57,4,20,7,97,15,244,2,19,6,230,34,31,7,144,23,39,3,19,113,94,17,29,15,54,12,47,50,73,2,15,29,78,19,75,36,55,0,27,10,4,59,15,5,90,168,29,6,56,552,19,5,2,3,21,18,11,1,1,75,9,76,1,5,4,12,5,35,58,14,5,53,2,11,42,80,23,0,13,12,5,36,32,9,0,7,59,5,15,15,137,10,11,20,14,7,43,92,12,0,2,8,165,2,6,37,22,5,31,10,10,10,49,16,8,65,4,3,13,1,14,8,26,17,39,4,36,8,3,6,21,4,6,29,6,30,53,5,21,12,1,4,45,70,46,17,101,12,11,14,138,103,118,84,31,219,13,133,140,15,44,199,35,11,24,12,61,39,10,1,7,23,6,16,85,7,13,26,13,127,51,15,7,14,27,62,8,28,68,3,19,227,8,1,7,5,205,65,395,7,8,1,7,404,16,3,39,5,16,5,13,16,20,12,7,3,4,2,17,144,22,16,40,15,7,8,14,67,74,14,27,1,11,5,6,3,4,10,60,2,92,49,14,50,14,4,15,10,21,9,8,1,7,22,3,18,0,16,5,2,13,17,6,11,23,42,12,6,16,11,8,5,78,46,20,9,56,14,3,21,18,10,6,5,15,317,39,11,7,8,5,0,22,7,4,10,7,39,10,3,11,95,9,4,6,57,79,3,114,2,1,58,1,14,157,0,4,2,12,1,47,4,47,17,41,6,17,7,3,0,12,11,7,1,14,11,2,12,5,14,2,6,7,8,2,2,2,5,15,3,0,4,3,8,9,48,42,101,109,25,0,0,0,3,13,8,15,11,10,21,2,7,24,1,46,25,10,8,1,2,70,5,0,8,7,41,15,13,22,33,4,0,13,10,10,0,19,1,4,8,3,4,4,6,25,3,6,22,4,2,6,3,13,3,2,6,217,178,1,3,8,7,10,60,11,1,48,9,27,4,9,28,15,12,6,1,17,3,5,4,17,30,1,6,1,4,3,26,6,5,4,8,8,17,13,51,13,1,3,2,15,6,19,3,20,36,3,5,6,16,24,7,3,17,33,6,11,0,5,78,10,7,16,5,11,6,12,13,31,7,7,12,20,12,56,28,24,18,182,1,10,2,7,14,2,179,11,20,12,5,6,1,9,15,24,8,13,10,13,24,12,4,2,6,18,11,31,9,1,1,4,22,9,15,8,13,29,14,5,5,12,23,42,3,5,13,11,4,7,28,14,4,6,19,3,20,13,27,21,32,15,0,0,72,5,12,11,5,8,21,8,191,17,3,11,146,15,4,5,2,2,33,51,3,1,12,5,1,2,6,4,1,0,8,14,12,30,11,79,7,13,8,5,18,37,19,58,45,12,21,19,31,16,4,26,45,9,4,19,42,7,33,12,1,33,29,6,13,2,5,14,26,49,5,3,12,2,89,3,44,27,39,8,3,6,12,7,3,2,30,0,1,33,1,1,13,8,30,3,2,3,13,98,13,60,27,8,9,15,22,15,2,47,7,3,5,3,237,216,329,251,19,7,19,7,86,74,24,24,78,23,44,16,7,28,7,4,0,1,16,20,25,15,6,17,20,5,3,12,27,12,8,4,28,23,10,11,6,1,14,14,26,6,27,15,0,19,9,41,6,1,2,6,7,14,7,23,3,5,15,7,3,3,4,4,20,2,15,2,36,42,6,4,14,2,15,56,93,14,0,3,16,12,26,16,12,5,1,3,2,11,28,10,1,7,1,4,13,2,30,6,9,7,30,1,7,2,2,2,3,2,6,1,5,9,19,42,5,20,6,8,8,0,3,12,7,1,17,9,4,23,8,11,16,5,11,1,36,0,5,4,9,9,1,19,3,3,1,9,4,0,19,0,4,43,22,2,82,7,169,15,44,2,7,5,46,4,6,10,10,3,10,9,0,5,28,7,3,8,15,6,36,6,47,4,40,8,8,304,87,113,66,68,1,438,3,9,1,5,14,29,110,77,18,57,1,37,18,9,6,11,41,19,26,0,3,5,3,6,5,7,2,18,7,10,3,30,7,19,9,3,10,10,8,3,0,1,10,15,3,0,18,4,53,1,0
treasury,0,48,12,465,4,8,4,43,8,6,8,10,26,57,5,7,9,77,2,5,22,152,6,60,24,26,4,46,14,111,15,660,239,16,106,92,44,125,62,3,32,4,8,10,68,15,115,41,623,4,110,2,25,29,2,2,250,257,4,18,45,8,6,42,55,4,244,17,14,13,368,18,16,5,132,26,25,15,260,37,246,6,25,13,792,196,68,1,313,29,56,4,4,199,280,54,31,23,109,24,30,90,112,25,21,93,87,4,70,29,106,20,50,67,4,78,38,25,248,468,88,16,81,585,21,12,8,6,28,7,18,2,5,107,45,72,2,7,11,7,5,53,137,24,2,144,13,20,72,112,110,2,73,41,11,51,50,12,1,7,47,4,19,34,38,11,10,27,42,29,29,150,38,2,13,15,525,8,15,99,71,11,2,21,7,33,91,35,50,111,11,9,16,1,6,18,99,10,45,31,91,23,10,25,84,19,50,101,34,55,171,10,72,32,1,5,34,18,64,12,277,21,23,31,199,364,109,124,38,100,19,117,133,69,96,334,96,15,14,11,216,85,14,2,21,30,19,91,188,20,54,78,26,193,47,65,40,41,36,37,10,28,99,26,42,358,5,2,24,18,404,170,714,12,15,0,33,324,54,12,114,23,5,20,22,3,4,15,34,4,22,4,65,116,42,46,200,16,29,21,48,141,32,44,49,2,30,12,6,2,4,53,160,14,327,136,29,110,44,11,53,16,50,3,47,8,13,42,18,83,2,44,9,15,17,27,27,12,65,77,28,14,54,13,24,7,160,93,53,2,105,26,19,154,45,12,7,6,46,306,63,8,16,65,9,0,120,10,4,25,8,62,16,16,19,108,18,17,16,100,180,2,159,8,1,109,7,86,231,9,27,3,36,8,87,47,178,63,76,14,54,11,3,0,33,21,18,0,56,16,0,5,25,32,3,13,21,13,4,0,8,24,33,16,2,8,7,26,18,48,415,203,144,75,4,4,0,6,6,5,25,38,10,13,0,0,19,6,105,72,52,24,4,34,93,12,0,15,32,84,28,42,59,22,11,5,26,10,8,1,15,4,9,2,9,11,4,45,52,12,10,25,1,6,16,9,51,8,5,6,140,249,0,4,27,16,3,108,41,24,51,15,26,4,15,255,12,46,19,8,35,11,17,18,38,71,14,20,2,19,2,24,24,41,28,15,47,27,56,99,32,8,0,27,25,41,38,7,87,89,9,1,6,10,52,9,4,65,43,32,76,18,19,152,4,42,59,22,23,25,86,21,100,10,39,64,49,8,108,77,74,44,176,18,17,18,50,16,10,243,19,75,29,25,24,9,11,30,18,13,36,76,23,20,32,5,14,4,44,42,45,2,16,7,8,84,19,68,14,62,73,28,26,10,56,41,89,6,25,21,84,147,20,289,35,16,9,38,14,67,282,79,70,61,11,16,19,49,8,45,22,2,15,47,9,484,12,15,18,342,11,8,23,20,10,55,170,11,12,47,24,2,20,16,12,4,1,20,38,48,52,26,65,41,69,24,13,36,23,13,33,46,25,23,45,60,39,10,7,16,20,19,76,24,21,31,32,1,50,57,7,15,17,8,43,29,58,11,30,25,4,161,21,80,61,33,5,16,7,27,21,5,2,82,2,3,35,4,3,31,32,76,51,21,14,12,48,18,24,14,21,9,8,13,7,24,103,9,18,12,17,369,183,279,180,48,19,29,11,185,170,37,80,109,38,79,20,9,12,15,9,2,10,31,17,27,61,19,20,41,6,18,23,74,21,16,41,17,59,56,3,22,10,21,26,46,10,20,19,12,19,37,30,12,8,3,34,21,34,16,48,8,23,40,16,8,16,15,34,41,5,35,2,36,11,20,4,31,66,26,130,61,36,4,7,19,14,58,7,15,18,18,6,13,40,48,43,7,27,5,8,89,8,69,5,39,17,84,7,10,18,8,43,6,17,23,3,11,12,52,17,12,207,127,18,13,2,7,28,0,11,46,13,7,25,19,18,26,9,45,1,14,2,7,11,17,5,8,39,0,36,2,10,11,7,34,5,89,85,46,34,200,15,318,18,92,8,7,4,14,26,4,25,31,9,19,0,3,7,137,21,5,11,21,13,61,33,46,7,38,7,37,217,221,145,277,139,438,1,5,5,10,6,34,39,262,12,2,171,12,14,2,21,13,20,23,22,22,4,1,1,7,10,5,22,5,2,49,25,2,28,5,36,148,12,52,11,8,12,1,1,6,30,0,1,33,3,24,0,0
satisfaction,2,27,4,58,2,1,2,8,4,1,17,3,2,22,3,8,0,0,2,2,10,22,3,9,9,1,1,4,0,6,5,72,44,3,14,15,14,3,1,2,2,2,2,2,14,4,9,2,128,4,12,0,8,6,2,5,24,17,0,9,5,8,2,7,4,1,24,2,1,4,2,4,1,3,15,7,6,3,40,11,13,1,8,0,90,9,3,0,16,0,3,0,0,16,18,2,3,2,13,4,5,12,24,5,10,11,4,1,4,0,2,3,3,5,0,18,5,2,35,47,8,10,1,17,5,2,1,4,1,0,3,1,1,23,8,15,5,1,1,5,0,13,11,0,2,27,2,4,1,3,28,0,13,2,3,6,12,3,2,1,4,1,7,2,0,0,1,4,10,8,3,30,2,1,0,5,78,1,1,10,17,7,1,3,3,6,11,8,14,25,0,3,2,0,1,1,2,0,6,3,4,0,0,6,11,0,1,11,7,7,37,1,9,2,0,0,0,1,4,0,0,4,3,1,26,24,9,10,0,1,3,6,1,3,13,5,19,4,2,3,22,18,3,0,2,3,5,6,21,1,6,14,15,4,4,11,13,0,5,5,0,11,10,2,3,2,3,2,2,6,44,5,11,3,4,0,5,2,13,0,11,5,0,9,2,0,0,0,7,1,0,3,7,1,2,3,27,1,3,9,8,7,2,1,3,0,12,0,1,1,0,1,16,0,13,7,3,20,3,3,45,3,13,0,19,2,5,15,6,8,0,2,5,2,5,18,5,3,2,11,4,6,3,6,2,1,8,31,5,1,7,6,8,3,6,0,1,2,7,9,5,6,1,4,5,2,15,4,2,5,0,5,1,9,2,6,4,0,10,4,42,0,20,2,1,12,2,21,3,1,14,1,3,6,13,3,34,1,20,2,5,0,1,2,4,2,6,2,8,6,0,0,5,4,3,6,2,4,1,1,1,1,5,5,0,3,4,12,6,3,9,3,1,6,2,8,0,10,3,3,8,11,1,8,0,1,1,4,12,2,4,4,0,0,18,3,0,8,1,18,2,5,10,4,2,1,4,9,8,0,9,0,2,0,0,2,2,4,2,2,1,10,1,6,5,8,3,5,1,1,25,26,1,0,5,4,0,8,7,2,1,2,1,0,1,8,1,8,2,4,0,2,6,1,5,5,2,4,1,4,1,17,5,2,9,3,9,1,11,8,4,2,7,1,4,1,10,1,10,8,4,2,0,2,4,9,3,14,15,1,7,6,4,22,0,1,17,0,2,3,14,0,12,0,7,7,12,2,16,16,4,4,7,2,2,8,2,3,4,2,1,5,2,5,4,0,1,5,2,1,8,18,7,1,10,1,1,5,40,9,13,0,3,4,6,8,5,8,4,1,8,13,3,2,29,2,11,0,2,3,8,0,0,4,0,5,3,5,9,9,2,6,9,5,4,1,4,3,1,9,4,0,1,7,10,5,4,4,1,96,10,2,1,2,3,9,8,2,6,6,3,2,19,11,7,5,0,5,6,4,10,3,13,21,47,1,2,9,1,3,1,20,16,4,3,5,5,1,1,2,8,9,7,2,10,6,3,3,5,5,13,2,6,4,2,2,13,1,2,4,3,1,0,18,5,6,5,7,6,2,5,2,4,7,1,1,6,0,0,4,1,5,1,3,6,1,9,3,8,1,3,3,2,8,4,0,7,2,5,9,5,4,0,6,1,3,2,7,2,5,4,11,3,0,7,3,2,9,0,9,1,1,0,4,1,3,1,2,6,5,0,1,3,2,3,2,2,0,7,12,2,1,0,4,3,3,2,6,3,0,5,2,5,1,2,2,2,6,6,3,4,3,11,6,2,2,3,9,2,5,2,0,7,5,4,3,0,11,1,2,3,4,5,1,3,5,8,15,0,7,13,5,0,2,4,1,4,2,5,11,26,21,4,2,0,1,4,4,0,2,8,6,8,2,0,3,4,2,1,4,3,2,0,4,2,0,5,14,7,1,15,10,1,4,14,5,1,3,1,6,2,11,1,7,13,2,3,1,2,0,0,7,0,3,0,2,2,5,4,15,0,1,2,12,7,2,0,8,1,3,4,11,2,3,3,5,7,24,11,1,2,3,4,8,8,2,0,2,2,2,1,9,1,1,4,8,0,3,5,1,0,4,1,0,0,2,2,0,10,15,6,2,1,1,0,13,0,3,0,1,8,4,0,2,15,10,6,4,1,5,0,3,2,1,3,1,1,1,10,1,4,0,2,0,0,0,1,10,0,0
corp,7,7,4,54,5,1,3,5,0,1,1,4,8,11,0,0,4,4,1,1,0,11,0,4,1,4,2,12,2,4,5,63,31,21,33,24,33,2,0,6,2,7,0,1,16,11,11,23,37,13,10,3,0,10,7,0,21,24,5,11,2,0,1,6,6,0,16,4,0,17,11,9,2,1,28,3,18,1,25,1,46,0,1,2,24,4,13,0,23,1,1,1,3,11,5,1,4,4,6,0,15,25,7,0,2,16,8,3,9,2,10,4,9,6,7,5,0,1,39,56,11,7,0,43,8,0,2,6,1,0,5,2,2,49,4,48,0,8,0,1,0,8,14,3,0,19,4,3,12,4,7,3,5,4,1,0,4,0,1,16,4,0,1,5,3,5,14,7,7,0,10,33,1,2,0,6,28,3,0,43,15,0,5,15,6,2,13,3,3,29,0,3,2,0,2,3,17,5,15,0,0,0,0,4,8,3,1,10,0,2,26,3,7,0,3,1,0,1,12,9,1,1,5,12,14,22,15,15,16,4,12,16,9,4,2,1,10,4,2,3,25,4,0,1,0,2,2,7,36,0,5,1,1,8,10,4,12,4,0,50,0,23,14,6,1,59,9,3,1,0,35,7,11,2,5,0,4,5,4,0,21,0,2,4,1,3,7,6,0,0,6,0,18,5,4,3,8,0,0,6,5,30,3,0,0,0,2,4,1,0,2,9,16,2,20,6,5,22,1,7,3,0,7,6,4,1,3,16,3,8,3,4,3,0,0,3,2,3,0,6,0,3,7,1,0,6,12,25,6,1,2,1,2,10,3,5,1,2,4,8,5,15,2,0,0,4,9,2,2,7,2,9,2,6,0,93,14,3,4,3,4,2,18,0,4,12,1,7,14,1,0,3,1,2,16,3,10,6,9,0,0,2,1,0,2,3,1,0,2,5,1,3,3,19,2,2,0,1,1,0,1,2,3,0,1,0,3,3,6,4,0,3,6,13,9,0,0,0,8,4,17,2,2,2,0,3,2,2,4,4,2,0,2,1,12,4,0,0,4,26,4,15,11,52,12,5,8,3,13,0,11,0,0,4,2,4,0,4,10,2,1,9,1,0,1,0,2,0,1,6,61,12,0,2,5,1,2,0,1,1,6,6,2,0,11,0,1,2,10,0,2,2,3,0,9,9,0,3,0,6,0,1,0,3,0,1,4,1,2,7,7,0,1,4,3,3,5,1,9,4,0,1,1,0,1,6,0,6,1,2,1,6,1,7,20,2,1,1,0,1,12,7,11,6,1,8,3,1,6,3,5,3,18,0,5,0,0,1,0,13,1,7,5,6,0,0,4,0,1,5,0,5,2,5,0,0,2,3,0,4,2,3,3,0,3,8,1,2,2,0,10,9,4,0,2,3,8,0,1,2,3,0,7,0,4,2,2,2,3,15,0,15,2,3,8,0,1,9,1,11,1,1,1,33,2,29,3,2,1,20,2,8,2,0,2,7,8,1,0,7,0,5,0,0,0,0,0,3,0,1,15,8,6,2,1,2,4,4,5,4,19,24,1,11,8,2,0,1,2,17,2,3,2,3,3,14,3,2,0,5,0,0,3,1,4,6,5,5,1,2,0,11,0,10,5,115,14,0,0,22,2,4,1,65,12,8,2,0,3,4,5,5,0,0,0,4,56,3,12,5,0,1,3,6,6,0,8,4,0,4,4,0,6,8,4,7,3,16,1,3,2,4,2,13,7,4,2,3,4,0,2,1,0,8,2,4,2,0,5,0,3,1,1,0,2,1,1,2,1,6,5,4,8,0,1,0,0,3,3,1,0,1,3,3,2,3,2,6,7,7,0,0,11,1,2,0,2,0,2,1,0,3,0,14,39,4,7,6,0,0,0,1,2,1,0,0,3,5,4,2,2,0,1,0,1,2,2,1,2,3,3,7,0,6,5,1,1,3,0,9,0,0,0,1,0,0,1,1,0,22,8,2,1,0,0,0,0,0,0,0,0,0,14,0,7,0,3,1,4,5,5,24,5,0,0,13,1,3,7,2,1,4,18,1,5,3,5,0,0,4,1,1,0,0,1,6,2,6,1,2,0,1,5,0,0,7,0,2,0,0,3,1,2,2,1,1,2,0,0,16,0,1,8,0,0,0,0,9,5,0,1,4,4,3,2,0,5,3,11,0,0,9,2,2,0,2,3,2,0,1,3,0,0,2,1,1,3,1,11,1,2,2,2,0,0,0,5,4,0,2,6,0,2,0,0,0,1,2,5,0
break,5,25,9,44,1,7,1,18,0,3,15,8,9,30,2,5,14,8,10,3,3,19,18,14,9,12,11,9,12,13,6,108,70,3,23,39,36,4,10,2,4,8,7,6,16,13,15,13,142,36,29,3,3,30,8,3,35,9,17,7,5,7,2,13,10,4,49,8,4,7,13,3,2,6,52,8,8,5,47,19,23,4,12,8,94,6,3,7,20,0,8,3,8,9,26,16,13,3,23,7,5,12,21,2,8,12,0,8,8,6,19,4,5,16,16,12,1,5,30,87,22,24,58,50,4,6,3,1,1,2,15,4,9,26,16,33,4,5,5,4,1,24,19,2,7,31,13,6,10,5,26,6,5,0,3,14,19,11,7,30,5,4,9,5,6,16,6,23,15,9,14,56,18,1,2,10,77,4,4,33,12,9,10,22,1,22,9,16,16,35,4,6,4,2,4,3,12,3,6,10,13,2,2,5,21,7,3,24,8,13,38,11,22,7,3,20,7,13,12,3,1,7,3,6,17,69,18,8,1,5,6,4,9,17,15,9,12,10,4,2,46,23,6,7,9,3,4,16,17,8,2,8,15,3,4,10,3,1,2,11,0,17,6,4,2,13,4,4,16,3,48,7,10,0,1,3,15,2,3,1,37,3,2,6,4,1,5,5,7,3,4,4,6,3,3,2,11,0,2,5,22,11,2,0,8,1,11,6,6,3,6,7,9,3,14,6,6,18,9,5,29,4,22,10,35,2,4,28,1,24,2,7,5,3,3,6,8,5,0,6,1,14,7,6,0,7,27,21,6,19,6,10,5,14,11,2,6,2,4,18,12,6,6,8,5,5,22,5,12,24,1,18,1,10,9,14,5,1,9,0,15,0,13,2,1,22,6,17,17,7,13,3,5,5,11,3,20,2,22,4,12,5,3,2,4,2,8,3,13,5,3,7,6,15,10,5,1,7,3,2,3,2,10,10,1,2,2,7,11,4,2,0,0,4,9,5,0,5,5,2,7,12,1,7,1,2,10,7,9,1,7,4,6,6,24,4,1,9,4,10,5,20,15,17,3,1,16,5,4,0,23,7,0,3,3,13,4,7,12,5,11,4,5,5,13,5,4,4,1,0,55,14,4,6,3,1,0,4,8,5,5,2,3,0,14,3,1,10,5,4,0,6,7,2,4,6,5,7,19,9,2,12,0,13,0,4,20,5,4,14,2,4,6,3,6,1,3,7,19,7,3,0,1,9,6,6,4,12,7,1,25,1,6,25,1,12,10,3,8,2,6,2,11,3,2,6,7,5,12,14,6,2,2,4,1,10,2,7,4,8,3,2,3,7,2,1,1,5,6,4,13,11,3,0,5,1,4,3,9,2,10,1,2,2,3,4,1,7,1,3,16,7,4,5,12,2,4,8,8,3,6,0,1,7,2,4,6,2,3,9,7,4,10,4,2,0,6,8,2,1,3,3,7,30,4,18,4,2,6,88,17,5,2,4,6,10,13,17,2,4,2,5,6,14,0,0,0,7,4,4,6,3,37,15,8,4,1,2,7,2,3,14,10,0,4,4,4,1,3,6,6,11,7,5,3,4,3,4,13,5,1,2,2,3,0,2,5,4,1,0,1,3,3,10,4,11,13,1,4,8,13,3,14,18,6,5,4,4,0,13,0,5,1,3,1,1,17,7,13,2,2,2,5,13,8,3,6,2,2,1,4,0,0,2,2,5,4,5,1,8,8,7,1,1,9,7,7,2,4,5,4,4,1,6,1,5,3,1,18,8,3,5,6,1,2,4,4,13,4,7,4,2,4,1,6,17,8,8,0,0,3,3,2,1,6,3,3,4,7,3,3,8,11,12,2,4,2,6,6,1,1,2,3,2,0,0,3,3,0,4,2,3,5,4,4,3,8,17,3,5,2,1,6,9,9,2,1,9,1,6,13,8,5,2,0,3,3,3,4,2,3,5,4,0,3,4,6,4,4,6,0,0,2,2,4,5,0,5,3,3,1,0,8,1,0,1,1,2,12,0,5,5,2,2,9,4,1,4,4,14,2,5,0,3,3,2,12,2,2,8,4,0,2,2,5,2,2,2,1,0,9,2,4,4,1,2,1,5,4,1,1,7,5,2,1,3,3,1,0,1,3,9,0,0,3,2,5,1,10,4,4,1,5,2,1,0,1,2,3,0,1,1,0,1,2,9,2,0,5,1,2,6,8,2,4,2,5,5,6,4,1,5,2,2,7,5,2,7,7,2,0,1,3,1,4,4,6,4,2,5
age,1,14,4,40,5,10,2,25,1,11,3,7,3,26,1,11,1,6,6,2,3,17,7,21,8,3,11,11,4,9,12,71,57,3,26,38,21,2,2,3,0,14,1,6,16,5,19,8,101,20,20,6,5,23,21,8,23,9,3,19,3,1,2,5,12,11,72,5,4,11,17,0,2,0,50,4,21,0,44,12,15,1,2,5,53,5,3,0,15,2,4,7,5,7,10,4,14,5,16,7,4,16,5,2,6,15,1,5,12,4,6,6,5,3,3,16,0,3,25,53,16,17,4,68,12,3,1,2,2,1,9,8,19,24,13,29,0,3,3,10,4,19,12,1,5,28,5,8,7,4,15,5,4,4,1,8,30,8,7,11,6,2,7,1,2,9,5,8,17,6,12,50,14,0,1,2,42,2,8,20,10,6,10,11,2,16,18,14,9,17,3,2,1,1,2,1,9,2,8,8,10,0,2,3,9,4,1,30,3,13,31,4,9,6,7,7,0,3,5,2,1,16,4,11,17,45,17,12,9,3,9,6,8,10,11,2,16,0,3,4,38,14,8,2,9,3,3,16,23,7,10,8,4,3,4,5,5,2,0,28,3,7,5,1,4,18,14,6,9,6,45,4,4,0,3,2,12,1,6,0,40,0,4,12,6,0,11,16,8,3,1,2,11,1,3,4,7,1,6,8,12,15,1,1,4,11,15,3,2,1,4,5,7,6,10,9,14,22,4,3,12,3,12,15,16,1,9,14,1,15,6,9,5,2,5,6,10,2,1,2,2,7,11,5,1,3,15,14,15,10,4,5,1,8,7,2,0,7,9,16,8,4,3,10,4,4,11,5,6,6,0,19,0,3,3,37,8,0,14,1,29,2,8,3,7,17,2,6,11,6,7,10,6,2,9,8,10,4,13,3,11,2,3,1,3,5,0,1,8,8,3,4,3,7,0,4,2,4,3,4,2,7,6,3,0,0,4,6,4,8,3,0,0,11,4,6,0,2,9,6,6,6,0,8,0,3,9,0,7,3,21,3,15,1,22,13,0,5,8,8,5,10,21,23,9,1,12,11,1,1,17,4,1,5,6,8,5,4,7,6,1,12,3,5,7,2,3,11,3,5,23,14,3,5,0,1,1,8,5,2,3,2,2,3,4,3,4,12,3,4,4,3,3,4,7,6,6,1,7,2,7,5,2,9,0,4,8,4,2,10,6,6,2,8,4,2,4,2,18,8,5,0,0,1,3,3,2,6,4,0,24,1,1,19,5,1,7,2,3,4,13,2,14,0,5,5,8,2,9,6,7,5,3,4,3,0,0,0,0,9,0,6,3,11,7,5,2,0,2,4,12,11,4,2,8,4,3,2,7,7,5,1,4,2,0,5,2,2,0,1,6,5,4,6,6,2,8,0,2,1,5,2,2,4,3,1,1,4,8,11,2,4,4,12,7,1,11,2,6,7,5,3,2,6,3,8,4,1,0,46,4,1,6,1,1,3,11,7,0,4,2,1,6,5,0,0,1,1,2,5,5,1,2,3,3,2,5,2,0,2,3,6,4,0,3,5,4,3,1,2,5,12,2,4,0,4,3,3,4,4,1,2,0,5,4,5,9,0,0,2,1,4,4,8,6,32,9,7,2,10,4,2,2,27,3,9,3,2,10,8,1,6,2,3,1,5,17,0,17,13,4,0,0,3,2,4,2,4,4,3,7,0,2,2,6,3,1,5,2,22,22,4,3,1,15,3,7,4,2,1,4,0,3,10,4,2,4,2,7,10,6,1,6,1,5,1,6,0,2,6,7,2,2,4,2,5,2,3,2,9,1,0,6,1,3,0,3,6,1,2,0,2,2,3,1,1,5,1,0,4,1,7,2,10,1,2,2,2,2,0,0,3,10,0,2,4,6,13,4,13,1,3,3,2,1,0,3,3,1,5,5,10,3,4,3,0,1,0,0,2,0,1,3,1,3,3,2,0,1,1,0,1,0,0,4,2,1,1,3,17,0,1,5,2,3,2,2,4,2,0,5,1,5,0,0,4,1,0,9,6,2,3,4,1,10,0,0,6,0,14,2,0,5,4,2,1,3,2,5,2,4,1,3,2,4,2,3,1,1,2,1,0,1,4,4,3,2,2,1,9,9,9,2,0,2,2,2,5,6,1,4,5,1,0,2,2,2,1,5,0,1,6,4,3,5,1,5,1,2,4,9,5,6,2,1,2,3,2,2,0,1,5,0,3,1,0,2,2,4,8,6,2,3,0,4,0,4,1,5,0
emergency,0,13,3,66,6,4,0,12,3,0,4,2,5,32,1,0,0,8,2,1,7,17,4,7,8,12,7,9,2,9,8,78,49,5,29,37,26,3,5,4,2,4,2,1,6,7,19,7,73,7,15,2,1,9,6,1,28,16,1,7,14,3,3,5,13,5,42,6,2,10,17,2,4,2,53,8,11,11,61,7,31,0,7,5,104,17,10,1,21,2,7,1,2,15,27,10,8,0,29,12,7,22,22,2,2,20,7,6,10,5,20,11,2,13,1,6,2,1,41,65,12,9,8,50,3,1,1,0,1,1,5,7,1,24,8,25,1,0,6,4,0,20,5,2,1,26,0,4,10,6,20,5,5,7,1,25,15,5,1,13,4,2,7,5,6,5,5,7,18,5,16,21,6,1,5,4,78,2,9,45,8,8,15,6,0,8,23,15,4,31,0,2,1,0,0,1,24,4,2,10,10,1,2,7,20,9,9,21,9,17,43,5,10,3,1,5,6,8,2,3,11,7,2,8,33,41,16,10,5,10,6,10,12,13,14,16,7,4,6,0,20,18,6,7,4,23,3,12,51,2,11,11,7,5,7,5,5,6,3,19,3,17,8,0,2,25,2,1,1,4,75,11,21,10,3,2,16,12,8,1,34,3,5,6,8,4,15,14,5,5,2,0,7,8,3,4,19,1,3,9,5,26,5,2,1,4,5,2,2,0,8,11,57,6,13,7,8,11,6,5,19,5,15,4,27,1,5,8,2,10,0,6,2,2,3,4,10,4,8,5,9,6,10,3,7,6,30,13,16,0,2,7,2,24,4,6,1,7,3,16,15,10,6,19,1,2,20,0,5,9,3,18,2,7,3,42,7,0,5,2,34,4,33,6,0,10,1,15,7,2,10,7,5,0,13,3,18,3,16,5,6,4,4,2,4,0,1,2,9,3,0,3,2,3,1,5,0,0,0,0,4,5,26,4,1,0,4,4,9,0,14,8,2,5,2,0,0,2,16,1,9,15,4,3,0,0,12,5,28,3,15,1,4,2,23,6,0,4,3,9,2,12,19,20,5,1,13,3,1,0,6,1,1,0,0,1,3,10,16,3,3,7,1,2,4,4,8,1,1,0,75,25,1,1,8,2,5,6,9,1,4,1,0,8,10,21,10,5,2,1,2,0,3,3,1,8,3,3,0,2,0,3,1,9,4,3,7,6,2,16,2,2,1,3,9,3,3,2,14,16,2,1,0,8,4,4,0,6,17,3,9,2,3,16,9,7,11,2,1,5,11,5,16,8,4,17,7,2,23,16,11,4,12,0,5,2,4,5,5,12,3,6,7,9,3,3,1,3,2,7,8,11,4,4,5,0,2,5,5,10,6,5,5,1,0,6,1,15,2,1,9,10,7,3,21,4,4,1,3,2,15,10,3,35,4,4,1,3,4,15,10,13,7,9,6,2,9,12,3,8,4,3,1,7,1,25,10,1,5,32,4,1,6,1,1,6,19,6,2,4,2,0,1,8,3,0,1,3,7,2,6,6,12,1,3,3,0,0,7,2,10,13,8,3,7,5,4,11,3,10,5,7,4,12,6,4,2,0,9,5,0,2,1,3,5,7,6,10,7,1,3,3,2,20,10,28,4,2,3,7,10,2,4,20,5,3,2,1,0,11,6,17,3,4,1,1,24,3,11,1,5,3,6,18,6,4,10,3,7,4,8,1,9,7,3,8,2,10,2,18,15,4,4,4,9,9,4,4,7,1,4,2,3,3,7,9,14,4,0,7,0,2,4,8,3,4,2,6,8,5,0,4,3,3,0,4,3,6,0,1,5,1,6,2,3,1,12,0,5,3,1,0,2,7,1,0,1,1,1,4,1,2,0,12,2,1,3,11,2,3,3,1,11,4,4,3,6,7,6,2,1,4,2,2,3,5,6,2,5,3,2,30,2,0,1,4,3,6,0,1,0,1,1,3,4,6,0,2,7,11,2,3,19,10,3,5,0,1,3,0,0,1,4,3,0,0,5,4,6,2,2,3,1,2,2,2,4,1,5,7,6,0,3,2,5,2,0,3,2,7,8,16,4,8,5,2,2,2,3,1,4,3,3,2,1,3,0,1,2,7,3,4,3,4,3,5,6,4,2,8,2,8,6,0,2,7,5,14,34,0,3,2,0,1,4,3,7,4,25,4,0,3,0,3,1,10,1,0,1,5,4,0,5,0,1,1,14,7,0,4,7,1,1,1,0,6,4,5,0,0,3,3,1,2,14,1,1,4,0,1
appropriate,0,22,13,146,2,0,1,9,4,2,9,6,4,18,2,2,2,8,0,2,2,15,0,15,8,4,4,2,3,7,9,139,35,3,12,26,14,6,5,2,3,2,2,2,14,6,8,7,110,8,23,3,6,11,1,3,24,32,0,9,4,0,0,6,2,1,32,2,1,6,25,5,2,1,21,1,6,0,28,2,40,3,5,2,99,54,8,1,17,2,4,0,2,17,16,5,10,2,22,5,16,15,22,4,6,15,6,2,13,5,5,1,12,3,1,17,5,0,52,63,14,3,26,68,4,1,1,2,1,2,4,1,0,22,7,41,1,0,3,5,1,10,13,2,1,30,3,7,2,20,36,1,3,3,5,19,8,3,1,8,5,4,3,3,2,0,6,10,7,2,4,28,9,0,1,5,63,3,7,13,11,9,7,5,19,3,15,9,11,24,0,0,0,0,3,1,12,3,3,4,7,2,1,4,9,6,1,12,5,14,26,1,25,3,2,0,1,4,9,9,8,6,5,10,30,42,13,20,3,11,15,11,20,7,21,15,12,3,4,1,22,11,4,1,3,3,4,11,38,1,7,5,7,6,7,12,7,3,3,13,3,8,16,5,2,66,6,2,5,2,60,28,58,2,2,1,4,30,9,13,19,1,1,6,7,3,1,8,1,1,1,4,20,2,2,8,21,5,8,2,4,40,5,4,3,0,5,4,3,0,3,10,22,3,30,5,7,17,5,3,5,3,11,0,27,6,4,6,2,8,0,10,1,4,3,3,7,4,1,6,2,1,6,9,4,4,13,36,16,5,17,8,1,29,4,8,2,3,6,36,12,7,3,10,3,0,21,4,0,2,3,7,1,5,6,26,4,1,2,8,32,0,26,1,1,19,3,6,15,0,7,2,18,6,25,1,26,1,15,3,15,0,0,0,3,1,2,0,9,7,0,3,2,10,2,3,1,3,0,2,1,6,6,5,0,1,1,8,5,4,2,0,4,10,2,3,0,5,10,0,0,7,4,3,3,3,5,3,9,1,3,2,1,3,18,2,0,7,2,10,2,5,4,12,3,1,5,5,4,0,6,0,0,3,1,5,0,11,10,3,0,4,1,0,3,1,9,2,2,5,56,29,1,0,5,1,3,10,1,1,4,6,4,3,6,11,0,6,4,1,2,2,2,4,6,7,2,3,1,1,3,5,4,11,5,6,3,0,22,13,3,0,1,2,3,2,7,3,19,14,2,2,0,2,3,5,1,7,6,5,18,5,2,19,3,3,9,2,8,6,17,5,16,2,2,3,5,2,50,13,5,5,54,0,11,0,1,0,2,15,0,17,7,5,3,1,4,5,4,4,6,9,4,6,5,5,1,2,30,12,17,1,1,4,0,11,10,18,4,2,14,23,10,3,9,5,26,2,4,3,4,1,3,8,5,5,5,7,4,6,2,18,5,12,3,0,0,16,6,10,2,2,1,12,1,29,5,7,7,51,7,3,2,5,3,7,10,5,2,5,3,1,6,6,8,4,0,7,5,5,11,6,29,14,18,3,6,12,3,8,11,23,6,6,7,4,6,4,4,9,9,7,13,9,4,14,7,0,7,16,8,1,4,2,14,6,4,5,0,1,0,5,4,11,13,17,2,2,4,11,6,4,0,13,6,4,2,1,7,5,5,21,1,1,4,5,27,6,29,3,13,3,11,5,5,1,8,7,1,4,6,9,20,32,29,4,2,3,6,7,5,4,2,6,11,6,7,6,9,6,2,4,2,5,5,4,1,2,1,11,2,3,8,0,2,5,4,1,3,9,3,7,5,3,5,21,1,6,0,4,1,4,7,1,0,1,4,1,11,2,1,1,4,7,0,7,2,3,2,8,3,6,0,7,6,3,2,12,5,1,11,5,5,1,5,5,7,6,4,2,9,4,3,1,3,7,9,1,2,3,0,9,4,3,2,4,0,11,0,1,3,1,4,3,3,0,3,2,3,19,8,4,0,0,6,2,0,4,9,3,4,2,1,1,6,5,1,6,2,9,2,11,0,0,4,6,4,2,2,5,5,2,3,2,4,1,0,5,1,5,0,0,1,48,4,4,0,4,2,3,2,3,5,3,1,4,1,2,1,0,18,2,1,4,4,4,0,8,1,19,1,7,14,8,6,17,6,29,39,0,2,1,2,4,1,1,0,3,22,2,6,4,1,8,1,5,8,16,2,3,1,2,2,1,2,3,6,3,2,2,6,4,3,0,3,6,2,4,9,0,1,1,2,1,3,3,1,4,2,0
1st,0,13,1,85,2,0,3,10,2,1,7,5,10,14,2,0,5,15,1,1,2,14,4,6,6,4,3,11,0,122,5,130,46,7,9,8,15,41,8,1,5,0,1,5,7,2,8,6,149,3,11,1,4,7,0,1,27,48,0,3,6,2,0,7,9,0,28,3,1,3,56,2,3,0,21,3,14,2,52,3,42,0,10,0,91,36,10,1,100,3,10,1,0,40,61,7,8,8,32,3,4,20,32,0,1,14,12,2,10,9,22,3,0,7,0,16,38,0,81,42,12,3,15,144,1,0,0,0,8,1,2,1,0,19,5,13,0,2,0,0,1,16,38,2,1,29,3,2,12,21,11,2,12,8,3,10,7,2,4,2,38,0,3,4,0,4,3,0,17,5,5,23,10,0,4,5,93,1,3,5,6,1,3,6,4,3,13,4,3,19,2,1,1,1,1,1,6,3,10,3,9,0,0,2,9,1,6,19,7,6,29,0,11,5,0,1,12,3,9,0,102,4,5,3,33,62,20,20,10,10,2,35,48,8,20,50,14,1,6,3,21,20,6,2,3,4,3,7,51,2,2,9,6,39,13,1,5,12,10,25,0,13,15,5,7,67,0,0,0,0,61,23,189,2,1,0,2,73,6,0,19,3,0,7,6,0,2,1,4,1,10,6,7,43,13,4,35,2,0,5,4,24,6,7,3,0,1,2,2,0,1,5,27,1,41,28,3,19,8,0,11,2,10,0,8,2,2,4,3,13,0,3,1,0,0,7,7,1,12,14,1,3,12,3,4,2,15,28,5,1,26,8,0,8,3,8,3,1,11,67,7,2,2,3,2,0,10,0,3,4,2,6,0,2,2,30,0,2,0,22,27,0,21,1,0,28,0,11,61,0,3,1,2,3,15,3,23,4,13,6,2,1,7,1,7,1,4,0,10,1,0,0,9,3,8,0,5,2,1,2,0,3,4,1,0,2,0,3,0,16,67,157,43,40,1,2,0,10,1,1,7,3,1,1,0,0,3,1,24,22,3,1,0,3,22,3,0,4,10,32,5,7,9,12,2,3,2,3,2,1,2,0,3,0,3,2,2,4,6,0,2,2,0,0,1,6,2,1,0,1,47,47,1,2,1,1,0,32,1,4,11,1,2,2,10,26,1,10,13,2,6,2,5,6,1,6,3,3,0,1,0,9,2,9,2,6,5,3,6,10,10,3,0,3,9,1,5,0,21,17,1,3,0,0,12,3,2,4,5,1,9,4,2,34,2,2,4,0,4,3,5,4,22,2,3,3,9,1,15,8,7,8,37,0,1,1,17,2,1,67,5,6,3,2,2,1,6,6,3,2,5,9,5,8,5,1,1,0,18,3,18,0,4,3,10,12,5,8,4,3,9,8,8,1,8,7,15,0,1,6,4,13,8,37,4,4,0,2,4,18,21,7,3,19,2,2,3,7,5,1,5,0,2,29,8,50,0,3,4,100,14,5,2,1,2,17,29,3,2,13,4,0,23,11,9,3,0,1,5,11,9,2,26,16,11,2,1,5,6,4,3,17,6,4,7,18,5,0,4,0,8,3,18,8,3,15,13,2,4,5,6,3,2,1,6,4,19,2,14,2,0,122,9,6,3,17,7,3,4,2,2,2,4,11,1,1,12,0,0,1,2,11,8,0,7,20,5,3,5,8,6,0,2,3,5,4,17,1,3,3,3,80,37,65,16,8,1,15,1,35,26,5,40,19,5,13,5,0,0,4,1,0,0,7,1,6,6,2,2,12,0,3,8,17,2,2,0,17,3,8,3,6,1,6,5,2,10,7,7,2,6,9,13,4,0,1,0,3,8,2,6,2,11,14,2,1,0,3,5,6,0,13,3,2,5,4,0,10,3,6,50,22,3,0,2,1,5,7,0,1,4,1,0,3,5,17,5,3,2,0,5,18,2,13,0,5,2,31,4,0,0,0,1,0,2,5,0,2,2,5,2,3,21,9,1,5,1,11,2,0,1,30,1,10,13,4,4,3,0,6,0,5,0,0,3,13,0,4,9,0,3,1,4,8,0,34,0,6,27,7,2,44,5,82,8,23,0,2,0,2,0,1,14,2,2,6,1,5,1,12,2,1,6,3,3,9,5,10,2,4,4,10,44,58,7,56,26,110,262,2,0,0,2,3,1,1,14,0,20,2,5,3,4,9,4,16,5,7,0,2,1,0,0,0,8,0,0,3,4,2,29,0,8,40,2,1,2,0,7,0,0,1,14,0,0,10,0,19,0,0
mile,0,7,1,60,2,6,7,30,3,2,8,2,7,15,4,6,3,6,3,1,2,34,5,6,5,0,10,3,1,17,2,112,64,5,25,11,8,5,2,2,2,5,0,5,18,4,25,7,221,18,13,0,5,11,3,1,20,72,3,15,6,0,0,5,4,1,30,0,2,35,6,11,4,2,15,4,10,1,36,8,96,1,10,5,72,15,6,0,61,0,9,2,1,31,12,17,19,8,12,6,32,19,12,1,7,9,16,10,78,14,14,1,2,0,0,21,3,8,26,68,13,9,0,130,8,0,2,0,2,9,1,0,1,40,2,27,3,1,7,2,2,13,16,1,3,35,7,7,32,13,30,0,2,3,1,7,8,5,3,0,9,0,3,4,2,4,12,1,8,5,58,26,0,1,6,1,56,2,0,13,9,3,2,4,23,3,11,6,5,32,0,3,3,1,0,0,8,1,18,1,6,3,2,9,9,4,2,24,5,11,28,6,2,5,4,4,4,0,31,4,2,2,0,17,22,22,33,42,14,5,6,23,8,10,23,56,27,4,0,3,26,6,6,2,4,1,2,3,21,1,2,12,6,29,75,3,3,3,0,34,0,12,9,1,7,67,0,1,0,1,57,0,27,6,2,1,9,42,6,1,16,0,0,4,10,21,1,2,5,2,4,0,4,4,4,12,20,3,0,8,7,14,1,8,2,0,4,0,0,0,3,3,6,0,34,47,9,14,6,0,5,5,20,1,22,3,5,7,0,22,1,3,3,6,0,17,7,12,3,8,0,7,10,5,15,10,14,24,7,1,2,1,3,15,16,23,0,2,10,35,3,17,5,5,3,0,9,4,1,1,5,4,14,3,0,49,18,3,5,0,24,1,17,1,1,37,0,4,12,0,4,3,7,2,19,7,19,4,10,12,3,19,6,0,3,4,4,1,6,3,4,34,2,8,4,2,1,6,0,0,1,7,9,4,0,3,4,10,5,5,4,1,14,4,3,2,2,2,4,2,9,8,1,29,8,17,6,1,24,6,4,7,2,3,47,5,0,1,4,12,5,8,11,9,13,7,8,11,14,3,10,0,14,2,0,4,2,3,4,5,4,2,3,1,2,3,5,1,0,0,30,24,2,0,2,6,2,12,3,3,34,1,6,1,8,2,1,2,3,5,2,1,2,2,4,3,3,4,2,2,0,13,7,8,1,7,3,2,1,9,0,0,3,5,7,2,2,2,15,4,0,0,4,2,2,3,0,5,8,5,16,2,7,76,2,2,32,8,2,1,15,1,12,2,7,2,8,3,10,8,10,4,18,1,4,8,0,4,4,85,0,10,5,1,0,1,2,0,22,1,8,10,2,21,3,0,0,2,22,7,8,0,3,1,2,4,6,2,4,8,8,10,2,5,11,20,10,0,2,1,11,2,1,8,4,6,14,6,8,31,3,10,10,3,14,0,0,45,10,3,5,0,9,41,2,8,1,0,0,141,25,2,2,1,3,28,17,2,0,10,2,6,4,14,1,2,1,2,2,5,10,9,82,7,9,2,1,8,8,25,8,20,2,9,2,1,5,0,41,74,7,1,14,59,3,19,0,0,0,7,2,3,4,1,8,13,19,6,0,10,5,27,0,8,16,15,10,3,10,2,3,0,2,14,1,11,11,0,6,9,2,9,2,0,1,17,13,6,73,22,2,17,3,11,33,0,19,7,4,6,7,6,1,50,24,11,1,21,6,47,40,6,5,11,20,4,12,3,1,8,5,3,0,8,8,11,5,1,6,2,2,0,3,0,7,4,0,41,31,13,0,5,1,6,28,8,13,24,4,1,0,7,13,3,1,0,0,6,3,2,2,3,11,2,2,0,6,10,2,14,1,22,0,1,30,3,0,9,0,3,3,5,4,2,5,2,5,6,25,0,0,1,1,1,1,23,3,3,10,4,5,20,4,6,0,2,2,2,4,2,1,3,1,2,3,10,5,3,10,16,0,4,3,1,0,4,0,2,8,0,4,3,3,0,17,3,8,14,8,13,10,22,0,4,1,0,14,1,6,4,0,2,3,1,2,4,2,6,2,8,4,1,0,16,4,5,7,4,2,6,7,11,3,1,1,3,10,0,1,3,1,1,6,10,5,17,12,3,0,7,0,5,18,0,7,11,0,77,12,2,5,1,2,7,0,14,1,28,10,1,35,17,1,4,11,8,2,0,2,18,12,3,1,5,1,3,0,2,11,8,130,2,3,3,2,1,5,2,5,0,4,1,6,0,0,2,0,6,1,1
atlantic,8,5,5,47,3,2,0,23,0,1,10,6,5,49,2,6,3,5,2,0,3,17,0,7,10,6,7,16,2,6,7,82,53,2,24,28,26,1,1,2,2,8,6,1,13,9,6,3,189,35,21,7,9,35,4,2,21,24,1,15,16,15,2,3,9,4,31,4,1,25,4,14,8,2,38,8,13,1,44,7,31,0,9,5,78,4,11,0,26,0,6,1,0,17,32,2,11,5,19,1,35,13,9,2,5,9,2,3,13,2,10,4,3,10,1,13,2,0,25,100,27,9,1,34,4,0,1,4,5,1,4,3,4,40,10,38,1,0,5,3,1,17,10,6,0,47,3,9,11,6,25,2,5,7,2,6,10,1,4,5,6,1,3,1,0,3,1,7,10,3,16,54,8,5,5,4,57,3,5,14,5,6,2,6,14,6,17,4,20,39,2,1,5,0,0,2,7,3,13,4,1,2,2,6,20,5,0,13,6,10,37,3,24,3,0,0,1,0,7,10,1,13,5,9,36,22,11,10,5,1,14,18,1,11,24,2,11,2,3,8,26,31,3,2,5,0,4,12,25,4,2,8,11,7,17,6,6,0,0,9,0,13,6,0,2,10,0,1,11,3,60,0,2,4,3,1,13,3,5,0,24,3,1,10,8,9,0,6,5,1,2,0,5,2,2,3,21,2,3,10,8,21,0,1,9,1,10,0,1,1,2,7,16,8,4,2,8,15,6,6,19,4,20,0,48,7,3,8,0,10,0,9,9,2,2,8,12,8,0,2,6,8,14,9,3,21,14,27,13,3,7,2,2,25,12,5,1,1,3,2,4,11,14,3,7,1,23,4,0,6,2,10,5,16,3,21,9,2,7,1,37,3,24,7,1,22,0,12,11,0,6,1,2,6,15,5,24,2,15,2,11,7,3,1,3,8,2,2,34,6,1,29,2,9,11,7,1,9,2,3,3,4,3,4,1,1,1,5,10,13,1,3,3,6,3,4,2,5,17,2,11,23,9,33,7,12,21,5,19,2,19,5,8,5,58,7,0,11,3,9,4,12,6,15,4,2,2,14,19,0,10,6,6,1,2,0,1,1,14,4,3,6,13,4,12,1,7,3,4,0,66,24,1,4,2,3,4,5,2,4,16,4,3,1,7,1,2,7,1,1,0,1,8,1,6,6,1,4,0,7,7,12,2,15,6,2,10,0,3,16,6,0,8,2,4,5,5,5,27,3,1,1,0,0,5,2,0,15,11,10,10,2,1,32,3,8,46,1,1,11,9,7,6,7,4,5,9,2,23,15,6,2,12,0,9,5,1,5,5,25,0,8,10,8,3,0,5,6,8,8,15,23,2,0,8,4,4,0,41,8,5,2,5,2,6,21,1,2,5,2,7,19,10,4,6,10,6,3,5,6,4,0,3,2,0,6,19,5,10,17,1,7,7,11,6,4,4,15,2,15,2,0,3,10,4,18,4,3,0,119,25,5,3,0,7,14,18,11,4,11,2,33,4,15,9,1,3,2,2,10,9,9,28,4,7,5,3,7,15,7,29,23,4,8,6,2,7,2,22,103,4,6,8,129,6,13,2,1,5,7,10,9,1,3,3,4,12,4,0,1,0,4,1,13,17,10,3,5,0,5,10,0,1,17,6,24,1,2,1,9,4,10,0,4,2,4,49,6,32,8,1,17,7,28,31,3,7,11,2,1,4,1,0,1,2,5,8,11,5,4,1,2,1,2,27,4,6,0,2,9,3,8,2,4,3,10,2,0,6,5,0,2,4,4,4,4,1,14,7,3,1,1,2,3,12,11,5,4,1,1,1,3,9,4,1,1,2,5,8,9,1,12,17,4,11,2,2,8,2,8,6,1,2,3,20,2,2,2,0,0,0,2,3,2,3,6,7,5,25,2,1,0,2,1,1,8,1,6,2,7,23,9,1,4,2,0,3,4,2,0,3,4,1,2,2,5,1,3,10,14,0,0,3,2,3,4,1,5,3,7,4,2,1,0,4,4,4,4,6,2,25,23,0,7,8,7,10,0,6,3,2,1,8,8,7,2,31,2,2,14,2,2,3,2,6,4,4,17,4,1,4,5,0,6,4,1,8,7,3,0,2,0,0,8,2,0,5,4,2,10,2,1,0,0,1,3,3,18,2,0,3,2,1,4,3,0,28,1,10,1,6,22,0,7,1,41,2,0,0,38,13,5,5,3,1,6,0,1,20,5,15,5,1,1,5,0,5,4,17,2,1,3,2,1,0,0,0,2,3,0
authorize,13,80,12,440,19,5,8,21,4,5,30,10,13,52,6,2,12,17,2,3,4,62,3,53,12,17,7,16,9,31,7,333,133,18,55,53,48,23,33,12,16,3,4,9,41,25,66,16,467,17,49,2,11,30,8,7,65,84,2,15,21,1,0,17,15,7,98,6,9,19,63,17,7,6,64,16,18,10,140,21,96,3,20,4,331,57,27,3,89,11,18,2,1,50,80,25,19,5,31,30,65,46,56,13,8,42,11,0,18,11,25,13,12,19,3,36,12,9,234,223,41,19,18,105,9,4,2,2,15,5,13,2,4,85,18,54,10,8,10,5,0,21,47,4,2,115,5,12,15,40,122,4,25,16,2,34,30,15,5,6,20,3,9,11,15,4,6,17,22,13,28,104,23,2,3,14,255,12,11,51,34,11,24,14,12,17,18,36,31,87,1,11,15,0,4,3,45,8,22,11,21,3,6,17,24,4,19,35,26,32,105,5,48,21,1,0,5,8,23,13,21,18,11,20,111,200,30,34,10,32,30,33,27,33,32,35,45,11,18,3,108,32,10,3,18,12,8,24,113,7,26,25,19,41,20,29,22,22,9,45,5,47,54,19,9,75,5,2,4,4,259,28,102,7,6,0,26,43,41,16,45,7,10,13,9,4,8,16,15,0,19,10,46,20,18,21,77,17,17,26,13,124,9,20,10,0,29,5,6,4,4,6,69,6,72,36,17,46,26,8,60,12,16,2,50,13,10,34,5,34,8,29,8,11,9,41,18,11,13,19,18,17,24,13,9,8,77,65,31,7,29,14,7,63,27,17,3,12,36,41,47,13,8,23,9,1,69,8,0,8,10,25,9,5,4,91,20,5,10,15,124,1,110,8,4,46,4,40,34,1,26,6,34,17,67,15,111,17,61,8,30,5,2,4,9,10,5,4,31,21,1,15,10,11,19,15,18,7,3,1,5,8,29,13,3,7,8,22,33,17,65,18,16,39,2,7,0,23,18,8,16,37,11,15,2,2,13,11,39,17,18,13,2,17,52,12,1,14,4,46,9,17,34,33,12,8,16,10,18,0,13,3,5,0,1,10,4,33,18,7,3,20,2,5,1,23,14,2,1,7,133,80,2,4,18,8,11,44,18,18,15,8,6,9,15,53,6,12,18,3,4,10,15,9,16,24,12,9,1,4,3,21,23,28,25,14,36,15,37,41,16,5,12,9,30,6,24,2,50,34,2,7,6,14,21,21,5,24,31,14,68,25,12,85,6,10,38,10,15,16,54,17,71,7,22,20,26,6,92,47,15,6,82,1,14,18,8,6,13,51,10,29,10,8,7,6,7,9,11,19,23,38,24,9,22,5,3,3,78,26,40,4,4,15,13,29,11,46,17,16,26,70,37,2,42,10,50,5,18,11,31,23,10,107,15,8,3,22,18,50,51,22,42,29,16,4,6,25,2,47,9,0,12,36,19,124,17,19,12,267,17,2,6,10,9,14,46,12,8,30,6,7,39,17,30,16,2,17,15,18,30,5,80,19,49,14,6,32,14,8,27,46,26,16,15,23,17,10,19,41,33,12,34,25,13,36,7,8,11,38,6,8,14,4,18,15,20,14,10,13,5,35,3,47,40,53,16,6,24,16,23,9,10,49,3,10,8,2,1,16,12,41,19,6,13,15,76,7,74,4,14,3,26,32,23,12,39,11,6,17,11,27,17,52,16,23,21,48,5,48,36,17,9,18,24,33,26,7,14,18,8,3,0,29,3,18,26,5,34,19,7,8,16,37,16,6,10,29,14,24,10,30,14,9,9,24,9,17,8,30,13,12,16,18,5,1,12,5,28,13,19,5,20,15,7,12,9,13,10,26,7,5,12,44,32,7,0,26,23,3,11,11,15,9,10,9,17,27,6,10,16,27,1,8,13,40,15,16,12,15,13,83,7,9,4,13,4,26,12,2,11,11,19,2,9,11,10,17,9,43,18,9,53,31,8,6,7,17,20,0,16,16,4,4,33,4,12,12,7,17,11,22,2,2,8,28,8,17,16,2,12,16,6,3,14,7,9,36,7,39,16,59,7,34,20,16,11,12,7,9,14,5,9,11,3,24,2,40,10,25,11,5,14,14,14,7,21,15,11,26,4,27,36,25,18,63,26,57,171,10,11,3,5,25,22,20,10,10,1,9,3,14,10,17,5,57,12,10,2,6,6,4,3,4,14,9,5,19,14,10,32,5,18,27,15,6,8,4,31,0,4,6,3,3,13,3,0,10,1,0
disposition,3,5,1,70,8,2,1,17,1,3,8,6,3,17,2,1,3,4,2,3,6,16,3,7,11,4,4,4,1,5,4,82,53,1,30,40,29,5,4,1,1,3,1,0,18,9,9,6,159,7,18,2,7,9,6,1,25,13,0,11,16,2,1,9,8,0,47,4,7,5,2,2,1,3,31,8,5,2,35,16,16,0,16,1,137,9,4,0,12,0,3,0,0,28,36,3,12,0,22,3,6,18,29,8,4,11,1,0,4,2,7,5,2,10,0,12,3,0,26,70,18,3,2,15,0,2,3,7,2,0,8,4,2,20,5,10,8,2,1,1,0,7,12,1,1,23,2,7,5,7,41,0,11,4,3,16,6,1,4,2,1,1,5,0,0,0,3,5,17,6,6,32,10,0,0,6,90,3,5,5,12,10,0,11,0,7,16,14,26,32,1,0,2,1,1,2,4,3,0,11,4,0,3,11,12,2,5,6,8,18,51,1,20,3,1,0,0,0,9,0,2,9,2,2,27,70,16,9,0,2,5,4,5,17,20,5,18,5,3,4,35,22,4,3,7,1,6,10,22,2,1,9,17,2,4,7,9,1,5,4,0,15,6,2,3,13,3,0,9,0,72,12,17,4,1,0,3,3,5,4,16,4,0,5,6,0,2,2,13,0,3,4,8,1,1,6,31,0,3,10,13,8,0,1,2,0,23,2,8,0,1,1,15,1,11,9,4,30,9,3,43,8,15,1,36,5,2,15,4,15,7,2,8,4,5,6,11,9,6,6,5,3,3,11,4,0,36,53,8,3,7,16,4,10,18,5,0,0,8,6,10,3,2,4,4,0,19,1,7,6,3,8,2,6,3,6,1,0,7,9,34,0,25,3,0,57,3,12,12,8,12,0,3,3,19,6,40,5,13,4,20,1,2,2,4,0,6,10,7,8,1,3,5,6,6,13,2,8,2,3,4,7,9,9,0,4,1,20,6,9,2,3,0,10,0,6,0,18,5,2,5,8,1,9,0,1,1,1,12,4,2,9,1,4,31,5,0,8,3,16,2,9,17,5,0,1,2,15,2,0,4,0,3,0,1,1,1,2,4,2,0,4,5,2,3,7,6,6,5,0,23,20,1,4,3,4,1,18,3,13,5,0,0,0,4,8,2,6,5,1,2,5,2,7,6,12,3,6,3,5,4,12,9,9,4,0,12,3,10,14,7,4,0,1,2,3,5,7,31,14,3,1,0,0,3,4,2,12,7,3,8,3,8,18,0,5,15,3,5,5,13,6,16,0,17,7,10,4,28,10,5,6,5,1,11,7,6,3,6,10,2,20,9,7,5,5,3,8,0,2,25,23,5,0,2,8,0,3,35,20,19,1,3,7,9,10,2,17,5,0,10,5,3,3,6,9,19,0,3,6,10,1,3,12,0,3,12,3,7,25,8,6,11,10,2,3,6,2,3,4,1,0,1,20,7,18,1,3,3,113,12,2,5,5,5,4,9,12,3,8,0,5,13,11,5,7,2,8,7,4,8,5,16,11,25,6,1,6,0,7,3,13,17,6,8,8,4,7,2,6,14,6,11,5,6,1,6,4,2,11,9,2,4,6,5,6,16,1,2,2,2,0,3,18,13,4,0,16,14,1,6,0,2,7,0,2,7,5,1,5,5,7,9,4,16,3,3,4,16,0,3,4,2,5,6,4,7,6,3,3,5,4,0,2,0,5,6,8,5,5,1,5,0,0,8,8,5,13,1,7,6,1,0,2,5,7,7,3,14,5,2,8,4,5,0,5,2,3,7,13,4,3,0,4,1,6,1,7,5,3,2,3,9,5,7,1,4,4,16,2,1,3,10,5,0,4,1,13,4,5,8,1,4,7,3,3,3,13,1,2,5,5,6,1,1,6,5,20,2,2,9,2,3,8,2,3,4,4,2,7,19,30,8,3,1,3,6,9,5,0,8,5,6,2,2,1,2,3,2,3,0,4,12,4,2,1,3,21,5,3,7,3,3,8,6,5,7,2,5,0,1,2,0,8,3,6,8,3,2,1,7,1,0,16,1,4,1,10,3,8,2,1,6,5,6,3,0,3,6,3,8,6,4,5,0,6,5,22,5,1,5,2,3,8,3,2,2,8,0,8,2,7,0,1,11,8,4,1,12,15,0,0,0,4,2,2,1,1,9,1,6,2,1,1,0,7,4,1,1,2,3,0,2,0,2,17,0,4,5,2,2,4,8,2,4,2,1,1,19,0,2,0,3,0,0,0,0,0,0,0
acre,0,1,0,74,0,0,3,11,2,2,1,8,5,20,3,0,5,8,0,2,2,9,0,7,9,6,2,2,3,11,0,71,27,3,10,1,1,44,40,0,0,0,1,5,5,3,16,12,206,1,10,0,7,6,2,4,1,40,0,6,5,0,8,5,9,1,15,1,0,4,45,0,0,0,12,3,7,0,50,3,99,0,0,0,64,9,12,0,81,1,1,0,0,41,16,7,14,18,17,3,22,24,13,0,6,17,7,5,39,12,14,3,2,40,0,36,1,2,71,42,13,2,2,131,2,3,0,3,1,8,1,2,1,14,4,33,0,7,6,4,0,36,28,0,3,42,8,5,19,14,17,1,8,3,3,9,5,8,1,11,6,8,1,1,2,6,6,7,11,2,14,25,12,0,0,0,56,0,4,8,6,3,2,6,32,2,33,1,1,25,0,2,4,0,0,29,5,2,7,5,19,1,0,2,8,0,69,38,7,24,32,0,13,3,0,2,1,0,41,1,6,4,0,2,16,62,16,11,10,5,5,15,24,9,5,8,21,4,6,5,11,7,1,0,0,0,0,4,16,1,2,13,6,25,21,5,3,2,0,16,0,1,9,10,7,28,5,0,10,1,42,6,134,0,5,1,19,1,6,5,8,3,1,8,6,56,0,4,1,0,0,2,7,1,2,20,47,4,0,7,16,18,7,7,0,0,2,0,3,0,0,17,2,0,25,10,3,20,7,2,5,4,8,17,26,0,2,3,0,6,1,2,3,5,0,89,10,4,2,14,0,10,8,0,4,0,21,17,24,19,13,0,0,17,3,0,0,3,4,16,21,5,6,11,3,3,7,3,4,0,2,18,7,4,1,1,0,0,2,18,13,0,10,0,0,406,0,2,38,0,8,2,6,4,13,6,47,0,11,12,2,3,0,0,10,3,0,0,0,12,0,4,0,4,0,2,3,3,4,0,1,0,8,0,1,0,1,3,1,6,0,6,19,14,1,0,0,4,1,11,3,8,6,6,0,3,4,0,11,1,2,0,1,6,34,0,0,3,1,14,2,4,5,4,2,0,17,22,17,1,3,1,0,0,0,1,0,4,8,20,1,4,0,0,2,0,3,2,1,1,6,33,0,0,0,12,1,2,1,2,14,0,5,0,7,1,5,2,1,5,2,5,1,2,5,9,0,7,3,2,4,12,3,3,6,1,13,7,2,7,5,0,0,3,3,0,6,0,13,57,0,0,2,7,51,1,0,5,2,5,0,2,2,58,0,2,2,1,0,2,7,7,11,0,10,4,3,1,17,23,5,7,14,0,4,5,0,0,0,32,0,11,1,3,9,1,4,0,9,1,3,18,2,23,2,9,2,2,12,8,15,2,4,4,8,3,6,8,4,0,14,5,2,3,7,6,9,1,1,1,7,0,2,11,9,3,2,1,7,31,0,14,1,4,3,1,5,34,1,1,0,0,1,46,1,27,1,1,5,77,6,21,1,0,1,11,36,1,0,25,0,0,0,0,5,4,0,14,4,0,11,3,20,12,10,2,2,8,0,21,4,7,3,4,8,0,0,2,22,18,17,7,16,15,6,12,9,1,2,4,0,0,3,4,20,5,8,5,1,2,2,0,0,1,24,1,1,4,2,1,7,0,0,1,0,9,10,0,0,2,1,6,131,0,102,0,0,0,45,10,6,7,0,0,3,0,31,11,1,11,9,44,36,17,6,3,3,0,7,15,3,11,0,8,10,13,0,2,3,32,2,3,2,1,1,2,3,9,26,15,6,1,3,2,4,6,5,12,13,3,1,2,2,6,57,8,11,18,2,0,0,3,4,0,0,0,0,2,8,1,0,2,0,13,0,0,3,1,2,6,0,19,0,2,119,4,0,41,0,7,2,15,0,0,0,3,3,2,8,3,3,2,0,1,0,3,7,6,6,4,6,3,5,6,0,1,2,74,0,0,0,2,2,2,0,0,2,0,3,4,2,11,1,1,4,4,0,3,0,0,0,5,1,0,9,3,2,5,7,8,1,9,4,3,1,1,4,0,17,0,3,2,1,1,0,8,0,2,0,10,3,3,2,17,2,22,0,0,0,1,4,3,6,0,0,4,3,0,0,0,5,2,3,46,12,23,1,12,2,4,0,1,60,0,2,7,0,37,14,6,0,1,1,0,6,5,35,6,3,6,1,10,2,0,6,0,30,2,1,0,0,2,4,0,0,0,3,1,2,0,0,4,0,0,0,7,5,6,3,0,2,1,18,3,0,4,0,4,0,0
mississippi,11,7,3,90,5,1,0,24,4,1,2,4,15,40,3,3,2,14,1,1,2,36,2,11,7,4,7,12,2,17,1,128,82,1,15,20,14,13,5,4,3,5,2,0,9,5,4,12,225,4,12,0,15,12,6,6,8,34,0,18,12,0,0,15,6,0,36,0,4,16,9,18,3,4,51,17,11,2,28,5,31,0,21,2,91,7,15,0,30,2,5,1,3,23,20,5,7,1,13,3,20,16,16,2,6,17,2,0,13,8,15,2,4,9,0,13,2,4,32,76,9,2,2,43,9,0,7,1,4,1,6,3,3,32,4,55,1,1,6,2,0,21,21,10,5,46,3,7,9,5,17,1,0,10,0,6,13,2,2,8,3,5,5,0,1,7,8,10,13,7,30,45,8,15,2,9,63,3,4,6,11,4,1,12,7,2,8,10,5,18,0,4,10,0,1,9,10,0,9,3,3,1,2,20,18,1,1,21,2,19,28,8,12,5,1,1,0,1,6,17,1,7,5,15,15,25,11,10,15,2,14,13,6,24,16,5,11,1,6,8,28,16,5,1,5,3,6,7,22,1,6,19,9,8,18,7,6,2,2,9,0,8,20,6,3,13,3,3,22,3,45,2,18,6,3,0,7,10,9,0,34,1,3,7,18,8,3,4,4,2,2,0,4,4,2,1,32,2,4,10,13,18,1,1,7,1,10,3,0,4,3,18,10,3,8,3,7,26,4,2,13,3,8,0,19,1,7,9,0,9,3,4,3,3,1,6,9,5,1,1,2,3,7,2,6,32,20,40,3,4,6,5,3,29,9,2,0,2,5,6,4,15,21,3,5,1,9,1,0,1,2,6,3,5,2,10,1,2,4,5,29,3,20,2,1,38,4,5,16,0,9,5,12,3,16,2,30,2,23,1,14,2,6,1,3,10,7,7,12,11,3,25,2,3,6,10,6,9,0,0,3,13,6,10,0,2,4,7,4,11,0,1,6,10,3,3,0,7,11,0,4,13,6,7,2,19,15,2,11,5,11,3,2,1,56,1,0,8,6,14,4,7,20,6,1,0,4,18,31,0,14,0,2,0,0,1,1,6,2,3,11,12,0,0,6,1,3,4,7,0,23,13,2,1,2,9,4,7,1,2,26,2,1,0,2,8,7,3,5,0,1,1,9,0,8,4,1,5,0,4,16,11,3,4,0,2,5,2,6,16,1,1,3,0,7,0,2,1,26,2,7,0,0,1,8,10,0,11,6,1,18,1,6,35,0,3,29,6,3,0,20,5,14,0,10,4,7,2,13,17,21,5,21,1,2,5,0,1,1,23,2,4,8,2,3,2,9,6,5,9,5,12,1,3,9,9,0,1,43,6,10,1,6,1,3,12,3,10,1,5,13,10,8,7,7,9,12,0,2,1,11,1,9,6,3,3,9,2,5,11,0,9,5,11,6,0,1,12,1,4,1,4,0,25,10,12,4,5,0,85,12,16,0,0,9,11,15,3,0,7,4,16,6,5,6,1,0,10,4,8,11,2,25,10,7,3,2,10,2,12,15,27,5,16,4,1,2,0,7,21,5,2,6,28,4,20,5,2,0,5,1,14,2,8,6,5,14,3,1,1,0,7,4,17,28,13,6,4,4,6,10,0,9,14,0,32,7,6,1,9,5,12,2,2,3,6,6,2,65,11,5,11,0,8,11,1,7,24,0,2,6,1,3,3,2,7,2,5,12,11,4,5,5,1,23,7,14,5,8,15,5,10,0,9,1,8,3,0,44,9,32,2,7,7,6,8,9,26,4,4,2,9,7,2,17,9,1,6,1,2,0,5,5,2,2,0,3,4,7,5,1,2,5,1,4,1,4,6,1,10,3,2,0,9,22,3,0,1,3,0,5,7,2,5,1,4,8,9,8,3,4,10,0,0,5,4,4,5,1,3,4,14,0,6,6,5,3,7,1,0,11,8,2,2,0,7,3,5,5,12,3,1,0,0,2,0,0,5,6,0,1,3,5,2,10,2,2,6,10,4,2,117,0,1,0,3,12,13,2,0,6,3,3,4,17,3,0,8,1,14,2,1,1,9,6,5,7,34,7,5,6,3,4,3,0,8,2,0,0,0,2,2,3,9,6,1,3,4,4,37,1,1,1,3,1,3,1,18,2,2,9,1,6,3,4,3,17,22,14,2,10,1,23,2,1,11,8,3,0,17,2,1,4,0,4,3,2,3,15,7,2,9,3,0,2,0,5,5,14,0,3,1,2,0,0,0,0,9,1,0
removal,7,27,8,61,1,1,2,4,1,1,3,2,0,18,5,2,1,5,1,6,3,43,5,5,12,5,2,1,4,6,2,91,71,6,18,17,12,7,2,0,8,6,1,2,9,11,13,4,121,4,15,0,5,4,6,6,41,19,0,10,12,0,1,6,8,0,36,0,3,2,6,8,4,2,22,8,6,1,43,8,21,0,6,4,90,7,8,0,12,0,8,2,0,18,14,0,5,2,12,6,1,14,13,1,5,9,8,2,7,0,10,1,0,4,0,16,1,2,28,48,13,0,3,30,3,2,6,0,5,0,7,1,6,19,11,11,4,6,4,1,2,11,18,4,1,26,5,9,9,13,45,1,6,1,4,14,11,0,1,1,4,3,4,0,0,0,4,9,9,2,7,35,8,0,2,2,93,4,4,17,9,7,0,4,4,9,12,7,11,17,1,4,12,0,1,3,7,1,7,7,9,0,0,26,11,7,2,12,8,22,41,0,4,1,1,0,0,0,42,0,3,7,0,11,18,37,19,16,1,2,8,7,7,6,9,10,14,1,4,4,39,18,1,3,8,3,4,13,29,10,10,14,6,13,7,4,4,2,5,9,2,5,16,4,4,33,4,1,10,2,75,9,12,7,2,0,2,13,8,0,31,3,4,5,2,0,3,2,5,0,7,2,15,4,1,5,24,3,5,3,18,9,0,0,5,1,6,11,5,0,2,0,7,2,12,8,12,24,4,1,10,4,9,1,25,9,0,9,2,15,0,6,5,6,0,4,11,1,1,4,4,3,2,1,2,0,11,19,12,0,12,17,4,11,8,0,1,5,5,14,4,2,2,2,2,0,12,6,11,2,1,16,1,8,5,21,5,2,3,4,23,5,20,1,3,15,1,15,16,0,9,2,5,14,19,12,32,4,24,0,15,0,3,0,0,2,1,0,19,8,0,2,4,3,5,6,4,6,1,0,5,6,9,8,0,1,3,13,3,9,5,2,2,5,1,9,0,6,2,2,6,8,1,3,0,5,0,1,23,0,12,0,2,1,13,21,2,0,5,14,3,7,7,12,6,0,11,10,1,0,11,0,4,1,3,6,1,7,3,1,7,5,0,1,5,3,4,1,3,2,12,13,1,0,4,6,1,9,5,9,3,3,2,0,1,18,3,2,3,2,0,2,3,6,18,15,4,8,0,13,5,10,4,22,2,3,12,0,8,15,4,6,2,10,7,2,6,2,24,4,6,0,1,3,5,6,2,3,10,1,19,5,2,23,1,6,10,5,3,1,15,1,9,0,17,11,5,5,6,14,15,13,17,1,5,1,1,4,4,7,5,12,5,6,7,1,7,6,3,5,12,10,2,2,20,2,1,2,24,9,6,1,0,3,2,5,5,20,9,1,14,5,16,8,22,5,11,0,4,4,9,4,3,9,2,3,0,5,5,13,4,8,6,3,0,3,5,3,3,5,1,1,11,12,6,22,5,3,0,62,3,0,5,3,6,7,15,3,0,9,6,2,6,4,6,1,0,6,8,7,15,4,5,12,7,0,1,6,0,1,2,17,4,4,2,10,8,4,0,7,4,6,3,0,0,6,7,1,5,8,4,2,1,4,3,1,5,1,2,0,7,6,6,14,14,2,6,4,6,2,2,2,3,14,0,10,5,5,4,2,4,6,4,4,1,1,3,3,7,8,14,0,1,3,2,5,10,3,4,4,8,0,2,8,8,9,3,5,4,0,0,8,2,4,10,2,7,7,4,8,6,3,4,8,5,3,6,4,44,4,19,6,4,4,2,2,5,0,0,18,2,6,0,7,0,8,0,4,7,31,1,2,1,1,2,1,7,1,18,5,0,0,8,7,0,1,1,4,0,4,3,2,1,11,1,5,4,4,7,0,7,3,7,0,1,9,5,31,1,2,1,1,1,4,4,5,1,4,2,0,16,23,5,2,0,5,2,0,3,1,8,5,9,4,1,6,10,4,5,5,4,0,0,0,2,7,5,3,4,4,4,1,3,2,10,1,0,2,1,1,0,11,0,3,1,1,1,0,0,2,7,2,2,4,2,3,0,12,4,17,4,0,2,2,6,1,4,2,5,0,6,2,8,4,5,8,0,3,0,12,4,4,4,5,4,0,5,1,3,8,4,1,6,3,2,3,1,9,21,1,2,0,4,0,1,4,1,0,10,1,2,23,1,0,0,9,4,1,0,0,0,2,6,0,3,5,2,3,7,0,0,5,7,4,1,0,6,0,1,0,1,1,1,0,0,1,1,3,0,0
compensation,3,11,6,109,0,1,3,9,2,0,4,1,7,7,0,1,5,3,0,4,1,32,0,19,14,3,0,4,0,7,2,130,55,6,14,11,9,10,6,0,2,4,0,2,8,11,19,18,99,2,12,0,0,9,0,4,28,27,0,5,9,0,0,8,8,0,18,1,1,16,14,5,3,1,25,0,1,2,32,8,39,0,7,1,64,5,5,0,16,2,7,1,1,10,20,7,3,12,18,11,3,13,12,1,10,15,3,0,7,1,14,2,7,7,3,8,3,3,48,82,11,5,0,39,1,0,2,10,1,6,5,0,3,29,3,26,0,1,1,2,2,8,11,0,2,45,6,7,4,19,14,1,8,4,3,17,5,0,1,3,25,3,7,2,2,2,6,1,7,5,5,43,8,2,0,5,52,3,2,15,8,0,3,8,1,7,10,20,12,26,0,2,5,0,0,3,23,6,3,2,9,0,0,4,9,6,0,34,4,12,41,0,19,5,0,0,1,2,19,0,1,4,8,1,22,95,19,18,3,10,9,9,8,5,11,13,9,2,1,0,40,10,1,1,8,5,3,3,41,0,16,2,1,5,5,5,2,0,3,15,38,4,11,1,1,54,1,0,3,0,49,4,31,3,4,0,3,11,5,2,16,1,0,21,7,0,6,5,3,1,2,1,8,2,1,3,45,5,3,13,1,26,2,0,4,1,2,6,5,1,2,3,8,3,27,6,18,26,5,1,9,7,10,1,19,2,0,6,3,13,1,5,2,9,3,15,6,1,3,4,0,4,16,3,0,0,18,17,3,22,4,7,1,19,8,15,0,3,3,12,26,8,2,2,1,0,8,3,1,6,0,5,5,2,7,59,14,8,3,2,32,3,21,3,3,3,2,8,9,1,13,0,5,10,11,1,37,0,21,5,26,1,0,0,6,1,1,0,3,4,0,7,0,10,0,7,2,2,0,0,2,11,8,2,2,1,0,8,14,15,0,6,4,5,0,2,0,1,2,4,19,3,1,11,0,3,2,0,11,6,1,1,2,1,14,1,0,0,1,15,5,1,12,15,4,0,5,4,3,0,15,0,4,0,1,6,2,2,6,1,1,3,4,2,3,6,9,0,0,7,26,10,0,3,2,3,2,12,4,4,3,1,8,9,12,0,3,7,18,2,1,1,5,5,3,1,1,3,0,3,1,14,6,4,1,4,3,0,12,10,2,2,1,0,14,1,9,0,10,8,3,4,2,0,2,6,0,4,11,5,1,2,5,20,2,2,16,2,2,3,6,5,29,3,7,5,8,1,16,13,2,3,17,1,1,5,5,1,1,21,3,5,4,6,3,1,9,3,6,7,9,13,13,5,19,1,3,11,14,5,16,0,1,3,7,14,0,8,11,1,8,21,15,4,16,0,9,0,6,5,2,0,8,8,0,1,4,5,9,16,0,21,10,8,2,1,4,8,1,7,4,4,1,19,11,11,14,7,10,72,7,4,0,1,5,5,15,5,0,9,1,7,10,4,4,6,2,4,6,1,9,5,9,27,13,1,3,14,11,3,7,40,5,6,9,5,1,1,4,7,18,4,6,8,6,6,5,1,5,10,7,5,3,3,5,4,16,0,0,2,1,8,0,13,11,7,1,1,3,4,3,1,4,32,0,3,4,2,2,3,0,10,1,5,1,22,2,1,11,2,7,5,1,1,2,5,3,2,8,19,2,4,5,10,6,5,4,10,5,14,13,4,1,9,24,2,8,5,0,1,3,0,6,9,2,8,2,1,12,3,3,4,3,0,7,7,0,1,7,7,4,17,8,4,15,12,35,3,0,10,13,0,5,0,0,0,1,5,15,5,0,0,9,2,0,1,2,1,0,6,3,3,2,10,2,0,1,6,0,3,10,2,2,1,3,1,5,14,3,1,1,0,2,7,13,9,0,0,9,3,6,6,7,0,2,4,2,2,1,3,2,1,7,0,5,3,5,1,1,20,6,2,2,0,4,0,0,0,3,0,7,6,1,1,18,2,6,3,0,1,5,4,0,2,6,0,1,2,2,1,4,0,1,3,3,3,0,4,3,10,0,1,3,12,2,4,1,3,1,2,0,3,6,4,3,0,0,2,3,0,1,1,9,12,1,4,3,6,3,9,1,3,8,0,3,25,2,6,13,1,2,1,3,3,8,9,4,7,17,1,0,2,0,1,2,5,1,7,4,5,4,1,1,4,4,6,18,0,4,0,52,1,7,0,3,2,1,0,0,0,3,1,2,0,0,1,6,4,0,0
12,3,11,4,43,0,6,1,9,5,1,1,2,2,21,2,1,4,9,10,1,1,11,8,16,5,17,6,3,1,19,2,47,28,2,11,15,17,5,20,1,3,3,0,10,7,2,17,12,87,16,12,0,2,25,4,0,20,14,15,8,2,1,0,3,9,9,26,9,6,2,56,3,4,0,12,2,17,1,25,5,64,6,1,6,41,14,3,1,32,14,25,2,41,9,25,22,7,4,18,4,9,9,6,3,15,4,10,11,17,7,6,1,3,9,6,10,5,2,32,42,12,11,34,90,9,0,2,2,8,9,3,2,7,19,2,27,2,4,2,5,1,4,14,3,3,22,2,8,6,4,7,5,8,3,3,19,12,4,1,7,12,0,0,19,59,7,4,4,9,5,6,19,4,0,0,5,49,1,2,6,6,1,9,4,3,5,11,7,2,15,2,0,4,3,0,0,14,1,10,6,13,6,6,2,7,2,4,11,5,6,20,4,9,4,4,4,14,8,7,1,3,1,3,5,10,15,9,17,3,22,4,9,30,6,5,16,7,2,2,1,10,9,2,2,3,9,0,4,20,1,5,5,4,6,1,6,3,16,0,17,4,8,5,10,4,16,3,0,3,1,31,5,20,2,3,0,7,16,1,0,4,0,1,1,9,2,3,1,1,3,13,8,9,7,20,3,19,4,0,1,0,10,6,28,2,1,3,5,3,4,0,4,11,3,32,9,8,26,7,1,5,0,8,7,3,0,8,8,3,6,2,5,3,0,2,2,4,1,4,6,4,3,6,4,7,3,8,4,6,7,3,0,0,9,7,0,7,0,1,9,10,7,3,1,2,2,2,1,1,0,3,9,2,7,5,7,0,3,0,0,10,0,10,2,5,13,0,5,7,2,1,1,5,3,4,1,6,2,7,9,2,3,1,0,5,0,1,0,3,3,0,3,9,4,5,2,1,1,3,3,0,1,5,4,1,0,2,1,2,5,3,7,9,7,2,4,2,3,4,2,1,4,4,7,1,2,6,2,5,7,6,1,3,2,12,0,0,1,1,7,3,5,1,9,2,4,9,8,3,2,5,2,1,1,1,2,2,3,2,3,1,3,2,3,3,0,5,1,0,0,25,14,1,2,4,0,3,6,1,1,1,4,4,3,0,9,5,3,0,0,3,0,2,2,2,6,1,0,0,9,1,2,1,3,1,4,1,3,2,7,1,0,0,1,3,0,0,2,13,4,1,1,3,11,3,2,1,3,2,1,11,1,3,18,4,1,5,0,0,1,4,0,7,3,2,0,1,2,6,6,1,1,12,0,1,2,13,3,4,13,3,5,2,2,1,0,1,0,1,2,3,5,3,1,5,0,0,3,7,3,3,1,0,1,1,5,4,3,1,3,13,7,3,1,4,2,0,0,0,2,0,9,1,9,3,3,5,4,0,13,4,5,5,5,4,1,3,7,3,3,5,0,0,4,1,29,0,2,5,44,6,3,0,0,1,4,12,0,0,5,0,0,1,3,1,1,0,1,3,1,1,2,1,1,5,1,0,0,1,0,0,8,0,2,3,3,3,1,0,2,12,0,2,0,3,3,0,0,5,4,2,3,1,0,2,2,8,2,0,2,0,15,0,7,2,5,2,0,11,6,1,1,1,5,0,0,0,0,3,7,1,5,5,1,0,1,7,2,2,2,1,3,3,5,2,4,12,2,2,0,1,7,10,10,12,3,2,3,3,75,82,3,5,23,9,10,1,0,5,5,1,0,2,5,2,6,10,1,3,1,1,0,0,1,9,2,1,0,3,3,1,3,1,1,4,4,1,2,1,2,2,2,3,2,2,0,0,1,4,1,10,0,1,3,1,2,1,5,0,1,1,3,1,5,0,1,1,6,1,3,3,2,1,1,0,1,1,7,1,3,0,1,0,2,12,10,2,3,1,0,8,6,0,1,3,2,1,5,2,2,0,1,0,2,1,1,1,2,1,4,1,6,26,7,7,0,0,0,3,0,1,8,0,3,2,3,1,2,1,5,2,2,1,0,3,7,1,2,5,3,1,1,3,2,2,2,0,1,1,5,2,4,0,9,2,8,1,3,1,1,1,2,2,1,4,1,0,0,1,3,2,5,2,1,0,1,3,4,1,3,0,8,4,8,4,7,8,11,20,0,0,2,5,1,1,4,11,1,5,0,6,1,0,2,1,10,1,3,2,0,1,0,8,2,2,0,1,1,0,3,9,0,3,1,3,4,3,3,4,1,0,0,1,0,3,13,2,3,1,1
vessel,10,33,1,174,6,0,12,17,6,4,17,14,5,130,4,5,3,11,8,6,4,90,5,21,15,11,3,7,7,21,75,257,175,5,85,60,49,14,2,1,5,3,17,1,32,35,24,20,740,21,70,5,3,48,1,11,152,61,0,24,46,32,2,39,10,2,27,12,5,21,14,43,4,11,68,9,17,11,123,24,57,0,34,13,295,14,29,0,107,7,12,4,1,41,82,13,34,12,43,8,80,41,53,11,10,32,14,0,20,9,28,12,13,13,0,66,26,9,237,258,59,64,4,127,4,6,3,7,24,10,8,3,0,85,13,41,9,2,10,8,0,65,64,3,3,158,7,10,6,15,63,0,43,9,5,1,70,3,15,0,25,6,27,21,1,1,6,21,22,6,46,154,21,0,2,15,299,3,25,35,29,26,0,25,2,35,46,52,77,129,8,5,6,0,8,4,13,7,37,13,13,2,5,24,49,12,12,14,17,29,121,3,48,7,0,0,0,0,1,0,8,29,8,19,108,175,22,30,8,3,17,49,25,30,59,23,36,7,41,12,127,81,15,8,12,11,8,31,79,17,7,48,21,17,11,18,19,13,6,90,7,71,19,14,1,96,0,2,24,5,266,12,52,23,9,0,58,18,27,0,76,19,5,23,4,6,4,10,4,2,39,3,12,7,44,20,84,4,19,27,28,66,11,34,30,0,43,2,0,4,3,13,32,8,62,26,18,51,11,6,124,5,41,1,166,27,1,32,10,16,0,10,22,5,6,32,34,24,3,16,15,38,25,25,0,11,80,111,15,3,22,10,17,46,57,14,7,17,13,28,21,3,7,35,8,0,70,7,1,7,8,16,7,0,7,77,8,0,10,5,107,2,87,23,0,54,10,43,34,0,37,3,13,10,46,3,110,6,81,9,51,0,7,0,10,3,12,8,118,16,3,23,18,27,59,23,6,13,3,0,3,5,27,22,1,5,2,14,22,19,15,22,18,41,2,11,0,33,23,7,56,53,11,20,4,2,46,10,51,2,23,17,0,0,140,29,0,27,7,38,9,21,32,50,2,1,23,34,55,0,18,1,5,1,10,24,5,20,28,6,6,7,7,16,9,9,13,6,3,4,197,52,0,5,20,6,12,26,19,8,16,13,3,0,12,3,0,14,10,2,6,8,28,14,24,16,5,4,0,14,3,57,13,37,21,18,47,1,20,22,19,3,15,12,15,4,16,2,40,16,18,4,3,2,6,14,55,16,25,6,11,5,24,117,2,21,125,14,21,16,27,14,40,11,17,18,16,11,58,27,16,8,34,4,11,12,8,8,9,47,29,24,18,21,15,1,17,6,18,15,35,55,26,13,6,2,9,2,128,22,29,9,3,4,24,27,8,22,8,9,30,69,9,12,81,13,30,2,11,3,21,2,5,21,4,15,23,16,20,46,6,44,38,33,8,3,3,20,15,68,41,1,10,14,17,101,14,22,4,593,87,13,2,16,20,20,38,43,12,58,6,25,45,81,25,9,15,3,7,25,23,3,62,27,65,13,4,16,23,7,8,127,39,19,28,6,15,4,10,104,25,7,38,57,20,28,20,9,40,23,11,19,4,11,10,19,19,19,3,9,2,56,12,66,52,20,14,19,12,14,21,6,15,47,8,20,9,1,5,8,13,24,13,5,6,3,207,11,28,7,7,18,23,105,106,12,29,1,1,23,13,3,16,57,13,5,18,27,5,58,41,4,8,19,28,11,12,9,1,4,6,2,3,62,5,15,8,0,2,11,0,4,20,1,14,11,6,5,7,28,10,12,2,13,19,9,4,8,12,2,7,20,34,5,1,5,8,3,21,17,44,8,233,20,49,13,3,20,10,36,11,8,7,59,3,9,0,15,7,0,6,9,0,6,14,4,24,30,41,13,11,10,0,6,24,41,7,9,18,28,120,47,24,7,2,4,2,14,39,4,47,18,20,5,7,12,7,4,30,29,0,4,6,6,4,8,24,39,12,3,10,16,2,17,18,7,6,9,6,5,5,41,0,14,15,61,6,5,19,8,10,6,3,22,0,30,5,7,20,58,6,9,25,28,46,27,13,59,1,9,15,12,21,34,8,18,9,29,7,1,15,4,20,10,11,5,9,18,15,19,9,18,10,1,8,22,10,41,23,13,2,9,1,10,5,16,8,41,57,7,0,11,9,5,10,1,8,4,0,32,10,7,15,10,16,23,1,4,6,12,22,8,9,4,14,1,16,12,107,8,0,2,15,0,0,0,0,18,3,0
interior,0,5,4,80,2,0,4,14,0,4,6,2,3,26,7,1,3,11,1,1,1,22,0,13,16,5,0,1,0,7,4,119,63,2,21,10,5,7,6,3,3,2,5,2,19,2,5,9,94,0,23,2,10,12,8,1,21,98,0,14,16,0,3,4,11,0,24,1,0,40,14,6,2,3,26,7,4,4,39,3,31,0,10,4,102,2,11,0,17,0,2,2,0,20,35,1,12,7,20,9,21,22,11,1,2,20,2,7,9,1,6,6,4,10,0,11,1,3,34,102,24,3,2,23,2,1,4,0,3,0,5,1,2,27,5,37,2,3,3,1,0,14,7,3,0,35,0,15,23,19,22,0,13,5,3,8,5,5,0,6,2,10,2,1,1,2,3,9,18,3,12,44,14,0,0,2,91,2,4,9,16,6,0,3,7,1,17,6,12,14,2,0,4,0,1,0,13,3,1,5,9,0,1,8,6,3,4,33,4,28,45,4,13,3,0,0,0,0,24,8,5,5,3,12,27,73,17,5,8,1,10,13,12,15,15,6,11,8,3,6,32,18,8,0,4,5,3,17,19,4,8,2,4,7,11,8,6,0,2,17,0,16,11,0,2,112,21,0,2,5,65,7,27,8,7,0,15,7,15,6,19,3,3,9,4,2,2,7,5,0,3,0,6,6,3,7,16,1,2,10,6,32,2,1,4,0,7,3,5,2,0,7,9,1,7,13,11,21,6,7,19,7,5,8,19,2,6,5,1,28,0,12,3,7,0,22,11,7,0,4,5,6,12,6,5,11,18,26,14,2,6,5,9,24,8,5,0,4,7,16,17,7,8,19,0,0,16,2,1,5,4,5,1,0,1,14,9,0,4,9,19,1,17,6,0,101,0,8,16,1,11,1,5,4,17,0,53,10,15,4,8,2,3,1,0,6,6,0,11,7,2,3,2,16,0,13,1,4,5,0,2,5,8,1,2,2,0,4,3,8,1,2,5,5,3,0,0,3,5,1,12,19,6,0,0,1,2,6,26,1,5,4,0,0,16,5,0,2,1,8,8,6,32,10,6,0,11,5,7,0,7,2,3,1,0,2,2,6,10,2,4,6,4,0,2,1,10,0,3,4,57,31,6,0,2,5,7,5,2,2,4,6,0,0,6,0,7,7,1,6,5,2,0,1,7,17,2,4,0,2,9,9,2,5,2,7,17,2,12,12,6,0,16,5,9,5,2,4,19,19,5,1,1,0,6,6,0,10,10,4,2,0,0,16,5,4,21,1,3,9,7,4,15,0,10,10,2,10,24,26,3,2,20,0,8,0,2,4,2,7,1,12,13,4,4,2,6,5,1,1,3,18,3,2,11,6,0,1,14,9,13,0,2,0,3,9,2,12,8,9,15,18,10,2,14,1,18,0,1,3,5,0,1,7,4,1,8,12,7,17,3,47,4,9,6,0,10,0,3,10,1,1,1,12,1,164,6,3,5,47,2,11,1,2,3,0,13,0,3,14,2,2,1,0,0,3,0,10,9,6,8,2,21,5,9,3,18,6,0,7,0,8,7,4,22,2,2,1,2,19,4,5,17,24,3,12,2,5,2,5,8,4,5,3,5,5,8,1,3,6,1,7,4,6,6,24,3,4,2,6,3,2,1,14,0,17,7,0,3,5,9,14,6,0,10,15,26,5,36,12,11,7,4,2,3,1,5,7,3,2,11,4,4,12,5,24,3,7,4,9,3,7,0,0,12,8,7,3,13,24,2,5,0,6,1,3,3,6,89,8,21,4,8,3,4,8,3,1,1,19,2,7,5,6,10,7,4,15,6,3,6,2,1,3,4,2,0,5,15,6,2,3,4,1,2,2,3,4,8,7,3,3,0,9,15,0,1,5,1,0,3,3,4,12,2,3,2,13,1,7,1,1,0,3,0,5,8,6,14,7,0,9,6,8,7,8,6,18,2,0,2,1,3,4,2,7,11,5,1,29,23,3,3,1,3,1,0,0,8,1,1,2,6,5,36,4,3,6,3,1,0,12,1,1,4,3,6,4,9,1,9,0,1,13,0,1,0,0,2,14,4,1,2,14,2,2,2,4,1,2,4,1,7,2,0,6,1,3,1,1,8,0,4,2,5,1,2,5,8,5,4,2,9,1,2,15,1,19,22,0,3,2,5,1,8,5,2,2,12,4,30,8,4,1,1,8,1,29,0,7,28,1,2,0,1,3,0,2,14,6,0,2,3,1,2,0,0,4,1,0,0,3,11,0,1,3,0,4,1,0
pension,0,1,3,79,8,1,0,11,0,0,4,0,5,19,6,3,1,1,3,6,0,7,8,4,10,7,0,2,2,13,1,99,28,13,20,7,5,2,2,0,0,0,0,8,37,6,5,10,29,0,10,0,1,10,6,0,14,40,0,4,5,0,0,1,10,0,38,2,0,5,27,1,0,7,29,2,8,3,35,8,83,6,2,0,70,19,6,0,45,1,9,1,1,6,15,10,16,14,15,0,7,13,8,2,1,18,9,2,11,2,5,0,6,4,1,19,5,1,60,59,8,10,10,129,6,0,0,2,1,0,2,1,8,15,1,43,5,7,0,8,0,7,28,3,0,24,1,0,14,24,4,1,1,0,0,7,7,2,2,9,18,0,4,0,0,0,8,9,22,4,5,19,4,0,3,7,105,1,0,6,32,1,4,12,1,0,11,1,3,9,0,1,0,1,0,1,12,11,8,4,7,11,3,0,19,1,1,29,1,7,31,0,15,10,0,5,0,4,46,0,9,3,0,3,12,60,16,20,5,8,2,15,15,5,16,20,6,2,0,1,31,7,5,0,0,21,1,3,33,2,6,8,2,8,1,6,2,1,0,74,8,2,4,4,2,42,5,1,2,0,24,19,97,1,9,1,16,35,2,0,38,10,0,11,9,1,6,10,6,3,0,2,8,10,1,0,19,1,4,7,4,25,24,2,0,6,9,1,3,0,0,3,8,2,44,16,18,22,0,0,13,2,2,0,5,0,0,14,4,4,0,6,2,0,0,25,4,2,0,4,2,2,5,2,4,2,28,12,12,7,6,3,2,6,2,2,0,0,4,46,21,5,2,8,0,2,4,0,10,10,0,25,4,4,10,51,0,1,0,6,6,1,12,3,7,8,1,7,24,0,13,1,2,0,4,2,6,3,9,0,1,0,5,1,3,2,3,0,0,5,0,1,0,5,0,0,0,9,3,0,1,2,3,1,4,0,0,2,1,9,0,1,10,8,1,0,0,0,5,1,0,10,1,0,1,0,2,1,8,4,10,0,7,1,11,3,0,4,5,6,2,7,8,16,0,0,8,4,0,5,11,0,1,0,0,5,0,0,4,4,1,3,0,0,1,0,8,1,3,11,100,17,0,0,0,0,6,18,1,0,2,3,5,11,7,2,0,5,5,5,4,2,5,5,3,10,0,0,0,1,2,0,3,0,2,53,3,0,3,4,2,0,3,4,4,5,0,0,12,3,0,0,0,2,2,0,0,3,2,0,1,0,3,30,8,5,1,1,3,2,8,5,14,1,2,5,1,3,12,4,1,5,14,1,2,0,3,2,4,37,1,9,0,6,3,0,1,7,4,0,5,6,44,16,3,1,1,2,1,2,3,0,0,0,8,12,13,1,5,4,7,8,1,0,28,0,4,0,4,2,2,1,1,12,4,0,1,6,1,14,0,11,3,9,2,1,6,7,8,1,23,2,5,2,0,29,2,2,4,12,0,0,0,4,1,30,7,1,0,7,6,1,0,0,1,0,0,3,2,7,11,0,2,2,55,3,1,7,0,1,0,3,3,1,1,8,3,3,2,1,2,5,3,5,3,4,2,0,3,5,0,1,2,6,3,1,5,1,0,1,0,16,1,9,3,43,1,4,2,6,2,0,2,10,0,1,2,4,20,0,2,0,1,0,2,2,27,0,6,1,2,0,0,0,0,0,32,0,7,20,0,13,37,85,49,6,6,6,4,38,16,8,4,9,6,5,2,4,2,3,2,0,2,28,3,4,1,2,6,1,0,0,9,2,9,2,4,1,3,6,0,5,3,2,3,14,0,7,2,1,0,1,6,12,1,0,0,2,16,1,1,0,2,1,0,3,0,2,1,2,1,29,2,1,1,4,5,5,1,0,33,1,1,1,0,3,2,17,0,8,2,0,0,0,0,3,5,0,3,1,0,2,1,6,1,5,1,1,1,2,0,9,2,0,0,6,0,2,0,5,57,0,3,0,6,3,0,0,2,0,3,11,0,1,41,0,0,0,1,0,1,1,1,0,4,0,1,0,3,5,1,0,3,0,0,0,0,0,2,0,1,3,0,19,4,0,0,0,2,6,3,0,4,2,0,4,0,0,2,3,6,12,0,3,0,8,3,3,2,3,2,2,43,12,5,42,3,26,22,3,2,0,1,0,16,7,0,0,10,1,2,3,1,7,3,4,29,1,0,2,0,3,0,8,0,1,34,6,2,2,0,0,3,0,1,1,2,2,0,1,3,0,4,1,1,25,10,0,0,0
majority,3,48,43,120,3,6,1,57,1,1,12,6,3,12,3,3,7,8,3,4,0,17,8,26,6,5,13,9,4,11,3,47,38,5,27,10,8,3,1,2,2,1,0,1,20,10,20,2,188,20,21,7,0,9,2,0,26,5,5,1,6,0,0,3,18,7,113,3,4,3,1,0,3,3,57,5,10,1,23,13,3,0,5,2,66,1,2,0,12,0,2,1,4,9,18,1,10,3,15,3,2,6,10,1,3,15,0,1,4,6,7,0,0,2,5,9,0,1,44,92,10,12,2,24,1,1,0,4,3,0,3,3,3,14,14,17,7,0,3,8,1,14,16,2,1,44,5,2,3,3,38,1,5,0,0,13,10,3,2,8,2,0,8,3,4,5,0,11,19,3,2,64,6,2,0,2,81,5,5,3,6,2,1,5,6,4,7,7,41,19,31,0,0,0,0,0,6,2,10,3,5,3,1,7,11,6,4,21,2,2,33,0,67,2,1,1,0,0,15,0,1,12,2,9,20,71,6,17,1,1,12,6,4,10,8,0,19,2,2,2,34,17,4,3,13,2,0,8,22,8,3,7,8,7,3,3,1,0,0,11,5,8,16,2,4,3,0,8,4,1,91,0,1,1,5,1,9,0,6,2,15,1,2,4,7,2,0,4,7,0,0,4,20,1,2,0,17,0,3,18,6,14,0,3,4,1,5,3,3,0,0,7,6,2,3,2,2,22,14,2,9,3,15,2,41,1,3,7,1,18,71,3,5,3,11,4,5,6,0,5,0,3,5,1,2,3,21,17,3,7,7,1,9,3,13,0,13,0,4,14,8,1,1,6,2,1,39,8,9,14,1,14,5,8,16,6,3,3,6,5,69,0,13,3,1,4,2,7,16,0,17,2,74,35,19,7,21,0,5,1,9,6,3,9,8,4,2,0,2,4,4,4,0,7,0,4,0,9,0,1,0,2,8,6,3,5,2,1,14,9,0,4,1,3,4,2,0,2,0,2,5,15,1,1,3,1,2,2,11,1,3,4,0,2,16,16,1,16,3,11,11,16,19,13,0,0,8,1,2,2,2,2,0,0,5,6,1,55,3,2,10,3,0,9,2,12,3,1,7,0,5,19,1,4,0,2,0,1,7,9,2,10,0,0,0,6,1,16,3,11,0,0,10,1,10,12,8,8,3,3,1,14,2,17,8,1,8,0,2,8,10,1,0,7,11,3,0,13,18,4,5,2,15,3,1,2,5,8,8,0,126,6,1,20,5,4,3,0,10,3,5,7,8,2,9,4,17,7,18,16,4,2,0,0,1,10,5,0,3,10,0,4,8,8,5,0,1,3,9,10,23,7,1,1,20,2,1,2,9,9,15,0,3,8,1,5,1,18,3,1,22,9,6,2,24,11,11,0,8,0,3,0,1,6,0,6,0,0,9,13,0,5,29,32,2,7,3,1,4,0,7,4,13,4,1,9,1,3,8,63,3,5,6,11,3,5,27,12,11,10,9,1,28,4,3,3,0,7,2,7,9,7,6,27,11,4,3,3,1,1,5,21,4,0,0,5,2,2,3,3,8,2,5,1,1,1,3,0,13,6,1,2,2,0,13,2,4,4,4,7,7,1,5,18,3,4,0,1,5,1,4,7,2,14,0,0,2,0,3,11,2,4,0,4,6,0,1,2,34,6,5,0,0,2,0,0,1,2,2,4,5,0,0,2,0,4,3,5,4,0,0,0,3,0,4,1,1,0,2,2,4,3,0,6,3,3,4,0,3,4,4,6,3,2,38,0,1,1,5,1,2,13,4,5,3,12,0,7,2,3,0,0,12,10,3,0,4,2,6,0,0,0,0,4,0,2,2,20,1,12,0,3,2,0,0,2,8,12,1,2,5,1,11,1,8,10,1,10,2,1,0,14,7,11,0,1,2,6,0,7,18,9,5,0,0,0,2,0,3,1,0,7,1,1,4,0,2,7,2,3,0,3,0,0,1,6,0,0,13,0,4,2,7,1,5,2,0,5,1,0,3,0,0,0,4,1,1,9,3,2,2,1,1,1,48,3,2,1,2,12,1,0,4,0,12,3,2,0,2,1,6,4,5,6,0,3,2,1,0,2,4,2,6,3,0,2,0,5,1,0,3,6,0,0,2,2,0,0,4,0,0,5,2,1,2,0,2,0,2,1,1,0,0,4,2,0,0,0,1,1,2,6,3,1,5,0,0,3,1,1,0,1,10,0,2,1,4,0,0,0,1,1,0,1,0,0,0,0,1,2
ocean,4,1,1,56,7,2,5,21,3,0,20,9,7,41,5,2,1,6,0,0,4,20,0,8,7,4,5,1,2,5,13,94,88,2,32,30,26,7,3,0,0,7,9,0,9,16,23,3,207,35,38,2,5,36,0,6,20,13,1,10,18,17,1,2,13,0,39,2,9,12,5,19,3,1,64,7,13,2,53,9,36,0,9,6,108,10,11,0,27,1,5,2,0,19,34,2,14,5,19,7,26,20,14,4,9,15,1,2,22,3,7,4,4,3,0,18,0,0,33,120,30,12,8,28,2,0,1,2,2,0,17,7,5,30,9,36,3,1,10,1,1,17,7,3,2,36,7,10,19,3,61,3,3,11,4,2,8,5,4,5,6,4,5,1,2,7,3,15,7,6,27,51,11,3,4,2,99,2,8,13,7,6,1,8,1,5,23,12,27,76,1,6,3,1,1,1,7,1,3,3,3,2,1,13,20,5,2,15,7,29,42,1,19,5,1,2,0,2,4,1,1,15,4,13,28,40,11,23,10,8,16,21,7,14,30,11,24,4,6,3,29,19,6,5,10,0,10,8,14,4,6,9,13,5,8,4,4,0,2,16,0,21,7,2,2,11,1,1,6,4,81,5,6,14,3,0,29,12,11,1,38,4,0,13,3,1,0,7,2,0,1,0,2,3,1,9,20,5,7,17,9,28,0,1,14,0,8,1,1,1,1,15,17,2,5,9,21,21,2,2,36,6,19,2,68,8,3,10,1,16,0,4,5,9,7,6,21,5,0,2,7,14,8,7,6,20,15,39,11,1,9,7,6,29,22,5,0,0,12,11,9,7,16,7,16,0,30,5,1,11,3,6,7,1,8,16,5,0,11,2,45,4,20,10,2,35,0,10,14,0,13,0,4,5,23,12,38,1,21,2,12,6,6,0,1,6,2,1,34,5,2,21,7,12,11,7,6,5,2,1,2,16,10,10,1,5,3,4,8,10,0,2,0,3,0,4,0,10,11,2,14,37,5,20,7,6,9,4,18,12,12,6,3,2,67,9,0,4,5,16,3,15,18,13,1,5,6,16,23,0,14,5,8,3,3,5,4,8,9,9,5,14,19,5,12,1,8,0,5,0,58,23,0,1,10,4,3,4,1,3,11,6,3,0,9,5,3,4,2,3,0,3,4,2,7,5,2,5,0,9,2,15,12,15,3,6,15,0,11,15,3,2,7,7,4,3,7,4,30,10,4,2,0,1,8,5,0,11,10,4,17,3,3,32,2,7,75,2,4,5,17,5,7,5,12,8,9,7,27,13,6,4,19,6,5,19,2,7,10,14,0,14,17,13,6,4,6,4,4,6,20,37,1,0,2,2,2,1,31,15,11,3,1,5,8,15,4,8,0,16,14,8,2,8,13,8,30,3,1,4,5,0,5,5,0,6,15,11,11,25,5,7,8,12,4,6,2,3,4,12,8,0,3,9,11,15,3,3,0,130,24,8,9,2,9,10,27,13,0,14,8,29,4,27,4,1,4,7,5,8,13,10,44,4,21,7,2,2,8,11,13,26,8,11,11,1,4,1,11,54,6,3,18,109,0,10,7,6,3,3,10,3,2,5,3,5,21,10,0,0,1,3,3,23,17,3,2,8,2,2,11,0,3,21,6,12,6,1,2,7,2,7,1,1,2,2,39,0,37,11,7,11,3,29,49,0,14,9,3,5,3,1,0,4,2,5,9,15,3,5,5,2,2,1,20,8,3,6,1,9,2,8,2,5,3,10,4,0,11,6,4,3,13,2,8,11,7,4,7,2,3,2,8,3,12,15,2,9,0,1,1,7,8,2,1,2,3,4,8,1,3,10,22,4,5,2,3,8,2,9,2,1,7,5,9,5,1,3,1,5,5,9,2,6,5,4,4,13,10,1,1,4,3,3,7,11,4,8,2,8,29,24,3,13,3,2,3,6,2,0,5,3,2,3,4,3,1,3,11,5,1,3,1,4,5,5,4,9,5,6,0,4,0,3,4,1,1,2,14,5,20,32,0,2,6,6,3,1,2,0,2,3,4,4,7,3,33,8,2,16,2,2,4,3,3,1,8,21,3,3,8,7,2,5,3,3,4,7,4,0,4,3,2,13,4,1,2,3,3,6,1,7,1,1,1,4,2,3,1,1,1,1,4,5,3,2,18,38,6,2,0,17,0,5,0,32,7,2,1,1,11,3,8,5,4,12,1,8,14,6,14,4,5,0,3,0,9,4,19,2,5,1,3,0,0,0,0,3,2,0
enemy,3,12,3,36,10,8,0,22,2,3,9,6,5,78,2,14,1,9,7,17,3,30,5,16,8,2,16,12,3,30,35,147,149,7,37,88,42,2,8,8,5,15,0,3,28,12,17,8,136,43,68,13,4,43,3,14,29,6,4,11,3,4,2,4,7,13,59,2,5,121,6,14,5,3,75,15,17,2,68,10,14,1,6,14,82,5,21,0,18,1,7,6,0,24,25,0,13,4,50,7,5,34,16,4,10,29,1,13,10,1,12,8,3,8,1,23,2,4,31,277,33,17,1,34,10,4,3,3,2,0,12,3,7,49,21,26,3,0,7,11,2,28,23,2,1,43,2,12,27,25,79,2,8,4,4,4,22,14,9,11,4,1,8,4,3,13,11,12,20,6,15,122,21,4,5,6,103,3,6,32,12,6,2,18,6,14,29,14,23,33,3,7,1,1,3,4,12,7,9,6,6,2,1,10,21,2,1,6,5,38,60,27,3,9,5,4,0,2,3,4,2,35,3,25,44,51,25,22,9,4,17,8,3,19,25,3,22,13,6,10,45,21,23,8,20,1,9,34,26,2,1,7,16,1,8,7,5,4,1,24,0,96,10,1,7,10,0,8,7,3,116,0,7,6,4,2,35,5,5,0,61,0,4,10,6,3,1,4,20,3,3,0,0,3,1,4,18,3,4,14,23,12,1,1,1,0,19,4,5,0,0,3,25,4,17,24,2,16,24,6,36,16,28,0,45,0,6,35,4,76,2,15,17,0,9,5,18,5,0,7,11,15,22,18,3,16,16,49,12,2,6,3,13,23,27,0,9,5,5,21,5,6,4,24,5,7,27,5,4,8,0,20,2,7,4,26,11,2,17,5,37,0,34,9,8,16,5,4,24,4,15,9,2,2,31,6,13,13,22,3,13,2,18,3,2,5,4,3,13,4,10,7,2,10,2,44,0,24,0,18,8,12,12,11,6,2,5,18,15,20,0,0,0,5,4,3,0,7,21,3,14,14,2,19,4,6,14,18,24,6,17,5,8,5,32,9,3,17,8,12,5,24,42,68,25,4,16,8,5,3,25,15,3,3,4,28,4,1,7,5,14,6,6,0,12,4,5,13,4,2,269,18,21,5,8,3,4,8,8,5,7,13,0,0,1,3,0,21,1,3,10,1,2,2,5,2,0,5,2,14,3,9,5,11,9,5,36,3,10,12,10,5,78,7,5,14,6,4,27,10,17,0,9,5,2,4,3,8,12,1,29,2,1,16,2,3,25,5,5,5,13,1,4,2,26,6,19,2,30,24,5,6,1,5,2,11,0,1,6,19,2,37,30,12,1,11,3,7,10,10,27,16,6,4,11,5,11,3,9,13,20,4,12,0,0,16,3,8,0,7,12,0,4,1,20,4,15,1,4,5,7,0,7,7,5,3,4,9,10,33,0,17,8,23,17,0,5,7,4,16,22,2,2,31,3,6,1,0,1,81,22,6,5,0,10,20,24,7,15,11,1,1,0,14,2,0,0,8,4,9,17,7,55,5,5,3,0,3,0,7,0,20,8,4,6,2,3,3,11,46,7,8,4,19,9,7,10,1,14,7,4,5,0,4,5,10,20,15,2,0,2,3,10,13,7,98,28,5,7,6,41,12,17,32,6,16,19,1,5,6,10,10,1,8,0,41,44,16,23,4,22,19,1,25,17,3,8,4,6,8,27,0,1,2,1,10,1,4,1,2,0,8,0,0,19,2,7,5,1,3,5,3,1,7,3,3,4,1,5,8,4,5,16,1,7,4,5,4,9,5,4,2,0,4,4,9,0,1,3,0,0,9,11,4,17,6,5,6,13,6,6,2,17,9,3,1,2,10,19,10,3,5,5,6,4,5,4,3,1,11,0,8,9,41,11,12,6,24,13,4,3,1,2,4,15,1,3,0,0,15,5,10,3,1,1,1,13,1,2,2,2,11,1,6,4,5,7,1,5,1,1,3,1,0,3,6,2,13,3,1,1,0,5,11,0,0,7,0,13,1,11,0,0,2,8,6,10,7,1,30,17,6,16,11,7,4,0,0,0,5,3,0,8,0,9,11,2,3,17,2,13,3,3,13,3,4,7,3,1,1,1,2,7,15,8,1,4,4,1,2,2,10,0,0,0,1,0,5,1,8,3,2,9,4,1,1,12,13,6,3,0,2,0,4,1,10,28,0,2,11,1,6,8,5,1,1,5,17,1,12,0,6,4,1,3,0,10,2,7,0,9,0,10,3,0,0,0,10,0,7
bind,0,34,4,77,9,2,1,29,2,3,16,4,4,48,8,5,2,7,4,1,2,14,7,27,11,5,9,19,8,15,6,92,57,4,38,34,27,2,0,7,1,8,0,1,15,19,23,5,220,14,35,2,3,24,0,1,38,2,2,4,11,5,2,7,7,4,64,2,3,5,4,2,3,0,44,11,8,3,41,13,12,0,2,6,129,6,6,0,12,0,4,2,0,15,34,2,9,4,17,7,11,15,20,5,6,8,0,0,6,3,9,2,0,9,1,21,3,3,33,121,22,8,1,31,4,6,2,6,2,0,8,0,5,18,12,18,11,0,6,4,5,11,17,1,5,22,2,4,3,4,67,1,8,6,0,11,13,5,9,6,4,1,5,0,1,1,6,7,11,10,22,58,13,1,5,8,102,1,13,15,9,9,1,7,8,9,14,11,21,37,1,1,3,1,0,1,8,3,8,19,7,0,1,4,13,7,6,14,5,22,45,1,21,1,0,3,0,0,10,2,2,20,0,7,22,68,6,14,6,2,3,15,3,15,11,5,23,3,2,3,48,10,6,2,3,2,8,17,20,10,5,10,15,7,8,11,5,1,1,2,1,13,17,2,4,5,1,5,15,5,78,2,4,2,1,0,17,1,7,0,47,4,0,13,12,2,2,8,3,2,0,1,27,0,1,4,18,1,1,8,12,12,0,0,7,1,12,0,3,0,1,4,12,9,14,7,4,13,5,2,26,4,23,0,64,7,2,11,3,28,10,9,10,1,5,17,16,1,2,7,3,1,2,6,2,1,26,35,12,2,5,5,5,8,9,4,1,4,7,10,9,2,5,6,8,0,20,4,3,8,1,7,4,4,1,8,4,1,17,3,56,5,19,9,1,11,4,8,15,5,15,1,15,13,22,10,42,3,17,0,20,0,3,0,1,4,0,0,17,3,3,7,2,10,21,3,1,4,1,0,2,6,13,9,0,3,1,9,11,14,4,3,4,3,3,3,3,3,5,5,6,9,2,5,0,1,5,2,17,3,7,6,4,1,31,7,1,7,2,25,7,8,11,12,4,3,5,5,3,1,15,4,6,5,3,7,5,9,4,3,4,4,3,5,1,6,3,6,2,1,48,23,0,4,3,3,1,14,4,2,5,3,1,0,2,8,1,7,5,7,2,9,4,1,7,15,3,6,2,9,4,13,6,32,4,3,12,0,9,23,4,7,4,12,7,10,10,6,18,4,2,1,1,0,10,7,1,10,10,2,70,5,2,28,3,3,13,0,4,4,24,2,11,6,15,6,4,5,23,17,5,4,3,7,4,7,5,2,5,6,4,5,8,13,9,4,0,6,3,7,18,17,5,0,9,2,4,1,53,10,10,2,6,15,1,10,5,16,1,0,12,7,3,1,15,8,9,0,9,1,5,2,0,5,0,2,13,3,9,16,2,7,14,14,2,2,1,4,3,4,5,1,12,10,5,5,4,2,6,102,24,3,6,6,5,7,25,10,6,13,3,5,18,21,4,7,5,4,2,7,10,5,41,17,19,4,0,9,10,1,4,22,10,2,5,9,32,3,4,4,13,1,8,6,4,5,4,7,4,12,2,2,3,1,5,3,7,6,6,4,4,6,11,23,15,6,1,6,1,1,13,0,5,5,1,0,6,0,0,11,5,7,1,4,1,0,3,0,46,9,4,3,0,2,4,1,7,2,3,6,5,1,0,1,0,4,5,6,1,0,0,4,2,0,9,4,3,4,0,4,0,1,0,8,0,5,11,2,5,7,4,2,15,2,5,6,8,9,3,2,5,4,2,3,4,8,6,2,0,1,2,3,8,2,3,0,8,8,8,4,4,3,5,7,5,2,3,5,4,11,4,1,10,4,1,5,1,14,5,8,2,3,7,6,3,6,16,16,7,3,0,3,2,8,3,11,2,9,3,3,23,9,5,7,0,0,2,0,14,1,3,4,5,2,1,9,4,4,4,6,3,2,0,8,6,3,0,11,6,1,7,4,3,6,2,1,3,2,5,4,9,1,0,8,4,7,3,3,4,6,4,7,2,6,8,2,0,17,1,18,2,1,7,6,7,1,1,3,2,1,10,2,4,4,4,6,2,9,2,1,3,2,5,1,5,3,2,4,6,7,5,5,0,0,0,8,5,3,7,4,0,6,5,0,2,0,3,5,4,0,2,1,2,1,0,7,1,3,6,3,6,1,0,5,0,2,4,8,6,8,2,3,2,3,1,0,16,0,18,2,2,0,3,3,0,0,0,3,1,1
rise,13,12,12,68,5,21,2,15,1,6,6,7,26,75,2,3,9,9,15,5,3,23,21,32,17,16,25,27,18,23,8,92,86,13,46,75,25,8,67,10,4,24,7,16,22,23,7,10,163,52,41,15,15,66,16,3,31,8,20,14,26,7,3,6,21,12,103,32,8,6,32,0,2,1,103,19,21,8,60,37,62,27,9,13,131,11,7,10,10,2,14,2,44,16,35,25,25,4,32,14,5,24,14,11,13,22,5,7,23,7,17,2,26,15,22,42,2,5,57,130,30,38,24,113,19,1,7,10,4,5,25,6,15,30,14,47,5,13,6,21,9,36,29,8,3,44,11,31,8,23,37,8,10,5,17,21,27,10,8,31,46,4,3,4,23,19,5,23,21,8,13,77,14,9,11,7,87,4,2,45,13,8,26,28,1,28,25,18,32,33,3,8,8,5,3,4,14,4,6,12,38,6,6,4,15,20,5,26,4,12,99,18,19,8,9,18,6,9,6,1,5,25,3,11,28,25,29,19,6,21,15,12,21,26,31,22,30,8,24,15,41,27,13,10,8,9,5,21,22,10,5,18,22,4,5,7,3,7,3,9,4,20,7,5,6,14,23,16,16,6,53,11,20,4,1,3,9,24,8,0,59,10,3,12,19,3,22,26,5,1,0,4,7,12,5,6,20,3,2,16,19,9,6,3,12,5,20,5,11,8,4,17,27,10,30,6,11,36,9,5,28,5,29,19,74,4,10,50,1,23,3,10,4,0,7,6,21,4,0,9,16,16,21,15,10,4,29,38,21,12,9,8,2,25,17,2,5,3,9,37,10,12,7,13,8,16,19,8,14,28,1,24,6,15,19,22,7,6,12,6,31,2,20,11,8,31,10,20,13,4,9,7,1,1,15,6,31,0,12,7,10,13,4,3,3,16,4,3,18,10,7,5,9,11,25,4,4,4,3,10,3,7,14,5,11,1,2,8,8,5,7,2,1,6,7,2,1,3,20,3,6,8,4,14,3,5,15,9,21,17,23,6,15,0,30,11,8,8,3,13,17,24,23,17,1,2,28,11,10,4,22,14,4,13,9,14,9,7,14,8,4,8,4,11,9,6,8,10,5,2,73,22,2,11,7,2,2,10,8,16,13,1,6,8,5,16,18,9,2,11,6,5,7,5,9,14,5,2,4,13,4,10,1,28,7,1,19,5,9,10,12,2,3,5,0,6,6,10,17,14,3,0,3,33,14,6,3,19,1,5,12,1,1,33,0,2,16,10,6,4,8,0,6,0,7,12,8,8,9,24,8,3,3,2,2,1,5,8,8,20,10,4,14,19,6,2,6,7,3,8,14,26,7,3,16,4,20,15,19,14,12,10,4,1,5,14,3,13,7,0,29,4,1,6,15,12,5,10,5,1,6,4,0,4,3,1,4,4,18,10,8,6,24,17,3,4,15,3,4,7,10,4,9,9,5,7,10,0,0,95,14,8,9,0,5,9,19,18,1,8,6,4,4,13,3,0,1,2,9,7,5,4,8,7,9,9,0,2,5,6,2,17,6,1,1,1,9,5,3,3,3,20,10,8,2,4,9,2,13,6,5,8,1,2,5,5,18,8,9,5,1,2,4,24,14,8,12,12,3,1,3,2,0,4,2,8,3,3,1,10,1,6,5,9,1,2,4,8,15,11,11,1,3,2,7,2,12,6,5,5,9,3,1,11,15,7,11,1,3,25,23,16,1,7,15,11,8,3,13,3,4,6,24,9,3,7,11,3,3,3,0,1,5,3,9,8,6,0,5,10,7,3,2,0,2,6,3,8,1,0,3,3,17,2,11,5,11,4,15,6,0,2,4,5,3,5,1,3,1,8,1,2,3,3,1,4,3,2,3,5,6,4,4,1,6,7,16,24,18,0,5,2,2,2,14,0,5,2,2,3,38,5,0,4,0,1,8,6,0,3,7,6,5,3,5,2,8,0,17,2,1,2,2,4,11,4,5,3,5,3,1,1,0,2,0,0,1,4,4,0,5,8,6,3,12,0,6,0,6,10,5,2,4,8,4,2,1,1,2,15,6,4,6,7,2,2,2,7,5,2,3,1,1,6,7,3,1,8,2,5,2,5,4,7,3,3,4,1,10,5,1,4,10,5,2,5,9,6,10,0,0,8,6,5,2,0,1,5,3,2,4,4,6,1,8,15,2,0,3,8,8,0,1,10,2,5,6,2,3,3,3,6,5,3,7,3,3,16,26,8,4,1,1,1,9,23,11,0,2,8
share,3,6,12,69,8,16,7,24,2,1,8,5,13,65,1,5,11,6,13,8,2,17,24,25,13,15,20,32,11,22,5,85,86,27,49,84,43,7,6,8,19,32,9,7,29,6,11,8,133,73,28,21,28,67,17,6,19,8,18,20,12,9,5,10,10,10,88,12,7,5,21,4,6,7,102,14,25,5,37,31,40,7,9,7,104,15,6,0,13,1,9,5,3,24,30,1,9,8,28,9,3,13,18,11,8,13,0,5,11,2,13,1,15,18,11,20,0,2,24,56,25,50,15,52,8,10,9,3,1,2,19,5,12,39,23,62,6,3,6,10,8,17,12,3,6,52,7,16,17,5,29,4,10,6,5,17,48,6,7,48,14,1,6,3,10,25,1,23,19,7,14,72,21,5,17,9,49,2,6,32,19,7,18,17,4,18,23,12,10,27,1,2,4,5,3,3,12,10,7,7,12,3,5,4,14,32,3,21,3,10,53,18,14,14,9,20,9,10,13,1,5,5,0,11,20,31,16,24,6,12,10,9,13,9,20,22,13,6,8,5,31,20,6,9,15,0,6,32,22,6,12,18,24,2,2,3,2,6,0,11,10,26,7,1,7,7,6,21,14,15,58,10,6,6,2,17,12,10,6,2,64,3,3,24,8,4,20,15,8,7,1,6,8,7,8,5,30,3,3,22,17,12,0,1,4,7,16,2,3,1,5,11,22,16,38,8,32,22,12,1,27,10,22,11,33,5,11,44,4,21,25,6,4,3,2,3,15,2,7,8,2,12,21,5,4,7,11,44,9,22,2,4,2,24,4,2,2,3,5,20,10,6,7,9,7,12,14,5,21,30,4,44,5,23,6,13,1,3,19,2,21,3,21,12,20,4,3,9,7,7,20,8,6,5,9,10,4,1,17,4,8,10,2,11,9,6,10,4,21,9,2,10,1,11,3,11,7,6,7,17,9,7,10,4,3,8,1,2,2,4,2,0,0,6,9,2,4,12,10,2,10,9,8,15,2,8,33,9,13,10,21,1,15,6,33,6,8,5,5,9,15,16,22,30,6,5,25,5,8,5,24,3,0,5,2,26,5,9,11,11,1,12,2,6,11,2,4,9,6,1,46,16,6,7,12,1,7,9,4,3,8,3,0,4,8,12,10,3,1,2,2,0,3,2,1,5,8,3,0,13,1,11,2,10,3,3,7,4,7,8,5,9,2,8,10,10,5,8,23,11,3,8,9,11,5,0,0,10,7,3,14,2,3,27,2,1,14,4,0,2,3,1,13,2,3,6,5,3,9,17,7,1,4,2,7,2,5,4,4,15,5,6,9,15,3,6,2,5,2,9,13,13,12,4,17,3,4,8,10,12,8,4,3,0,3,12,4,3,5,3,11,4,3,2,10,0,2,2,1,0,2,0,2,9,5,0,3,1,0,11,4,9,10,8,4,8,6,2,6,0,7,11,5,0,1,5,2,3,6,76,14,6,5,0,1,9,19,7,3,7,2,7,5,11,2,2,0,0,2,5,8,3,18,7,10,2,1,2,0,1,6,17,1,4,10,4,13,5,0,5,3,27,4,9,4,7,3,0,10,8,14,1,0,1,4,4,11,6,1,1,1,2,0,14,4,8,9,5,6,6,3,1,1,10,4,7,3,6,2,6,5,11,3,3,1,0,10,2,8,7,4,4,3,3,2,2,8,11,6,8,10,0,3,1,1,9,2,2,3,12,12,18,1,1,11,13,5,7,7,3,10,6,6,8,4,8,7,4,1,6,2,0,7,2,9,7,3,2,3,0,6,7,2,0,5,9,0,2,4,0,5,0,6,3,10,2,3,1,8,3,2,0,2,1,3,1,5,9,2,3,3,1,12,0,1,0,9,6,3,4,7,4,7,3,5,4,3,10,2,2,0,5,0,3,4,2,3,8,1,2,4,7,5,1,3,3,3,3,3,5,0,2,1,6,3,4,2,1,4,7,2,3,5,5,3,4,2,4,12,6,3,2,3,1,5,0,1,1,1,1,8,1,3,2,2,1,1,2,4,10,3,0,8,2,2,2,0,4,9,6,2,9,7,5,3,0,3,4,2,2,0,1,0,1,3,0,2,4,1,1,3,4,2,1,3,0,2,1,3,13,0,20,2,0,0,6,5,5,5,2,2,2,2,0,1,0,5,3,4,0,0,0,0,4,2,10,0,8,1,5,5,5,10,1,0,3,6,1,3,2,1,2,2,1,1,2,7,21,1,9,4,2,2,11,1,6,4,1,5,15
inform,7,24,6,110,7,1,2,12,3,1,26,11,2,29,0,3,4,11,4,2,4,28,0,9,13,8,2,7,1,13,6,107,56,3,25,17,30,1,1,1,2,2,1,2,11,12,15,4,231,5,30,0,5,12,0,2,36,25,0,15,20,6,0,11,7,1,30,2,7,11,7,0,1,1,26,4,6,3,43,9,11,0,14,1,132,4,5,0,40,0,6,1,0,22,24,4,6,0,14,9,1,11,23,4,4,15,10,0,4,0,9,5,1,7,0,12,15,1,36,77,19,5,4,33,3,1,2,6,2,2,2,0,2,27,7,13,2,1,1,3,0,16,17,1,0,34,2,5,7,10,22,0,13,0,0,6,7,2,3,2,3,1,3,1,2,1,1,16,9,6,10,44,6,1,0,4,112,1,5,8,6,7,2,5,0,9,11,14,51,52,1,3,4,0,0,0,5,2,4,4,6,0,0,7,9,4,0,16,12,15,36,3,16,6,1,0,2,5,6,2,5,10,6,9,25,43,8,7,2,2,2,10,10,9,21,4,15,4,5,1,27,12,3,0,3,0,6,16,12,4,6,10,9,6,4,12,9,3,4,11,3,9,26,10,3,30,0,0,5,2,39,2,18,1,3,0,8,8,10,2,25,3,0,9,1,0,0,1,5,0,9,3,6,4,1,7,43,17,5,8,12,14,1,2,4,1,6,3,0,0,2,1,6,9,21,8,4,27,5,2,32,4,10,1,30,4,0,21,7,7,2,5,8,2,1,6,7,7,3,7,7,8,5,8,0,0,18,41,5,2,1,6,4,16,10,1,4,3,16,15,5,4,1,8,6,0,30,4,1,3,1,2,0,3,3,11,3,1,6,6,37,0,17,6,0,14,2,12,17,1,11,1,5,13,19,2,48,2,26,1,10,1,3,0,1,0,6,4,16,6,0,4,0,8,7,9,12,4,2,1,0,8,7,10,2,1,2,5,6,5,8,7,3,4,0,8,0,15,6,4,5,9,2,5,1,0,1,3,22,5,4,4,0,2,45,3,1,7,1,18,4,6,18,0,0,0,5,8,2,0,4,0,1,1,1,2,0,9,8,2,0,6,7,1,3,10,6,2,0,1,24,19,0,5,2,11,1,8,5,4,5,3,1,0,6,7,0,8,1,2,2,0,8,1,5,11,1,3,0,4,2,11,3,6,2,3,13,1,13,23,2,2,5,3,5,1,11,3,18,10,4,1,0,1,1,7,2,14,6,3,12,2,2,14,1,4,11,1,3,3,14,0,10,1,11,4,6,3,18,9,3,7,7,1,2,6,0,3,1,18,0,11,5,6,4,1,3,6,5,7,14,20,8,0,6,1,0,3,48,13,11,2,4,17,5,7,4,17,2,5,9,7,12,4,24,4,8,4,6,5,6,0,3,11,1,2,9,1,7,11,4,13,7,14,3,0,2,1,1,12,5,0,3,14,9,19,2,8,1,145,11,1,5,1,4,5,31,7,5,5,2,1,12,19,13,13,2,6,7,6,9,3,58,11,17,3,1,11,1,1,0,18,14,6,4,4,5,6,2,6,11,4,12,5,13,5,8,6,6,12,3,0,16,1,7,5,13,6,0,6,3,6,1,20,8,18,4,5,5,1,6,2,5,13,1,4,3,0,1,6,1,9,1,2,10,3,2,1,23,8,7,3,2,4,5,3,9,0,1,3,7,4,0,13,11,14,5,6,2,6,5,11,3,1,4,8,8,4,1,4,6,1,1,10,1,8,3,2,4,5,5,2,2,5,2,7,2,29,0,16,4,5,0,3,5,5,1,3,8,3,1,4,6,6,1,1,4,5,10,3,3,2,9,16,1,5,2,2,6,7,20,0,5,2,5,3,1,7,0,7,2,7,5,3,1,7,2,15,4,10,15,4,3,12,5,1,2,0,5,5,9,15,1,3,0,4,1,5,7,0,8,3,4,2,8,1,0,3,2,2,3,0,2,0,1,3,7,11,5,3,2,6,4,8,9,3,7,5,5,4,2,5,0,10,3,9,6,5,6,1,4,9,0,5,1,5,2,10,1,14,1,1,3,9,11,4,1,7,2,3,8,8,3,6,6,6,1,43,6,3,6,7,7,4,3,0,4,2,2,3,1,4,2,5,0,16,6,7,22,15,1,4,1,1,2,8,1,1,14,2,0,4,3,4,2,16,1,0,5,4,1,0,2,0,1,4,0,3,7,5,1,4,4,0,2,0,7,0,20,1,3,1,4,0,0,1,0,8,0,1
intercourse,4,10,0,50,7,0,9,15,1,1,23,6,1,45,4,4,2,6,2,9,0,22,0,4,8,3,4,5,6,1,4,84,95,3,19,32,34,1,1,2,5,3,1,1,18,7,6,5,157,14,11,2,5,18,0,4,22,7,0,10,32,16,1,4,6,6,42,1,11,18,0,3,3,2,14,12,6,2,33,6,40,1,16,2,129,1,2,0,20,1,0,3,0,10,30,0,7,2,36,7,8,6,14,9,4,13,2,0,6,1,7,4,2,1,0,16,3,2,35,68,14,10,0,24,3,2,4,6,2,0,2,1,0,17,10,4,6,1,0,3,0,17,21,0,2,23,2,11,6,3,43,0,8,3,2,10,11,3,10,1,0,2,3,1,0,0,2,4,6,7,6,30,8,0,8,5,85,1,1,5,14,12,0,4,8,10,12,8,10,49,2,1,5,0,0,0,6,3,4,8,6,1,1,11,13,1,3,8,9,24,46,3,13,1,0,0,0,0,5,2,0,4,2,7,25,57,4,10,1,1,7,4,2,3,13,5,12,2,7,6,33,26,5,0,11,4,11,5,16,1,2,9,16,2,1,10,7,0,3,6,0,11,13,2,1,21,2,2,6,1,88,4,4,1,5,0,8,2,3,0,27,1,0,11,6,1,2,1,10,1,2,2,1,1,1,4,25,3,1,3,11,11,0,1,9,2,12,1,1,1,1,3,7,5,4,8,8,16,2,2,33,6,13,1,32,3,1,14,3,13,0,1,6,6,2,6,11,5,1,2,6,4,11,5,3,12,35,35,6,4,4,12,2,11,16,6,2,0,7,7,10,8,2,8,8,0,11,2,1,3,0,4,0,12,5,10,2,0,7,4,25,1,19,5,0,8,0,18,14,0,10,1,3,6,21,7,37,3,11,2,17,1,2,2,9,6,3,9,37,16,3,7,4,6,8,11,2,13,0,2,1,3,5,12,2,2,0,17,9,6,7,3,0,6,4,8,0,15,2,1,4,21,1,21,6,4,5,3,16,7,6,5,0,3,30,5,0,3,2,18,1,24,15,4,1,0,7,17,3,0,4,0,2,0,0,5,3,8,4,1,1,3,11,1,3,0,3,3,3,0,35,26,3,0,3,7,1,9,1,8,2,0,0,0,3,7,0,5,2,3,2,5,4,4,5,6,4,3,2,4,3,10,15,13,4,2,6,0,8,15,3,3,1,6,2,1,8,8,15,4,3,0,0,0,2,2,1,22,12,5,9,1,0,20,2,4,56,1,4,2,21,2,11,0,10,4,8,4,15,15,7,3,2,1,1,1,3,3,0,7,3,10,12,17,4,3,5,3,3,4,17,20,2,2,3,0,2,1,44,9,10,0,2,3,4,12,2,7,3,1,14,5,2,13,13,2,12,0,0,4,8,1,3,8,1,6,11,4,4,30,3,7,7,8,0,0,2,0,0,5,0,1,1,7,8,7,3,6,0,109,9,2,3,1,2,9,14,7,3,4,4,7,12,19,12,5,1,2,7,6,12,6,25,5,11,8,2,5,3,7,7,20,10,6,9,3,3,5,3,14,11,11,7,29,3,4,8,1,3,13,6,2,7,0,3,0,14,2,0,2,4,5,7,8,10,2,2,4,6,0,2,3,8,9,0,10,1,2,2,2,2,4,1,6,2,5,8,0,26,5,3,9,7,5,10,4,4,0,1,6,2,1,0,5,0,8,6,12,3,2,2,2,0,1,31,6,2,10,4,8,1,5,1,4,1,3,0,2,13,4,5,6,8,0,5,4,0,4,3,7,12,1,2,1,5,11,1,2,4,3,2,2,6,2,2,0,6,2,17,3,2,4,28,2,3,3,3,5,3,8,5,0,5,2,2,5,3,3,4,3,1,7,16,0,6,2,7,15,1,3,5,5,2,2,6,1,0,4,2,6,19,11,13,3,0,1,8,1,1,0,9,3,5,1,4,8,4,5,2,4,0,19,2,1,1,1,2,16,6,10,0,1,0,8,4,14,1,2,5,1,8,7,0,8,2,5,4,1,0,6,3,4,1,6,0,1,2,11,1,10,5,1,0,2,4,1,0,17,4,5,15,3,2,6,6,6,10,14,5,3,9,2,5,4,3,1,7,0,1,9,1,1,1,0,0,2,0,2,5,10,1,2,2,1,3,0,3,6,9,17,0,3,5,6,0,23,3,1,0,12,1,2,5,3,4,1,0,7,6,5,8,6,4,5,12,1,4,1,14,0,4,0,5,0,0,0,0,3,4,0
veteran,0,1,2,63,20,6,2,6,0,3,2,1,7,43,0,0,4,3,3,0,0,9,17,9,7,10,16,10,7,17,4,75,55,40,30,44,6,3,4,2,3,7,3,10,19,4,5,33,26,36,14,5,4,48,0,0,3,0,16,6,0,2,0,5,4,2,16,2,0,6,58,6,2,1,38,2,14,1,29,11,48,1,2,5,44,3,2,1,12,3,3,3,4,15,9,3,13,4,23,2,10,22,5,6,6,15,8,4,20,4,15,5,7,6,24,16,0,3,11,21,11,23,8,55,3,7,4,2,0,1,11,3,8,31,11,39,0,3,3,9,3,21,11,1,1,22,4,7,10,4,9,7,10,3,1,35,23,1,2,40,12,3,4,3,13,28,8,4,9,2,4,37,4,0,14,2,31,2,2,32,14,0,30,8,0,6,8,0,2,15,0,2,0,4,7,2,4,2,3,1,9,1,3,6,12,10,0,33,5,4,38,9,10,5,4,5,3,24,11,0,0,2,0,4,18,20,8,8,2,42,2,9,13,6,12,2,3,3,3,4,23,10,0,4,2,23,3,33,22,6,0,5,8,5,3,3,2,2,2,16,7,32,6,2,0,18,8,18,9,2,19,7,10,0,1,3,11,33,0,3,44,0,0,13,8,2,17,33,5,0,0,7,2,1,3,6,38,6,3,5,8,24,3,1,5,4,4,0,4,1,3,4,18,6,12,6,40,13,2,2,10,3,14,9,16,0,4,24,2,6,7,0,0,1,3,8,7,1,1,3,2,7,16,2,4,6,8,13,18,13,2,3,0,9,1,2,1,1,1,13,20,8,2,2,1,2,6,3,12,29,2,31,3,25,1,81,1,1,7,0,10,5,14,5,24,1,0,5,4,0,8,5,2,0,6,4,9,2,10,0,4,7,2,4,1,1,0,0,1,6,0,2,0,8,0,8,6,5,2,10,2,4,3,0,0,2,4,3,1,2,0,1,0,7,6,1,2,6,9,2,5,1,4,2,4,0,27,5,1,7,16,0,9,3,6,4,6,0,1,1,5,6,9,39,5,2,27,5,2,0,17,3,0,2,2,3,1,1,7,1,0,2,0,2,9,2,4,7,0,8,100,10,1,3,7,0,1,9,3,0,4,1,2,15,3,2,7,5,4,1,0,0,3,2,8,1,2,0,0,4,0,1,2,3,1,2,4,0,8,4,4,3,4,1,8,6,0,2,14,2,0,0,2,2,2,0,0,6,2,4,0,1,0,14,9,2,2,0,2,0,5,3,10,4,0,1,4,2,11,9,5,1,4,7,1,0,6,0,0,33,0,0,4,13,0,1,2,3,1,11,7,3,5,4,5,1,3,2,0,6,3,9,0,0,1,7,5,2,2,1,8,13,4,1,14,1,1,0,0,0,0,0,0,8,3,4,0,5,2,5,2,3,5,3,2,1,12,14,9,4,2,3,4,4,1,5,6,5,8,16,0,0,1,1,1,6,2,2,0,3,0,1,0,0,0,3,0,2,6,0,3,0,3,0,10,0,1,8,0,3,2,5,1,0,0,2,7,3,3,4,0,23,2,2,1,13,2,0,2,2,0,0,0,1,0,2,5,7,0,0,0,4,0,10,1,19,15,0,0,5,3,0,1,13,1,2,1,0,1,2,1,8,1,1,2,6,6,0,0,3,3,0,1,0,0,0,3,2,1,3,3,4,17,1,2,5,0,10,3,4,2,6,0,5,11,3,2,1,2,1,9,0,1,3,3,3,2,0,0,2,0,0,4,0,2,4,0,0,4,5,0,2,2,1,0,4,0,1,0,4,3,1,1,1,7,0,1,11,2,1,0,0,0,3,3,0,0,4,1,6,0,1,0,4,2,0,5,7,2,1,6,0,0,9,2,0,1,1,0,0,0,1,0,5,3,0,2,2,3,0,0,4,1,4,9,5,3,2,0,3,0,0,1,1,2,3,0,2,4,11,20,0,0,0,1,2,0,0,3,0,1,1,2,0,1,1,0,1,1,0,3,6,7,2,8,1,0,2,4,9,4,0,11,2,0,0,0,0,0,7,4,6,0,1,0,3,1,1,3,3,2,6,2,0,0,0,0,0,2,0,1,6,0,0,1,2,4,0,2,6,2,5,5,2,2,5,11,18,2,6,3,5,3,14,6,0,0,0,5,0,3,2,2,18,1,1,0,34,0,1,5,4,6,6,0,0,1,1,0,1,0,1,2,0,4,2,0,13,0,2,0,4,4,7,13,2,2,0,0,6
resort,4,19,2,67,16,1,2,22,2,1,10,4,6,39,10,4,9,11,4,2,5,25,4,15,13,6,6,4,3,13,8,70,100,7,39,32,22,7,6,4,5,1,3,1,21,15,17,6,170,4,36,1,7,19,1,5,55,12,0,3,10,2,1,10,10,2,64,3,6,3,7,1,3,2,45,7,6,6,40,9,29,6,6,0,151,16,12,1,19,1,8,5,1,22,38,13,8,6,16,8,6,15,26,10,7,18,3,0,16,1,7,5,4,11,0,21,0,4,29,153,12,6,16,29,5,2,2,3,2,1,9,0,1,18,17,8,13,1,6,2,2,18,22,4,3,29,5,3,15,7,49,0,9,11,0,12,14,1,4,1,4,2,3,0,0,1,1,16,20,5,5,46,14,0,1,10,106,1,6,10,6,12,1,5,3,12,23,24,20,35,1,4,3,0,0,6,5,2,3,6,8,3,1,15,26,9,6,20,7,25,32,4,15,4,0,0,1,1,9,2,2,11,2,14,23,57,10,21,1,5,5,6,9,17,34,19,19,7,2,1,70,19,3,1,10,14,6,10,28,4,10,19,11,9,8,18,11,2,6,4,1,27,22,2,2,16,0,4,6,4,91,9,13,7,2,1,14,8,7,0,40,5,1,11,5,2,0,1,9,1,2,1,9,3,1,7,24,2,10,10,25,15,0,0,7,0,7,0,0,0,0,3,21,8,19,14,6,20,5,4,36,7,24,0,42,1,0,17,4,17,2,5,15,1,4,7,14,9,2,12,18,5,11,8,8,3,47,37,13,0,9,8,3,25,15,0,0,2,14,13,8,3,5,9,2,0,28,5,0,12,3,10,5,7,11,8,5,2,14,8,44,1,29,6,0,11,2,15,14,2,16,0,7,4,19,8,50,4,22,1,12,2,2,2,2,4,5,1,21,6,1,4,1,7,13,6,7,9,0,1,3,4,13,15,0,1,3,9,15,9,13,4,0,4,0,3,2,5,8,3,6,20,3,13,1,0,3,5,16,8,5,5,2,3,36,6,0,7,4,30,9,11,13,12,4,0,14,8,4,1,8,2,1,3,1,0,0,5,14,5,3,15,5,4,9,10,13,8,3,4,72,31,1,3,10,5,0,5,11,3,11,5,0,2,1,22,1,9,4,4,2,10,4,6,18,14,2,2,1,8,1,13,4,11,9,5,19,7,9,18,8,2,2,4,9,6,9,2,31,12,5,2,3,7,8,4,5,22,13,3,41,1,3,44,4,4,21,7,4,6,18,4,16,2,13,26,16,5,23,11,5,11,10,6,3,7,1,4,4,8,5,8,4,11,8,2,2,9,2,8,18,20,3,0,17,0,4,1,34,10,14,2,9,0,2,15,5,34,2,4,19,8,3,3,29,4,18,1,4,3,10,7,5,28,4,7,1,7,14,18,21,11,14,14,7,5,6,0,3,15,3,1,7,7,11,10,7,3,6,107,14,4,8,6,6,5,31,9,6,5,5,5,7,13,6,1,9,17,26,8,20,8,30,13,19,6,0,2,3,1,3,12,8,10,7,6,14,6,3,12,7,2,5,16,11,3,14,2,14,10,2,2,4,5,5,4,12,4,2,2,4,5,3,28,8,18,5,7,3,2,10,3,9,10,1,3,11,2,5,9,4,6,8,1,1,2,15,9,23,4,3,4,2,9,11,4,9,2,5,3,6,4,2,5,2,13,15,7,2,9,4,8,2,1,9,9,2,5,6,6,3,1,1,7,2,11,11,4,8,10,8,8,14,1,7,2,6,8,10,9,2,6,4,5,2,7,3,4,3,3,4,3,9,1,8,2,4,3,12,4,4,2,6,6,6,4,2,4,3,5,1,6,1,0,1,5,2,7,13,6,3,6,9,8,3,7,12,32,6,2,3,5,1,9,6,6,3,3,2,16,15,17,10,1,3,2,6,7,5,2,4,3,6,0,9,8,3,4,5,6,5,0,13,17,5,5,3,6,14,0,0,2,2,6,9,6,2,3,5,6,5,5,0,0,12,6,2,1,3,0,4,6,1,7,7,0,4,9,1,12,3,15,2,7,7,4,1,2,1,2,6,8,4,10,0,2,0,10,3,4,4,2,6,8,5,0,2,10,4,4,2,8,2,3,1,11,11,7,49,4,1,5,2,7,3,3,2,1,19,4,1,3,3,0,1,4,2,6,3,8,17,8,2,1,3,7,1,1,6,2,0,2,5,10,7,4,10,3,7,0,3,0,2,1,0,0,0,2,1,1
connect,2,14,4,122,7,5,5,29,2,0,11,7,5,33,8,1,2,8,3,2,4,25,0,11,19,16,7,17,0,8,8,126,84,8,29,22,16,5,3,2,1,7,2,4,21,16,21,5,249,30,26,2,14,27,17,0,45,58,7,25,12,5,1,32,14,4,40,7,11,44,8,10,2,5,36,10,10,5,41,13,26,1,30,7,144,11,6,0,35,2,7,3,9,24,38,12,6,6,11,15,14,25,35,11,8,21,4,1,13,6,5,6,7,12,9,24,2,4,47,98,23,12,7,52,0,1,1,1,3,0,5,0,6,49,11,49,6,1,2,5,1,19,17,2,3,44,4,6,15,5,41,5,8,4,3,19,9,5,6,12,10,1,7,0,1,6,2,5,13,5,20,54,18,0,0,5,125,3,5,19,16,9,3,6,12,18,14,25,36,58,1,3,4,1,2,2,12,5,6,7,19,1,1,10,14,2,3,33,7,14,72,4,22,5,2,3,2,1,12,12,2,14,4,13,31,58,16,18,2,2,21,17,14,43,39,18,26,9,4,5,47,25,8,2,15,1,7,12,27,7,10,18,13,5,16,17,7,0,7,14,10,8,28,1,3,43,6,1,7,4,115,11,25,7,5,1,11,10,18,3,71,7,2,12,7,3,3,7,5,0,3,3,8,15,2,6,30,6,2,24,12,40,1,2,12,5,12,9,4,1,2,17,14,9,19,18,19,38,12,4,22,7,14,10,55,3,10,25,1,11,0,15,11,4,0,18,18,5,9,5,5,4,16,2,2,9,40,41,14,5,9,12,7,25,28,6,0,4,11,19,20,3,6,11,11,2,29,10,0,10,4,16,6,12,9,25,5,6,8,5,38,4,30,11,3,48,3,22,14,5,8,3,6,4,36,5,65,6,27,3,9,4,4,1,1,4,2,0,24,8,4,20,2,12,6,6,5,9,0,1,1,4,10,6,1,6,7,11,5,16,17,7,13,12,7,8,0,8,8,3,14,21,8,14,1,8,8,5,42,3,6,1,2,8,55,8,0,7,11,20,9,7,19,21,6,0,5,10,24,1,12,2,7,2,1,8,4,6,20,2,4,4,18,2,10,4,15,3,7,0,44,22,1,1,5,5,10,16,4,14,6,5,2,0,30,28,3,11,3,3,4,5,6,8,10,16,1,9,1,7,8,13,14,13,4,7,22,14,13,27,3,5,3,7,5,3,13,1,16,16,6,0,2,3,5,7,2,13,9,14,11,4,7,31,12,10,35,3,12,4,21,9,16,5,9,13,7,7,27,32,8,9,12,4,9,6,4,7,3,10,8,17,17,8,3,0,7,7,1,4,11,19,9,4,40,2,0,2,19,9,16,0,8,2,5,14,5,9,6,4,10,13,11,8,21,6,24,17,6,3,7,6,2,6,3,4,30,8,11,17,10,28,21,16,6,4,12,6,5,12,3,1,3,8,11,50,7,4,4,142,9,4,9,0,3,19,34,1,7,16,3,12,19,24,3,1,0,6,7,11,11,9,38,7,17,5,2,14,6,4,38,18,17,14,10,9,15,0,7,23,6,5,16,24,6,22,8,3,9,16,1,2,7,5,16,3,9,6,2,3,3,11,5,18,10,18,5,7,0,6,0,4,3,24,9,15,2,4,3,11,5,9,2,6,3,6,17,7,36,3,6,10,6,4,7,1,13,7,5,2,8,5,0,9,1,10,3,18,3,4,2,8,1,2,15,19,11,10,7,10,11,10,3,5,1,11,12,7,15,10,9,6,13,2,3,13,2,5,4,10,8,15,11,6,16,11,7,9,2,8,3,4,4,10,3,1,3,3,15,4,3,4,2,12,2,2,2,0,5,9,3,4,3,14,44,6,6,4,10,4,4,7,14,4,5,9,8,20,12,10,10,8,3,1,3,9,7,2,7,7,14,28,1,13,5,7,7,5,2,0,6,13,1,0,4,13,3,3,7,12,6,2,3,20,2,2,0,15,11,5,4,0,5,3,9,3,7,4,4,3,17,41,4,6,9,12,8,1,6,0,4,4,1,13,8,5,16,9,2,7,5,3,9,11,5,3,7,10,5,2,9,9,2,12,1,8,3,12,4,3,11,0,6,7,2,3,13,3,2,14,2,7,7,5,1,20,3,10,25,1,11,6,2,0,2,4,11,20,14,5,2,15,7,4,0,6,14,2,1,14,1,6,3,3,7,6,0,6,1,2,11,4,4,8,6,1,15,2,12,2,7,1,12,0,1,2,3,5,3,0
inhabitant,14,18,11,106,6,2,1,43,4,5,29,3,3,27,1,7,4,3,1,2,0,23,0,12,6,1,4,2,2,5,6,88,84,7,24,20,31,3,1,1,4,5,1,0,13,15,5,4,272,6,25,1,14,7,7,8,26,8,0,8,22,5,0,6,6,2,46,2,1,14,3,5,1,3,19,6,4,2,43,12,28,0,14,1,103,3,9,0,30,0,3,3,0,27,29,3,10,1,21,6,1,10,15,4,3,5,2,5,4,1,6,3,3,5,0,20,11,0,66,99,27,9,4,20,2,2,0,3,2,1,2,2,4,21,8,12,1,2,0,1,1,21,20,0,2,37,1,2,8,5,25,0,6,3,1,10,10,4,13,1,4,1,3,0,0,0,3,10,9,4,22,42,6,0,0,8,80,2,5,8,13,14,0,5,1,3,16,8,22,31,1,3,0,2,0,0,2,1,1,6,4,0,0,10,18,5,2,16,3,17,43,2,21,1,0,0,0,0,6,0,0,10,1,6,27,56,18,17,2,2,9,7,11,12,10,9,20,4,3,11,44,18,5,0,4,4,4,8,33,2,4,5,8,4,1,1,8,0,1,18,1,17,14,0,2,9,3,2,7,2,75,0,12,0,2,0,23,6,4,4,21,4,0,12,11,0,3,4,9,2,4,1,3,2,3,6,13,5,5,9,11,21,0,1,7,0,13,1,2,0,3,13,7,2,7,1,11,11,7,4,31,3,10,0,58,9,3,7,1,19,2,4,4,2,1,4,9,1,1,12,6,7,10,12,1,7,29,34,6,4,6,4,1,5,17,2,3,6,12,8,8,3,3,12,0,1,31,3,2,10,0,6,1,3,1,10,7,1,4,11,56,2,20,7,2,17,2,8,17,7,14,4,19,22,21,7,33,1,22,2,5,1,2,1,8,4,0,2,6,2,2,4,1,6,15,5,2,6,1,0,1,7,8,17,0,0,2,6,8,7,2,2,4,9,1,2,0,4,7,4,12,23,4,4,2,1,2,3,24,1,8,4,1,3,18,6,1,13,0,18,5,6,20,9,3,5,5,10,8,0,9,1,0,2,3,2,5,21,10,0,9,7,2,2,8,1,1,3,2,4,54,10,5,4,1,9,1,3,2,5,4,5,1,0,2,4,3,5,4,3,4,2,9,6,8,12,1,3,0,6,0,19,4,22,5,3,15,2,3,11,3,1,6,2,3,3,5,3,18,1,6,0,0,1,1,0,1,8,5,4,49,2,4,37,2,4,9,2,4,5,18,4,26,3,5,13,8,1,13,21,5,4,5,7,5,0,0,4,3,14,2,9,8,10,2,1,6,8,5,3,11,23,2,3,9,0,1,1,44,10,15,0,4,6,2,6,6,23,0,7,13,5,9,3,10,11,13,2,3,9,8,3,0,3,1,6,10,3,7,46,2,11,9,18,10,1,0,4,2,2,3,1,3,8,4,13,3,2,2,143,33,1,1,6,8,10,19,18,7,7,5,3,10,13,4,6,0,5,7,8,12,6,64,12,13,8,3,3,4,2,1,15,13,8,8,2,7,3,16,8,13,5,11,10,3,4,2,7,5,14,2,4,2,8,4,4,11,4,1,9,7,7,11,13,14,27,2,5,5,1,1,4,3,15,1,22,8,3,2,11,1,11,2,3,2,6,6,4,58,16,9,11,0,3,7,1,3,2,2,12,6,1,0,3,5,5,4,12,4,5,4,6,1,2,27,5,7,2,6,6,3,1,1,13,5,7,1,0,16,8,3,2,4,0,11,4,8,51,1,7,2,25,10,3,4,16,0,8,1,3,3,4,12,6,2,3,3,3,9,6,2,1,11,2,5,1,2,4,8,8,5,5,0,5,3,1,0,4,5,3,4,4,6,9,2,1,4,11,15,1,7,8,3,1,0,3,4,2,2,11,24,20,4,5,0,6,3,2,8,1,5,9,4,1,4,4,7,1,7,4,4,1,1,1,5,7,1,5,11,0,0,7,2,2,2,0,6,2,17,5,3,19,0,3,5,4,10,15,3,1,4,6,6,9,6,5,0,7,6,12,4,2,3,5,14,2,2,10,3,5,8,0,2,5,0,3,1,4,1,0,3,1,0,7,5,2,1,4,3,1,1,3,0,1,1,3,5,3,2,5,1,4,0,4,2,2,8,5,10,2,0,7,0,0,3,12,6,2,1,6,12,8,3,2,5,5,1,2,2,1,6,4,4,2,2,5,10,0,18,2,0,1,5,0,0,0,0,3,0,0
mail,5,1,1,115,0,1,2,22,2,0,7,0,11,4,0,2,0,5,0,0,2,18,2,3,49,3,6,2,1,12,1,147,55,5,16,9,3,2,1,5,3,0,0,2,25,10,21,17,136,15,17,1,5,5,1,0,9,97,0,9,19,3,0,1,6,5,38,1,0,55,7,3,2,0,15,5,8,2,49,10,158,0,14,3,72,13,10,0,74,1,7,4,0,8,18,47,9,21,15,0,11,17,12,3,4,20,23,3,23,4,10,5,3,7,0,7,2,3,51,67,14,14,10,134,3,0,2,2,0,1,4,0,0,42,4,14,1,1,0,0,0,21,6,2,0,31,4,15,7,29,17,4,3,2,4,6,10,2,0,2,81,0,2,2,1,0,3,2,18,7,57,31,15,0,0,0,98,1,0,9,11,2,0,11,9,10,23,12,7,24,0,2,0,0,0,0,27,8,14,3,20,1,1,8,12,3,4,20,6,14,46,5,8,2,0,1,7,0,33,0,6,8,4,1,49,79,56,24,4,5,10,18,22,9,30,92,9,2,0,0,37,13,4,2,5,2,4,9,37,0,19,12,1,21,19,4,0,2,6,32,5,5,18,0,5,218,8,0,10,2,72,1,90,2,7,0,5,102,8,1,21,27,0,7,9,1,0,2,3,0,2,0,6,9,9,10,54,1,6,7,5,41,2,8,2,2,1,4,1,0,2,2,24,2,78,36,8,41,0,5,10,2,16,0,31,1,1,8,0,1,0,8,1,7,0,8,9,7,0,12,0,18,4,5,12,6,14,15,8,0,13,1,2,21,13,101,0,0,4,61,10,21,1,4,2,0,22,0,2,2,11,15,3,7,5,139,22,14,1,4,37,1,28,3,0,4,0,12,13,0,8,1,13,0,21,1,58,11,25,14,12,0,2,0,2,0,4,1,10,8,1,28,0,17,3,4,1,1,7,0,1,1,4,1,1,1,1,7,1,4,2,11,16,21,2,1,0,2,4,1,15,3,5,5,5,0,9,1,32,7,5,11,3,0,34,5,0,1,2,24,4,3,7,2,1,7,1,10,0,0,7,4,7,0,0,5,0,1,10,0,0,2,5,0,0,7,17,0,1,0,17,24,1,0,7,3,0,15,9,6,4,6,20,2,36,1,0,3,29,1,6,4,0,2,0,7,1,3,1,1,0,5,4,8,3,1,1,0,14,14,6,1,4,2,23,2,7,3,24,19,0,0,0,3,2,7,0,13,14,8,0,5,3,50,4,1,21,7,1,3,19,5,18,0,6,1,17,0,23,15,4,2,22,2,5,3,3,7,0,32,4,6,4,4,7,0,3,5,7,8,4,12,12,23,12,0,4,1,2,2,19,2,0,0,4,16,10,2,23,4,11,10,3,12,21,7,13,3,1,2,4,2,3,10,2,4,25,17,2,54,0,21,10,7,1,1,0,17,16,16,6,0,0,48,12,10,4,8,4,102,6,1,0,5,1,16,34,1,6,10,0,3,2,12,2,0,0,3,6,3,10,3,11,2,4,0,9,2,24,0,2,107,6,15,8,0,3,0,11,12,7,1,15,31,8,8,3,2,4,4,5,1,3,1,18,2,17,3,1,14,0,24,2,5,14,1,1,0,1,10,5,4,0,6,1,1,1,2,8,10,6,11,0,0,0,60,19,10,13,15,8,4,4,8,9,8,23,4,0,14,2,31,16,62,37,20,8,42,21,58,52,3,4,18,36,1,8,2,5,9,1,2,3,9,1,11,4,0,2,5,0,5,8,0,4,14,1,2,12,23,4,1,1,3,50,4,71,6,11,1,15,6,6,0,1,3,2,6,11,1,0,5,15,6,4,0,2,10,5,11,3,31,0,8,7,2,0,10,0,3,24,4,0,0,2,1,3,14,7,0,2,0,0,0,17,56,6,0,25,4,3,18,2,5,1,1,0,1,2,0,4,0,0,1,5,4,0,3,3,33,0,0,2,1,3,1,1,1,9,1,2,5,0,0,2,9,12,4,6,8,12,5,2,1,0,2,1,0,9,0,1,0,1,1,0,5,3,11,1,4,5,0,21,33,7,2,21,3,1,7,7,3,16,7,4,0,1,5,2,1,2,1,8,4,6,20,34,7,0,13,6,1,33,0,13,24,1,30,28,0,2,1,1,7,6,29,130,15,32,2,0,2,0,52,9,22,0,0,0,14,0,2,3,1,1,8,0,0,11,6,1,4,0,1,3,0,5,1,1,1,2,1,15,0,0,18,1,3,2,0
nature,4,9,11,85,6,1,4,35,2,0,9,6,5,39,5,8,4,8,4,4,2,33,4,9,10,8,3,10,3,6,6,105,84,3,31,29,16,2,6,3,6,7,0,2,18,8,8,10,136,6,29,2,7,15,3,2,59,14,1,9,8,4,5,10,18,6,51,7,3,9,6,2,4,9,53,14,7,3,49,12,22,0,4,2,118,3,7,0,11,0,11,4,0,6,27,12,8,1,24,6,7,11,17,16,8,18,0,0,12,5,10,5,5,7,2,20,4,1,42,58,18,3,1,33,4,1,2,0,0,0,5,0,6,33,11,21,1,2,6,1,1,32,16,1,4,24,6,10,15,10,46,0,5,6,2,18,19,3,5,4,8,0,1,0,0,1,3,14,9,3,6,41,11,0,0,3,111,4,3,11,12,11,7,5,4,16,28,16,25,16,0,0,3,0,0,3,12,3,2,7,23,0,6,9,13,6,3,11,9,17,47,4,13,3,3,0,0,6,8,6,0,7,5,10,30,47,17,19,3,1,14,4,5,12,13,13,15,5,12,6,49,17,8,2,11,1,6,15,18,7,6,8,7,1,10,9,6,3,4,18,2,16,15,0,3,18,12,4,15,3,88,9,16,3,3,1,9,5,4,1,38,5,4,22,7,0,6,1,9,1,2,2,4,1,3,1,13,0,6,10,20,21,1,1,13,2,6,1,3,4,2,5,16,5,14,8,11,27,5,5,24,3,22,3,31,10,2,13,4,9,5,3,10,9,9,9,13,5,0,3,4,6,9,8,2,4,24,26,13,2,9,13,4,23,16,5,3,2,11,10,18,4,3,4,1,3,18,7,7,13,2,7,2,9,9,15,11,3,11,4,45,2,29,6,1,12,12,16,17,3,11,2,2,13,12,8,39,0,12,2,22,4,4,1,4,7,9,1,14,9,5,7,3,18,4,5,2,10,1,2,7,8,16,14,1,4,3,11,4,3,2,0,1,4,5,2,0,8,4,3,8,13,8,3,0,2,3,3,12,4,11,1,2,1,36,4,1,9,11,19,8,23,16,22,5,0,10,12,8,0,9,5,2,3,2,15,5,6,6,4,9,12,7,5,7,7,4,2,5,0,23,23,2,1,3,4,1,5,6,11,9,2,0,0,4,14,3,15,5,4,0,9,4,2,9,21,3,7,6,9,7,11,10,14,10,8,15,6,18,27,3,7,3,7,5,7,4,5,33,13,3,1,1,8,4,7,2,9,13,5,27,3,8,29,9,9,20,1,1,4,12,3,13,2,16,5,12,7,14,21,12,4,4,2,3,4,15,7,0,4,11,9,13,10,9,4,12,8,5,12,17,16,6,4,10,11,4,0,26,9,8,4,6,5,6,13,6,17,7,8,23,11,8,7,41,8,18,3,4,6,8,0,4,3,1,8,8,7,17,21,2,17,19,18,6,1,3,6,0,7,7,3,5,16,7,8,4,2,4,63,5,5,3,3,6,4,19,5,5,8,2,7,2,6,11,5,2,5,9,6,21,7,10,17,28,5,5,1,3,6,3,17,11,5,10,2,5,1,4,3,9,11,12,9,3,4,6,2,9,13,3,6,4,1,7,8,12,4,5,0,4,3,3,18,4,14,8,3,2,2,5,5,7,16,1,8,3,6,3,14,4,5,4,9,2,0,8,4,16,10,8,2,3,3,8,3,5,5,2,2,7,0,1,2,0,4,4,9,4,3,4,7,0,2,13,8,9,9,8,4,6,3,0,8,2,5,7,2,7,9,0,5,10,4,7,2,2,1,7,8,3,4,1,4,9,9,1,5,0,5,2,3,8,2,0,1,8,2,16,7,4,1,5,2,4,4,0,0,2,8,1,0,4,7,3,6,1,5,3,1,2,3,16,2,6,11,9,23,12,1,4,5,2,4,0,1,9,1,5,9,12,13,3,3,3,4,6,2,4,2,2,4,5,2,4,5,7,2,2,6,5,4,1,6,3,6,2,1,8,0,1,5,1,5,4,3,1,3,3,4,1,12,0,1,7,3,3,2,5,1,2,3,1,4,7,1,5,2,1,16,0,2,4,2,15,2,2,9,2,2,10,5,5,10,0,4,6,10,2,1,5,1,3,6,6,2,4,4,5,10,1,12,1,2,2,4,3,7,5,3,2,5,5,1,4,0,2,5,5,4,4,9,5,1,0,8,2,0,1,4,6,3,6,2,4,6,1,2,4,4,4,1,4,7,3,3,3,2,7,1,5,4,3,2,0,1,0,0,5,0
ascertain,5,10,7,97,9,0,1,15,2,0,11,4,0,20,1,0,6,9,1,2,5,17,4,17,7,5,3,7,3,7,4,117,44,3,19,13,13,7,18,0,1,3,7,0,15,9,14,5,191,3,33,2,3,3,2,2,74,19,0,6,5,0,1,8,10,0,46,7,5,2,35,4,2,3,26,4,1,4,43,16,20,0,10,0,104,23,8,0,26,0,8,1,0,12,32,9,5,1,12,0,6,13,31,4,5,12,5,1,8,5,13,6,3,2,0,16,7,1,43,91,19,1,6,48,1,2,1,6,6,2,4,2,1,25,8,8,3,3,4,2,1,12,17,7,1,43,3,3,7,13,27,0,8,2,0,6,4,1,4,0,8,0,1,3,0,0,3,6,10,3,12,42,5,0,5,6,93,1,6,12,13,5,0,6,3,12,22,9,28,36,1,3,8,0,3,0,4,3,3,5,6,0,0,9,6,3,1,12,5,4,27,3,11,8,2,0,0,1,19,0,3,9,3,10,30,50,11,12,11,4,13,7,10,10,15,50,26,2,8,5,46,23,2,4,5,3,3,1,31,4,13,11,7,18,9,6,10,0,5,11,2,9,11,5,3,28,4,0,8,2,101,1,60,1,4,0,3,15,9,1,27,3,1,9,6,1,3,9,7,2,5,6,8,9,2,6,40,3,3,9,19,21,0,2,0,0,8,7,2,1,1,4,13,0,43,7,7,29,3,5,34,3,11,1,18,1,5,16,4,18,7,9,3,3,2,4,7,6,3,13,10,10,8,4,3,1,18,27,6,2,9,9,5,16,7,1,0,0,8,29,9,4,3,5,2,0,23,2,2,2,1,9,4,3,8,16,7,1,3,6,39,1,27,2,0,20,5,6,19,6,11,2,9,5,23,6,38,6,12,4,7,0,3,0,2,1,6,2,3,4,0,3,0,7,10,2,4,4,1,0,1,2,5,3,0,3,3,6,8,10,9,8,10,11,1,4,0,10,0,1,8,15,2,8,1,1,0,1,11,6,4,2,1,2,31,4,0,12,3,11,5,10,8,5,5,0,3,5,8,0,4,1,5,0,2,3,0,14,7,3,9,7,3,2,4,7,4,1,1,1,16,23,1,1,0,6,0,19,2,4,6,3,4,0,0,15,3,6,7,4,7,3,11,5,11,13,5,8,2,2,0,10,3,7,3,6,11,0,10,17,3,2,5,3,7,4,8,6,29,11,5,0,1,3,10,7,0,12,4,2,23,9,3,24,4,5,8,4,6,5,15,8,18,2,7,8,8,7,27,21,2,7,13,0,5,10,3,4,4,10,3,7,6,6,5,1,6,1,1,6,18,13,2,0,5,3,4,2,33,5,16,0,4,3,9,13,4,10,10,11,22,13,14,1,14,3,14,2,5,14,6,5,2,20,1,4,3,3,7,12,3,8,33,20,3,2,2,1,2,9,6,0,1,10,8,21,4,5,4,105,21,6,2,8,5,13,23,5,4,9,2,4,9,13,7,5,3,10,6,8,11,11,27,12,33,1,1,10,0,3,8,13,15,2,6,9,9,2,2,7,7,6,12,5,5,9,8,6,7,10,7,2,4,2,8,3,14,1,3,5,1,4,6,21,5,5,7,4,8,5,9,1,6,15,2,9,13,4,4,10,0,12,2,1,9,7,2,4,15,6,4,1,0,1,3,0,9,1,1,8,4,16,3,18,17,8,5,3,2,11,11,7,9,6,7,10,6,5,6,5,6,5,0,13,0,4,2,1,8,6,1,2,6,6,1,3,4,15,3,9,4,6,2,6,4,7,0,4,1,16,5,9,16,4,4,3,2,1,14,9,5,1,10,5,3,3,7,7,3,6,3,2,2,9,26,6,0,0,10,4,12,4,5,0,3,8,6,16,3,13,11,4,0,9,6,6,2,5,3,7,7,13,5,5,2,3,2,8,2,1,3,5,13,1,6,2,3,1,5,6,6,1,4,4,3,1,2,11,5,2,2,7,2,8,12,4,9,6,2,4,2,25,1,4,8,5,3,8,2,0,3,3,0,5,10,9,0,3,4,9,2,0,1,23,7,11,5,4,3,3,8,10,4,15,3,11,1,18,3,3,3,2,7,2,1,3,1,2,2,9,1,8,10,5,4,26,6,19,36,2,2,2,0,1,3,8,3,1,18,8,0,3,7,7,3,9,3,3,10,5,4,2,5,2,4,4,2,5,4,4,0,4,1,5,3,3,3,1,8,0,2,1,0,0,0,0,1,7,0,0
silver,0,7,0,81,0,1,5,24,5,4,0,0,3,26,0,1,0,39,0,8,5,50,8,5,8,11,3,4,4,42,1,151,131,4,45,51,4,84,52,0,8,0,0,0,30,10,42,1,187,6,48,0,12,45,1,0,38,7,1,4,5,19,0,1,16,0,109,2,7,4,18,0,9,0,57,8,23,3,102,25,62,2,22,0,234,77,27,0,63,1,26,2,0,9,48,8,17,11,39,16,6,24,54,14,4,16,5,1,20,15,17,15,8,14,0,35,8,9,74,223,19,4,0,73,12,4,4,5,14,0,5,0,1,20,12,6,0,3,6,4,2,31,30,5,1,41,0,11,10,12,52,1,27,3,2,9,16,3,2,3,31,0,7,1,0,3,1,8,9,7,13,82,17,0,2,7,163,1,3,21,10,12,0,17,1,23,25,18,20,62,3,9,9,0,0,9,17,4,17,8,57,8,1,6,59,6,7,29,8,8,73,4,14,10,0,0,0,0,6,0,1,6,0,18,74,123,21,46,20,126,9,16,7,19,23,16,28,8,19,2,66,38,14,0,11,23,3,47,34,6,21,29,13,23,20,34,10,9,7,8,0,21,24,5,9,15,0,2,17,7,129,6,106,4,0,9,17,2,3,2,38,1,0,11,21,0,0,4,13,0,4,1,34,0,0,21,58,0,5,11,23,16,5,0,10,0,9,1,0,4,0,9,23,4,64,32,12,55,22,7,8,3,31,0,7,0,2,30,1,43,0,20,10,4,14,6,20,4,9,24,4,1,13,2,10,2,43,22,9,2,6,8,3,87,15,0,0,3,22,10,25,1,0,13,4,0,39,1,0,2,9,6,11,13,3,6,2,3,6,3,57,0,37,1,3,16,0,38,17,11,0,0,1,2,27,24,39,10,20,0,10,2,9,0,7,9,10,0,33,18,3,1,27,6,0,2,2,7,0,3,2,3,25,19,5,0,4,7,12,18,175,15,0,9,7,3,0,0,0,5,0,6,0,38,1,0,6,4,44,11,20,11,0,17,24,1,0,2,15,22,4,18,22,6,11,0,17,4,1,0,4,1,6,0,0,11,2,9,11,14,3,8,5,0,5,0,15,4,12,0,13,30,2,0,14,7,1,26,5,19,11,6,29,0,6,177,1,17,17,4,2,7,3,1,27,16,7,1,2,23,0,7,27,19,12,4,15,15,7,17,5,8,0,0,4,4,1,2,43,24,5,2,4,7,40,4,3,22,14,4,35,3,6,36,0,8,12,6,6,6,28,15,18,0,19,17,8,7,34,53,6,3,0,0,2,14,7,3,15,7,2,16,12,12,9,2,1,8,8,3,12,23,12,4,22,2,31,10,1,15,15,0,2,0,2,15,0,6,5,11,34,0,1,1,12,13,10,4,1,3,42,192,1,104,9,2,1,11,1,24,405,10,12,12,1,5,6,6,0,7,16,0,6,3,2,42,4,2,1,98,0,3,12,0,4,9,74,12,6,12,5,1,2,5,2,0,0,9,10,7,9,11,5,0,4,3,1,1,0,1,0,9,6,5,11,4,37,2,13,0,4,1,19,3,1,3,8,1,4,14,0,1,2,0,5,4,10,2,17,0,1,41,6,14,20,5,0,3,6,0,1,1,0,1,0,0,15,0,6,17,17,5,17,2,5,1,4,9,2,6,7,4,0,0,5,15,21,2,3,9,12,22,10,8,4,1,13,8,2,61,60,10,35,22,6,128,2,0,0,1,4,2,3,3,0,3,29,3,0,4,0,3,14,6,8,0,19,1,49,12,2,0,0,7,1,16,1,6,7,0,5,7,13,1,14,2,8,13,13,1,17,1,1,7,2,3,7,10,14,20,3,13,16,8,1,9,12,5,101,2,4,0,7,5,5,15,6,32,10,0,2,5,0,0,23,14,7,6,8,3,0,18,2,4,0,9,4,6,0,5,8,2,5,9,31,9,0,3,4,12,0,0,20,145,1,8,1,2,11,0,5,20,0,0,7,4,11,3,0,15,0,2,0,5,5,2,0,0,11,4,5,3,0,2,0,4,0,56,8,7,9,6,3,10,5,0,7,1,16,4,9,6,11,3,0,2,1,0,1,63,3,0,1,6,3,8,5,11,0,2,2,22,30,2,3,101,39,9,148,1,0,2,3,1,0,40,3,1,27,2,0,0,4,0,1,4,1,0,0,0,1,3,3,1,0,5,0,10,8,2,1,7,5,1,4,5,11,1,0,0,0,2,4,0,0,2,4,2,0,0
repeat,5,13,3,88,9,5,2,22,2,2,4,5,5,39,4,5,5,6,8,3,1,20,8,26,19,6,7,3,9,10,6,118,69,3,20,25,17,2,8,3,2,5,2,7,24,12,11,6,168,4,27,5,9,13,7,3,49,23,7,5,13,3,2,10,7,8,55,6,3,9,9,5,4,2,36,8,17,2,35,13,29,1,7,3,108,17,10,0,31,0,3,3,5,28,36,5,10,1,14,9,9,17,15,7,7,21,9,14,9,4,16,3,2,9,3,28,13,2,31,124,20,13,23,36,7,2,0,4,1,1,9,1,3,26,12,15,7,2,4,4,0,13,17,3,3,31,6,2,5,11,24,0,7,5,3,13,17,3,8,10,4,5,4,3,5,7,2,11,13,1,7,41,14,4,4,9,116,2,5,18,19,8,1,10,3,10,22,19,27,30,0,3,3,0,2,1,7,0,5,10,14,2,1,11,9,6,2,21,14,18,58,4,14,5,4,4,6,4,10,1,1,8,7,12,31,50,7,12,5,0,5,8,8,17,21,16,21,6,3,6,46,16,3,2,6,2,7,10,23,5,12,8,6,2,5,10,6,1,4,13,2,8,16,5,1,14,5,3,7,4,66,4,7,6,0,3,9,2,6,3,31,3,1,8,7,1,4,11,10,1,2,1,3,4,2,6,16,15,1,10,10,23,0,2,3,2,11,2,4,0,5,11,12,3,17,11,17,17,9,3,26,5,18,3,37,2,6,18,5,12,2,3,7,6,2,4,10,5,2,3,9,5,12,9,2,4,26,27,9,6,8,11,2,18,12,2,4,1,10,16,13,7,5,16,1,0,17,6,5,7,5,12,2,7,15,12,7,2,14,4,52,2,16,10,1,15,5,16,15,5,17,3,6,5,18,6,44,6,16,2,7,1,2,2,6,6,4,1,10,6,2,7,3,8,16,4,2,10,3,0,5,1,15,14,0,2,2,9,7,10,7,1,2,6,1,3,0,14,8,0,9,13,7,3,0,2,3,5,13,1,4,3,2,4,33,7,0,5,4,18,6,13,19,7,3,0,9,5,3,1,19,4,1,2,1,4,1,4,9,4,5,7,0,6,9,6,6,1,1,3,53,29,3,1,6,4,0,6,3,10,7,4,0,7,3,7,11,22,4,6,4,8,2,5,13,15,3,9,4,6,1,15,8,14,6,2,16,12,12,19,11,4,1,9,3,2,6,4,19,19,2,0,1,6,3,7,1,12,6,8,17,3,3,20,2,3,13,4,8,9,12,3,9,4,12,15,13,7,18,15,5,18,10,2,1,9,8,7,4,7,3,6,3,11,6,6,5,7,1,4,10,25,3,1,15,2,4,2,35,21,9,1,2,2,3,24,5,30,2,2,19,2,3,2,17,2,8,5,3,3,8,2,1,11,2,1,8,4,7,17,7,18,16,19,3,5,3,2,3,11,4,2,4,7,7,15,4,6,5,98,8,4,10,2,3,2,18,14,2,6,4,3,9,13,3,7,0,10,5,4,10,6,39,13,12,7,1,1,1,8,4,9,9,11,10,6,7,2,8,7,8,5,7,13,4,6,5,0,11,12,4,4,21,6,5,2,5,4,2,1,2,3,6,19,5,10,3,5,3,0,7,2,7,12,1,5,4,1,2,4,2,7,0,5,2,6,13,6,29,4,9,4,1,3,2,1,7,3,1,2,6,2,1,6,3,7,8,19,2,10,13,6,2,1,8,3,5,3,1,8,1,3,1,15,2,7,2,1,21,6,2,9,7,0,3,3,5,22,2,7,3,2,4,5,4,16,1,17,1,3,3,0,3,1,2,2,8,4,13,6,12,2,17,4,3,3,6,2,1,8,2,6,5,1,2,6,2,1,2,6,5,7,8,2,6,10,7,11,4,1,2,2,1,4,4,3,2,2,8,12,20,14,5,3,1,5,6,5,4,2,7,6,3,1,4,8,6,1,8,47,2,7,3,7,2,1,2,11,12,0,1,3,4,3,3,6,0,2,2,1,6,8,1,4,4,4,5,2,4,2,2,4,2,4,7,4,4,3,3,16,4,2,2,4,6,3,2,3,1,3,6,7,2,3,0,1,0,12,1,1,2,2,6,4,5,3,3,2,7,4,2,1,1,2,10,9,6,3,12,3,0,7,1,0,3,2,2,5,15,4,0,2,1,3,3,14,2,1,2,3,3,1,7,1,2,12,4,7,6,2,3,3,3,4,1,4,7,1,33,3,2,4,1,0,0,3,1,5,0,1
taxation,1,1,5,57,1,4,0,18,0,1,8,3,5,31,3,5,4,13,0,1,3,11,4,7,6,5,6,5,8,6,0,112,94,4,30,27,9,8,16,5,77,5,0,1,18,9,15,7,146,0,17,0,11,13,1,0,39,10,0,5,5,0,3,8,4,3,95,8,0,10,16,0,9,5,50,9,12,2,26,16,91,0,7,2,217,33,8,0,20,9,5,2,0,13,50,35,16,6,17,32,7,32,16,7,2,14,40,0,16,2,8,1,11,9,0,27,1,4,16,161,34,5,232,35,4,1,2,0,6,2,4,0,2,33,8,16,3,4,7,3,3,16,3,1,0,22,1,14,20,12,22,0,9,3,1,36,13,4,4,7,12,3,7,3,8,1,4,7,18,6,3,82,30,3,13,1,134,2,4,14,9,8,3,10,1,8,30,9,19,5,0,0,4,0,8,2,4,1,4,19,20,7,7,9,19,0,2,56,4,14,31,0,15,14,6,0,8,14,5,1,6,12,2,12,19,61,14,17,4,16,15,11,42,8,33,61,14,9,11,14,66,13,3,8,3,6,3,13,17,3,7,25,5,18,6,6,1,3,0,15,2,5,6,0,2,6,3,2,21,10,94,11,52,6,1,0,10,29,3,1,50,5,0,5,4,0,1,5,6,0,1,1,13,22,3,6,42,5,11,16,10,12,1,9,17,0,9,1,1,0,1,36,9,2,74,14,16,22,10,4,24,5,5,7,28,0,4,9,1,12,11,20,1,4,3,9,22,3,10,7,10,1,15,11,11,8,20,13,5,3,16,4,3,29,16,2,2,0,16,12,23,2,2,34,7,0,9,1,11,13,0,26,4,2,12,1,2,3,8,10,35,2,44,4,1,19,4,14,16,5,7,0,4,4,15,2,39,4,4,0,17,0,2,0,9,9,3,1,8,1,1,2,0,23,0,2,0,2,2,1,1,1,5,7,0,2,1,1,4,7,13,0,0,0,1,0,0,0,2,3,13,27,12,5,0,0,5,3,22,10,11,7,1,1,21,7,0,20,12,13,3,14,15,26,2,0,16,2,0,0,18,0,1,7,2,34,1,7,26,2,3,3,0,1,5,9,7,0,0,1,26,32,0,0,5,2,0,6,6,5,16,5,12,2,2,17,3,16,4,3,14,0,6,2,8,6,2,3,3,6,1,27,3,14,9,1,6,13,15,9,10,5,0,18,4,1,1,8,20,10,1,0,1,11,8,5,0,12,8,5,27,1,5,29,3,5,13,8,15,3,7,8,21,0,4,20,8,7,16,9,10,6,12,1,3,0,30,9,6,7,11,6,16,9,2,8,6,8,2,5,19,30,4,2,18,1,1,4,6,5,14,4,3,1,0,12,2,8,2,11,16,9,0,4,13,11,20,4,6,6,12,3,1,11,2,18,1,20,7,19,7,11,20,16,2,2,3,22,1,2,23,0,1,10,5,14,6,0,5,42,2,4,2,4,7,7,25,22,3,5,7,0,2,6,2,1,0,2,5,4,8,3,0,17,6,8,7,4,10,2,7,9,3,2,5,7,19,6,0,1,10,11,6,0,1,1,4,2,66,9,0,6,2,5,9,0,9,2,5,1,3,7,1,19,15,5,0,4,3,6,2,3,1,1,0,1,6,2,1,6,3,8,7,7,1,2,2,4,5,5,4,1,2,0,3,3,20,1,5,11,11,9,2,4,5,3,9,2,0,49,44,13,1,7,5,16,11,4,10,4,1,0,2,8,4,4,4,1,6,12,0,2,5,5,8,3,7,0,11,4,2,9,1,1,9,15,4,7,0,2,22,3,10,1,1,1,8,9,17,1,10,0,0,6,0,3,9,6,0,15,2,1,0,0,0,6,2,3,2,8,2,5,10,1,6,5,2,3,3,2,0,3,11,0,3,6,7,0,2,0,4,3,2,18,0,1,5,6,4,3,1,5,0,2,2,4,0,5,4,4,1,2,20,19,4,4,0,6,4,1,0,2,0,2,1,2,1,2,2,1,0,0,0,5,3,0,0,0,10,0,15,0,0,5,2,0,0,4,2,8,0,8,3,11,2,0,0,4,3,1,2,9,2,26,1,3,0,1,0,3,1,6,4,6,2,9,1,2,3,7,0,60,12,12,24,19,37,10,52,1,0,5,0,6,6,1,1,0,6,2,7,0,0,2,4,1,0,1,1,0,0,0,3,2,0,1,2,4,1,5,0,3,3,5,4,1,16,2,0,0,3,2,0,1,1,29,2,1,0,0
equally,5,10,11,73,10,3,7,45,6,3,23,2,4,70,2,8,5,12,4,2,5,12,11,13,14,7,10,9,4,9,10,124,112,8,52,44,48,7,4,7,14,8,1,1,26,23,23,6,268,13,31,2,11,21,3,6,40,10,0,13,14,12,5,9,12,7,77,1,10,4,5,3,0,1,56,8,8,5,47,17,41,3,11,6,173,16,3,0,20,0,2,3,1,20,41,6,10,0,23,10,5,21,28,7,7,19,5,0,10,4,14,6,8,20,0,26,4,4,35,154,31,9,24,41,6,5,2,4,3,3,4,7,5,42,23,28,7,1,7,6,5,18,16,0,9,40,7,6,9,12,74,1,16,8,2,25,14,2,13,7,5,2,9,1,1,4,1,14,14,7,7,82,15,1,2,10,123,4,10,15,20,12,2,12,1,13,30,15,40,48,0,2,1,3,2,1,13,8,4,16,19,0,2,7,23,8,3,39,6,21,49,5,8,10,2,0,0,0,4,2,4,16,6,11,42,57,11,20,1,1,21,5,15,25,27,27,20,4,2,11,51,23,1,4,18,12,4,21,18,3,12,17,18,5,12,18,8,3,4,8,1,21,19,1,3,24,2,5,25,7,133,1,10,12,3,3,17,11,3,2,53,6,5,26,11,2,1,8,11,1,2,3,3,3,2,3,22,1,5,36,18,15,0,1,18,3,17,4,7,2,2,8,17,16,12,13,12,37,7,6,50,6,24,6,72,8,12,24,3,12,5,12,16,2,4,11,26,5,4,12,13,5,17,12,2,9,31,32,12,5,17,6,7,23,30,5,3,6,15,27,10,10,6,20,2,2,21,13,3,7,6,13,2,11,12,22,8,8,26,7,47,1,25,17,2,15,6,18,18,2,24,1,4,7,27,14,59,4,20,0,17,0,1,2,6,7,8,1,21,19,4,7,2,14,6,6,6,8,0,1,4,2,19,20,2,5,1,20,12,15,11,1,3,4,1,3,1,12,5,0,23,31,10,15,2,2,8,3,25,5,8,4,1,4,51,16,2,12,9,29,9,13,27,31,7,0,7,17,17,2,13,7,5,2,3,21,3,9,13,2,11,10,8,5,10,12,11,6,5,5,64,25,2,4,3,1,0,10,9,20,15,6,5,1,1,28,3,18,2,8,5,11,2,9,16,16,3,10,3,9,1,22,10,24,11,4,19,8,9,24,6,9,0,12,5,4,13,4,22,22,4,3,0,8,1,6,5,23,10,5,42,5,1,27,10,10,31,9,0,3,13,4,19,7,27,13,9,13,29,20,16,9,6,4,2,12,6,5,7,9,9,11,13,16,11,9,4,13,4,12,39,35,8,3,31,4,2,5,45,26,26,1,5,9,3,14,4,22,4,7,14,5,3,9,17,10,24,1,4,5,3,5,3,10,1,8,6,8,6,20,5,16,26,21,3,7,4,7,2,10,21,4,11,12,6,8,6,3,5,127,11,7,13,2,6,4,37,18,2,7,4,12,9,25,7,4,2,5,8,7,23,9,40,20,24,7,5,7,1,7,0,24,14,4,8,12,12,3,2,9,12,4,16,11,5,1,7,5,17,16,2,7,0,2,7,7,17,9,3,1,4,3,1,31,12,14,2,11,9,9,9,6,5,21,4,5,5,1,2,13,5,5,3,7,3,2,26,2,39,9,11,4,4,13,5,1,11,8,5,15,7,7,4,3,0,13,6,7,3,5,5,8,3,3,25,5,6,5,12,10,5,2,3,11,1,8,16,4,17,13,4,3,14,1,6,8,3,16,8,6,3,5,2,6,3,15,0,1,6,0,11,5,4,4,3,1,5,5,10,3,2,5,8,4,5,3,3,4,3,5,7,4,4,1,2,8,7,4,9,3,2,14,11,0,6,11,16,13,16,5,4,14,9,7,4,12,12,6,7,15,34,16,9,14,1,1,5,2,11,0,4,10,2,4,7,6,7,2,9,4,1,5,2,20,9,6,4,13,13,3,7,1,1,5,0,6,5,5,10,2,4,6,1,1,6,3,9,0,2,1,4,6,3,15,2,3,8,6,0,14,4,0,8,6,8,4,0,21,8,4,10,7,7,13,7,6,0,8,1,6,3,2,8,8,5,3,4,3,6,12,9,12,4,2,4,9,7,10,11,1,5,2,2,4,2,2,5,5,8,1,5,5,6,1,3,16,0,2,4,9,10,16,3,7,7,4,0,10,15,10,5,3,3,11,7,16,1,0,18,6,6,4,5,1,3,6,2,9,2,2
expand,0,12,4,88,5,26,3,17,2,0,5,3,19,66,2,0,12,6,10,6,4,20,26,18,7,20,25,28,12,26,3,112,82,24,22,83,20,5,29,9,11,22,8,9,26,3,23,28,103,90,28,11,23,99,29,3,7,4,29,11,9,5,1,12,12,7,61,7,4,9,50,1,6,1,129,6,14,0,31,19,67,12,6,9,72,15,12,1,8,2,8,8,12,25,21,6,17,0,60,17,8,27,7,14,18,23,6,15,26,4,15,4,54,38,44,26,1,2,31,55,11,50,42,92,11,4,6,2,2,3,31,6,10,48,27,101,1,4,6,7,4,30,19,6,0,58,9,31,10,2,24,10,10,11,12,28,24,16,1,82,17,0,12,3,15,25,3,27,21,6,20,64,24,6,21,0,29,9,8,71,5,14,50,28,5,24,18,4,4,27,1,2,9,4,6,4,20,15,11,3,36,8,14,5,15,14,10,25,8,32,41,15,18,7,10,13,7,24,13,2,8,6,2,7,20,23,8,11,5,11,8,13,30,20,28,4,12,15,20,7,38,23,5,6,14,6,7,38,49,14,10,15,13,1,4,7,0,4,3,12,2,29,6,1,10,24,25,27,19,3,27,12,7,5,0,9,21,10,4,1,54,4,2,13,10,11,46,29,7,3,2,16,9,9,5,6,18,6,6,9,12,15,4,1,5,1,14,5,4,6,7,21,37,26,22,6,18,13,12,11,19,4,24,20,22,0,10,39,2,15,9,7,3,2,2,13,14,7,3,5,4,17,11,3,12,9,19,23,20,28,4,6,0,36,1,13,4,0,3,29,12,29,19,7,3,11,12,4,25,32,7,60,3,35,5,34,0,1,6,3,19,5,11,4,14,12,4,14,13,4,6,10,6,4,7,6,9,3,15,4,12,12,1,9,3,3,5,1,80,24,1,5,28,9,2,17,16,5,7,18,1,7,13,2,7,2,1,1,4,4,5,1,0,8,12,3,12,18,22,9,10,6,3,20,9,4,40,13,8,9,34,0,25,2,16,0,10,2,3,4,14,20,17,14,9,3,32,17,7,6,24,4,1,7,1,1,5,2,11,9,0,10,1,4,5,0,10,11,1,0,37,10,0,5,20,1,4,6,6,3,1,4,1,19,3,55,23,3,3,2,1,4,0,2,5,2,6,2,2,11,0,4,7,7,1,0,18,3,10,8,7,4,4,2,7,3,1,4,13,4,2,7,3,14,23,1,2,4,3,1,3,1,1,22,11,0,21,4,7,1,5,0,5,1,2,5,8,5,4,12,8,1,2,1,4,0,7,2,2,25,4,2,6,14,0,1,0,3,0,8,14,10,10,5,5,1,12,9,4,6,8,5,4,1,1,4,4,4,2,1,5,4,6,2,1,3,1,7,2,0,8,3,5,19,8,2,3,3,4,19,6,4,5,4,2,4,2,8,9,4,5,5,3,5,0,6,13,7,3,56,2,3,2,4,0,14,13,3,0,2,0,11,1,3,4,0,0,0,1,0,3,1,7,0,1,6,2,0,1,2,4,16,1,3,3,2,7,8,0,5,6,43,5,3,5,9,6,0,7,0,5,0,0,0,5,5,7,5,1,1,0,5,1,16,9,10,14,2,3,7,3,0,1,7,5,7,3,13,3,8,2,5,2,11,0,0,13,6,6,15,3,0,6,5,4,4,8,22,7,0,8,1,7,1,3,3,1,4,2,4,2,12,2,3,12,13,8,4,6,1,15,6,11,7,2,4,28,7,0,1,0,0,4,5,3,7,0,0,3,3,3,1,0,0,4,5,1,2,1,0,2,1,2,0,12,5,4,0,2,5,3,0,8,2,3,2,4,8,1,3,0,0,6,3,1,0,8,2,7,2,13,1,9,3,7,2,1,3,0,7,1,1,0,5,0,10,4,12,0,7,5,6,2,0,5,6,1,1,0,4,0,2,1,8,3,1,2,0,3,10,4,3,3,19,3,4,0,3,5,2,1,0,0,0,0,1,5,1,7,3,11,5,18,0,0,1,3,5,7,15,7,1,7,3,0,1,1,1,3,5,6,25,1,4,2,1,2,3,3,3,0,8,3,0,1,1,3,0,0,3,3,14,3,0,3,1,13,1,2,9,0,8,5,1,6,7,6,8,8,1,4,7,2,5,4,0,2,4,4,1,6,5,0,0,3,12,4,2,0,4,2,0,16,21,0,1,13,3,2,0,1,2,1,1,1,2,0,1,0,7,4,10,1,9,11,5,14,2,10,17
spain,9,21,2,153,21,0,9,17,12,7,30,28,4,120,3,14,12,15,9,9,12,56,0,40,20,19,10,12,7,12,33,276,147,5,72,48,96,9,0,8,10,5,3,1,30,64,44,17,769,25,102,9,9,45,0,29,124,15,0,27,93,24,1,20,35,9,80,3,17,27,5,6,0,4,75,6,11,28,131,24,13,0,37,12,437,3,11,0,56,3,13,5,0,68,75,10,37,6,77,1,4,27,37,28,11,19,8,3,6,5,12,6,0,7,0,99,38,5,166,311,63,19,2,66,9,7,2,19,7,0,11,3,3,51,16,15,9,1,0,2,5,47,63,4,3,96,2,15,12,3,98,2,10,16,0,1,27,0,55,3,5,2,0,2,0,3,5,39,16,11,14,101,27,0,1,19,230,4,9,22,24,11,0,24,1,17,25,54,82,110,5,7,6,1,0,8,2,2,5,6,0,0,0,35,65,23,4,7,31,27,141,6,41,4,3,0,0,0,10,0,4,25,17,27,51,67,19,53,6,3,10,13,5,28,27,10,69,5,14,20,110,54,8,5,8,10,21,17,34,18,29,35,42,0,14,12,28,5,15,17,0,45,24,22,18,17,0,7,21,4,151,5,22,1,3,0,23,3,45,0,50,16,0,22,14,2,0,5,19,0,17,13,5,2,6,14,71,14,8,15,50,42,3,4,54,2,66,0,4,0,1,10,31,10,77,4,5,91,4,0,115,11,41,1,164,15,8,36,14,43,2,25,36,5,23,19,47,23,1,17,26,36,15,42,1,4,94,150,20,4,18,10,7,20,59,1,2,6,15,33,7,5,10,12,1,0,64,12,18,7,4,10,0,6,5,6,15,2,25,3,72,0,33,26,0,31,0,41,35,0,48,1,12,22,62,8,113,6,55,8,36,0,4,1,5,3,4,15,45,7,6,25,11,10,264,22,8,26,3,6,6,7,20,17,2,6,7,36,34,31,11,6,11,18,2,31,0,74,17,5,12,14,16,29,0,7,4,9,64,4,11,22,5,15,50,32,0,34,8,64,12,19,23,23,5,11,28,23,21,1,13,17,1,0,13,5,3,15,25,1,6,16,12,31,10,10,3,7,8,7,195,57,1,29,2,19,8,53,15,16,11,2,1,0,4,1,0,20,7,10,0,5,20,4,13,21,7,5,4,6,4,29,4,42,20,17,34,0,26,27,25,1,2,12,8,9,22,4,34,7,13,8,2,0,5,20,10,19,14,10,14,15,4,86,2,5,53,13,15,10,40,4,24,0,9,17,24,15,51,43,3,14,24,4,12,17,9,9,13,29,0,20,11,43,8,4,15,5,4,3,14,70,7,2,12,4,0,0,168,40,40,1,11,23,48,44,13,32,11,2,62,15,16,2,46,17,26,0,13,2,8,0,0,13,0,7,26,21,27,47,8,23,24,31,11,1,13,4,1,7,0,0,10,18,48,32,3,8,1,610,187,11,10,0,17,16,66,89,12,26,8,4,55,32,34,37,10,28,19,11,16,5,92,28,155,30,2,17,2,27,1,50,37,7,17,6,34,11,1,32,30,11,50,30,14,3,15,9,27,8,1,22,17,5,5,1,32,6,0,13,6,37,8,63,22,9,10,37,35,0,14,3,28,21,3,36,1,1,4,11,5,19,7,4,10,16,22,5,84,8,3,24,2,21,22,3,19,4,5,9,7,3,1,18,7,11,35,17,0,21,26,22,4,2,32,5,14,2,1,35,4,6,1,16,4,16,0,3,6,12,1,8,27,0,7,18,9,98,9,20,12,10,0,9,2,15,1,8,5,9,21,13,44,3,1,8,3,7,45,14,36,9,98,17,5,22,11,32,18,34,26,6,13,9,2,6,1,15,7,9,6,15,1,1,23,8,17,36,33,12,30,9,0,15,19,0,6,8,9,22,138,68,12,4,2,14,4,1,18,1,41,18,1,0,10,12,3,0,45,19,0,7,0,0,9,19,37,79,18,4,9,18,8,20,29,16,10,4,5,4,6,32,0,11,39,42,4,3,18,2,15,28,11,32,1,24,7,24,4,44,12,0,4,25,17,10,4,14,15,4,19,21,2,23,16,18,18,105,24,1,9,14,7,14,15,0,4,5,26,4,6,9,0,0,0,27,7,3,12,10,0,7,4,0,9,7,5,17,31,19,3,14,1,0,4,107,1,0,0,19,7,18,26,1,20,14,0,7,12,18,1,7,8,0,33,0,18,0,1,12,3,3,8,0,0,0,0,15,1,1
parent,3,4,2,35,7,14,0,4,0,3,0,4,13,27,0,4,5,4,2,2,0,7,22,10,8,20,18,17,6,11,3,74,41,9,20,48,5,1,1,5,1,4,4,8,11,9,9,4,64,41,13,6,3,25,162,3,3,3,19,6,7,7,1,2,12,6,31,1,8,5,34,0,6,3,74,5,20,0,25,21,11,0,2,10,39,2,3,1,6,0,2,5,5,15,9,3,15,0,17,9,0,14,2,8,0,8,0,17,12,6,14,0,3,8,16,21,0,0,20,33,7,33,23,41,8,2,1,3,1,5,16,6,7,27,12,69,7,2,1,0,10,13,10,1,3,29,4,9,0,3,10,5,3,3,0,6,23,2,6,63,5,3,4,2,4,23,3,4,8,2,8,51,13,2,12,3,22,1,11,41,8,2,15,9,1,4,6,6,17,12,2,0,0,1,10,1,10,2,6,3,12,2,5,1,0,14,0,4,7,5,46,12,15,15,14,27,0,10,3,0,2,4,0,6,18,16,7,1,6,5,4,6,15,8,10,0,9,11,0,6,20,8,11,6,2,0,0,20,19,7,6,3,8,0,0,7,2,2,1,5,1,10,0,0,3,1,38,8,7,2,14,3,0,1,1,4,12,0,2,0,47,7,2,19,1,1,20,41,6,1,0,4,1,6,4,2,6,2,1,6,9,3,0,0,7,7,8,1,15,2,0,3,9,7,14,1,5,8,1,0,13,2,18,46,43,2,4,35,2,3,7,1,0,0,2,3,11,1,0,1,4,13,17,7,0,6,10,18,3,41,2,2,1,15,4,5,8,1,0,11,2,7,7,4,0,16,10,4,13,16,1,29,4,24,2,3,2,0,7,1,7,0,9,4,9,4,4,8,11,4,6,4,4,0,5,4,5,0,1,0,3,5,1,9,1,1,1,1,2,9,5,1,1,6,9,6,3,1,6,5,1,1,9,4,4,1,0,0,1,0,0,0,0,3,6,2,1,4,8,0,4,2,0,2,0,1,16,4,11,4,12,2,13,2,10,3,6,3,6,2,9,11,5,17,14,1,23,2,8,6,24,10,0,4,6,14,4,1,7,2,1,5,0,9,5,1,0,13,3,2,29,4,4,6,3,0,0,1,1,5,1,0,1,9,2,2,0,3,0,2,0,0,0,2,5,4,9,0,0,2,0,0,0,5,3,1,3,3,3,6,5,5,1,3,1,9,0,1,7,0,1,1,2,2,1,0,0,5,0,0,0,0,0,7,5,1,5,1,2,0,3,1,0,1,2,2,1,1,3,6,3,0,1,3,4,0,0,0,2,7,0,0,5,6,3,2,2,1,0,4,1,11,3,6,1,0,1,1,2,4,3,0,3,0,5,8,2,3,0,0,5,1,1,1,2,3,3,1,1,0,1,0,0,6,3,1,2,1,2,6,1,0,4,5,1,1,4,1,7,1,2,4,6,1,0,1,0,1,3,34,4,1,0,0,0,3,7,15,2,3,7,0,0,4,0,0,0,0,1,2,1,0,12,5,2,4,0,0,0,1,1,2,1,0,3,2,4,0,1,0,2,9,3,2,0,2,2,1,2,0,0,3,1,1,0,3,7,3,0,1,0,0,1,9,1,6,4,3,6,1,1,1,2,2,0,0,0,7,2,3,1,4,0,0,0,2,4,0,4,3,0,0,0,3,2,0,2,2,1,7,5,0,0,1,1,0,2,2,0,0,2,1,0,2,10,10,4,0,0,0,3,0,0,2,0,7,4,0,0,2,0,0,0,0,2,2,4,8,1,2,5,2,0,0,0,7,0,0,0,0,0,0,5,0,3,0,1,2,0,1,0,0,2,2,0,2,0,5,1,2,0,0,2,0,0,1,13,0,1,0,3,4,1,0,1,2,2,2,8,2,0,0,0,2,0,1,0,1,1,1,20,1,7,0,3,1,0,0,0,2,0,1,0,0,1,3,0,0,6,1,1,0,0,0,1,0,0,3,2,1,0,1,0,0,1,0,0,2,4,0,14,0,20,1,2,0,0,9,3,6,0,1,3,3,1,0,0,0,0,10,2,2,1,0,6,0,1,0,3,0,1,0,1,2,3,0,0,0,1,0,1,6,0,3,0,0,0,1,1,1,0,8,0,1,0,2,1,0,1,1,2,2,8,0,0,0,0,2,0,0,0,0,0,0,1,8,0,1,0,2,0,2,8,9,1,0,2,0,2,2,1,1,0,0,3,0,6,7,12,1,3,1,0,2,2,4,3,0,7,5
knowledge,2,5,3,61,11,1,3,12,5,1,7,5,3,30,4,7,2,6,3,0,2,11,3,3,8,0,5,6,2,4,7,64,54,7,21,30,28,3,1,9,1,6,2,3,6,8,12,7,99,10,10,0,3,24,10,3,27,14,3,9,5,2,4,1,8,6,37,2,3,7,3,1,2,2,46,3,7,0,34,8,18,0,2,5,84,4,7,0,5,0,3,6,0,6,13,0,9,2,11,7,7,9,8,1,5,12,1,0,2,0,17,2,5,8,1,10,1,2,16,57,12,7,5,24,4,1,1,2,0,0,7,7,7,37,9,26,2,2,2,7,3,21,9,1,3,23,3,7,6,7,20,0,6,6,8,6,16,3,4,9,7,1,4,0,0,1,0,8,3,2,3,19,5,2,3,3,62,1,1,24,4,8,4,5,5,15,19,8,3,14,2,3,3,0,0,3,4,4,0,5,13,0,1,1,11,6,1,10,4,9,31,7,9,5,2,2,0,0,6,0,0,4,5,7,18,30,9,8,0,0,9,3,2,9,19,9,14,6,12,2,23,18,5,2,7,0,2,9,12,0,1,11,6,1,4,4,1,1,1,9,3,8,6,1,4,28,12,4,5,5,43,6,2,3,3,1,11,1,4,0,28,2,1,8,4,0,7,7,7,2,1,1,7,2,1,1,18,4,0,3,7,17,0,0,3,2,14,1,3,3,3,7,7,5,3,7,3,20,4,9,18,2,17,5,19,0,6,13,0,11,0,1,3,1,3,7,4,2,1,1,3,1,11,4,4,0,4,16,13,2,2,2,5,13,12,2,1,3,2,5,4,7,8,6,8,2,13,3,6,3,1,6,2,9,8,23,6,6,8,4,14,2,13,2,2,14,2,9,6,2,12,4,10,3,9,3,20,3,8,1,9,0,1,1,0,5,3,0,3,10,0,4,0,5,2,4,1,3,1,2,4,4,5,3,2,1,3,7,2,8,2,1,0,2,1,1,0,5,3,5,8,12,3,3,2,2,5,1,14,3,5,4,3,1,21,2,1,2,6,9,3,9,20,14,5,0,5,7,0,0,14,2,1,2,1,11,7,5,5,5,2,8,2,3,3,6,7,2,3,4,22,15,2,2,5,1,2,4,1,4,4,2,1,0,5,1,5,6,1,3,1,1,2,2,6,4,1,1,1,4,4,9,4,6,4,5,10,4,13,18,2,5,1,2,8,5,5,2,14,11,2,1,1,11,2,0,4,7,3,1,9,3,3,13,1,4,13,1,1,3,10,1,5,0,5,6,5,1,8,21,11,7,5,1,4,1,1,0,3,4,4,8,10,3,2,0,7,3,0,2,16,10,3,0,21,3,6,1,8,4,3,1,2,0,3,12,5,4,1,2,20,1,1,8,12,7,4,2,3,3,6,0,0,3,4,2,10,4,13,5,0,11,11,7,5,2,9,4,1,7,6,2,8,10,3,5,0,1,1,58,3,5,2,1,2,6,17,2,2,4,1,1,0,3,1,1,1,1,3,7,9,2,2,11,14,6,0,4,0,11,0,10,6,4,3,3,8,1,1,1,4,7,8,6,2,9,4,0,0,6,1,2,1,2,5,9,8,2,0,3,4,1,2,8,6,7,5,4,4,3,4,6,0,16,4,5,2,2,6,5,5,5,5,2,0,5,1,3,9,5,2,5,4,3,3,0,7,1,5,3,4,0,0,0,0,5,5,10,0,1,0,2,4,0,9,5,10,5,9,1,7,8,3,11,4,2,0,2,2,7,1,2,3,2,4,3,2,2,3,7,3,2,2,4,3,9,2,1,3,1,1,3,3,1,5,3,5,3,9,2,2,1,1,1,2,2,6,2,1,2,1,3,0,3,6,2,0,3,1,4,2,7,12,0,2,8,2,13,9,8,7,8,2,6,1,3,2,2,4,6,9,11,2,4,3,0,3,1,1,0,1,1,0,2,0,2,0,0,2,5,2,3,0,0,2,1,2,7,5,0,0,2,0,1,4,0,2,3,5,4,2,2,2,2,4,2,3,1,4,4,1,2,6,1,1,1,6,2,4,4,2,2,2,0,7,1,0,2,4,1,4,0,1,3,1,5,4,5,0,1,2,0,2,3,3,2,5,0,0,12,2,1,0,2,1,2,0,1,1,4,6,0,6,3,1,0,4,1,4,2,2,3,1,3,0,0,0,3,1,5,9,2,4,4,3,4,0,3,7,0,2,5,2,0,2,3,6,4,3,3,1,2,6,1,1,1,1,6,11,0
assist,2,1,3,61,3,4,3,11,1,1,11,2,7,31,0,3,2,5,1,3,1,15,9,15,10,7,12,8,7,9,0,71,56,13,14,39,21,0,4,4,3,7,1,8,13,2,13,16,86,21,20,9,11,36,4,1,29,8,4,16,6,5,2,6,1,4,40,4,1,1,17,1,4,1,54,6,10,3,21,9,14,1,5,5,74,10,8,0,4,2,2,5,0,13,13,9,4,2,27,9,12,15,9,4,7,17,2,0,5,2,8,2,4,7,5,7,0,0,29,30,8,10,2,30,5,4,2,2,0,0,13,4,5,30,13,41,1,2,1,2,2,16,7,3,1,27,7,5,3,3,17,3,7,4,2,29,17,9,8,32,5,2,14,3,6,5,1,21,16,7,2,28,20,2,6,3,38,2,2,38,9,6,24,10,4,12,11,5,2,12,1,0,3,1,0,3,10,7,2,6,17,2,4,4,12,10,1,14,3,10,28,4,9,3,2,1,1,5,10,2,1,6,2,9,9,34,6,6,1,17,11,8,8,10,12,8,15,17,9,4,21,23,7,3,10,9,1,10,35,4,4,4,13,3,1,4,2,6,1,10,0,17,2,1,4,20,10,7,8,7,47,6,7,3,1,3,6,10,1,5,19,1,6,11,1,7,6,1,4,2,5,4,1,5,2,4,6,3,2,10,8,12,4,1,7,0,14,1,4,5,10,8,14,12,5,4,9,13,6,9,12,0,9,4,12,1,7,11,1,7,4,4,0,3,2,14,5,5,9,3,8,5,6,4,2,4,12,21,23,8,1,4,0,13,6,5,1,4,7,13,15,16,15,4,5,1,13,4,6,8,2,19,5,18,4,24,6,0,10,1,36,1,21,10,7,13,8,4,11,2,7,7,5,1,10,5,11,3,8,2,8,3,1,6,2,4,2,2,18,18,5,4,4,5,4,9,6,2,3,7,1,4,18,7,5,3,3,4,3,2,1,0,0,5,1,2,4,6,7,1,6,12,14,6,2,9,14,6,11,5,17,2,8,4,5,2,4,1,5,7,7,5,13,12,5,5,10,2,4,1,11,2,1,0,1,2,2,4,13,1,4,13,2,1,3,0,8,3,2,2,35,8,3,4,6,1,2,5,6,2,3,5,2,4,3,15,6,4,0,0,2,2,0,1,6,2,5,3,0,5,4,11,2,6,1,0,9,2,3,11,3,2,4,3,3,7,0,6,7,3,0,1,4,16,5,0,2,3,0,4,6,0,6,17,10,2,8,1,8,2,3,2,6,5,3,3,6,3,15,15,4,2,4,3,9,1,20,2,0,11,2,12,4,4,3,1,5,0,1,6,9,5,4,2,14,5,3,6,6,7,1,1,2,1,1,7,2,11,4,4,16,2,16,4,2,4,5,2,4,1,3,1,5,4,7,3,1,3,2,13,3,9,4,5,4,3,5,6,2,8,2,4,2,7,3,8,7,13,2,45,10,2,3,0,5,6,14,4,2,2,0,4,1,0,1,0,3,5,6,6,5,0,4,9,4,1,2,2,1,2,2,16,3,3,6,3,4,8,1,1,7,8,5,6,2,4,2,0,7,7,4,1,1,1,4,3,4,7,1,2,1,1,0,8,5,7,6,1,0,3,3,3,0,13,1,4,3,0,1,3,5,15,0,2,2,0,7,3,3,10,3,3,5,1,1,1,3,27,10,3,5,0,5,0,1,4,3,6,4,0,0,3,0,4,4,7,5,5,20,3,7,5,1,8,3,6,10,2,0,1,0,2,2,2,5,6,1,2,6,5,0,4,0,2,1,9,1,1,1,1,2,3,2,2,5,2,1,1,0,2,3,4,0,2,0,2,1,5,0,0,0,0,4,26,0,3,3,2,2,0,3,0,9,3,4,6,4,2,2,8,1,3,2,1,0,2,6,11,0,5,2,8,3,0,4,2,1,0,2,1,1,1,2,11,2,3,1,1,3,5,5,2,0,2,4,3,2,1,3,1,1,0,0,0,4,3,1,0,0,3,5,1,0,1,1,2,3,5,3,3,1,3,4,4,7,1,1,1,5,3,7,10,2,2,1,1,0,2,2,1,0,0,1,6,2,2,0,1,3,1,3,6,1,4,0,0,7,2,2,9,2,5,4,0,5,4,1,10,6,0,0,1,2,3,1,1,1,3,6,0,1,1,1,1,0,2,3,0,1,1,0,0,1,2,1,0,4,0,1,1,1,4,1,2,4,2,4,10,3,1,2,1,1,1,9,4,5,2,0,6
exhibit,6,6,1,59,6,0,2,19,0,1,7,7,1,31,2,3,1,6,1,1,3,14,1,4,10,3,2,6,2,7,6,100,77,2,24,28,27,10,5,8,2,5,2,1,9,6,9,11,121,2,28,1,18,26,1,4,27,73,0,17,5,8,3,8,4,2,39,2,4,16,9,1,2,1,13,4,3,5,43,8,52,0,4,3,92,6,17,0,40,2,1,4,0,20,28,2,7,4,20,16,7,21,13,2,2,14,3,3,7,7,6,3,6,5,0,15,4,0,23,64,21,5,0,74,6,0,0,5,6,1,5,1,6,18,2,21,1,0,0,4,1,15,15,1,1,29,3,10,5,14,17,1,12,10,5,17,10,5,2,2,7,6,2,0,0,0,3,5,16,1,9,39,4,0,0,6,65,2,4,11,9,6,0,3,3,8,20,5,6,14,0,4,7,0,1,5,1,2,11,6,12,0,1,6,15,4,1,14,2,6,28,3,6,0,0,0,3,2,16,4,7,7,11,5,22,44,20,15,4,4,7,12,13,11,15,26,12,3,3,1,26,21,3,1,9,2,5,4,18,1,6,8,12,17,10,5,10,1,5,21,0,8,10,1,3,83,5,0,8,3,69,7,40,3,4,0,4,22,8,1,37,4,0,12,10,1,2,6,9,2,3,1,1,2,4,5,19,0,7,11,11,14,1,2,2,1,10,5,2,1,0,9,12,3,10,24,6,19,6,1,14,3,3,5,9,1,0,9,3,23,3,6,4,0,0,8,3,3,7,14,4,2,11,2,5,1,15,23,5,1,7,4,1,8,7,11,3,3,6,18,5,1,1,12,9,0,11,6,2,3,1,2,0,2,1,26,3,1,7,9,23,1,13,5,0,19,3,9,16,0,7,0,3,1,18,5,14,13,9,14,4,0,4,0,3,4,5,2,11,9,2,0,8,15,5,8,0,6,0,1,0,2,6,1,0,0,1,12,5,7,5,9,5,3,9,5,0,5,5,3,8,7,3,6,3,2,4,6,38,7,10,7,0,0,32,1,0,1,1,7,5,6,9,16,4,0,6,2,3,0,2,1,3,1,0,1,2,11,5,2,0,13,2,1,11,2,8,3,0,4,63,36,3,2,6,6,8,7,5,5,7,4,8,0,1,17,1,8,2,4,3,3,5,2,5,6,1,4,0,5,2,4,7,8,2,0,5,0,7,9,0,1,6,2,1,5,3,3,9,12,3,3,1,0,4,5,2,14,2,3,12,2,2,26,3,7,11,0,1,7,14,0,4,3,8,4,5,6,15,13,9,5,14,1,7,2,4,6,5,10,10,16,7,4,4,4,4,4,0,5,6,13,5,3,9,1,1,0,10,4,14,2,5,4,1,9,1,18,3,2,12,15,2,8,6,6,6,4,3,1,6,5,4,3,1,5,8,8,7,10,6,18,3,7,12,2,2,6,1,3,9,0,1,26,1,60,1,1,1,62,4,1,8,3,1,10,17,2,1,6,1,1,3,4,3,2,0,5,5,4,5,1,29,20,4,2,6,4,0,0,1,14,9,7,8,8,7,0,2,3,8,2,13,14,1,13,5,0,4,4,2,1,3,0,14,5,7,6,0,6,5,9,3,17,2,20,8,6,2,5,8,1,2,17,0,5,4,1,7,6,3,10,1,2,5,18,28,3,15,10,3,2,7,3,4,0,11,4,2,4,5,15,3,14,5,11,2,8,4,8,7,3,3,2,15,11,7,6,5,2,2,1,0,3,5,6,3,7,8,1,2,5,7,1,6,3,0,15,6,12,4,6,1,6,2,5,0,5,12,4,1,0,7,5,2,3,3,8,6,5,4,0,0,1,1,3,4,1,6,3,3,8,8,15,7,2,1,4,4,2,6,5,7,3,3,12,9,9,6,2,4,1,5,1,5,4,4,0,9,8,5,11,1,5,0,0,2,5,1,2,13,0,2,0,2,7,1,2,5,13,8,1,2,6,3,7,0,7,4,4,9,5,6,3,12,4,2,9,2,1,2,4,0,3,3,3,1,2,5,1,6,4,3,4,13,2,1,2,3,8,1,6,3,5,3,3,1,2,7,2,6,2,2,9,0,4,0,3,1,3,7,0,4,5,4,4,2,3,1,7,4,2,17,9,10,10,9,15,30,2,2,3,3,1,2,14,6,2,3,3,18,2,1,2,1,15,11,4,0,3,10,3,1,2,4,5,4,2,12,5,15,3,0,4,1,0,5,1,8,0,6,1,1,0,0,5,0,7,0,0
commitment,1,6,1,37,11,6,3,5,2,0,2,1,9,37,1,1,8,2,7,5,1,3,29,16,2,11,12,16,8,12,3,45,30,8,13,45,23,0,9,6,4,13,2,7,15,1,12,7,16,54,8,13,5,31,9,3,2,3,13,4,1,3,0,2,9,4,24,4,1,1,7,1,4,0,63,6,8,0,7,9,19,3,1,6,24,5,0,2,4,0,4,4,2,13,7,2,3,0,20,2,5,7,2,8,5,4,5,1,3,4,9,1,6,6,6,5,0,0,11,15,5,21,9,39,3,2,2,2,1,4,13,3,6,21,10,34,1,4,6,0,4,10,3,0,3,33,2,6,1,1,4,5,3,4,4,4,17,8,4,24,2,4,4,1,27,4,0,7,5,2,1,25,5,1,5,2,3,1,0,33,2,2,11,6,0,8,5,2,1,11,3,1,1,4,4,3,7,3,3,0,2,1,1,0,12,6,5,6,4,10,20,11,7,5,3,8,13,12,7,3,4,4,0,0,12,5,4,6,1,22,3,10,9,4,3,2,7,6,0,2,12,5,0,2,4,1,7,30,17,6,2,1,8,1,0,7,1,5,0,1,0,14,6,0,0,2,7,17,9,0,6,8,1,2,1,8,6,4,0,0,19,0,4,2,1,5,13,15,3,2,0,3,3,4,3,3,5,2,3,2,2,1,5,1,0,12,2,2,1,1,4,6,36,16,8,1,10,5,3,0,4,0,8,5,6,0,3,19,2,9,4,0,2,1,0,0,7,3,1,2,1,4,13,0,1,3,3,9,7,15,2,3,1,12,1,0,3,0,5,18,8,3,10,4,0,5,4,4,12,16,1,22,2,9,0,2,0,0,4,0,13,2,4,0,16,7,0,2,10,2,2,6,3,0,0,1,4,0,1,2,4,7,1,11,1,2,0,0,1,5,1,2,6,1,1,10,7,1,2,12,1,1,4,0,3,0,7,0,0,2,0,0,0,3,4,3,7,5,15,3,4,1,4,16,2,5,11,7,0,1,38,1,11,8,1,2,3,0,2,0,8,8,8,12,2,1,12,5,1,1,10,3,1,2,3,1,0,2,3,1,1,3,0,1,3,0,1,3,0,2,21,2,1,3,6,0,0,2,3,1,0,0,1,2,0,5,0,1,1,2,1,1,3,0,3,0,3,0,0,7,0,0,0,1,1,3,4,2,1,0,1,3,2,2,1,1,0,2,4,0,5,8,3,2,0,1,0,0,0,0,0,0,0,6,0,1,2,0,1,0,0,1,0,2,2,0,1,0,5,5,3,0,0,1,0,0,0,0,1,9,0,1,1,5,1,1,1,0,1,5,6,1,10,1,4,0,0,3,8,2,1,2,1,0,0,0,2,4,0,0,2,5,1,1,0,0,0,2,0,0,0,0,0,4,1,0,1,0,0,2,5,0,2,1,0,1,0,2,1,1,1,1,0,0,0,1,2,4,5,16,1,0,2,1,1,5,1,3,0,1,0,3,0,0,1,0,0,5,0,2,0,0,0,0,2,2,0,1,1,0,2,10,2,0,0,0,2,9,1,0,0,7,0,0,0,2,1,0,1,0,2,0,0,0,4,3,2,3,1,0,1,0,0,4,3,1,10,0,0,1,0,0,2,1,0,2,0,2,0,2,0,2,0,1,0,0,0,0,0,0,4,0,0,0,0,0,3,9,2,0,2,1,3,1,3,4,0,1,0,0,0,8,2,2,3,5,1,0,0,2,3,3,1,0,1,3,1,2,0,0,0,0,1,0,4,2,0,0,2,2,6,0,0,0,0,0,0,0,1,0,0,1,0,0,4,3,1,2,1,2,1,0,0,0,0,0,0,4,0,1,0,0,4,0,2,0,4,1,1,0,4,0,1,5,2,1,0,1,0,0,0,0,0,5,0,8,0,6,2,6,1,0,0,0,0,2,0,0,0,1,1,0,0,5,0,1,0,0,3,1,0,1,0,0,3,0,0,0,6,0,0,0,0,4,0,0,1,0,2,2,1,3,1,2,0,0,0,1,0,4,0,0,7,2,1,0,0,2,0,2,1,0,0,0,1,0,0,0,4,2,0,1,0,0,0,0,0,0,0,0,0,1,0,0,1,0,0,0,0,1,1,3,5,0,1,5,3,3,0,0,0,1,0,2,1,0,0,1,3,0,3,0,0,0,0,0,0,1,1,0,3,3,1,11,0,0,7,1,0,0,0,2,0,0,0,1,1,9,0,2,1,1,0,1,4,1,1,0,3,6
housing,0,1,1,37,2,6,0,0,1,0,1,15,13,12,0,0,2,2,1,0,1,4,6,0,3,10,0,6,1,1,0,36,11,2,7,3,1,7,12,1,2,2,0,5,4,1,6,29,24,16,6,5,4,5,14,0,1,1,11,7,0,0,2,3,1,6,15,11,0,3,27,0,2,1,36,1,6,0,13,5,21,12,0,4,28,7,0,0,4,0,3,1,11,3,13,24,4,0,14,15,33,13,3,2,7,6,0,5,9,3,3,4,8,17,21,9,0,1,15,27,5,22,4,46,4,0,4,8,4,3,4,0,9,25,4,33,0,9,1,1,1,17,7,1,1,26,1,9,3,0,8,13,1,4,0,34,11,3,0,40,8,0,5,2,6,12,2,9,14,3,4,14,13,3,2,0,5,0,0,29,5,1,36,8,1,11,7,2,2,3,3,0,0,4,1,1,12,1,6,1,14,5,7,3,2,4,1,5,4,4,26,5,11,4,0,14,1,2,2,0,0,3,1,1,8,13,2,4,0,2,2,6,2,9,1,2,4,13,7,0,0,5,4,1,3,2,3,11,35,4,3,4,11,1,0,0,0,1,0,16,0,2,1,3,0,6,12,1,2,3,2,13,1,0,1,3,5,1,1,0,14,1,4,1,4,5,14,10,1,1,0,1,3,7,0,0,3,1,0,1,2,17,0,0,3,4,3,1,1,2,2,11,13,4,5,0,3,4,9,4,8,0,14,7,4,0,9,4,1,3,0,1,0,0,0,4,2,0,10,1,1,2,2,2,0,1,8,6,13,28,0,6,0,9,0,6,1,0,0,2,27,2,6,10,0,1,2,0,7,5,2,8,3,10,3,5,0,0,0,1,4,2,7,4,6,5,2,5,2,1,3,8,15,2,2,5,1,0,0,1,1,2,2,4,1,2,0,0,0,4,1,0,3,12,0,2,0,0,0,0,2,0,9,0,0,1,0,0,1,0,0,1,0,1,4,3,0,0,3,1,3,1,5,0,0,0,13,3,6,2,5,0,3,1,3,1,0,1,2,0,1,7,3,2,5,0,39,4,3,0,1,2,0,2,0,3,0,2,3,3,0,0,0,0,0,0,2,1,2,3,8,2,1,5,1,1,3,1,2,4,0,1,1,11,1,6,7,3,3,1,4,0,0,2,0,0,9,0,0,5,0,3,0,1,0,1,3,0,0,5,3,2,2,2,5,0,0,0,3,3,1,1,0,2,21,1,0,13,0,0,0,0,0,3,5,0,1,2,2,0,6,1,6,1,0,0,0,0,4,9,0,1,1,0,0,0,1,0,0,3,0,1,1,1,0,0,2,0,1,2,4,2,6,1,7,0,2,4,0,0,3,0,1,0,1,0,0,0,3,0,5,3,3,4,4,1,0,0,0,0,1,0,1,4,2,1,0,4,1,6,0,0,3,0,4,7,10,3,0,1,1,3,0,3,0,0,6,3,9,5,0,2,1,1,2,1,0,0,0,0,0,0,0,0,0,0,0,0,0,0,0,1,0,0,1,0,0,0,0,0,0,4,0,0,1,1,2,11,0,1,2,12,1,0,0,4,0,0,0,0,3,1,0,0,0,1,1,0,0,0,2,0,0,7,2,2,0,0,1,2,0,2,0,0,0,0,0,0,0,1,0,7,0,0,0,0,0,0,0,4,1,0,14,0,0,6,2,12,6,0,0,0,0,0,1,3,0,4,4,1,0,1,0,6,3,6,25,1,0,0,4,0,5,0,1,2,7,1,0,0,0,1,1,3,0,0,0,0,3,1,0,10,3,0,0,0,0,2,0,0,0,0,0,1,0,2,0,1,2,2,1,0,0,0,0,0,2,1,0,0,0,0,0,0,0,0,0,5,0,4,1,2,4,1,1,0,0,3,1,1,0,1,0,1,0,3,3,0,1,1,1,9,2,0,0,0,0,5,0,3,2,0,0,1,0,0,0,0,0,1,2,3,0,0,1,0,0,0,0,3,0,0,1,0,3,0,2,1,0,3,2,0,5,0,0,0,0,1,5,3,9,0,1,2,0,0,0,0,0,2,8,9,1,0,0,0,1,0,0,0,0,0,3,0,0,0,0,0,4,1,2,2,0,0,0,0,5,0,0,5,0,1,7,0,0,1,0,0,1,0,0,4,4,14,3,0,0,0,13,0,0,0,0,0,3,0,1,1,0,0,0,0,9,1,0,0,13,0,1,0,0,0,0,0,0,1,3,11,0,2,1,9,0,4,1,2,4,3,0,0
income,1,2,1,67,1,12,1,3,1,4,2,0,15,28,1,1,5,5,6,1,2,18,20,20,5,8,2,6,8,1,0,77,43,3,17,35,6,10,21,2,13,2,0,13,14,3,20,12,61,14,12,8,4,11,37,0,17,13,13,5,5,1,1,6,20,4,61,17,3,7,57,0,4,1,59,9,23,3,31,17,75,7,4,5,90,14,4,4,27,3,6,10,35,12,13,23,10,1,26,21,1,17,15,2,11,11,33,27,14,4,19,1,29,6,25,32,0,5,42,103,29,25,242,151,8,2,2,9,6,9,11,3,18,28,14,42,2,5,1,6,6,21,5,2,1,34,3,15,11,19,13,6,5,4,14,29,16,6,3,31,29,6,2,8,19,22,0,12,17,2,2,52,12,2,2,6,74,0,2,30,8,4,11,6,1,8,26,6,12,22,2,0,3,2,7,4,15,5,10,25,25,6,7,4,14,3,4,31,8,7,23,2,13,42,8,17,11,20,9,0,17,15,2,19,16,47,16,23,8,29,12,8,43,2,23,61,8,8,6,1,35,10,5,6,7,24,5,19,30,2,8,26,7,14,7,10,4,8,2,19,1,4,7,0,3,40,7,6,3,2,50,13,37,0,0,3,12,52,4,4,19,2,5,14,13,0,26,22,6,1,0,2,7,7,5,1,35,3,0,6,11,27,6,11,6,3,3,3,10,8,2,21,19,5,73,10,21,19,10,6,11,7,11,6,12,1,8,11,3,9,0,15,0,6,4,9,8,1,2,3,5,4,5,2,4,2,15,15,4,41,12,5,1,10,14,7,4,0,5,20,12,14,5,14,0,1,8,3,11,14,4,18,4,9,4,12,3,15,1,18,19,1,15,5,4,11,2,17,6,1,7,4,10,1,4,1,13,6,14,2,4,3,6,0,3,3,5,1,5,2,1,2,3,12,0,1,2,3,0,1,1,1,5,2,2,2,3,2,1,6,4,6,1,13,1,0,0,1,2,1,4,2,0,2,0,1,6,1,8,10,10,1,3,2,14,0,0,10,3,6,10,11,9,14,3,0,13,4,3,5,9,4,1,4,3,16,1,2,17,1,1,1,0,0,0,4,4,1,0,1,23,12,0,3,3,0,1,6,6,1,12,7,11,15,4,6,25,3,9,0,2,0,1,1,2,2,7,1,2,9,0,7,1,7,0,0,4,12,6,12,12,1,0,5,1,7,2,0,12,10,0,0,1,28,9,2,0,11,5,2,2,0,3,16,2,3,5,3,10,2,6,0,3,0,3,4,7,3,9,10,13,1,11,0,1,0,7,1,4,14,4,0,6,4,1,4,3,6,0,3,11,8,9,8,15,2,11,13,3,5,8,2,7,0,0,9,5,10,2,5,15,0,0,3,9,0,3,0,5,0,3,1,2,2,0,10,0,5,4,12,2,4,7,3,3,6,10,15,2,2,11,1,3,8,7,9,10,1,2,31,2,1,1,4,3,3,11,6,2,1,1,0,3,6,0,0,0,0,0,4,1,2,0,11,1,4,9,1,5,0,4,3,3,7,2,5,3,1,0,0,5,5,4,0,3,2,3,0,25,5,0,1,0,1,6,4,16,1,2,1,0,8,2,7,6,1,0,2,2,6,0,2,0,2,1,2,2,2,0,5,1,6,4,4,2,5,0,5,0,7,5,0,0,0,0,1,8,2,1,4,1,26,14,9,9,9,7,6,3,41,26,6,2,5,10,8,2,6,17,2,1,2,13,11,1,2,9,2,0,4,0,0,7,1,10,3,3,0,9,12,4,7,0,3,2,14,0,7,2,0,0,3,4,5,2,0,4,4,7,0,3,0,0,9,1,1,4,3,0,6,0,4,1,3,2,1,3,2,1,8,4,4,1,1,1,1,2,7,0,1,2,1,6,0,14,6,4,0,7,1,4,1,2,9,2,0,2,6,0,7,0,4,1,2,0,1,1,4,0,2,1,1,4,6,0,1,0,4,1,4,0,2,0,1,8,0,2,2,3,1,1,0,12,0,1,2,0,1,5,2,4,0,0,1,1,1,1,1,8,8,1,6,2,6,2,1,1,0,6,6,1,2,1,1,0,0,0,2,2,1,4,11,0,2,0,9,2,6,2,8,4,17,10,3,23,12,38,18,33,0,0,4,0,1,3,10,2,0,3,0,4,0,1,1,13,0,3,25,0,0,0,0,23,6,1,0,2,0,2,0,18,1,0,2,3,29,6,5,0,4,1,4,5,1,2,1,16,0,0,1
worker,0,8,1,21,3,21,2,3,0,3,0,6,9,20,1,2,10,11,5,0,1,8,27,9,3,14,11,11,9,10,3,86,34,1,22,34,2,8,16,1,5,7,1,9,19,3,20,4,27,66,13,4,8,29,19,2,0,2,9,7,0,1,1,5,27,3,38,6,2,4,38,2,3,1,68,5,26,1,29,13,43,10,3,8,34,14,0,0,7,3,5,7,14,3,11,11,4,1,11,25,6,9,5,6,4,8,5,13,10,1,9,2,22,21,72,15,0,0,14,30,13,23,21,42,9,0,1,9,0,1,10,12,16,26,5,81,0,4,2,5,5,12,21,1,2,25,6,17,3,2,12,10,10,0,3,9,11,6,0,41,5,3,11,8,8,38,6,11,16,2,11,26,17,4,3,2,12,0,5,58,9,3,19,17,1,18,16,6,0,11,5,4,7,1,3,2,13,3,4,2,36,6,9,3,8,9,0,17,8,6,39,11,18,20,7,38,3,8,2,2,5,9,3,6,5,14,9,13,2,8,2,4,8,6,15,0,4,3,13,1,21,20,13,7,12,3,5,18,25,10,1,11,7,2,1,17,0,3,0,9,12,5,1,0,5,1,15,7,7,1,8,9,6,6,0,4,16,2,0,1,33,3,4,8,6,3,16,12,9,7,1,1,14,9,6,6,12,2,0,7,9,4,7,3,12,11,4,2,10,11,2,2,6,6,48,4,26,10,2,1,3,1,13,3,22,1,5,16,0,3,3,2,2,0,2,5,3,0,3,5,2,9,20,3,2,3,3,11,2,25,2,0,0,14,5,5,5,1,5,10,15,12,6,3,2,4,5,2,11,17,0,7,5,11,5,9,4,8,6,2,7,6,8,1,8,5,1,10,24,4,2,3,3,0,3,2,2,0,6,1,2,1,2,1,3,3,8,1,29,7,2,2,5,5,0,1,1,3,2,0,2,2,7,2,6,3,0,3,0,2,1,1,0,2,5,4,0,1,3,3,4,11,0,11,2,1,10,4,4,9,13,0,11,4,9,8,0,0,5,2,15,10,12,14,11,0,16,9,0,7,11,4,2,1,1,11,7,0,7,5,3,4,0,1,6,1,3,0,0,0,21,6,1,4,1,0,3,2,4,4,2,2,0,12,20,6,10,4,5,2,0,0,0,3,5,1,3,2,0,4,3,2,0,0,1,1,5,3,1,12,4,1,2,3,3,6,0,6,9,5,1,0,6,26,19,1,2,7,1,2,0,0,1,4,3,2,0,1,10,2,1,0,0,3,0,0,1,2,2,10,2,0,0,2,2,0,3,2,3,21,2,2,5,5,1,7,2,2,0,5,5,3,7,7,23,0,11,41,0,3,7,0,9,0,1,0,1,1,1,0,7,1,0,0,1,2,0,8,0,0,2,1,1,3,6,0,0,1,1,7,3,2,6,3,1,4,2,3,2,5,2,5,2,3,0,1,12,2,1,14,1,2,0,0,4,2,3,4,3,4,0,3,0,0,0,0,0,8,1,2,0,0,0,1,3,0,0,0,0,0,0,3,1,0,0,0,2,7,2,0,4,16,1,0,0,0,0,0,1,0,5,1,0,0,5,3,2,1,1,0,2,0,1,8,5,0,1,1,3,4,0,3,3,1,8,4,0,4,0,7,0,6,6,2,0,1,0,1,0,5,7,0,3,3,0,1,2,4,3,2,2,0,0,0,2,4,1,1,2,11,10,6,0,2,9,6,4,0,4,0,13,2,8,5,1,7,7,4,0,1,0,0,0,4,4,4,1,0,3,2,0,3,2,0,9,8,2,0,0,1,3,2,2,0,7,2,3,1,4,0,1,0,0,2,1,0,1,2,0,0,0,0,2,3,0,0,12,0,0,1,6,1,1,0,5,2,0,7,2,2,0,0,0,10,2,0,4,2,0,0,4,3,1,0,3,0,3,1,0,1,0,4,3,3,0,0,0,0,0,4,2,0,1,1,2,4,1,0,0,14,1,0,0,0,1,0,0,3,5,0,5,0,17,0,0,0,0,1,6,3,1,0,2,1,0,0,0,1,0,4,3,5,0,0,0,0,1,0,6,0,0,1,0,2,1,0,1,0,3,2,2,11,0,1,0,0,0,1,1,2,1,2,1,0,2,8,1,4,3,1,1,6,4,1,1,0,0,0,0,0,0,0,1,6,2,0,0,10,0,0,0,0,11,4,0,0,2,0,3,0,1,0,1,4,1,2,2,14,0,3,1,5,0,1,4,16,1,0,7,2
commence,2,10,1,80,8,0,3,21,3,2,19,1,4,24,5,3,2,4,2,1,4,15,1,7,7,4,4,6,1,19,9,120,49,1,21,15,18,7,3,2,7,0,2,2,20,8,13,6,185,3,27,2,5,4,1,2,29,30,0,8,8,0,2,9,11,1,27,0,3,10,1,15,4,1,13,6,7,2,35,9,16,0,11,0,88,11,2,0,38,2,16,2,0,24,35,1,9,5,27,4,18,27,24,1,3,13,4,3,12,2,13,4,3,9,0,20,9,8,56,77,17,4,5,65,1,2,1,2,4,1,2,3,0,26,5,50,1,2,2,4,0,12,16,2,3,36,3,2,9,8,32,2,23,4,0,3,7,5,7,0,6,0,4,0,0,0,1,7,10,6,13,41,3,0,2,4,75,3,6,9,16,7,1,4,9,6,14,10,16,45,2,8,4,0,1,1,8,1,8,5,8,0,2,9,11,0,2,20,9,14,39,2,12,2,0,0,1,0,10,3,8,6,5,11,32,32,18,20,4,0,7,19,18,4,8,14,23,8,2,1,24,15,5,2,6,2,3,6,14,0,6,11,10,4,11,13,4,1,1,7,0,16,15,2,4,22,1,1,7,2,63,5,38,4,4,0,9,13,4,2,23,0,0,9,5,1,0,3,3,1,9,4,7,11,0,6,41,3,2,13,3,19,3,1,2,0,14,4,0,0,1,5,13,3,18,18,5,17,11,2,27,2,11,2,17,1,2,8,5,10,1,7,4,2,4,13,6,5,5,12,2,6,10,2,1,3,19,36,8,3,4,7,3,4,9,2,4,1,8,45,8,3,1,4,3,0,21,6,1,3,0,3,0,2,0,23,4,2,12,8,26,0,28,4,1,25,1,5,26,0,8,2,9,7,24,1,37,8,18,5,11,0,3,0,6,0,4,0,8,7,0,6,5,2,1,14,0,1,0,0,1,7,7,7,0,3,1,9,13,15,6,3,15,7,1,0,0,21,10,5,9,11,1,5,0,2,0,4,13,4,5,2,0,6,32,3,0,12,4,17,2,11,11,5,4,1,7,6,2,0,3,0,1,0,1,2,3,8,0,2,6,6,0,0,6,9,2,5,0,3,65,40,3,3,0,14,0,14,4,7,3,0,1,2,6,16,0,6,4,6,0,1,7,2,4,11,2,9,2,4,1,11,7,6,0,3,12,1,10,14,3,1,6,3,8,4,12,2,17,12,2,2,0,0,4,11,8,7,2,4,18,6,4,22,3,2,22,1,4,2,14,5,15,2,16,8,16,4,22,12,10,7,26,0,2,15,3,3,4,4,0,9,8,0,8,1,1,1,2,5,14,19,8,0,9,7,0,0,30,4,14,2,2,2,7,11,10,5,3,6,15,12,8,4,3,1,13,0,3,5,7,1,4,13,3,4,6,2,11,10,6,14,13,10,10,2,0,4,4,6,8,0,3,30,4,27,0,4,2,107,7,2,5,0,1,9,19,15,2,7,2,4,10,16,8,2,0,3,7,6,6,2,95,5,14,2,3,14,2,3,8,15,13,6,10,3,4,1,5,9,12,0,7,3,8,24,5,1,5,14,5,1,9,1,6,7,8,9,0,2,1,25,2,17,13,23,15,4,2,5,17,4,21,13,2,7,4,0,1,7,0,8,0,1,1,5,14,1,33,4,6,9,3,1,3,1,5,1,5,4,8,15,18,36,23,9,2,7,1,2,2,3,9,18,8,15,8,4,0,6,3,0,0,7,4,12,7,3,9,11,3,2,12,0,2,1,3,40,2,3,7,12,8,3,4,10,4,3,0,4,4,3,10,10,2,1,3,6,12,6,4,2,11,8,1,1,4,10,6,4,3,6,0,8,8,6,0,6,5,3,8,19,6,4,10,3,9,16,5,6,9,6,2,1,1,16,6,2,8,7,17,14,2,6,1,2,1,7,6,1,8,1,1,2,7,6,1,1,3,2,1,4,10,18,1,3,6,6,7,0,3,6,0,7,21,1,9,4,1,11,1,14,0,5,4,12,5,2,8,1,1,6,5,6,5,5,4,9,1,7,2,7,0,15,10,9,0,11,3,1,15,9,1,0,0,7,0,17,2,4,4,1,11,8,7,5,0,2,1,18,3,6,30,6,10,13,19,53,24,10,2,4,1,4,4,19,6,2,10,0,4,9,3,4,3,18,4,0,0,3,10,3,0,1,8,3,0,2,5,3,3,0,7,2,5,1,9,2,15,0,6,2,7,0,3,0,0,1,0,0
science,2,4,5,29,0,9,4,10,1,3,3,7,7,26,2,6,1,5,1,1,3,7,12,3,3,6,8,5,1,1,5,62,49,3,15,38,20,0,1,6,1,5,2,0,8,6,17,7,42,41,7,4,11,45,38,5,5,5,15,14,6,7,8,5,9,2,40,4,1,1,7,0,4,3,49,6,8,0,19,11,29,0,6,6,36,0,4,0,3,1,1,1,2,3,13,2,6,4,14,10,4,8,7,3,5,12,1,2,3,4,13,3,9,14,13,8,1,0,13,33,5,22,4,35,7,1,1,0,1,3,14,8,8,21,4,28,1,4,0,11,2,23,10,2,4,15,4,11,3,4,25,4,3,9,3,8,17,6,2,13,0,0,2,2,5,4,1,2,10,2,9,25,5,2,0,1,20,2,0,18,3,2,13,4,5,5,9,12,2,11,0,1,4,2,2,4,6,2,9,3,9,2,10,1,7,5,3,5,3,13,35,2,2,11,1,12,0,7,4,3,1,7,2,2,8,12,9,4,1,6,9,6,0,8,10,1,13,10,2,3,8,15,2,1,4,0,5,13,22,5,3,7,4,1,1,5,2,0,1,3,0,7,3,0,2,20,43,3,6,7,18,5,1,0,3,4,3,1,3,0,39,1,0,5,7,4,7,2,4,2,0,1,0,3,3,7,11,4,1,10,4,6,0,3,2,2,11,0,2,7,2,19,10,10,4,3,10,13,1,0,9,2,16,17,11,1,6,12,1,6,0,1,1,1,1,2,10,8,0,6,1,4,10,5,2,1,10,16,3,8,2,4,2,12,0,4,4,2,8,5,5,6,18,6,6,5,4,3,6,8,0,12,1,8,4,12,1,1,1,1,7,0,11,3,2,9,1,6,5,0,1,3,3,3,4,1,9,1,4,1,7,9,1,2,2,3,3,2,6,9,0,4,1,6,0,8,0,0,2,0,2,4,17,0,9,1,4,4,2,2,2,1,0,2,5,2,4,1,3,1,2,3,2,7,2,0,7,1,3,5,4,2,4,1,13,1,2,1,3,6,4,10,6,8,10,0,10,5,4,1,21,1,1,4,6,14,9,0,3,4,0,21,3,1,8,0,1,10,0,3,14,3,0,5,1,1,3,4,2,0,2,2,0,0,0,1,0,3,3,0,2,2,1,1,1,4,3,1,0,3,7,3,2,5,1,0,3,0,5,2,2,2,0,2,0,2,2,3,18,1,0,3,1,4,1,0,5,5,4,1,6,2,1,5,2,2,16,0,2,1,6,2,3,1,2,2,5,0,3,11,10,0,1,0,3,0,0,1,2,12,5,2,5,8,1,8,4,0,1,10,5,4,1,0,10,2,8,1,2,3,1,5,2,1,2,5,6,0,3,2,8,3,3,1,3,3,6,1,3,0,4,0,1,1,5,1,6,2,2,4,0,6,5,6,1,1,1,2,9,4,2,5,1,3,1,4,1,0,2,18,2,4,1,0,2,1,4,5,1,5,2,1,1,3,1,0,0,0,1,3,9,1,4,0,1,1,2,0,0,3,1,7,2,1,2,1,2,9,1,2,2,9,1,4,0,8,1,0,0,2,7,1,0,2,5,12,5,4,0,1,2,2,1,9,5,5,0,1,2,4,1,2,2,5,8,1,0,11,2,6,0,4,1,2,1,2,17,3,5,5,0,0,2,5,10,3,6,20,3,1,1,0,0,1,0,5,2,4,0,0,0,1,1,5,11,3,5,0,10,0,5,3,2,1,3,7,2,0,0,3,0,0,4,1,3,4,0,0,4,2,3,2,1,1,0,4,1,0,1,0,3,1,1,0,0,3,2,0,3,0,0,1,1,0,2,0,2,2,0,0,0,1,1,6,0,0,8,2,0,2,2,4,9,1,0,2,1,4,2,2,1,1,1,2,0,1,0,0,1,3,2,2,0,1,5,6,0,1,0,9,1,1,0,10,0,0,3,3,0,3,0,1,1,0,2,2,0,7,8,15,0,0,2,1,1,0,1,0,1,4,6,3,10,2,1,0,3,2,1,4,2,5,10,1,0,1,0,1,0,5,0,2,0,4,1,0,1,4,2,0,2,1,0,1,3,4,4,0,0,0,4,2,2,0,1,0,1,0,0,9,1,3,0,0,1,0,1,1,0,0,5,2,5,0,2,0,1,3,1,0,0,1,0,0,1,3,1,0,1,2,0,1,2,5,0,4,0,1,3,0,2,5,0,0,0,0,2,10,1,7,11,0,0,3,0,0,7,0,1,2
democracy,0,7,1,30,5,26,0,9,4,5,6,2,14,57,0,16,8,6,10,11,4,19,36,20,12,21,29,26,19,29,2,56,35,22,12,77,54,0,0,8,4,64,11,11,29,4,8,7,46,123,25,15,13,98,5,6,1,1,22,9,3,7,4,6,13,7,75,2,2,0,7,0,4,3,57,8,12,0,34,26,14,1,2,4,46,1,0,1,4,0,5,6,5,28,5,1,13,1,33,4,0,8,2,14,1,16,0,3,7,0,19,1,6,13,8,22,0,1,18,21,11,40,1,49,11,9,3,0,2,1,26,5,21,19,28,52,0,3,6,7,7,18,3,3,2,50,6,12,1,0,36,3,5,2,2,2,41,5,0,49,2,0,5,1,3,17,1,13,8,7,2,50,20,5,19,5,17,5,3,23,5,3,13,16,3,15,4,6,2,19,2,1,1,10,3,4,4,6,6,17,1,1,1,4,8,10,0,6,11,5,33,18,13,2,7,16,1,6,9,1,3,6,0,1,13,21,8,4,9,2,3,8,5,8,15,0,10,4,1,6,23,9,2,6,10,4,9,29,12,5,3,2,10,0,0,14,1,1,0,3,0,26,3,0,8,1,4,27,17,0,13,6,0,4,0,10,7,0,0,0,45,2,2,3,3,1,9,5,4,3,0,7,1,1,2,3,7,3,4,8,11,1,0,1,0,2,25,1,5,0,1,3,19,17,2,5,5,2,4,0,19,0,19,3,47,0,7,38,2,24,19,3,0,0,1,1,23,5,1,1,1,12,10,1,2,4,9,22,7,16,1,7,1,19,0,0,7,0,8,23,1,8,5,3,1,16,7,4,30,32,6,62,1,19,3,0,2,0,19,4,6,2,4,3,14,4,0,10,6,4,11,11,3,4,2,7,0,0,1,1,16,19,0,11,0,3,2,1,7,18,4,9,1,3,2,15,9,8,3,23,0,4,13,10,5,0,4,1,2,6,0,0,0,11,5,3,4,9,18,6,10,10,0,15,2,15,35,11,4,4,29,2,21,2,6,2,11,2,3,0,13,7,24,26,1,3,23,6,0,3,17,7,3,3,5,5,1,1,4,2,9,14,8,4,3,1,1,19,0,0,29,4,0,14,12,1,1,1,3,1,3,1,0,3,0,7,0,4,1,3,0,1,0,0,1,0,1,0,6,7,1,6,1,11,0,5,6,2,4,3,4,4,18,0,3,4,0,7,3,0,2,4,8,2,2,0,4,3,1,0,2,0,0,22,0,1,4,2,1,0,0,0,0,1,1,1,9,0,10,11,3,1,0,0,0,0,0,0,0,10,0,0,3,12,4,5,4,0,0,11,22,6,6,3,7,0,1,1,2,4,1,0,1,1,0,4,3,1,1,0,8,2,3,3,0,0,3,1,0,0,0,0,0,8,3,0,1,1,0,5,3,3,7,5,1,1,2,2,4,0,5,6,1,0,0,2,1,8,1,36,0,8,1,0,1,6,0,4,2,0,0,1,0,0,0,0,0,1,1,1,0,0,0,3,0,2,0,1,3,0,3,9,1,3,0,0,4,3,0,0,2,21,0,2,0,5,3,2,6,0,2,0,0,0,4,4,5,3,0,0,1,1,0,1,1,5,14,0,1,0,0,0,0,3,0,2,0,1,0,2,0,0,0,0,0,0,0,0,1,2,1,0,0,1,0,5,4,12,1,0,7,0,0,0,1,2,1,1,1,0,0,7,0,2,5,6,3,0,1,0,11,9,2,2,1,2,2,0,0,1,0,0,1,0,4,4,0,0,4,0,3,0,0,0,0,2,0,2,0,0,2,0,0,0,14,6,1,2,6,0,1,15,0,0,0,0,0,9,0,1,0,0,3,0,0,0,6,1,3,0,11,0,6,5,4,4,3,12,0,4,1,0,0,1,1,0,2,6,0,4,2,8,3,2,0,3,0,0,0,3,0,5,0,5,2,0,5,0,5,0,0,0,1,0,3,12,0,0,4,1,0,1,0,0,0,0,0,0,2,0,8,0,1,0,0,0,1,1,2,22,0,0,8,1,7,0,10,0,0,3,0,0,9,0,2,1,0,0,2,0,0,0,0,0,0,0,5,2,0,0,1,3,0,1,0,0,1,0,4,0,0,3,0,0,0,0,2,0,0,0,0,5,0,1,0,0,1,0,0,0,0,0,0,0,1,0,0,0,2,0,7,1,8,15,1,0,6,1,0,0,0,0,0,0,1,0,2,17,1,5,0,6,0,6,0,1,2,0,2,1
